0,1,2,3,4,5
31000.0,2019-11-01,"(844.718, 915.5]",1,1,0
31000.0,2019-11-01,"(915.5, 986.0]",1,1,0
31000.0,2019-11-01,"(986.0, 1056.5]",1,1,0
31000.0,2019-11-01,"(1056.5, 1127.0]",2,4,-2
31001.0,2019-11-01,"(763.571, 871.25]",1,3,-2
31001.0,2019-11-01,"(1085.75, 1193.0]",1,2,-1
31002.0,2019-11-01,"(357.214, 554.5]",4,10,-6
31002.0,2019-11-01,"(554.5, 751.0]",3,3,0
31002.0,2019-11-01,"(751.0, 947.5]",4,7,-3
31002.0,2019-11-01,"(947.5, 1144.0]",4,7,-3
31003.0,2019-11-01,"(426.32, 597.0]",2,4,-2
31003.0,2019-11-01,"(597.0, 767.0]",2,4,-2
31003.0,2019-11-01,"(767.0, 937.0]",2,2,0
31003.0,2019-11-01,"(937.0, 1107.0]",2,5,-3
31004.0,2019-11-01,"(879.0, 1072.0]",1,4,-3
31004.0,2019-11-01,"(1072.0, 1265.0]",2,1,1
31005.0,2019-11-01,"(439.162, 649.5]",4,5,-1
31005.0,2019-11-01,"(649.5, 859.0]",3,5,-2
31005.0,2019-11-01,"(859.0, 1068.5]",2,6,-4
31005.0,2019-11-01,"(1068.5, 1278.0]",2,8,-6
31006.0,2019-11-01,"(937.0, 1136.0]",5,1,4
31006.0,2019-11-01,"(1136.0, 1335.0]",1,1,0
31007.0,2019-11-01,"(424.017, 670.75]",14,22,-8
31007.0,2019-11-01,"(670.75, 916.5]",4,6,-2
31007.0,2019-11-01,"(916.5, 1162.25]",7,20,-13
31007.0,2019-11-01,"(1162.25, 1408.0]",2,4,-2
31009.0,2019-11-01,"(381.286, 560.5]",4,4,0
31009.0,2019-11-01,"(560.5, 739.0]",1,3,-2
31009.0,2019-11-01,"(739.0, 917.5]",2,3,-1
31009.0,2019-11-01,"(917.5, 1096.0]",2,3,-1
31010.0,2019-11-01,"(777.75, 930.5]",1,2,-1
31010.0,2019-11-01,"(930.5, 1083.25]",1,1,0
31010.0,2019-11-01,"(1083.25, 1236.0]",1,1,0
31011.0,2019-11-01,"(406.987, 661.25]",4,6,-2
31011.0,2019-11-01,"(661.25, 914.5]",2,4,-2
31011.0,2019-11-01,"(914.5, 1167.75]",2,5,-3
31012.0,2019-11-01,"(362.181, 567.75]",5,6,-1
31012.0,2019-11-01,"(567.75, 772.5]",1,1,0
31012.0,2019-11-01,"(977.25, 1182.0]",1,4,-3
31013.0,2019-11-01,"(928.5, 1167.25]",2,6,-4
31013.0,2019-11-01,"(1167.25, 1406.0]",1,1,0
31014.0,2019-11-01,"(171.778, 478.5]",3,4,-1
31014.0,2019-11-01,"(478.5, 784.0]",18,26,-8
31014.0,2019-11-01,"(784.0, 1089.5]",13,27,-14
31014.0,2019-11-01,"(1089.5, 1395.0]",9,13,-4
31015.0,2019-11-01,"(84.755, 397.25]",2,3,-1
31015.0,2019-11-01,"(397.25, 708.5]",10,10,0
31015.0,2019-11-01,"(708.5, 1019.75]",5,13,-8
31015.0,2019-11-01,"(1019.75, 1331.0]",5,7,-2
31016.0,2019-11-01,"(90.017, 336.75]",3,4,-1
31016.0,2019-11-01,"(336.75, 582.5]",3,7,-4
31016.0,2019-11-01,"(582.5, 828.25]",1,1,0
31016.0,2019-11-01,"(828.25, 1074.0]",4,8,-4
31017.0,2019-11-01,"(475.055, 712.25]",7,8,-1
31017.0,2019-11-01,"(712.25, 948.5]",1,4,-3
31017.0,2019-11-01,"(1184.75, 1421.0]",1,6,-5
31018.0,2019-11-01,"(423.272, 606.0]",1,5,-4
31018.0,2019-11-01,"(970.0, 1152.0]",2,1,1
31019.0,2019-11-01,"(675.0, 935.5]",2,1,1
31019.0,2019-11-01,"(935.5, 1196.0]",3,1,2
31020.0,2019-11-01,"(819.5, 1092.0]",1,1,0
31021.0,2019-11-01,"(101.754, 414.5]",2,2,0
31021.0,2019-11-01,"(414.5, 726.0]",1,8,-7
31021.0,2019-11-01,"(726.0, 1037.5]",2,4,-2
31021.0,2019-11-01,"(1037.5, 1349.0]",3,6,-3
31022.0,2019-11-01,"(392.25, 709.5]",2,5,-3
31022.0,2019-11-01,"(709.5, 1026.75]",1,3,-2
31022.0,2019-11-01,"(1026.75, 1344.0]",1,4,-3
31023.0,2019-11-01,"(502.108, 726.0]",2,4,-2
31023.0,2019-11-01,"(726.0, 949.0]",1,2,-1
31023.0,2019-11-01,"(949.0, 1172.0]",1,3,-2
31023.0,2019-11-01,"(1172.0, 1395.0]",1,2,-1
31024.0,2019-11-01,"(371.975, 629.25]",6,9,-3
31024.0,2019-11-01,"(629.25, 885.5]",1,2,-1
31024.0,2019-11-01,"(885.5, 1141.75]",9,16,-7
31024.0,2019-11-01,"(1141.75, 1398.0]",2,5,-3
31025.0,2019-11-01,"(652.5, 814.0]",2,1,1
31025.0,2019-11-01,"(814.0, 975.5]",2,3,-1
31025.0,2019-11-01,"(975.5, 1137.0]",2,3,-1
31026.0,2019-11-01,"(61.652, 400.0]",1,1,0
31026.0,2019-11-01,"(737.0, 1074.0]",3,1,2
31026.0,2019-11-01,"(1074.0, 1411.0]",1,7,-6
31027.0,2019-11-01,"(741.25, 939.5]",1,3,-2
31027.0,2019-11-01,"(1137.75, 1336.0]",2,1,1
31028.0,2019-11-01,"(486.324, 656.0]",3,3,0
31028.0,2019-11-01,"(994.0, 1163.0]",1,1,0
31029.0,2019-11-01,"(686.0, 921.0]",5,12,-7
31029.0,2019-11-01,"(921.0, 1156.0]",3,10,-7
31029.0,2019-11-01,"(1156.0, 1391.0]",1,4,-3
31030.0,2019-11-01,"(2.573, 360.75]",2,2,0
31030.0,2019-11-01,"(1074.25, 1431.0]",4,10,-6
31031.0,2019-11-01,"(77.998, 329.5]",1,1,0
31031.0,2019-11-01,"(830.5, 1081.0]",3,4,-1
31032.0,2019-11-01,"(967.0, 1132.0]",3,2,1
31033.0,2019-11-01,"(550.832, 593.0]",1,1,0
31034.0,2019-11-01,"(433.029, 676.75]",3,5,-2
31034.0,2019-11-01,"(919.5, 1162.25]",3,1,2
31034.0,2019-11-01,"(1162.25, 1405.0]",1,9,-8
31035.0,2019-11-01,"(63.642, 404.5]",1,3,-2
31035.0,2019-11-01,"(404.5, 744.0]",1,4,-3
31035.0,2019-11-01,"(744.0, 1083.5]",2,4,-2
31035.0,2019-11-01,"(1083.5, 1423.0]",1,1,0
31036.0,2019-11-01,"(656.5, 861.0]",1,2,-1
31036.0,2019-11-01,"(1065.5, 1270.0]",2,2,0
31037.0,2019-11-01,"(419.212, 617.0]",12,18,-6
31037.0,2019-11-01,"(814.0, 1011.0]",5,4,1
31037.0,2019-11-01,"(1011.0, 1208.0]",4,9,-5
31038.0,2019-11-01,"(429.24, 620.0]",2,4,-2
31038.0,2019-11-01,"(620.0, 810.0]",1,2,-1
31038.0,2019-11-01,"(1000.0, 1190.0]",3,3,0
31039.0,2019-11-01,"(468.291, 646.25]",4,10,-6
31039.0,2019-11-01,"(646.25, 823.5]",1,3,-2
31039.0,2019-11-01,"(1000.75, 1178.0]",7,1,6
31040.0,2019-11-01,"(407.156, 619.0]",3,3,0
31040.0,2019-11-01,"(619.0, 830.0]",2,4,-2
31041.0,2019-11-01,"(519.296, 696.0]",1,1,0
31041.0,2019-11-01,"(696.0, 872.0]",1,1,0
31041.0,2019-11-01,"(872.0, 1048.0]",3,5,-2
31041.0,2019-11-01,"(1048.0, 1224.0]",3,9,-6
31042.0,2019-11-01,"(456.433, 598.75]",12,14,-2
31042.0,2019-11-01,"(598.75, 740.5]",4,4,0
31042.0,2019-11-01,"(740.5, 882.25]",1,3,-2
31042.0,2019-11-01,"(882.25, 1024.0]",2,6,-4
31043.0,2019-11-01,"(661.432, 804.0]",2,3,-1
31043.0,2019-11-01,"(946.0, 1088.0]",2,2,0
31043.0,2019-11-01,"(1088.0, 1230.0]",2,5,-3
31044.0,2019-11-01,"(493.343, 658.25]",2,3,-1
31044.0,2019-11-01,"(658.25, 822.5]",3,4,-1
31044.0,2019-11-01,"(986.75, 1151.0]",2,1,1
31045.0,2019-11-01,"(482.365, 641.75]",1,4,-3
31045.0,2019-11-01,"(800.5, 959.25]",1,2,-1
31045.0,2019-11-01,"(959.25, 1118.0]",2,2,0
31046.0,2019-11-01,"(905.0, 1091.0]",3,1,2
31046.0,2019-11-01,"(1091.0, 1277.0]",1,5,-4
31047.0,2019-11-01,"(359.965, 619.75]",11,20,-9
31047.0,2019-11-01,"(619.75, 878.5]",2,5,-3
31047.0,2019-11-01,"(878.5, 1137.25]",11,20,-9
31047.0,2019-11-01,"(1137.25, 1396.0]",3,12,-9
31048.0,2019-11-01,"(585.23, 778.5]",5,6,-1
31048.0,2019-11-01,"(778.5, 971.0]",1,2,-1
31048.0,2019-11-01,"(971.0, 1163.5]",3,6,-3
31049.0,2019-11-01,"(749.25, 893.5]",1,1,0
31049.0,2019-11-01,"(1037.75, 1182.0]",1,1,0
31050.0,2019-11-01,"(346.001, 596.75]",1,4,-3
31050.0,2019-11-01,"(1096.25, 1346.0]",1,1,0
31051.0,2019-11-01,"(306.184, 511.0]",1,5,-4
31051.0,2019-11-01,"(715.0, 919.0]",2,3,-1
31051.0,2019-11-01,"(919.0, 1123.0]",5,2,3
31052.0,2019-11-01,"(495.312, 668.0]",4,6,-2
31052.0,2019-11-01,"(1012.0, 1184.0]",5,1,4
31053.0,2019-11-01,"(768.0, 910.5]",1,2,-1
31053.0,2019-11-01,"(910.5, 1053.0]",2,2,0
31054.0,2019-11-01,"(723.879, 754.25]",1,1,0
31054.0,2019-11-01,"(814.75, 845.0]",1,2,-1
31055.0,2019-11-01,"(484.461, 619.75]",1,3,-2
31055.0,2019-11-01,"(889.25, 1024.0]",2,3,-1
31056.0,2019-11-01,"(828.0, 1026.5]",1,2,-1
31056.0,2019-11-01,"(1026.5, 1225.0]",2,1,1
31057.0,2019-11-01,"(458.341, 623.75]",1,3,-2
31057.0,2019-11-01,"(953.25, 1118.0]",2,2,0
31058.0,2019-11-01,"(740.25, 762.0]",1,1,0
31059.0,2019-11-01,"(684.0, 818.5]",1,1,0
31059.0,2019-11-01,"(818.5, 953.0]",1,2,-1
31060.0,2019-11-01,"(631.539, 747.25]",2,2,0
31060.0,2019-11-01,"(977.75, 1093.0]",3,1,2
31061.0,2019-11-01,"(642.25, 762.5]",1,1,0
31061.0,2019-11-01,"(882.75, 1003.0]",1,1,0
31062.0,2019-11-01,"(652.23, 845.5]",7,14,-7
31062.0,2019-11-01,"(845.5, 1038.0]",4,12,-8
31062.0,2019-11-01,"(1038.0, 1230.5]",3,6,-3
31062.0,2019-11-01,"(1230.5, 1423.0]",1,1,0
31063.0,2019-11-01,"(549.5, 824.25]",1,1,0
31063.0,2019-11-01,"(824.25, 1099.0]",1,1,0
31064.0,2019-11-01,"(497.335, 664.25]",3,6,-3
31064.0,2019-11-01,"(996.75, 1163.0]",8,1,7
31065.0,2019-11-01,"(568.25, 755.5]",1,4,-3
31065.0,2019-11-01,"(942.75, 1130.0]",2,2,0
31066.0,2019-11-01,"(472.205, 671.75]",1,3,-2
31066.0,2019-11-01,"(870.5, 1069.25]",2,5,-3
31066.0,2019-11-01,"(1069.25, 1268.0]",2,2,0
31067.0,2019-11-01,"(716.5, 953.0]",2,2,0
31067.0,2019-11-01,"(953.0, 1189.5]",3,2,1
31067.0,2019-11-01,"(1189.5, 1426.0]",1,4,-3
31068.0,2019-11-01,"(970.5, 1104.0]",2,1,1
31069.0,2019-11-01,"(353.154, 565.5]",1,7,-6
31069.0,2019-11-01,"(565.5, 777.0]",1,1,0
31069.0,2019-11-01,"(777.0, 988.5]",3,3,0
31069.0,2019-11-01,"(988.5, 1200.0]",4,5,-1
31070.0,2019-11-01,"(632.5, 813.0]",1,1,0
31070.0,2019-11-01,"(993.5, 1174.0]",3,2,1
31071.0,2019-11-01,"(471.043, 711.25]",3,5,-2
31071.0,2019-11-01,"(711.25, 950.5]",2,6,-4
31071.0,2019-11-01,"(950.5, 1189.75]",3,3,0
31071.0,2019-11-01,"(1189.75, 1429.0]",3,3,0
31072.0,2019-11-01,"(540.0, 720.0]",1,1,0
31073.0,2019-11-01,"(954.75, 1273.0]",1,1,0
31074.0,2019-11-01,"(645.518, 766.5]",1,2,-1
31074.0,2019-11-01,"(766.5, 887.0]",1,1,0
31074.0,2019-11-01,"(1007.5, 1128.0]",2,2,0
31075.0,2019-11-01,"(710.0, 989.0]",1,1,0
31075.0,2019-11-01,"(989.0, 1268.0]",5,1,4
31076.0,2019-11-01,"(422.384, 577.0]",1,1,0
31076.0,2019-11-01,"(885.0, 1039.0]",2,1,1
31077.0,2019-11-01,"(465.297, 641.75]",2,6,-4
31077.0,2019-11-01,"(817.5, 993.25]",7,1,6
31077.0,2019-11-01,"(993.25, 1169.0]",4,9,-5
31078.0,2019-11-01,"(493.305, 667.75]",8,8,0
31078.0,2019-11-01,"(667.75, 841.5]",1,2,-1
31078.0,2019-11-01,"(1015.25, 1189.0]",1,4,-3
31079.0,2019-11-01,"(646.75, 888.5]",3,10,-7
31079.0,2019-11-01,"(888.5, 1130.25]",4,3,1
31079.0,2019-11-01,"(1130.25, 1372.0]",7,6,1
31080.0,2019-11-01,"(451.087, 680.25]",2,10,-8
31080.0,2019-11-01,"(680.25, 908.5]",2,5,-3
31080.0,2019-11-01,"(908.5, 1136.75]",6,9,-3
31080.0,2019-11-01,"(1136.75, 1365.0]",5,6,-1
31081.0,2019-11-01,"(545.534, 662.5]",1,1,0
31081.0,2019-11-01,"(779.0, 895.5]",1,1,0
31081.0,2019-11-01,"(895.5, 1012.0]",2,1,1
31082.0,2019-11-01,"(723.717, 794.75]",2,2,0
31083.0,2019-11-01,"(884.5, 1036.75]",2,2,0
31083.0,2019-11-01,"(1036.75, 1189.0]",1,2,-1
31084.0,2019-11-01,"(463.216, 660.0]",3,4,-1
31084.0,2019-11-01,"(660.0, 856.0]",3,4,-1
31084.0,2019-11-01,"(1052.0, 1248.0]",1,1,0
31085.0,2019-11-01,"(831.0, 1108.0]",1,1,0
31086.0,2019-11-01,"(413.008, 662.0]",1,3,-2
31086.0,2019-11-01,"(662.0, 910.0]",1,1,0
31086.0,2019-11-01,"(910.0, 1158.0]",2,4,-2
31086.0,2019-11-01,"(1158.0, 1406.0]",2,2,0
31087.0,2019-11-01,"(343.146, 557.5]",1,1,0
31087.0,2019-11-01,"(557.5, 771.0]",1,2,-1
31087.0,2019-11-01,"(771.0, 984.5]",1,2,-1
31087.0,2019-11-01,"(984.5, 1198.0]",1,2,-1
31088.0,2019-11-01,"(408.991, 662.25]",1,4,-3
31088.0,2019-11-01,"(662.25, 914.5]",1,1,0
31088.0,2019-11-01,"(914.5, 1166.75]",3,6,-3
31088.0,2019-11-01,"(1166.75, 1419.0]",1,1,0
31089.0,2019-11-01,"(398.0, 744.0]",11,2,9
31089.0,2019-11-01,"(744.0, 1090.0]",7,18,-11
31089.0,2019-11-01,"(1090.0, 1436.0]",8,18,-10
,,,,1.0,
,,,,2.0,
31091.0,2019-11-01,"(835.5, 1054.25]",5,5,0
31091.0,2019-11-01,"(1054.25, 1273.0]",2,5,-3
31092.0,2019-11-01,"(875.0, 1040.5]",1,1,0
31092.0,2019-11-01,"(1040.5, 1206.0]",1,1,0
31093.0,2019-11-01,"(879.5, 1006.25]",1,2,-1
31093.0,2019-11-01,"(1006.25, 1133.0]",1,4,-3
31094.0,2019-11-01,"(660.75, 815.5]",1,1,0
31094.0,2019-11-01,"(815.5, 970.25]",2,1,1
31094.0,2019-11-01,"(970.25, 1125.0]",1,2,-1
,,,,1.0,
,,,,1.0,
31096.0,2019-11-01,"(723.612, 821.0]",1,2,-1
31096.0,2019-11-01,"(1015.0, 1112.0]",1,1,0
31097.0,2019-11-01,"(507.104, 732.0]",3,4,-1
31097.0,2019-11-01,"(732.0, 956.0]",3,3,0
31097.0,2019-11-01,"(956.0, 1180.0]",2,4,-2
31097.0,2019-11-01,"(1180.0, 1404.0]",6,12,-6
31098.0,2019-11-01,"(419.083, 649.25]",5,10,-5
31098.0,2019-11-01,"(649.25, 878.5]",1,1,0
31098.0,2019-11-01,"(878.5, 1107.75]",4,7,-3
31098.0,2019-11-01,"(1107.75, 1337.0]",5,9,-4
31099.0,2019-11-01,"(1038.0, 1228.0]",5,2,3
31100.0,2019-11-01,"(477.124, 697.0]",13,13,0
31100.0,2019-11-01,"(697.0, 916.0]",4,10,-6
31100.0,2019-11-01,"(916.0, 1135.0]",1,5,-4
31100.0,2019-11-01,"(1135.0, 1354.0]",1,2,-1
31101.0,2019-11-01,"(26.601, 377.75]",3,6,-3
31101.0,2019-11-01,"(377.75, 727.5]",25,73,-48
31101.0,2019-11-01,"(727.5, 1077.25]",35,63,-28
31101.0,2019-11-01,"(1077.25, 1427.0]",45,63,-18
31102.0,2019-11-01,"(397.0, 741.0]",3,3,0
31102.0,2019-11-01,"(741.0, 1085.0]",7,28,-21
31102.0,2019-11-01,"(1085.0, 1429.0]",12,16,-4
31103.0,2019-11-01,"(30.596, 383.0]",1,4,-3
31103.0,2019-11-01,"(383.0, 734.0]",3,39,-36
31103.0,2019-11-01,"(734.0, 1085.0]",17,48,-31
31103.0,2019-11-01,"(1085.0, 1436.0]",8,31,-23
31104.0,2019-11-01,"(128.706, 453.5]",2,8,-6
31104.0,2019-11-01,"(453.5, 777.0]",5,22,-17
31104.0,2019-11-01,"(777.0, 1100.5]",19,33,-14
31104.0,2019-11-01,"(1100.5, 1424.0]",15,26,-11
31105.0,2019-11-01,"(426.139, 642.25]",5,23,-18
31105.0,2019-11-01,"(642.25, 857.5]",1,4,-3
31105.0,2019-11-01,"(857.5, 1072.75]",3,13,-10
31105.0,2019-11-01,"(1072.75, 1288.0]",3,5,-2
31106.0,2019-11-01,"(415.018, 661.5]",3,17,-14
31106.0,2019-11-01,"(907.0, 1152.5]",8,3,5
31106.0,2019-11-01,"(1152.5, 1398.0]",1,10,-9
31107.0,2019-11-01,"(359.958, 621.5]",1,20,-19
31107.0,2019-11-01,"(621.5, 882.0]",5,13,-8
31107.0,2019-11-01,"(882.0, 1142.5]",14,31,-17
31107.0,2019-11-01,"(1142.5, 1403.0]",13,22,-9
31108.0,2019-11-01,"(358.953, 621.75]",4,20,-16
31108.0,2019-11-01,"(621.75, 883.5]",12,25,-13
31108.0,2019-11-01,"(883.5, 1145.25]",28,47,-19
31108.0,2019-11-01,"(1145.25, 1407.0]",15,19,-4
31109.0,2019-11-01,"(419.989, 673.75]",6,21,-15
31109.0,2019-11-01,"(673.75, 926.5]",10,23,-13
31109.0,2019-11-01,"(926.5, 1179.25]",17,23,-6
31109.0,2019-11-01,"(1179.25, 1432.0]",7,16,-9
31110.0,2019-11-01,"(8.578, 365.5]",3,5,-2
31110.0,2019-11-01,"(365.5, 721.0]",21,50,-29
31110.0,2019-11-01,"(721.0, 1076.5]",24,48,-24
31110.0,2019-11-01,"(1076.5, 1432.0]",22,45,-23
31111.0,2019-11-01,"(83.655, 421.25]",1,4,-3
31111.0,2019-11-01,"(421.25, 757.5]",5,19,-14
31111.0,2019-11-01,"(757.5, 1093.75]",13,18,-5
31111.0,2019-11-01,"(1093.75, 1430.0]",12,20,-8
31112.0,2019-11-01,"(514.337, 680.75]",1,6,-5
31112.0,2019-11-01,"(846.5, 1012.25]",1,1,0
31112.0,2019-11-01,"(1012.25, 1178.0]",6,1,5
31113.0,2019-11-01,"(340.916, 613.0]",2,19,-17
31113.0,2019-11-01,"(884.0, 1155.0]",13,1,12
31113.0,2019-11-01,"(1155.0, 1426.0]",12,20,-8
31114.0,2019-11-01,"(91.695, 419.25]",2,7,-5
31114.0,2019-11-01,"(419.25, 745.5]",3,23,-20
31114.0,2019-11-01,"(745.5, 1071.75]",25,35,-10
31114.0,2019-11-01,"(1071.75, 1398.0]",24,38,-14
31115.0,2019-11-01,"(389.0, 737.0]",5,2,3
31115.0,2019-11-01,"(737.0, 1085.0]",8,21,-13
31115.0,2019-11-01,"(1085.0, 1433.0]",19,23,-4
31116.0,2019-11-01,"(354.921, 625.75]",4,24,-20
31116.0,2019-11-01,"(625.75, 895.5]",12,22,-10
31116.0,2019-11-01,"(895.5, 1165.25]",12,25,-13
31116.0,2019-11-01,"(1165.25, 1435.0]",6,10,-4
31117.0,2019-11-01,"(322.989, 576.75]",5,24,-19
31117.0,2019-11-01,"(576.75, 829.5]",4,13,-9
31117.0,2019-11-01,"(829.5, 1082.25]",7,15,-8
31117.0,2019-11-01,"(1082.25, 1335.0]",7,11,-4
31118.0,2019-11-01,"(434.997, 686.75]",4,24,-20
31118.0,2019-11-01,"(686.75, 937.5]",4,7,-3
31118.0,2019-11-01,"(937.5, 1188.25]",16,24,-8
31118.0,2019-11-01,"(1188.25, 1439.0]",7,9,-2
31119.0,2019-11-01,"(817.386, 971.5]",4,9,-5
31119.0,2019-11-01,"(971.5, 1125.0]",11,25,-14
31119.0,2019-11-01,"(1125.0, 1278.5]",8,20,-12
31119.0,2019-11-01,"(1278.5, 1432.0]",5,8,-3
31120.0,2019-11-01,"(148.716, 471.0]",4,9,-5
31120.0,2019-11-01,"(471.0, 792.0]",8,19,-11
31120.0,2019-11-01,"(792.0, 1113.0]",9,21,-12
31120.0,2019-11-01,"(1113.0, 1434.0]",12,24,-12
31121.0,2019-11-01,"(354.107, 578.25]",10,17,-7
31121.0,2019-11-01,"(578.25, 801.5]",3,6,-3
31121.0,2019-11-01,"(801.5, 1024.75]",6,15,-9
31121.0,2019-11-01,"(1024.75, 1248.0]",8,25,-17
31122.0,2019-11-01,"(18.604, 369.0]",1,2,-1
31122.0,2019-11-01,"(369.0, 718.0]",2,17,-15
31122.0,2019-11-01,"(718.0, 1067.0]",5,16,-11
31122.0,2019-11-01,"(1067.0, 1416.0]",9,19,-10
31123.0,2019-11-01,"(144.715, 467.25]",2,6,-4
31123.0,2019-11-01,"(467.25, 788.5]",4,23,-19
31123.0,2019-11-01,"(788.5, 1109.75]",5,8,-3
31123.0,2019-11-01,"(1109.75, 1431.0]",4,10,-6
31124.0,2019-11-01,"(38.603, 389.25]",1,2,-1
31124.0,2019-11-01,"(389.25, 738.5]",15,48,-33
31124.0,2019-11-01,"(738.5, 1087.75]",24,47,-23
31124.0,2019-11-01,"(1087.75, 1437.0]",22,60,-38
31125.0,2019-11-01,"(218.79, 522.5]",10,36,-26
31125.0,2019-11-01,"(522.5, 825.0]",7,16,-9
31125.0,2019-11-01,"(825.0, 1127.5]",32,44,-12
31125.0,2019-11-01,"(1127.5, 1430.0]",14,23,-9
31126.0,2019-11-01,"(52.632, 396.0]",3,4,-1
31126.0,2019-11-01,"(396.0, 738.0]",6,37,-31
31126.0,2019-11-01,"(738.0, 1080.0]",21,35,-14
31126.0,2019-11-01,"(1080.0, 1422.0]",22,29,-7
31127.0,2019-11-01,"(171.787, 476.25]",1,2,-1
31127.0,2019-11-01,"(476.25, 779.5]",15,19,-4
31127.0,2019-11-01,"(779.5, 1082.75]",18,35,-17
31127.0,2019-11-01,"(1082.75, 1386.0]",7,25,-18
31128.0,2019-11-01,"(67.635, 410.25]",3,6,-3
31128.0,2019-11-01,"(410.25, 751.5]",29,50,-21
31128.0,2019-11-01,"(751.5, 1092.75]",25,42,-17
31128.0,2019-11-01,"(1092.75, 1434.0]",8,24,-16
31129.0,2019-11-01,"(478.05, 716.5]",13,21,-8
31129.0,2019-11-01,"(716.5, 954.0]",22,35,-13
31129.0,2019-11-01,"(954.0, 1191.5]",11,25,-14
31129.0,2019-11-01,"(1191.5, 1429.0]",1,5,-4
31130.0,2019-11-01,"(33.62, 380.0]",1,2,-1
31130.0,2019-11-01,"(380.0, 725.0]",1,9,-8
31130.0,2019-11-01,"(725.0, 1070.0]",13,24,-11
31130.0,2019-11-01,"(1070.0, 1415.0]",12,18,-6
31131.0,2019-11-01,"(111.674, 444.5]",2,4,-2
31131.0,2019-11-01,"(444.5, 776.0]",1,12,-11
31131.0,2019-11-01,"(776.0, 1107.5]",5,17,-12
31131.0,2019-11-01,"(1107.5, 1439.0]",8,14,-6
31200.0,2019-11-01,"(109.689, 438.75]",3,6,-3
31200.0,2019-11-01,"(438.75, 766.5]",45,65,-20
31200.0,2019-11-01,"(766.5, 1094.25]",30,56,-26
31200.0,2019-11-01,"(1094.25, 1422.0]",23,49,-26
31201.0,2019-11-01,"(0.601, 351.75]",3,8,-5
31201.0,2019-11-01,"(351.75, 701.5]",25,58,-33
31201.0,2019-11-01,"(701.5, 1051.25]",41,64,-23
31201.0,2019-11-01,"(1051.25, 1401.0]",28,50,-22
31202.0,2019-11-01,"(38.626, 383.5]",1,5,-4
31202.0,2019-11-01,"(383.5, 727.0]",14,34,-20
31202.0,2019-11-01,"(727.0, 1070.5]",37,56,-19
31202.0,2019-11-01,"(1070.5, 1414.0]",14,36,-22
31203.0,2019-11-01,"(185.747, 500.25]",6,19,-13
31203.0,2019-11-01,"(500.25, 813.5]",21,49,-28
31203.0,2019-11-01,"(813.5, 1126.75]",34,47,-13
31203.0,2019-11-01,"(1126.75, 1440.0]",30,51,-21
31204.0,2019-11-01,"(60.671, 394.25]",1,1,0
31204.0,2019-11-01,"(394.25, 726.5]",17,25,-8
31204.0,2019-11-01,"(726.5, 1058.75]",6,20,-14
31204.0,2019-11-01,"(1058.75, 1391.0]",5,10,-5
31205.0,2019-11-01,"(87.656, 425.0]",1,1,0
31205.0,2019-11-01,"(425.0, 761.0]",37,44,-7
31205.0,2019-11-01,"(761.0, 1097.0]",18,52,-34
31205.0,2019-11-01,"(1097.0, 1433.0]",4,25,-21
31206.0,2019-11-01,"(433.257, 619.75]",10,12,-2
31206.0,2019-11-01,"(805.5, 991.25]",1,1,0
31206.0,2019-11-01,"(991.25, 1177.0]",2,6,-4
31207.0,2019-11-01,"(706.5, 916.0]",2,5,-3
31207.0,2019-11-01,"(916.0, 1125.5]",1,6,-5
31207.0,2019-11-01,"(1125.5, 1335.0]",1,3,-2
31208.0,2019-11-01,"(231.959, 493.25]",6,8,-2
31208.0,2019-11-01,"(493.25, 753.5]",5,8,-3
31208.0,2019-11-01,"(753.5, 1013.75]",11,20,-9
31208.0,2019-11-01,"(1013.75, 1274.0]",8,16,-8
31209.0,2019-11-01,"(489.233, 681.75]",3,5,-2
31209.0,2019-11-01,"(681.75, 873.5]",2,5,-3
31209.0,2019-11-01,"(873.5, 1065.25]",4,11,-7
31209.0,2019-11-01,"(1065.25, 1257.0]",8,10,-2
31211.0,2019-11-01,"(396.991, 650.25]",13,16,-3
31211.0,2019-11-01,"(650.25, 902.5]",8,18,-10
31211.0,2019-11-01,"(902.5, 1154.75]",15,23,-8
31211.0,2019-11-01,"(1154.75, 1407.0]",2,4,-2
31212.0,2019-11-01,"(349.938, 616.5]",21,25,-4
31212.0,2019-11-01,"(616.5, 882.0]",19,29,-10
31212.0,2019-11-01,"(882.0, 1147.5]",12,36,-24
31212.0,2019-11-01,"(1147.5, 1413.0]",3,6,-3
31213.0,2019-11-01,"(258.88, 540.0]",27,35,-8
31213.0,2019-11-01,"(540.0, 820.0]",16,38,-22
31213.0,2019-11-01,"(820.0, 1100.0]",15,32,-17
31213.0,2019-11-01,"(1100.0, 1380.0]",4,9,-5
31214.0,2019-11-01,"(261.825, 556.75]",7,31,-24
31214.0,2019-11-01,"(556.75, 850.5]",12,18,-6
31214.0,2019-11-01,"(850.5, 1144.25]",37,60,-23
31214.0,2019-11-01,"(1144.25, 1438.0]",14,23,-9
31215.0,2019-11-01,"(330.913, 603.75]",22,27,-5
31215.0,2019-11-01,"(603.75, 875.5]",17,22,-5
31215.0,2019-11-01,"(875.5, 1147.25]",17,29,-12
31215.0,2019-11-01,"(1147.25, 1419.0]",4,10,-6
31216.0,2019-11-01,"(448.257, 634.75]",21,23,-2
31216.0,2019-11-01,"(634.75, 820.5]",5,9,-4
31216.0,2019-11-01,"(820.5, 1006.25]",2,9,-7
31216.0,2019-11-01,"(1006.25, 1192.0]",6,22,-16
31217.0,2019-11-01,"(392.292, 570.0]",12,14,-2
31217.0,2019-11-01,"(570.0, 747.0]",1,3,-2
31217.0,2019-11-01,"(747.0, 924.0]",5,11,-6
31217.0,2019-11-01,"(924.0, 1101.0]",1,10,-9
31218.0,2019-11-01,"(325.096, 552.0]",7,21,-14
31218.0,2019-11-01,"(552.0, 778.0]",9,15,-6
31218.0,2019-11-01,"(778.0, 1004.0]",7,11,-4
31218.0,2019-11-01,"(1004.0, 1230.0]",11,24,-13
31219.0,2019-11-01,"(436.245, 625.75]",11,12,-1
31219.0,2019-11-01,"(625.75, 814.5]",9,17,-8
31219.0,2019-11-01,"(814.5, 1003.25]",9,21,-12
31219.0,2019-11-01,"(1003.25, 1192.0]",6,10,-4
31220.0,2019-11-01,"(319.293, 496.75]",6,7,-1
31220.0,2019-11-01,"(496.75, 673.5]",10,11,-1
31220.0,2019-11-01,"(673.5, 850.25]",6,9,-3
31220.0,2019-11-01,"(850.25, 1027.0]",5,17,-12
31221.0,2019-11-01,"(382.953, 645.75]",37,45,-8
31221.0,2019-11-01,"(645.75, 907.5]",14,29,-15
31221.0,2019-11-01,"(907.5, 1169.25]",16,42,-26
31221.0,2019-11-01,"(1169.25, 1431.0]",5,15,-10
31222.0,2019-11-01,"(493.11, 716.5]",18,23,-5
31222.0,2019-11-01,"(716.5, 939.0]",6,17,-11
31222.0,2019-11-01,"(939.0, 1161.5]",9,24,-15
31222.0,2019-11-01,"(1161.5, 1384.0]",6,9,-3
31223.0,2019-11-01,"(41.605, 391.75]",4,7,-3
31223.0,2019-11-01,"(391.75, 740.5]",12,40,-28
31223.0,2019-11-01,"(740.5, 1089.25]",18,37,-19
31223.0,2019-11-01,"(1089.25, 1438.0]",11,26,-15
31224.0,2019-11-01,"(424.004, 674.0]",21,22,-1
31224.0,2019-11-01,"(674.0, 923.0]",11,22,-11
31224.0,2019-11-01,"(923.0, 1172.0]",8,29,-21
31224.0,2019-11-01,"(1172.0, 1421.0]",3,6,-3
31225.0,2019-11-01,"(355.957, 617.75]",6,11,-5
31225.0,2019-11-01,"(617.75, 878.5]",9,11,-2
31225.0,2019-11-01,"(878.5, 1139.25]",12,26,-14
31225.0,2019-11-01,"(1139.25, 1400.0]",4,10,-6
31226.0,2019-11-01,"(320.938, 587.5]",3,10,-7
31226.0,2019-11-01,"(587.5, 853.0]",2,2,0
31226.0,2019-11-01,"(853.0, 1118.5]",5,11,-6
31226.0,2019-11-01,"(1118.5, 1384.0]",2,4,-2
31227.0,2019-11-01,"(125.857, 412.75]",1,2,-1
31227.0,2019-11-01,"(412.75, 698.5]",50,56,-6
31227.0,2019-11-01,"(698.5, 984.25]",11,22,-11
31227.0,2019-11-01,"(984.25, 1270.0]",10,23,-13
31228.0,2019-11-01,"(44.633, 387.75]",3,3,0
31228.0,2019-11-01,"(387.75, 729.5]",27,43,-16
31228.0,2019-11-01,"(729.5, 1071.25]",26,52,-26
31228.0,2019-11-01,"(1071.25, 1413.0]",18,38,-20
31229.0,2019-11-01,"(16.591, 370.25]",2,3,-1
31229.0,2019-11-01,"(370.25, 722.5]",12,42,-30
31229.0,2019-11-01,"(722.5, 1074.75]",44,78,-34
31229.0,2019-11-01,"(1074.75, 1427.0]",43,80,-37
31230.0,2019-11-01,"(328.983, 584.25]",40,50,-10
31230.0,2019-11-01,"(584.25, 838.5]",15,19,-4
31230.0,2019-11-01,"(838.5, 1092.75]",22,54,-32
31230.0,2019-11-01,"(1092.75, 1347.0]",12,39,-27
31231.0,2019-11-01,"(385.14, 601.0]",24,26,-2
31231.0,2019-11-01,"(601.0, 816.0]",5,9,-4
31231.0,2019-11-01,"(816.0, 1031.0]",7,18,-11
31231.0,2019-11-01,"(1031.0, 1246.0]",4,14,-10
31232.0,2019-11-01,"(123.705, 448.75]",3,5,-2
31232.0,2019-11-01,"(448.75, 772.5]",21,27,-6
31232.0,2019-11-01,"(772.5, 1096.25]",25,50,-25
31232.0,2019-11-01,"(1096.25, 1420.0]",19,53,-34
31233.0,2019-11-01,"(398.039, 639.25]",40,43,-3
31233.0,2019-11-01,"(639.25, 879.5]",5,9,-4
31233.0,2019-11-01,"(879.5, 1119.75]",13,31,-18
31233.0,2019-11-01,"(1119.75, 1360.0]",4,8,-4
31234.0,2019-11-01,"(115.828, 410.0]",1,4,-3
31234.0,2019-11-01,"(410.0, 703.0]",23,47,-24
31234.0,2019-11-01,"(703.0, 996.0]",17,29,-12
31234.0,2019-11-01,"(996.0, 1289.0]",29,46,-17
31235.0,2019-11-01,"(380.051, 618.25]",9,11,-2
31235.0,2019-11-01,"(618.25, 855.5]",7,11,-4
31235.0,2019-11-01,"(855.5, 1092.75]",6,11,-5
31236.0,2019-11-01,"(367.0, 700.0]",20,2,18
31236.0,2019-11-01,"(700.0, 1033.0]",6,21,-15
31236.0,2019-11-01,"(1033.0, 1366.0]",6,20,-14
31237.0,2019-11-01,"(39.619, 386.25]",2,2,0
31237.0,2019-11-01,"(386.25, 731.5]",12,20,-8
31237.0,2019-11-01,"(731.5, 1076.75]",30,57,-27
31237.0,2019-11-01,"(1076.75, 1422.0]",13,27,-14
31238.0,2019-11-01,"(416.105, 640.75]",22,26,-4
31238.0,2019-11-01,"(640.75, 864.5]",9,21,-12
31238.0,2019-11-01,"(864.5, 1088.25]",7,25,-18
31238.0,2019-11-01,"(1088.25, 1312.0]",7,17,-10
31239.0,2019-11-01,"(341.962, 602.5]",21,29,-8
31239.0,2019-11-01,"(602.5, 862.0]",15,26,-11
31239.0,2019-11-01,"(862.0, 1121.5]",15,43,-28
31239.0,2019-11-01,"(1121.5, 1381.0]",4,9,-5
31240.0,2019-11-01,"(517.353, 679.75]",3,10,-7
31240.0,2019-11-01,"(679.75, 841.5]",1,2,-1
31240.0,2019-11-01,"(841.5, 1003.25]",12,23,-11
31240.0,2019-11-01,"(1003.25, 1165.0]",4,6,-2
31241.0,2019-11-01,"(97.698, 424.5]",1,8,-7
31241.0,2019-11-01,"(424.5, 750.0]",30,65,-35
31241.0,2019-11-01,"(750.0, 1075.5]",19,46,-27
31241.0,2019-11-01,"(1075.5, 1401.0]",29,50,-21
31242.0,2019-11-01,"(448.011, 696.25]",32,35,-3
31242.0,2019-11-01,"(696.25, 943.5]",13,28,-15
31242.0,2019-11-01,"(943.5, 1190.75]",7,31,-24
31242.0,2019-11-01,"(1190.75, 1438.0]",1,1,0
31243.0,2019-11-01,"(354.75, 699.5]",21,1,20
31243.0,2019-11-01,"(699.5, 1044.25]",10,25,-15
31243.0,2019-11-01,"(1044.25, 1389.0]",8,37,-29
31244.0,2019-11-01,"(416.993, 669.75]",11,18,-7
31244.0,2019-11-01,"(669.75, 921.5]",9,16,-7
31244.0,2019-11-01,"(921.5, 1173.25]",4,15,-11
31244.0,2019-11-01,"(1173.25, 1425.0]",4,8,-4
31245.0,2019-11-01,"(59.749, 373.75]",1,1,0
31245.0,2019-11-01,"(373.75, 686.5]",9,21,-12
31245.0,2019-11-01,"(686.5, 999.25]",10,17,-7
31245.0,2019-11-01,"(999.25, 1312.0]",28,42,-14
31246.0,2019-11-01,"(386.969, 645.75]",15,26,-11
31246.0,2019-11-01,"(645.75, 903.5]",16,30,-14
31246.0,2019-11-01,"(903.5, 1161.25]",28,52,-24
31246.0,2019-11-01,"(1161.25, 1419.0]",7,14,-7
31247.0,2019-11-01,"(437.012, 685.0]",14,18,-4
31247.0,2019-11-01,"(685.0, 932.0]",37,67,-30
31247.0,2019-11-01,"(932.0, 1179.0]",21,55,-34
31247.0,2019-11-01,"(1179.0, 1426.0]",9,22,-13
31248.0,2019-11-01,"(354.962, 615.5]",10,19,-9
31248.0,2019-11-01,"(615.5, 875.0]",15,29,-14
31248.0,2019-11-01,"(875.0, 1134.5]",31,63,-32
31248.0,2019-11-01,"(1134.5, 1394.0]",6,12,-6
31249.0,2019-11-01,"(625.512, 748.0]",5,11,-6
31249.0,2019-11-01,"(748.0, 870.0]",9,18,-9
31249.0,2019-11-01,"(870.0, 992.0]",8,20,-12
31249.0,2019-11-01,"(992.0, 1114.0]",19,31,-12
31250.0,2019-11-01,"(393.177, 599.75]",23,27,-4
31250.0,2019-11-01,"(599.75, 805.5]",7,12,-5
31250.0,2019-11-01,"(805.5, 1011.25]",9,17,-8
31250.0,2019-11-01,"(1011.25, 1217.0]",3,20,-17
31251.0,2019-11-01,"(333.899, 610.25]",24,44,-20
31251.0,2019-11-01,"(610.25, 885.5]",13,27,-14
31251.0,2019-11-01,"(885.5, 1160.75]",7,19,-12
31251.0,2019-11-01,"(1160.75, 1436.0]",6,8,-2
31252.0,2019-11-01,"(470.032, 713.0]",21,24,-3
31252.0,2019-11-01,"(713.0, 955.0]",3,9,-6
31252.0,2019-11-01,"(1197.0, 1439.0]",4,4,0
31253.0,2019-11-01,"(401.141, 616.75]",20,22,-2
31253.0,2019-11-01,"(616.75, 831.5]",13,22,-9
31253.0,2019-11-01,"(831.5, 1046.25]",2,13,-11
31253.0,2019-11-01,"(1046.25, 1261.0]",5,21,-16
31254.0,2019-11-01,"(80.839, 372.25]",1,2,-1
31254.0,2019-11-01,"(372.25, 662.5]",25,30,-5
31254.0,2019-11-01,"(662.5, 952.75]",7,15,-8
31254.0,2019-11-01,"(952.75, 1243.0]",7,33,-26
31255.0,2019-11-01,"(350.926, 620.5]",17,26,-9
31255.0,2019-11-01,"(620.5, 889.0]",2,8,-6
31255.0,2019-11-01,"(889.0, 1157.5]",8,23,-15
31255.0,2019-11-01,"(1157.5, 1426.0]",6,10,-4
31256.0,2019-11-01,"(297.958, 559.5]",16,18,-2
31256.0,2019-11-01,"(559.5, 820.0]",2,4,-2
31256.0,2019-11-01,"(820.0, 1080.5]",14,36,-22
31256.0,2019-11-01,"(1080.5, 1341.0]",14,20,-6
31257.0,2019-11-01,"(142.729, 461.75]",1,3,-2
31257.0,2019-11-01,"(461.75, 779.5]",23,39,-16
31257.0,2019-11-01,"(779.5, 1097.25]",30,54,-24
31257.0,2019-11-01,"(1097.25, 1415.0]",11,34,-23
31258.0,2019-11-01,"(564.165, 773.75]",19,42,-23
31258.0,2019-11-01,"(773.75, 982.5]",22,49,-27
31258.0,2019-11-01,"(982.5, 1191.25]",21,44,-23
31258.0,2019-11-01,"(1191.25, 1400.0]",4,7,-3
31259.0,2019-11-01,"(447.168, 656.0]",14,14,0
31259.0,2019-11-01,"(864.0, 1072.0]",1,5,-4
31260.0,2019-11-01,"(348.979, 605.25]",12,16,-4
31260.0,2019-11-01,"(605.25, 860.5]",5,14,-9
31260.0,2019-11-01,"(860.5, 1115.75]",4,19,-15
31260.0,2019-11-01,"(1115.75, 1371.0]",3,6,-3
31261.0,2019-11-01,"(188.93, 457.5]",1,2,-1
31261.0,2019-11-01,"(457.5, 725.0]",9,13,-4
31261.0,2019-11-01,"(725.0, 992.5]",8,13,-5
31261.0,2019-11-01,"(992.5, 1260.0]",4,19,-15
31262.0,2019-11-01,"(410.146, 624.5]",10,12,-2
31262.0,2019-11-01,"(624.5, 838.0]",2,4,-2
31262.0,2019-11-01,"(838.0, 1051.5]",6,15,-9
31262.0,2019-11-01,"(1051.5, 1265.0]",6,11,-5
31263.0,2019-11-01,"(302.865, 587.75]",22,32,-10
31263.0,2019-11-01,"(587.75, 871.5]",14,26,-12
31263.0,2019-11-01,"(871.5, 1155.25]",20,55,-35
31263.0,2019-11-01,"(1155.25, 1439.0]",4,8,-4
31264.0,2019-11-01,"(450.062, 685.5]",18,23,-5
31264.0,2019-11-01,"(685.5, 920.0]",6,13,-7
31264.0,2019-11-01,"(920.0, 1154.5]",11,27,-16
31264.0,2019-11-01,"(1154.5, 1389.0]",6,8,-2
31265.0,2019-11-01,"(102.665, 437.75]",5,9,-4
31265.0,2019-11-01,"(437.75, 771.5]",16,33,-17
31265.0,2019-11-01,"(771.5, 1105.25]",27,54,-27
31265.0,2019-11-01,"(1105.25, 1439.0]",18,32,-14
31266.0,2019-11-01,"(91.665, 426.75]",2,12,-10
31266.0,2019-11-01,"(426.75, 760.5]",7,25,-18
31266.0,2019-11-01,"(760.5, 1094.25]",27,44,-17
31266.0,2019-11-01,"(1094.25, 1428.0]",21,40,-19
31267.0,2019-11-01,"(406.5, 751.0]",39,1,38
31267.0,2019-11-01,"(751.0, 1095.5]",18,62,-44
31267.0,2019-11-01,"(1095.5, 1440.0]",11,38,-27
31268.0,2019-11-01,"(57.644, 398.0]",4,4,0
31268.0,2019-11-01,"(398.0, 737.0]",8,40,-32
31268.0,2019-11-01,"(737.0, 1076.0]",15,24,-9
31268.0,2019-11-01,"(1076.0, 1415.0]",25,39,-14
31269.0,2019-11-01,"(372.999, 624.25]",11,22,-11
31269.0,2019-11-01,"(624.25, 874.5]",8,16,-8
31269.0,2019-11-01,"(874.5, 1124.75]",16,30,-14
31269.0,2019-11-01,"(1124.75, 1375.0]",3,9,-6
31270.0,2019-11-01,"(389.031, 632.25]",15,19,-4
31270.0,2019-11-01,"(632.25, 874.5]",3,14,-11
31270.0,2019-11-01,"(874.5, 1116.75]",21,38,-17
31270.0,2019-11-01,"(1116.75, 1359.0]",4,8,-4
31271.0,2019-11-01,"(349.097, 575.75]",10,13,-3
31271.0,2019-11-01,"(575.75, 801.5]",12,18,-6
31271.0,2019-11-01,"(801.5, 1027.25]",16,35,-19
31271.0,2019-11-01,"(1027.25, 1253.0]",5,13,-8
31272.0,2019-11-01,"(444.233, 636.75]",23,23,0
31272.0,2019-11-01,"(636.75, 828.5]",9,14,-5
31272.0,2019-11-01,"(828.5, 1020.25]",18,37,-19
31272.0,2019-11-01,"(1020.25, 1212.0]",4,19,-15
31273.0,2019-11-01,"(444.304, 619.0]",1,4,-3
31273.0,2019-11-01,"(619.0, 793.0]",3,7,-4
31273.0,2019-11-01,"(793.0, 967.0]",2,4,-2
31273.0,2019-11-01,"(967.0, 1141.0]",7,13,-6
31274.0,2019-11-01,"(367.986, 622.5]",19,25,-6
31274.0,2019-11-01,"(622.5, 876.0]",8,17,-9
31274.0,2019-11-01,"(876.0, 1129.5]",9,21,-12
31274.0,2019-11-01,"(1129.5, 1383.0]",4,10,-6
31275.0,2019-11-01,"(150.726, 470.5]",10,12,-2
31275.0,2019-11-01,"(470.5, 789.0]",27,54,-27
31275.0,2019-11-01,"(789.0, 1107.5]",19,40,-21
31275.0,2019-11-01,"(1107.5, 1426.0]",11,20,-9
31276.0,2019-11-01,"(465.257, 651.75]",23,28,-5
31276.0,2019-11-01,"(651.75, 837.5]",9,15,-6
31276.0,2019-11-01,"(837.5, 1023.25]",3,10,-7
31276.0,2019-11-01,"(1023.25, 1209.0]",3,23,-20
31277.0,2019-11-01,"(431.009, 679.75]",33,43,-10
31277.0,2019-11-01,"(679.75, 927.5]",10,16,-6
31277.0,2019-11-01,"(927.5, 1175.25]",19,59,-40
31277.0,2019-11-01,"(1175.25, 1423.0]",12,13,-1
31278.0,2019-11-01,"(178.743, 494.25]",2,4,-2
31278.0,2019-11-01,"(494.25, 808.5]",10,34,-24
31278.0,2019-11-01,"(808.5, 1122.75]",24,39,-15
31278.0,2019-11-01,"(1122.75, 1437.0]",15,24,-9
31279.0,2019-11-01,"(398.298, 574.5]",16,16,0
31279.0,2019-11-01,"(574.5, 750.0]",8,15,-7
31279.0,2019-11-01,"(750.0, 925.5]",7,16,-9
31279.0,2019-11-01,"(925.5, 1101.0]",9,34,-25
31280.0,2019-11-01,"(80.647, 420.25]",2,3,-1
31280.0,2019-11-01,"(420.25, 758.5]",5,23,-18
31280.0,2019-11-01,"(758.5, 1096.75]",14,20,-6
31280.0,2019-11-01,"(1096.75, 1435.0]",14,20,-6
31000.0,2019-11-02,"(577.597, 678.75]",1,1,0
31000.0,2019-11-02,"(678.75, 779.5]",1,3,-2
31000.0,2019-11-02,"(779.5, 880.25]",2,3,-1
31000.0,2019-11-02,"(880.25, 981.0]",2,4,-2
31001.0,2019-11-02,"(1027.5, 1233.0]",3,1,2
31002.0,2019-11-02,"(553.485, 682.75]",2,5,-3
31002.0,2019-11-02,"(811.5, 940.25]",10,1,9
31002.0,2019-11-02,"(940.25, 1069.0]",4,13,-9
31003.0,2019-11-02,"(573.42, 719.0]",1,2,-1
31003.0,2019-11-02,"(719.0, 864.0]",3,8,-5
31003.0,2019-11-02,"(864.0, 1009.0]",5,5,0
31004.0,2019-11-02,"(876.0, 984.0]",1,2,-1
31005.0,2019-11-02,"(560.229, 753.75]",5,7,-2
31005.0,2019-11-02,"(753.75, 946.5]",8,10,-2
31005.0,2019-11-02,"(946.5, 1139.25]",2,7,-5
31005.0,2019-11-02,"(1139.25, 1332.0]",2,5,-3
31006.0,2019-11-02,"(913.0, 1118.5]",1,1,0
31006.0,2019-11-02,"(1118.5, 1324.0]",3,3,0
31007.0,2019-11-02,"(354.934, 622.5]",1,1,0
31007.0,2019-11-02,"(622.5, 889.0]",11,15,-4
31007.0,2019-11-02,"(889.0, 1155.5]",9,20,-11
31009.0,2019-11-02,"(978.0, 1098.5]",2,3,-1
31009.0,2019-11-02,"(1098.5, 1219.0]",1,2,-1
31010.0,2019-11-02,"(545.453, 682.75]",2,4,-2
31010.0,2019-11-02,"(682.75, 819.5]",1,4,-3
31010.0,2019-11-02,"(819.5, 956.25]",3,7,-4
31010.0,2019-11-02,"(956.25, 1093.0]",3,6,-3
31011.0,2019-11-02,"(682.329, 850.75]",3,4,-1
31011.0,2019-11-02,"(850.75, 1018.5]",3,9,-6
31011.0,2019-11-02,"(1186.25, 1354.0]",2,1,1
,,,,1.0,
,,,,1.0,
31013.0,2019-11-02,"(718.286, 897.5]",5,8,-3
31013.0,2019-11-02,"(897.5, 1076.0]",2,4,-2
31013.0,2019-11-02,"(1254.5, 1433.0]",1,2,-1
31014.0,2019-11-02,"(436.093, 663.75]",5,6,-1
31014.0,2019-11-02,"(663.75, 890.5]",7,16,-9
31014.0,2019-11-02,"(890.5, 1117.25]",7,11,-4
31014.0,2019-11-02,"(1117.25, 1344.0]",7,8,-1
31015.0,2019-11-02,"(280.308, 454.0]",1,1,0
31015.0,2019-11-02,"(454.0, 627.0]",1,1,0
31015.0,2019-11-02,"(627.0, 800.0]",2,3,-1
31015.0,2019-11-02,"(800.0, 973.0]",7,7,0
31016.0,2019-11-02,"(8.804, 309.0]",1,1,0
31016.0,2019-11-02,"(608.0, 907.0]",3,1,2
31016.0,2019-11-02,"(907.0, 1206.0]",3,8,-5
31017.0,2019-11-02,"(462.294, 639.5]",3,3,0
31017.0,2019-11-02,"(639.5, 816.0]",1,3,-2
31017.0,2019-11-02,"(816.0, 992.5]",1,3,-2
31017.0,2019-11-02,"(992.5, 1169.0]",1,7,-6
31018.0,2019-11-02,"(903.25, 1051.0]",2,3,-1
31019.0,2019-11-02,"(407.25, 717.5]",1,1,0
31019.0,2019-11-02,"(717.5, 1027.75]",2,2,0
31019.0,2019-11-02,"(1027.75, 1338.0]",2,4,-2
31020.0,2019-11-02,"(654.326, 823.5]",2,4,-2
31020.0,2019-11-02,"(823.5, 992.0]",1,6,-5
31020.0,2019-11-02,"(992.0, 1160.5]",1,1,0
31020.0,2019-11-02,"(1160.5, 1329.0]",2,3,-1
31021.0,2019-11-02,"(594.488, 723.0]",1,2,-1
31021.0,2019-11-02,"(723.0, 851.0]",1,4,-3
31021.0,2019-11-02,"(851.0, 979.0]",3,4,-1
31022.0,2019-11-02,"(349.25, 696.5]",3,2,1
31022.0,2019-11-02,"(696.5, 1043.75]",6,5,1
31023.0,2019-11-02,"(333.75, 646.5]",1,5,-4
31023.0,2019-11-02,"(646.5, 959.25]",3,3,0
31023.0,2019-11-02,"(959.25, 1272.0]",5,4,1
31024.0,2019-11-02,"(38.752, 352.0]",3,4,-1
31024.0,2019-11-02,"(352.0, 664.0]",1,3,-2
31024.0,2019-11-02,"(664.0, 976.0]",8,14,-6
31024.0,2019-11-02,"(976.0, 1288.0]",5,11,-6
31025.0,2019-11-02,"(759.25, 989.0]",1,1,0
31026.0,2019-11-02,"(678.272, 861.0]",2,4,-2
31026.0,2019-11-02,"(861.0, 1043.0]",1,3,-2
31026.0,2019-11-02,"(1225.0, 1407.0]",1,1,0
31027.0,2019-11-02,"(32.86, 319.0]",1,1,0
31027.0,2019-11-02,"(604.0, 889.0]",3,4,-1
31027.0,2019-11-02,"(889.0, 1174.0]",1,4,-3
31028.0,2019-11-02,"(645.279, 826.25]",2,2,0
31028.0,2019-11-02,"(826.25, 1006.5]",3,6,-3
31029.0,2019-11-02,"(717.75, 920.5]",5,3,2
31029.0,2019-11-02,"(920.5, 1123.25]",4,9,-5
31029.0,2019-11-02,"(1123.25, 1326.0]",2,6,-4
31030.0,2019-11-02,"(914.5, 1142.25]",7,3,4
31030.0,2019-11-02,"(1142.25, 1370.0]",1,1,0
31031.0,2019-11-02,"(662.253, 849.75]",1,6,-5
31031.0,2019-11-02,"(849.75, 1036.5]",5,7,-2
31031.0,2019-11-02,"(1223.25, 1410.0]",2,2,0
31032.0,2019-11-02,"(579.603, 679.25]",1,1,0
31032.0,2019-11-02,"(778.5, 877.75]",1,4,-3
31032.0,2019-11-02,"(877.75, 977.0]",2,4,-2
31033.0,2019-11-02,"(556.607, 655.25]",1,2,-1
31033.0,2019-11-02,"(851.75, 950.0]",2,1,1
31034.0,2019-11-02,"(26.638, 368.5]",5,7,-2
31034.0,2019-11-02,"(368.5, 709.0]",1,1,0
31034.0,2019-11-02,"(709.0, 1049.5]",2,6,-4
31034.0,2019-11-02,"(1049.5, 1390.0]",2,5,-3
31035.0,2019-11-02,"(569.239, 760.25]",1,3,-2
31035.0,2019-11-02,"(950.5, 1140.75]",1,1,0
31035.0,2019-11-02,"(1140.75, 1331.0]",2,1,1
31036.0,2019-11-02,"(813.0, 1084.0]",1,1,0
31037.0,2019-11-02,"(420.068, 654.0]",2,4,-2
31037.0,2019-11-02,"(654.0, 887.0]",7,8,-1
31037.0,2019-11-02,"(887.0, 1120.0]",3,8,-5
31037.0,2019-11-02,"(1120.0, 1353.0]",2,4,-2
,,,,1.0,
,,,,1.0,
31039.0,2019-11-02,"(684.438, 825.5]",2,5,-3
31039.0,2019-11-02,"(825.5, 966.0]",1,2,-1
31039.0,2019-11-02,"(1106.5, 1247.0]",1,1,0
31040.0,2019-11-02,"(486.411, 634.25]",1,1,0
31040.0,2019-11-02,"(634.25, 781.5]",1,2,-1
31041.0,2019-11-02,"(636.558, 747.5]",8,8,0
31041.0,2019-11-02,"(747.5, 858.0]",3,7,-4
31041.0,2019-11-02,"(858.0, 968.5]",3,6,-3
31041.0,2019-11-02,"(968.5, 1079.0]",8,9,-1
31042.0,2019-11-02,"(495.101, 720.75]",7,9,-2
31042.0,2019-11-02,"(720.75, 945.5]",2,9,-7
31042.0,2019-11-02,"(945.5, 1170.25]",1,2,-1
31042.0,2019-11-02,"(1170.25, 1395.0]",1,1,0
31043.0,2019-11-02,"(662.464, 797.0]",2,4,-2
31043.0,2019-11-02,"(931.0, 1065.0]",1,2,-1
31043.0,2019-11-02,"(1065.0, 1199.0]",1,3,-2
31044.0,2019-11-02,"(439.237, 630.75]",1,2,-1
31044.0,2019-11-02,"(821.5, 1012.25]",1,1,0
31044.0,2019-11-02,"(1012.25, 1203.0]",2,6,-4
31045.0,2019-11-02,"(517.51, 640.5]",1,1,0
31045.0,2019-11-02,"(640.5, 763.0]",2,2,0
31045.0,2019-11-02,"(763.0, 885.5]",5,6,-1
31046.0,2019-11-02,"(653.646, 742.5]",1,2,-1
31046.0,2019-11-02,"(831.0, 919.5]",1,2,-1
31046.0,2019-11-02,"(919.5, 1008.0]",1,2,-1
31047.0,2019-11-02,"(457.073, 689.75]",3,6,-3
31047.0,2019-11-02,"(689.75, 921.5]",6,11,-5
31047.0,2019-11-02,"(921.5, 1153.25]",2,8,-6
31047.0,2019-11-02,"(1153.25, 1385.0]",2,3,-1
31048.0,2019-11-02,"(701.584, 806.0]",1,1,0
31048.0,2019-11-02,"(910.0, 1014.0]",2,1,1
31048.0,2019-11-02,"(1014.0, 1118.0]",5,2,3
31049.0,2019-11-02,"(498.205, 697.75]",1,1,0
31049.0,2019-11-02,"(697.75, 896.5]",1,2,-1
31049.0,2019-11-02,"(1095.25, 1294.0]",1,1,0
31050.0,2019-11-02,"(798.75, 1058.0]",2,1,1
31051.0,2019-11-02,"(670.5, 730.25]",3,5,-2
31052.0,2019-11-02,"(661.541, 776.75]",1,1,0
31052.0,2019-11-02,"(891.5, 1006.25]",3,3,0
31053.0,2019-11-02,"(1005.5, 1096.75]",1,3,-2
31053.0,2019-11-02,"(1096.75, 1188.0]",3,1,2
,,,,1.0,
,,,,1.0,
31055.0,2019-11-02,"(665.505, 789.75]",2,6,-4
31055.0,2019-11-02,"(913.5, 1037.25]",2,3,-1
31055.0,2019-11-02,"(1037.25, 1161.0]",2,2,0
31056.0,2019-11-02,"(584.197, 785.75]",2,7,-5
31056.0,2019-11-02,"(986.5, 1187.25]",3,1,2
31056.0,2019-11-02,"(1187.25, 1388.0]",2,3,-1
31057.0,2019-11-02,"(842.0, 942.5]",1,3,-2
31057.0,2019-11-02,"(942.5, 1043.0]",3,1,2
31058.0,2019-11-02,"(540.174, 747.5]",2,4,-2
31059.0,2019-11-02,"(836.5, 977.75]",3,2,1
31059.0,2019-11-02,"(977.75, 1119.0]",3,1,2
31060.0,2019-11-02,"(585.212, 783.0]",6,8,-2
31060.0,2019-11-02,"(783.0, 980.0]",3,7,-4
31060.0,2019-11-02,"(980.0, 1177.0]",7,9,-2
31061.0,2019-11-02,"(565.5, 848.25]",1,1,0
31061.0,2019-11-02,"(848.25, 1131.0]",1,1,0
31062.0,2019-11-02,"(469.5, 595.0]",8,10,-2
31062.0,2019-11-02,"(595.0, 720.0]",7,16,-9
31062.0,2019-11-02,"(720.0, 845.0]",14,32,-18
31062.0,2019-11-02,"(845.0, 970.0]",13,18,-5
31063.0,2019-11-02,"(534.398, 685.5]",1,2,-1
31063.0,2019-11-02,"(986.5, 1137.0]",1,1,0
31064.0,2019-11-02,"(348.266, 532.5]",2,3,-1
31064.0,2019-11-02,"(532.5, 716.0]",10,19,-9
31064.0,2019-11-02,"(716.0, 899.5]",18,37,-19
31064.0,2019-11-02,"(899.5, 1083.0]",27,58,-31
,,,,1.0,
,,,,1.0,
,,,,1.0,
31066.0,2019-11-02,"(922.0, 957.0]",2,2,0
31066.0,2019-11-02,"(992.0, 1027.0]",1,2,-1
31067.0,2019-11-02,"(724.75, 940.5]",1,4,-3
31067.0,2019-11-02,"(940.5, 1156.25]",2,2,0
31067.0,2019-11-02,"(1156.25, 1372.0]",2,4,-2
31068.0,2019-11-02,"(54.09, 282.5]",1,1,0
31068.0,2019-11-02,"(737.5, 965.0]",1,2,-1
31069.0,2019-11-02,"(905.0, 1151.0]",2,3,-1
31069.0,2019-11-02,"(1151.0, 1397.0]",1,4,-3
31070.0,2019-11-02,"(956.75, 1109.5]",1,1,0
31070.0,2019-11-02,"(1109.5, 1262.25]",1,2,-1
31070.0,2019-11-02,"(1262.25, 1415.0]",2,1,1
31071.0,2019-11-02,"(185.87, 469.5]",4,8,-4
31071.0,2019-11-02,"(469.5, 752.0]",2,3,-1
31071.0,2019-11-02,"(752.0, 1034.5]",9,23,-14
31071.0,2019-11-02,"(1034.5, 1317.0]",5,9,-4
31072.0,2019-11-02,"(604.5, 806.0]",1,1,0
31073.0,2019-11-02,"(821.617, 917.75]",1,3,-2
31073.0,2019-11-02,"(1109.25, 1205.0]",2,3,-1
31074.0,2019-11-02,"(442.376, 599.0]",1,2,-1
31074.0,2019-11-02,"(599.0, 755.0]",1,2,-1
31074.0,2019-11-02,"(911.0, 1067.0]",3,5,-2
,,,,1.0,
,,,,1.0,
,,,,4.0,
31076.0,2019-11-02,"(694.732, 762.0]",1,3,-2
31076.0,2019-11-02,"(896.0, 963.0]",1,1,0
31077.0,2019-11-02,"(28.598, 380.5]",1,1,0
31077.0,2019-11-02,"(380.5, 731.0]",8,22,-14
31077.0,2019-11-02,"(731.0, 1081.5]",34,52,-18
31077.0,2019-11-02,"(1081.5, 1432.0]",6,9,-3
31078.0,2019-11-02,"(462.5, 693.75]",1,1,0
31078.0,2019-11-02,"(693.75, 925.0]",1,1,0
31079.0,2019-11-02,"(27.615, 375.25]",3,3,0
31079.0,2019-11-02,"(721.5, 1067.75]",6,6,0
31079.0,2019-11-02,"(1067.75, 1414.0]",5,10,-5
31080.0,2019-11-02,"(563.216, 760.0]",1,7,-6
31080.0,2019-11-02,"(760.0, 956.0]",3,7,-4
31080.0,2019-11-02,"(956.0, 1152.0]",2,2,0
31080.0,2019-11-02,"(1152.0, 1348.0]",3,3,0
31081.0,2019-11-02,"(979.0, 1106.0]",1,1,0
,,,,1.0,
,,,,2.0,
31083.0,2019-11-02,"(773.584, 878.0]",2,6,-4
31083.0,2019-11-02,"(982.0, 1086.0]",5,7,-2
31083.0,2019-11-02,"(1086.0, 1190.0]",1,3,-2
31084.0,2019-11-02,"(882.25, 926.5]",1,1,0
31084.0,2019-11-02,"(926.5, 970.75]",2,1,1
31084.0,2019-11-02,"(970.75, 1015.0]",1,2,-1
,,,,1.0,
,,,,1.0,
,,,,4.0,
31086.0,2019-11-02,"(552.463, 687.25]",2,4,-2
31086.0,2019-11-02,"(687.25, 821.5]",3,5,-2
31086.0,2019-11-02,"(955.75, 1090.0]",4,1,3
31087.0,2019-11-02,"(722.639, 813.25]",2,3,-1
31087.0,2019-11-02,"(993.75, 1084.0]",2,2,0
31088.0,2019-11-02,"(463.348, 627.0]",2,3,-1
31088.0,2019-11-02,"(627.0, 790.0]",1,5,-4
31088.0,2019-11-02,"(953.0, 1116.0]",2,3,-1
31089.0,2019-11-02,"(371.0, 717.0]",2,1,1
31089.0,2019-11-02,"(717.0, 1063.0]",11,7,4
31089.0,2019-11-02,"(1063.0, 1409.0]",2,23,-21
31090.0,2019-11-02,"(941.982, 946.5]",1,2,-1
31090.0,2019-11-02,"(955.5, 960.0]",1,1,0
31091.0,2019-11-02,"(734.484, 864.0]",1,6,-5
31091.0,2019-11-02,"(993.0, 1122.0]",1,1,0
31091.0,2019-11-02,"(1122.0, 1251.0]",1,1,0
31092.0,2019-11-02,"(776.0, 925.0]",2,1,1
31092.0,2019-11-02,"(925.0, 1074.0]",2,2,0
31093.0,2019-11-02,"(899.5, 1002.0]",1,1,0
31094.0,2019-11-02,"(673.5, 898.0]",1,1,0
,,,,2.0,
31096.0,2019-11-02,"(706.0, 830.0]",1,1,0
31096.0,2019-11-02,"(954.0, 1078.0]",2,2,0
31097.0,2019-11-02,"(778.701, 853.75]",1,3,-2
31097.0,2019-11-02,"(928.5, 1003.25]",1,1,0
31097.0,2019-11-02,"(1003.25, 1078.0]",7,2,5
31098.0,2019-11-02,"(494.163, 704.25]",4,6,-2
31098.0,2019-11-02,"(704.25, 913.5]",5,6,-1
31098.0,2019-11-02,"(913.5, 1122.75]",1,2,-1
31098.0,2019-11-02,"(1122.75, 1332.0]",2,3,-1
31099.0,2019-11-02,"(883.0, 1032.5]",2,1,1
31099.0,2019-11-02,"(1032.5, 1182.0]",2,3,-1
31100.0,2019-11-02,"(428.051, 666.25]",1,2,-1
31100.0,2019-11-02,"(666.25, 903.5]",2,3,-1
31100.0,2019-11-02,"(903.5, 1140.75]",2,4,-2
31100.0,2019-11-02,"(1140.75, 1378.0]",1,7,-6
31101.0,2019-11-02,"(3.588, 358.0]",3,5,-2
31101.0,2019-11-02,"(358.0, 711.0]",20,37,-17
31101.0,2019-11-02,"(711.0, 1064.0]",43,84,-41
31101.0,2019-11-02,"(1064.0, 1417.0]",33,50,-17
31102.0,2019-11-02,"(16.617, 363.75]",6,10,-4
31102.0,2019-11-02,"(363.75, 709.5]",4,13,-9
31102.0,2019-11-02,"(709.5, 1055.25]",9,30,-21
31102.0,2019-11-02,"(1055.25, 1401.0]",9,16,-7
31103.0,2019-11-02,"(74.668, 409.0]",2,6,-4
31103.0,2019-11-02,"(409.0, 742.0]",10,40,-30
31103.0,2019-11-02,"(742.0, 1075.0]",14,44,-30
31103.0,2019-11-02,"(1075.0, 1408.0]",6,14,-8
31104.0,2019-11-02,"(2.567, 362.25]",1,8,-7
31104.0,2019-11-02,"(362.25, 720.5]",15,30,-15
31104.0,2019-11-02,"(720.5, 1078.75]",38,78,-40
31104.0,2019-11-02,"(1078.75, 1437.0]",13,22,-9
31105.0,2019-11-02,"(59.748, 374.0]",2,4,-2
31105.0,2019-11-02,"(687.0, 1000.0]",1,2,-1
31105.0,2019-11-02,"(1000.0, 1313.0]",4,2,2
31106.0,2019-11-02,"(607.367, 766.25]",2,7,-5
31106.0,2019-11-02,"(924.5, 1082.75]",1,4,-3
31107.0,2019-11-02,"(6.581, 362.75]",4,6,-2
31107.0,2019-11-02,"(362.75, 717.5]",7,25,-18
31107.0,2019-11-02,"(717.5, 1072.25]",12,32,-20
31107.0,2019-11-02,"(1072.25, 1427.0]",11,28,-17
31108.0,2019-11-02,"(4.569, 363.75]",1,3,-2
31108.0,2019-11-02,"(363.75, 721.5]",19,48,-29
31108.0,2019-11-02,"(721.5, 1079.25]",38,71,-33
31108.0,2019-11-02,"(1079.25, 1437.0]",18,25,-7
31109.0,2019-11-02,"(34.605, 384.75]",2,7,-5
31109.0,2019-11-02,"(384.75, 733.5]",8,15,-7
31109.0,2019-11-02,"(733.5, 1082.25]",21,39,-18
31109.0,2019-11-02,"(1082.25, 1431.0]",11,22,-11
31110.0,2019-11-02,"(41.604, 392.0]",2,3,-1
31110.0,2019-11-02,"(392.0, 741.0]",17,34,-17
31110.0,2019-11-02,"(741.0, 1090.0]",16,42,-26
31110.0,2019-11-02,"(1090.0, 1439.0]",8,14,-6
31111.0,2019-11-02,"(70.659, 407.25]",3,8,-5
31111.0,2019-11-02,"(407.25, 742.5]",9,15,-6
31111.0,2019-11-02,"(742.5, 1077.75]",15,29,-14
31111.0,2019-11-02,"(1077.75, 1413.0]",12,25,-13
31112.0,2019-11-02,"(692.257, 878.75]",2,10,-8
31112.0,2019-11-02,"(878.75, 1064.5]",3,12,-9
31112.0,2019-11-02,"(1250.25, 1436.0]",1,1,0
31113.0,2019-11-02,"(2.567, 362.25]",1,3,-2
31113.0,2019-11-02,"(362.25, 720.5]",3,17,-14
31113.0,2019-11-02,"(720.5, 1078.75]",9,24,-15
31113.0,2019-11-02,"(1078.75, 1437.0]",7,21,-14
31114.0,2019-11-02,"(2.568, 362.0]",1,7,-6
31114.0,2019-11-02,"(362.0, 720.0]",10,24,-14
31114.0,2019-11-02,"(720.0, 1078.0]",21,53,-32
31114.0,2019-11-02,"(1078.0, 1436.0]",15,23,-8
31115.0,2019-11-02,"(4.612, 353.0]",2,5,-3
31115.0,2019-11-02,"(353.0, 700.0]",5,19,-14
31115.0,2019-11-02,"(700.0, 1047.0]",4,11,-7
31115.0,2019-11-02,"(1047.0, 1394.0]",14,24,-10
31116.0,2019-11-02,"(58.648, 398.0]",1,1,0
31116.0,2019-11-02,"(398.0, 736.0]",5,14,-9
31116.0,2019-11-02,"(736.0, 1074.0]",21,45,-24
31116.0,2019-11-02,"(1074.0, 1412.0]",10,17,-7
31117.0,2019-11-02,"(237.837, 529.75]",2,7,-5
31117.0,2019-11-02,"(529.75, 820.5]",11,24,-13
31117.0,2019-11-02,"(820.5, 1111.25]",11,22,-11
31117.0,2019-11-02,"(1111.25, 1402.0]",8,15,-7
31118.0,2019-11-02,"(92.803, 393.25]",1,2,-1
31118.0,2019-11-02,"(393.25, 692.5]",2,8,-6
31118.0,2019-11-02,"(692.5, 991.75]",10,22,-12
31118.0,2019-11-02,"(991.75, 1291.0]",10,17,-7
31119.0,2019-11-02,"(-0.414, 354.5]",3,7,-4
31119.0,2019-11-02,"(354.5, 708.0]",11,26,-15
31119.0,2019-11-02,"(708.0, 1061.5]",12,29,-17
31119.0,2019-11-02,"(1061.5, 1415.0]",12,24,-12
31120.0,2019-11-02,"(97.694, 425.5]",2,3,-1
31120.0,2019-11-02,"(425.5, 752.0]",5,14,-9
31120.0,2019-11-02,"(752.0, 1078.5]",13,29,-16
31120.0,2019-11-02,"(1078.5, 1405.0]",8,12,-4
31121.0,2019-11-02,"(43.684, 374.0]",1,1,0
31121.0,2019-11-02,"(374.0, 703.0]",14,23,-9
31121.0,2019-11-02,"(703.0, 1032.0]",14,31,-17
31121.0,2019-11-02,"(1032.0, 1361.0]",10,12,-2
31122.0,2019-11-02,"(358.125, 577.75]",3,8,-5
31122.0,2019-11-02,"(577.75, 796.5]",6,16,-10
31122.0,2019-11-02,"(796.5, 1015.25]",4,14,-10
31122.0,2019-11-02,"(1015.25, 1234.0]",3,6,-3
31123.0,2019-11-02,"(3.573, 361.75]",3,6,-3
31123.0,2019-11-02,"(361.75, 718.5]",4,9,-5
31123.0,2019-11-02,"(718.5, 1075.25]",5,10,-5
31123.0,2019-11-02,"(1075.25, 1432.0]",6,10,-4
31124.0,2019-11-02,"(30.601, 381.75]",2,4,-2
31124.0,2019-11-02,"(381.75, 731.5]",23,49,-26
31124.0,2019-11-02,"(731.5, 1081.25]",23,62,-39
31124.0,2019-11-02,"(1081.25, 1431.0]",12,33,-21
31125.0,2019-11-02,"(105.677, 437.75]",2,4,-2
31125.0,2019-11-02,"(437.75, 768.5]",17,44,-27
31125.0,2019-11-02,"(768.5, 1099.25]",36,60,-24
31125.0,2019-11-02,"(1099.25, 1430.0]",21,36,-15
31126.0,2019-11-02,"(0.562, 361.5]",2,4,-2
31126.0,2019-11-02,"(361.5, 721.0]",7,34,-27
31126.0,2019-11-02,"(721.0, 1080.5]",18,46,-28
31126.0,2019-11-02,"(1080.5, 1440.0]",7,16,-9
31127.0,2019-11-02,"(6.597, 358.75]",3,6,-3
31127.0,2019-11-02,"(358.75, 709.5]",3,8,-5
31127.0,2019-11-02,"(709.5, 1060.25]",13,27,-14
31127.0,2019-11-02,"(1060.25, 1411.0]",6,13,-7
31128.0,2019-11-02,"(488.12, 709.0]",13,21,-8
31128.0,2019-11-02,"(709.0, 929.0]",18,35,-17
31128.0,2019-11-02,"(929.0, 1149.0]",13,27,-14
31128.0,2019-11-02,"(1149.0, 1369.0]",3,5,-2
31129.0,2019-11-02,"(374.0, 700.0]",16,1,15
31129.0,2019-11-02,"(700.0, 1026.0]",38,22,16
31129.0,2019-11-02,"(1026.0, 1352.0]",8,56,-48
31130.0,2019-11-02,"(518.5, 824.0]",13,1,12
31130.0,2019-11-02,"(824.0, 1129.5]",14,21,-7
31130.0,2019-11-02,"(1129.5, 1435.0]",8,23,-15
31131.0,2019-11-02,"(26.687, 356.25]",2,7,-5
31131.0,2019-11-02,"(356.25, 684.5]",1,9,-8
31131.0,2019-11-02,"(684.5, 1012.75]",3,10,-7
31131.0,2019-11-02,"(1012.75, 1341.0]",6,10,-4
31200.0,2019-11-02,"(2.585, 357.75]",2,4,-2
31200.0,2019-11-02,"(357.75, 711.5]",27,33,-6
31200.0,2019-11-02,"(711.5, 1065.25]",57,107,-50
31200.0,2019-11-02,"(1065.25, 1419.0]",29,49,-20
31201.0,2019-11-02,"(24.587, 379.25]",4,9,-5
31201.0,2019-11-02,"(379.25, 732.5]",21,40,-19
31201.0,2019-11-02,"(732.5, 1085.75]",55,109,-54
31201.0,2019-11-02,"(1085.75, 1439.0]",31,51,-20
31202.0,2019-11-02,"(2.569, 361.75]",6,10,-4
31202.0,2019-11-02,"(361.75, 719.5]",27,45,-18
31202.0,2019-11-02,"(719.5, 1077.25]",36,68,-32
31202.0,2019-11-02,"(1077.25, 1435.0]",14,31,-17
31203.0,2019-11-02,"(-0.427, 357.75]",5,10,-5
31203.0,2019-11-02,"(357.75, 714.5]",25,42,-17
31203.0,2019-11-02,"(714.5, 1071.25]",50,92,-42
31203.0,2019-11-02,"(1071.25, 1428.0]",34,57,-23
31204.0,2019-11-02,"(478.75, 798.5]",4,2,2
31204.0,2019-11-02,"(798.5, 1118.25]",6,5,1
31204.0,2019-11-02,"(1118.25, 1438.0]",5,13,-8
31205.0,2019-11-02,"(119.73, 438.5]",1,2,-1
31205.0,2019-11-02,"(438.5, 756.0]",5,11,-6
31205.0,2019-11-02,"(756.0, 1073.5]",16,29,-13
31205.0,2019-11-02,"(1073.5, 1391.0]",7,19,-12
31206.0,2019-11-02,"(628.577, 734.75]",1,1,0
31206.0,2019-11-02,"(946.25, 1052.0]",6,10,-4
31207.0,2019-11-02,"(1076.0, 1234.0]",2,2,0
31207.0,2019-11-02,"(1234.0, 1392.0]",2,3,-1
31208.0,2019-11-02,"(521.507, 645.25]",2,4,-2
31208.0,2019-11-02,"(645.25, 768.5]",1,4,-3
31208.0,2019-11-02,"(891.75, 1015.0]",18,5,13
31209.0,2019-11-02,"(15.62, 362.0]",1,4,-3
31209.0,2019-11-02,"(362.0, 707.0]",12,15,-3
31209.0,2019-11-02,"(707.0, 1052.0]",25,35,-10
31209.0,2019-11-02,"(1052.0, 1397.0]",11,21,-10
31211.0,2019-11-02,"(545.208, 744.0]",1,1,0
31211.0,2019-11-02,"(744.0, 942.0]",2,10,-8
31211.0,2019-11-02,"(942.0, 1140.0]",4,6,-2
31211.0,2019-11-02,"(1140.0, 1338.0]",1,4,-3
31212.0,2019-11-02,"(24.653, 362.75]",3,4,-1
31212.0,2019-11-02,"(362.75, 699.5]",10,16,-6
31212.0,2019-11-02,"(699.5, 1036.25]",13,33,-20
31212.0,2019-11-02,"(1036.25, 1373.0]",12,19,-7
31213.0,2019-11-02,"(312.879, 594.25]",9,14,-5
31213.0,2019-11-02,"(594.25, 874.5]",20,29,-9
31213.0,2019-11-02,"(874.5, 1154.75]",11,18,-7
31213.0,2019-11-02,"(1154.75, 1435.0]",2,6,-4
31214.0,2019-11-02,"(11.579, 368.25]",1,3,-2
31214.0,2019-11-02,"(368.25, 723.5]",18,52,-34
31214.0,2019-11-02,"(723.5, 1078.75]",44,79,-35
31214.0,2019-11-02,"(1078.75, 1434.0]",9,21,-12
31215.0,2019-11-02,"(339.5, 651.0]",7,1,6
31215.0,2019-11-02,"(651.0, 962.5]",40,7,33
31215.0,2019-11-02,"(962.5, 1274.0]",10,67,-57
31216.0,2019-11-02,"(494.254, 681.5]",2,3,-1
31216.0,2019-11-02,"(681.5, 868.0]",25,30,-5
31216.0,2019-11-02,"(868.0, 1054.5]",6,12,-6
31216.0,2019-11-02,"(1054.5, 1241.0]",2,10,-8
31217.0,2019-11-02,"(432.006, 681.5]",1,3,-2
31217.0,2019-11-02,"(681.5, 930.0]",9,14,-5
31217.0,2019-11-02,"(930.0, 1178.5]",11,32,-21
31217.0,2019-11-02,"(1178.5, 1427.0]",2,6,-4
31218.0,2019-11-02,"(537.31, 710.5]",9,12,-3
31218.0,2019-11-02,"(710.5, 883.0]",14,18,-4
31218.0,2019-11-02,"(883.0, 1055.5]",7,35,-28
31218.0,2019-11-02,"(1055.5, 1228.0]",2,5,-3
,,,,2.0,
31220.0,2019-11-02,"(1003.5, 1338.0]",1,1,0
31221.0,2019-11-02,"(455.049, 693.75]",16,17,-1
31221.0,2019-11-02,"(693.75, 931.5]",8,20,-12
31221.0,2019-11-02,"(931.5, 1169.25]",20,25,-5
31221.0,2019-11-02,"(1169.25, 1407.0]",4,10,-6
31222.0,2019-11-02,"(417.75, 731.5]",8,1,7
31222.0,2019-11-02,"(731.5, 1045.25]",40,13,27
31222.0,2019-11-02,"(1045.25, 1359.0]",5,65,-60
31223.0,2019-11-02,"(535.099, 761.25]",6,14,-8
31223.0,2019-11-02,"(761.25, 986.5]",20,29,-9
31223.0,2019-11-02,"(986.5, 1211.75]",9,15,-6
31223.0,2019-11-02,"(1211.75, 1437.0]",2,9,-7
31224.0,2019-11-02,"(556.162, 766.5]",7,11,-4
31224.0,2019-11-02,"(766.5, 976.0]",4,7,-3
31224.0,2019-11-02,"(976.0, 1185.5]",5,7,-2
31225.0,2019-11-02,"(40.645, 380.75]",1,1,0
31225.0,2019-11-02,"(380.75, 719.5]",5,10,-5
31225.0,2019-11-02,"(719.5, 1058.25]",42,69,-27
31225.0,2019-11-02,"(1058.25, 1397.0]",6,12,-6
31226.0,2019-11-02,"(200.936, 468.0]",1,1,0
31226.0,2019-11-02,"(468.0, 734.0]",2,5,-3
31226.0,2019-11-02,"(734.0, 1000.0]",9,14,-5
31226.0,2019-11-02,"(1000.0, 1266.0]",6,16,-10
31227.0,2019-11-02,"(339.972, 598.0]",1,2,-1
31227.0,2019-11-02,"(598.0, 855.0]",28,39,-11
31227.0,2019-11-02,"(855.0, 1112.0]",11,18,-7
31227.0,2019-11-02,"(1112.0, 1369.0]",2,3,-1
31228.0,2019-11-02,"(15.618, 362.5]",2,6,-4
31228.0,2019-11-02,"(362.5, 708.0]",19,25,-6
31228.0,2019-11-02,"(708.0, 1053.5]",30,48,-18
31228.0,2019-11-02,"(1053.5, 1399.0]",19,50,-31
31229.0,2019-11-02,"(77.648, 417.0]",4,10,-6
31229.0,2019-11-02,"(417.0, 755.0]",30,70,-40
31229.0,2019-11-02,"(755.0, 1093.0]",29,71,-42
31229.0,2019-11-02,"(1093.0, 1431.0]",21,40,-19
31230.0,2019-11-02,"(372.75, 704.5]",9,1,8
31230.0,2019-11-02,"(704.5, 1036.25]",49,15,34
31230.0,2019-11-02,"(1036.25, 1368.0]",10,76,-66
31231.0,2019-11-02,"(441.5, 662.25]",1,1,0
31231.0,2019-11-02,"(662.25, 883.0]",4,1,3
31232.0,2019-11-02,"(181.832, 475.0]",3,6,-3
31232.0,2019-11-02,"(475.0, 767.0]",26,32,-6
31232.0,2019-11-02,"(767.0, 1059.0]",41,86,-45
31232.0,2019-11-02,"(1059.0, 1351.0]",17,42,-25
31233.0,2019-11-02,"(4.61, 353.5]",2,3,-1
31233.0,2019-11-02,"(353.5, 701.0]",6,8,-2
31233.0,2019-11-02,"(701.0, 1048.5]",10,16,-6
31233.0,2019-11-02,"(1048.5, 1396.0]",6,10,-4
31234.0,2019-11-02,"(393.75, 715.5]",8,2,6
31234.0,2019-11-02,"(715.5, 1037.25]",17,14,3
31234.0,2019-11-02,"(1037.25, 1359.0]",12,33,-21
31235.0,2019-11-02,"(526.168, 735.0]",1,11,-10
31235.0,2019-11-02,"(735.0, 943.0]",9,15,-6
31235.0,2019-11-02,"(943.0, 1151.0]",2,12,-10
31235.0,2019-11-02,"(1151.0, 1359.0]",3,3,0
31236.0,2019-11-02,"(469.064, 704.0]",4,7,-3
31236.0,2019-11-02,"(704.0, 938.0]",11,23,-12
31236.0,2019-11-02,"(938.0, 1172.0]",15,21,-6
31236.0,2019-11-02,"(1172.0, 1406.0]",2,9,-7
31237.0,2019-11-02,"(110.737, 427.75]",2,2,0
31237.0,2019-11-02,"(427.75, 743.5]",13,30,-17
31237.0,2019-11-02,"(743.5, 1059.25]",15,31,-16
31237.0,2019-11-02,"(1059.25, 1375.0]",11,20,-9
31238.0,2019-11-02,"(350.93, 619.5]",5,7,-2
31238.0,2019-11-02,"(619.5, 887.0]",24,31,-7
31238.0,2019-11-02,"(887.0, 1154.5]",26,57,-31
31239.0,2019-11-02,"(17.634, 360.5]",1,3,-2
31239.0,2019-11-02,"(360.5, 702.0]",7,10,-3
31239.0,2019-11-02,"(702.0, 1043.5]",19,38,-19
31239.0,2019-11-02,"(1043.5, 1385.0]",6,16,-10
31240.0,2019-11-02,"(509.254, 696.5]",11,17,-6
31240.0,2019-11-02,"(696.5, 883.0]",20,49,-29
31240.0,2019-11-02,"(883.0, 1069.5]",16,32,-16
31240.0,2019-11-02,"(1069.5, 1256.0]",2,4,-2
31241.0,2019-11-02,"(0.588, 355.0]",7,11,-4
31241.0,2019-11-02,"(355.0, 708.0]",10,28,-18
31241.0,2019-11-02,"(708.0, 1061.0]",30,65,-35
31241.0,2019-11-02,"(1061.0, 1414.0]",16,39,-23
31242.0,2019-11-02,"(341.0, 663.0]",2,1,1
31242.0,2019-11-02,"(663.0, 985.0]",9,2,7
31242.0,2019-11-02,"(985.0, 1307.0]",9,14,-5
31243.0,2019-11-02,"(42.625, 387.75]",2,4,-2
31243.0,2019-11-02,"(387.75, 731.5]",5,15,-10
31243.0,2019-11-02,"(731.5, 1075.25]",72,143,-71
31243.0,2019-11-02,"(1075.25, 1419.0]",10,15,-5
31244.0,2019-11-02,"(346.75, 686.5]",3,2,1
31244.0,2019-11-02,"(686.5, 1026.25]",13,6,7
31244.0,2019-11-02,"(1026.25, 1366.0]",13,30,-17
31245.0,2019-11-02,"(62.625, 407.75]",2,4,-2
31245.0,2019-11-02,"(407.75, 751.5]",5,12,-7
31245.0,2019-11-02,"(751.5, 1095.25]",23,55,-32
31245.0,2019-11-02,"(1095.25, 1439.0]",13,27,-14
31246.0,2019-11-02,"(5.621, 351.75]",1,2,-1
31246.0,2019-11-02,"(351.75, 696.5]",13,16,-3
31246.0,2019-11-02,"(696.5, 1041.25]",47,80,-33
31246.0,2019-11-02,"(1041.25, 1386.0]",12,25,-13
31247.0,2019-11-02,"(66.715, 389.25]",4,4,0
31247.0,2019-11-02,"(389.25, 710.5]",23,47,-24
31247.0,2019-11-02,"(710.5, 1031.75]",96,197,-101
31247.0,2019-11-02,"(1031.75, 1353.0]",30,52,-22
31248.0,2019-11-02,"(6.578, 363.5]",2,5,-3
31248.0,2019-11-02,"(363.5, 719.0]",20,26,-6
31248.0,2019-11-02,"(719.0, 1074.5]",104,231,-127
31248.0,2019-11-02,"(1074.5, 1430.0]",13,18,-5
31249.0,2019-11-02,"(709.378, 865.5]",14,43,-29
31249.0,2019-11-02,"(865.5, 1021.0]",32,62,-30
31249.0,2019-11-02,"(1021.0, 1176.5]",5,17,-12
31249.0,2019-11-02,"(1176.5, 1332.0]",2,7,-5
31250.0,2019-11-02,"(483.335, 650.25]",6,10,-4
31250.0,2019-11-02,"(650.25, 816.5]",3,5,-2
31250.0,2019-11-02,"(816.5, 982.75]",3,6,-3
31250.0,2019-11-02,"(982.75, 1149.0]",6,10,-4
31251.0,2019-11-02,"(59.685, 389.75]",1,1,0
31251.0,2019-11-02,"(389.75, 718.5]",4,13,-9
31251.0,2019-11-02,"(718.5, 1047.25]",28,41,-13
31251.0,2019-11-02,"(1047.25, 1376.0]",7,14,-7
31252.0,2019-11-02,"(480.165, 689.75]",6,10,-4
31252.0,2019-11-02,"(689.75, 898.5]",10,20,-10
31252.0,2019-11-02,"(898.5, 1107.25]",10,14,-4
31252.0,2019-11-02,"(1107.25, 1316.0]",4,10,-6
31253.0,2019-11-02,"(346.0, 679.0]",1,2,-1
31253.0,2019-11-02,"(679.0, 1012.0]",7,1,6
31253.0,2019-11-02,"(1012.0, 1345.0]",2,10,-8
31254.0,2019-11-02,"(345.091, 573.25]",3,3,0
31254.0,2019-11-02,"(573.25, 800.5]",3,10,-7
31254.0,2019-11-02,"(800.5, 1027.75]",28,45,-17
31254.0,2019-11-02,"(1027.75, 1255.0]",5,8,-3
31255.0,2019-11-02,"(598.343, 763.25]",6,6,0
31255.0,2019-11-02,"(763.25, 927.5]",4,7,-3
31255.0,2019-11-02,"(1091.75, 1256.0]",1,1,0
31256.0,2019-11-02,"(124.785, 429.75]",1,3,-2
31256.0,2019-11-02,"(429.75, 733.5]",17,25,-8
31256.0,2019-11-02,"(733.5, 1037.25]",21,47,-26
31256.0,2019-11-02,"(1037.25, 1341.0]",15,35,-20
31257.0,2019-11-02,"(420.022, 665.5]",5,8,-3
31257.0,2019-11-02,"(665.5, 910.0]",14,30,-16
31257.0,2019-11-02,"(910.0, 1154.5]",15,27,-12
31257.0,2019-11-02,"(1154.5, 1399.0]",9,14,-5
31258.0,2019-11-02,"(221.895, 499.25]",1,3,-2
31258.0,2019-11-02,"(499.25, 775.5]",29,54,-25
31258.0,2019-11-02,"(775.5, 1051.75]",87,171,-84
31258.0,2019-11-02,"(1051.75, 1328.0]",15,26,-11
31259.0,2019-11-02,"(834.0, 969.0]",3,3,0
31259.0,2019-11-02,"(1104.0, 1239.0]",2,8,-6
31260.0,2019-11-02,"(350.0, 601.0]",2,2,0
31260.0,2019-11-02,"(601.0, 851.0]",9,13,-4
31260.0,2019-11-02,"(851.0, 1101.0]",4,6,-2
31260.0,2019-11-02,"(1101.0, 1351.0]",6,11,-5
31261.0,2019-11-02,"(736.454, 873.5]",4,6,-2
31261.0,2019-11-02,"(873.5, 1010.0]",6,13,-7
31261.0,2019-11-02,"(1010.0, 1146.5]",4,6,-2
31261.0,2019-11-02,"(1146.5, 1283.0]",3,5,-2
31262.0,2019-11-02,"(357.5, 694.0]",2,2,0
31262.0,2019-11-02,"(694.0, 1030.5]",25,3,22
31262.0,2019-11-02,"(1030.5, 1367.0]",3,48,-45
31263.0,2019-11-02,"(179.965, 439.75]",1,1,0
31263.0,2019-11-02,"(439.75, 698.5]",8,18,-10
31263.0,2019-11-02,"(698.5, 957.25]",32,45,-13
31263.0,2019-11-02,"(957.25, 1216.0]",17,30,-13
31264.0,2019-11-02,"(20.617, 367.75]",1,1,0
31264.0,2019-11-02,"(367.75, 713.5]",6,7,-1
31264.0,2019-11-02,"(713.5, 1059.25]",38,92,-54
31264.0,2019-11-02,"(1059.25, 1405.0]",3,7,-4
31265.0,2019-11-02,"(15.592, 369.0]",4,6,-2
31265.0,2019-11-02,"(369.0, 721.0]",12,24,-12
31265.0,2019-11-02,"(721.0, 1073.0]",35,71,-36
31265.0,2019-11-02,"(1073.0, 1425.0]",11,22,-11
31266.0,2019-11-02,"(3.582, 359.5]",5,9,-4
31266.0,2019-11-02,"(359.5, 714.0]",11,34,-23
31266.0,2019-11-02,"(714.0, 1068.5]",35,64,-29
31266.0,2019-11-02,"(1068.5, 1423.0]",21,38,-17
31267.0,2019-11-02,"(13.59, 367.5]",3,5,-2
31267.0,2019-11-02,"(367.5, 720.0]",7,16,-9
31267.0,2019-11-02,"(720.0, 1072.5]",17,46,-29
31267.0,2019-11-02,"(1072.5, 1425.0]",9,20,-11
31268.0,2019-11-02,"(9.577, 366.75]",3,6,-3
31268.0,2019-11-02,"(366.75, 722.5]",9,16,-7
31268.0,2019-11-02,"(722.5, 1078.25]",24,44,-20
31268.0,2019-11-02,"(1078.25, 1434.0]",14,27,-13
31269.0,2019-11-02,"(101.668, 436.0]",1,2,-1
31269.0,2019-11-02,"(436.0, 769.0]",16,28,-12
31269.0,2019-11-02,"(769.0, 1102.0]",26,56,-30
31269.0,2019-11-02,"(1102.0, 1435.0]",11,22,-11
31270.0,2019-11-02,"(26.658, 363.5]",1,2,-1
31270.0,2019-11-02,"(363.5, 699.0]",10,12,-2
31270.0,2019-11-02,"(699.0, 1034.5]",33,79,-46
31270.0,2019-11-02,"(1034.5, 1370.0]",10,18,-8
31271.0,2019-11-02,"(489.261, 674.75]",19,25,-6
31271.0,2019-11-02,"(674.75, 859.5]",104,115,-11
31271.0,2019-11-02,"(859.5, 1044.25]",93,196,-103
31271.0,2019-11-02,"(1044.25, 1229.0]",8,32,-24
31272.0,2019-11-02,"(35.771, 344.25]",1,1,0
31272.0,2019-11-02,"(651.5, 958.75]",40,2,38
31272.0,2019-11-02,"(958.75, 1266.0]",12,71,-59
31273.0,2019-11-02,"(534.178, 740.5]",7,14,-7
31273.0,2019-11-02,"(740.5, 946.0]",5,7,-2
31273.0,2019-11-02,"(946.0, 1151.5]",4,8,-4
31274.0,2019-11-02,"(371.017, 617.75]",2,2,0
31274.0,2019-11-02,"(617.75, 863.5]",10,10,0
31274.0,2019-11-02,"(863.5, 1109.25]",24,47,-23
31274.0,2019-11-02,"(1109.25, 1355.0]",2,9,-7
31275.0,2019-11-02,"(43.649, 382.75]",5,7,-2
31275.0,2019-11-02,"(382.75, 720.5]",5,15,-10
31275.0,2019-11-02,"(720.5, 1058.25]",20,35,-15
31275.0,2019-11-02,"(1058.25, 1396.0]",6,15,-9
31276.0,2019-11-02,"(488.131, 706.25]",4,7,-3
31276.0,2019-11-02,"(706.25, 923.5]",12,19,-7
31276.0,2019-11-02,"(923.5, 1140.75]",4,12,-8
31277.0,2019-11-02,"(105.723, 426.25]",5,5,0
31277.0,2019-11-02,"(426.25, 745.5]",5,11,-6
31277.0,2019-11-02,"(745.5, 1064.75]",61,119,-58
31277.0,2019-11-02,"(1064.75, 1384.0]",15,19,-4
31278.0,2019-11-02,"(167.825, 462.75]",2,3,-1
31278.0,2019-11-02,"(462.75, 756.5]",10,25,-15
31278.0,2019-11-02,"(756.5, 1050.25]",14,37,-23
31278.0,2019-11-02,"(1050.25, 1344.0]",15,22,-7
31279.0,2019-11-02,"(544.244, 734.0]",5,8,-3
31279.0,2019-11-02,"(734.0, 923.0]",4,9,-5
31279.0,2019-11-02,"(923.0, 1112.0]",2,5,-3
31279.0,2019-11-02,"(1112.0, 1301.0]",1,2,-1
31280.0,2019-11-02,"(234.828, 529.0]",2,6,-4
31280.0,2019-11-02,"(529.0, 822.0]",20,37,-17
31280.0,2019-11-02,"(822.0, 1115.0]",16,27,-11
31280.0,2019-11-02,"(1115.0, 1408.0]",2,9,-7
31000.0,2019-11-03,"(538.109, 761.75]",1,2,-1
31000.0,2019-11-03,"(761.75, 984.5]",2,2,0
31000.0,2019-11-03,"(984.5, 1207.25]",1,2,-1
31000.0,2019-11-03,"(1207.25, 1430.0]",2,2,0
31001.0,2019-11-03,"(537.165, 746.75]",1,1,0
31001.0,2019-11-03,"(746.75, 955.5]",4,8,-4
31001.0,2019-11-03,"(955.5, 1164.25]",1,2,-1
31001.0,2019-11-03,"(1164.25, 1373.0]",1,1,0
31002.0,2019-11-03,"(695.25, 895.5]",2,3,-1
31002.0,2019-11-03,"(895.5, 1095.75]",5,2,3
31002.0,2019-11-03,"(1095.75, 1296.0]",1,9,-8
31003.0,2019-11-03,"(709.825, 753.75]",2,3,-1
31003.0,2019-11-03,"(797.5, 841.25]",1,2,-1
31003.0,2019-11-03,"(841.25, 885.0]",1,4,-3
31004.0,2019-11-03,"(499.587, 603.25]",2,4,-2
31004.0,2019-11-03,"(706.5, 809.75]",1,2,-1
31004.0,2019-11-03,"(809.75, 913.0]",2,3,-1
31005.0,2019-11-03,"(783.667, 867.25]",2,6,-4
31005.0,2019-11-03,"(1033.75, 1117.0]",4,1,3
31006.0,2019-11-03,"(452.086, 681.5]",3,8,-5
31006.0,2019-11-03,"(681.5, 910.0]",2,3,-1
31006.0,2019-11-03,"(910.0, 1138.5]",4,6,-2
31006.0,2019-11-03,"(1138.5, 1367.0]",1,4,-3
31007.0,2019-11-03,"(381.5, 719.0]",3,1,2
31007.0,2019-11-03,"(719.0, 1056.5]",5,6,-1
31007.0,2019-11-03,"(1056.5, 1394.0]",2,8,-6
,,,,1.0,
,,,,1.0,
31010.0,2019-11-03,"(600.571, 708.25]",1,2,-1
31010.0,2019-11-03,"(815.5, 922.75]",1,3,-2
31010.0,2019-11-03,"(922.75, 1030.0]",5,9,-4
31011.0,2019-11-03,"(846.683, 926.25]",2,4,-2
31011.0,2019-11-03,"(1084.75, 1164.0]",1,2,-1
,,,,2.0,
31013.0,2019-11-03,"(716.516, 838.0]",2,3,-1
31013.0,2019-11-03,"(959.0, 1080.0]",1,1,0
31013.0,2019-11-03,"(1080.0, 1201.0]",4,4,0
31014.0,2019-11-03,"(338.5, 644.0]",7,1,6
31014.0,2019-11-03,"(644.0, 949.5]",12,9,3
31014.0,2019-11-03,"(949.5, 1255.0]",6,20,-14
31015.0,2019-11-03,"(253.852, 542.0]",1,2,-1
31015.0,2019-11-03,"(542.0, 829.0]",8,13,-5
31015.0,2019-11-03,"(829.0, 1116.0]",5,6,-1
31015.0,2019-11-03,"(1116.0, 1403.0]",1,2,-1
31016.0,2019-11-03,"(370.055, 607.25]",1,4,-3
31016.0,2019-11-03,"(607.25, 843.5]",4,8,-4
31016.0,2019-11-03,"(843.5, 1079.75]",4,7,-3
31016.0,2019-11-03,"(1079.75, 1316.0]",1,4,-3
,,,,1.0,
,,,,3.0,
,,,,3.0,
31018.0,2019-11-03,"(804.75, 911.0]",2,1,1
31019.0,2019-11-03,"(590.377, 746.75]",2,3,-1
31019.0,2019-11-03,"(746.75, 902.5]",2,5,-3
31019.0,2019-11-03,"(902.5, 1058.25]",1,2,-1
31019.0,2019-11-03,"(1058.25, 1214.0]",1,2,-1
31020.0,2019-11-03,"(523.096, 750.0]",3,4,-1
31020.0,2019-11-03,"(750.0, 976.0]",1,2,-1
31021.0,2019-11-03,"(533.132, 751.0]",6,7,-1
31021.0,2019-11-03,"(751.0, 968.0]",3,6,-3
31021.0,2019-11-03,"(968.0, 1185.0]",2,3,-1
31022.0,2019-11-03,"(602.221, 797.75]",2,3,-1
31022.0,2019-11-03,"(797.75, 992.5]",6,12,-6
31022.0,2019-11-03,"(992.5, 1187.25]",1,3,-2
31022.0,2019-11-03,"(1187.25, 1382.0]",2,4,-2
31023.0,2019-11-03,"(378.0, 701.0]",1,5,-4
31023.0,2019-11-03,"(701.0, 1024.0]",4,2,2
31023.0,2019-11-03,"(1024.0, 1347.0]",2,9,-7
31024.0,2019-11-03,"(85.761, 396.75]",1,1,0
31024.0,2019-11-03,"(396.75, 706.5]",2,7,-5
31024.0,2019-11-03,"(706.5, 1016.25]",5,10,-5
31024.0,2019-11-03,"(1016.25, 1326.0]",2,5,-3
31025.0,2019-11-03,"(367.75, 630.5]",1,1,0
31025.0,2019-11-03,"(630.5, 893.25]",1,1,0
31025.0,2019-11-03,"(893.25, 1156.0]",2,1,1
31026.0,2019-11-03,"(581.5, 644.0]",1,2,-1
31026.0,2019-11-03,"(706.5, 769.0]",1,1,0
,,,,1.0,
,,,,2.0,
,,,,1.0,
31028.0,2019-11-03,"(665.632, 758.0]",2,2,0
31028.0,2019-11-03,"(942.0, 1034.0]",1,2,-1
31029.0,2019-11-03,"(577.214, 774.5]",1,6,-5
31029.0,2019-11-03,"(774.5, 971.0]",1,3,-2
31029.0,2019-11-03,"(971.0, 1167.5]",1,2,-1
31029.0,2019-11-03,"(1167.5, 1364.0]",2,3,-1
31030.0,2019-11-03,"(14.585, 369.75]",1,1,0
31030.0,2019-11-03,"(723.5, 1077.25]",2,1,1
31030.0,2019-11-03,"(1077.25, 1431.0]",2,4,-2
31031.0,2019-11-03,"(612.394, 764.5]",2,6,-4
31031.0,2019-11-03,"(764.5, 916.0]",1,4,-3
31031.0,2019-11-03,"(916.0, 1067.5]",1,3,-2
31031.0,2019-11-03,"(1067.5, 1219.0]",1,1,0
,,,,1.0,
,,,,1.0,
31033.0,2019-11-03,"(647.453, 784.75]",3,5,-2
31033.0,2019-11-03,"(784.75, 921.5]",1,2,-1
31034.0,2019-11-03,"(76.165, 285.75]",4,4,0
31034.0,2019-11-03,"(494.5, 703.25]",2,1,1
31034.0,2019-11-03,"(703.25, 912.0]",3,2,1
31035.0,2019-11-03,"(284.159, 495.25]",1,3,-2
31035.0,2019-11-03,"(705.5, 915.75]",1,1,0
31035.0,2019-11-03,"(915.75, 1126.0]",3,6,-3
,,,,2.0,
31037.0,2019-11-03,"(595.225, 789.75]",5,9,-4
31037.0,2019-11-03,"(789.75, 983.5]",1,3,-2
31037.0,2019-11-03,"(983.5, 1177.25]",5,10,-5
,,,,1.0,
,,,,1.0,
31039.0,2019-11-03,"(360.5, 637.0]",3,1,2
31039.0,2019-11-03,"(637.0, 913.5]",2,4,-2
31039.0,2019-11-03,"(913.5, 1190.0]",2,4,-2
31040.0,2019-11-03,"(656.405, 805.75]",3,4,-1
31040.0,2019-11-03,"(805.75, 954.5]",1,2,-1
31041.0,2019-11-03,"(666.531, 784.25]",4,5,-1
31041.0,2019-11-03,"(784.25, 901.5]",2,5,-3
31041.0,2019-11-03,"(1018.75, 1136.0]",1,2,-1
31042.0,2019-11-03,"(672.299, 848.25]",6,8,-2
31042.0,2019-11-03,"(848.25, 1023.5]",8,15,-7
31042.0,2019-11-03,"(1023.5, 1198.75]",1,3,-2
31042.0,2019-11-03,"(1198.75, 1374.0]",2,3,-1
31043.0,2019-11-03,"(773.647, 862.25]",1,1,0
31043.0,2019-11-03,"(862.25, 950.5]",4,5,-1
31044.0,2019-11-03,"(827.5, 948.25]",5,1,4
31044.0,2019-11-03,"(948.25, 1069.0]",3,7,-4
31045.0,2019-11-03,"(799.879, 830.25]",1,2,-1
31046.0,2019-11-03,"(975.5, 1092.0]",2,1,1
31047.0,2019-11-03,"(701.5, 1042.75]",9,1,8
31047.0,2019-11-03,"(1042.75, 1384.0]",2,1,1
31048.0,2019-11-03,"(674.459, 810.25]",2,5,-3
31049.0,2019-11-03,"(861.25, 987.0]",1,2,-1
31050.0,2019-11-03,"(260.5, 521.0]",1,1,0
31050.0,2019-11-03,"(781.5, 1042.0]",1,1,0
31051.0,2019-11-03,"(726.0, 836.0]",2,1,1
31051.0,2019-11-03,"(946.0, 1056.0]",2,4,-2
31052.0,2019-11-03,"(865.673, 947.75]",1,4,-3
31052.0,2019-11-03,"(947.75, 1029.5]",2,2,0
31052.0,2019-11-03,"(1029.5, 1111.25]",2,2,0
31053.0,2019-11-03,"(992.683, 1072.25]",1,2,-1
31053.0,2019-11-03,"(1072.25, 1151.5]",1,1,0
31053.0,2019-11-03,"(1230.75, 1310.0]",1,1,0
31054.0,2019-11-03,"(947.75, 997.0]",1,1,0
31055.0,2019-11-03,"(4.241, 194.75]",1,1,0
31055.0,2019-11-03,"(574.25, 764.0]",3,8,-5
,,,,1.0,
,,,,1.0,
31057.0,2019-11-03,"(548.622, 643.5]",1,2,-1
31057.0,2019-11-03,"(643.5, 738.0]",1,1,0
31057.0,2019-11-03,"(738.0, 832.5]",2,5,-3
31057.0,2019-11-03,"(832.5, 927.0]",3,5,-2
,,,,1.0,
,,,,1.0,
31059.0,2019-11-03,"(626.535, 743.25]",2,4,-2
31059.0,2019-11-03,"(743.25, 859.5]",2,4,-2
31059.0,2019-11-03,"(859.5, 975.75]",1,5,-4
31059.0,2019-11-03,"(975.75, 1092.0]",1,1,0
31060.0,2019-11-03,"(592.392, 745.0]",2,6,-4
31060.0,2019-11-03,"(745.0, 897.0]",6,12,-6
31060.0,2019-11-03,"(897.0, 1049.0]",1,1,0
31060.0,2019-11-03,"(1049.0, 1201.0]",1,1,0
,,,,2.0,
31062.0,2019-11-03,"(514.22, 710.0]",2,6,-4
31062.0,2019-11-03,"(710.0, 905.0]",7,15,-8
31062.0,2019-11-03,"(905.0, 1100.0]",8,16,-8
31062.0,2019-11-03,"(1100.0, 1295.0]",1,2,-1
,,,,2.0,
31064.0,2019-11-03,"(49.878, 331.5]",1,2,-1
31064.0,2019-11-03,"(331.5, 612.0]",4,5,-1
31064.0,2019-11-03,"(612.0, 892.5]",12,29,-17
31064.0,2019-11-03,"(892.5, 1173.0]",20,36,-16
,,,,2.0,
31066.0,2019-11-03,"(657.338, 823.5]",1,2,-1
31066.0,2019-11-03,"(1154.5, 1320.0]",1,1,0
31067.0,2019-11-03,"(520.535, 637.25]",1,4,-3
31067.0,2019-11-03,"(869.75, 986.0]",1,1,0
31068.0,2019-11-03,"(601.238, 792.5]",1,4,-3
31068.0,2019-11-03,"(792.5, 983.0]",2,4,-2
31068.0,2019-11-03,"(983.0, 1173.5]",2,2,0
31068.0,2019-11-03,"(1173.5, 1364.0]",1,1,0
31069.0,2019-11-03,"(729.75, 820.5]",2,3,-1
31069.0,2019-11-03,"(911.25, 1002.0]",1,3,-2
31070.0,2019-11-03,"(532.421, 677.75]",2,5,-3
31070.0,2019-11-03,"(677.75, 822.5]",1,1,0
31070.0,2019-11-03,"(967.25, 1112.0]",1,3,-2
31071.0,2019-11-03,"(735.25, 894.5]",4,4,0
31071.0,2019-11-03,"(894.5, 1053.75]",2,10,-8
31071.0,2019-11-03,"(1053.75, 1213.0]",3,3,0
,,,,1.0,
,,,,1.0,
31073.0,2019-11-03,"(449.778, 505.5]",1,2,-1
31074.0,2019-11-03,"(585.339, 751.25]",1,2,-1
31074.0,2019-11-03,"(916.5, 1081.75]",1,1,0
31074.0,2019-11-03,"(1081.75, 1247.0]",1,3,-2
31075.0,2019-11-03,"(1100.999, 1101.25]",1,1,0
31076.0,2019-11-03,"(328.5, 438.0]",1,1,0
31077.0,2019-11-03,"(507.354, 669.5]",2,2,0
31077.0,2019-11-03,"(669.5, 831.0]",1,9,-8
31077.0,2019-11-03,"(831.0, 992.5]",6,7,-1
31077.0,2019-11-03,"(992.5, 1154.0]",2,2,0
,,,,2.0,
31079.0,2019-11-03,"(531.351, 694.25]",1,5,-4
31079.0,2019-11-03,"(694.25, 856.5]",2,2,0
31079.0,2019-11-03,"(1018.75, 1181.0]",2,1,1
31080.0,2019-11-03,"(494.154, 706.5]",1,6,-5
31080.0,2019-11-03,"(706.5, 918.0]",2,4,-2
31080.0,2019-11-03,"(918.0, 1129.5]",2,4,-2
31080.0,2019-11-03,"(1129.5, 1341.0]",1,2,-1
31081.0,2019-11-03,"(648.0, 719.0]",1,1,0
31081.0,2019-11-03,"(790.0, 861.0]",1,1,0
31082.0,2019-11-03,"(683.824, 728.0]",1,1,0
31082.0,2019-11-03,"(816.0, 860.0]",1,1,0
31083.0,2019-11-03,"(445.5, 594.0]",1,1,0
,,,,1.0,
,,,,2.0,
,,,,2.0,
31086.0,2019-11-03,"(595.82, 641.0]",3,3,0
31087.0,2019-11-03,"(980.25, 1092.0]",1,1,0
31088.0,2019-11-03,"(496.379, 652.25]",1,3,-2
31088.0,2019-11-03,"(652.25, 807.5]",2,2,0
31088.0,2019-11-03,"(962.75, 1118.0]",2,1,1
31089.0,2019-11-03,"(11.719, 333.25]",1,2,-1
31089.0,2019-11-03,"(333.25, 653.5]",1,4,-3
31089.0,2019-11-03,"(653.5, 973.75]",2,8,-6
31089.0,2019-11-03,"(973.75, 1294.0]",2,4,-2
31090.0,2019-11-03,"(470.828, 514.0]",2,2,0
31090.0,2019-11-03,"(600.0, 643.0]",2,3,-1
31091.0,2019-11-03,"(709.574, 816.5]",1,2,-1
31091.0,2019-11-03,"(816.5, 923.0]",1,2,-1
31092.0,2019-11-03,"(51.75, 69.0]",1,1,0
31093.0,2019-11-03,"(975.0, 1105.0]",2,1,1
31094.0,2019-11-03,"(540.0, 810.0]",1,1,0
31094.0,2019-11-03,"(810.0, 1080.0]",1,1,0
31095.0,2019-11-03,"(693.75, 780.5]",2,2,0
31096.0,2019-11-03,"(655.558, 766.5]",2,3,-1
31096.0,2019-11-03,"(766.5, 877.0]",1,1,0
31097.0,2019-11-03,"(20.677, 352.75]",1,1,0
31097.0,2019-11-03,"(352.75, 683.5]",1,1,0
31097.0,2019-11-03,"(683.5, 1014.25]",4,9,-5
31097.0,2019-11-03,"(1014.25, 1345.0]",4,5,-1
31098.0,2019-11-03,"(488.38, 644.0]",2,4,-2
31098.0,2019-11-03,"(954.0, 1109.0]",3,1,2
,,,,1.0,
,,,,1.0,
31100.0,2019-11-03,"(375.75, 694.5]",2,1,1
31100.0,2019-11-03,"(694.5, 1013.25]",6,5,1
31100.0,2019-11-03,"(1013.25, 1332.0]",2,9,-7
31101.0,2019-11-03,"(3.615, 351.25]",8,19,-11
31101.0,2019-11-03,"(351.25, 697.5]",21,38,-17
31101.0,2019-11-03,"(697.5, 1043.75]",50,91,-41
31101.0,2019-11-03,"(1043.75, 1390.0]",32,50,-18
31102.0,2019-11-03,"(3.646, 343.5]",3,5,-2
31102.0,2019-11-03,"(343.5, 682.0]",2,15,-13
31102.0,2019-11-03,"(682.0, 1020.5]",7,20,-13
31102.0,2019-11-03,"(1020.5, 1359.0]",9,20,-11
31103.0,2019-11-03,"(43.606, 393.5]",1,3,-2
31103.0,2019-11-03,"(393.5, 742.0]",12,37,-25
31103.0,2019-11-03,"(742.0, 1090.5]",12,58,-46
31103.0,2019-11-03,"(1090.5, 1439.0]",7,26,-19
31104.0,2019-11-03,"(7.594, 360.5]",3,12,-9
31104.0,2019-11-03,"(360.5, 712.0]",10,26,-16
31104.0,2019-11-03,"(712.0, 1063.5]",17,39,-22
31104.0,2019-11-03,"(1063.5, 1415.0]",9,21,-12
31105.0,2019-11-03,"(521.209, 719.75]",1,5,-4
31105.0,2019-11-03,"(719.75, 917.5]",2,6,-4
31105.0,2019-11-03,"(917.5, 1115.25]",1,4,-3
31106.0,2019-11-03,"(615.205, 814.75]",2,9,-7
31106.0,2019-11-03,"(814.75, 1013.5]",5,16,-11
31106.0,2019-11-03,"(1013.5, 1212.25]",1,3,-2
31106.0,2019-11-03,"(1212.25, 1411.0]",1,4,-3
31107.0,2019-11-03,"(7.647, 347.25]",8,10,-2
31107.0,2019-11-03,"(347.25, 685.5]",3,12,-9
31107.0,2019-11-03,"(685.5, 1023.75]",14,28,-14
31107.0,2019-11-03,"(1023.75, 1362.0]",15,22,-7
31108.0,2019-11-03,"(24.621, 370.75]",4,4,0
31108.0,2019-11-03,"(370.75, 715.5]",6,18,-12
31108.0,2019-11-03,"(715.5, 1060.25]",23,47,-24
31108.0,2019-11-03,"(1060.25, 1405.0]",21,38,-17
31109.0,2019-11-03,"(21.696, 349.0]",2,8,-6
31109.0,2019-11-03,"(349.0, 675.0]",11,22,-11
31109.0,2019-11-03,"(675.0, 1001.0]",15,27,-12
31109.0,2019-11-03,"(1001.0, 1327.0]",14,26,-12
31110.0,2019-11-03,"(115.734, 433.5]",2,3,-1
31110.0,2019-11-03,"(433.5, 750.0]",13,30,-17
31110.0,2019-11-03,"(750.0, 1066.5]",28,56,-28
31110.0,2019-11-03,"(1066.5, 1383.0]",14,23,-9
31111.0,2019-11-03,"(17.599, 369.25]",2,6,-4
31111.0,2019-11-03,"(369.25, 719.5]",6,15,-9
31111.0,2019-11-03,"(719.5, 1069.75]",16,29,-13
31111.0,2019-11-03,"(1069.75, 1420.0]",5,12,-7
31112.0,2019-11-03,"(488.224, 683.0]",3,6,-3
31112.0,2019-11-03,"(683.0, 877.0]",16,23,-7
31112.0,2019-11-03,"(877.0, 1071.0]",11,23,-12
31112.0,2019-11-03,"(1071.0, 1265.0]",1,2,-1
31113.0,2019-11-03,"(85.751, 399.25]",1,3,-2
31113.0,2019-11-03,"(399.25, 711.5]",4,15,-11
31113.0,2019-11-03,"(711.5, 1023.75]",14,29,-15
31113.0,2019-11-03,"(1023.75, 1336.0]",4,17,-13
31114.0,2019-11-03,"(21.612, 370.0]",2,8,-6
31114.0,2019-11-03,"(370.0, 717.0]",7,18,-11
31114.0,2019-11-03,"(717.0, 1064.0]",30,58,-28
31114.0,2019-11-03,"(1064.0, 1411.0]",8,18,-10
31115.0,2019-11-03,"(12.647, 352.25]",2,6,-4
31115.0,2019-11-03,"(352.25, 690.5]",3,10,-7
31115.0,2019-11-03,"(690.5, 1028.75]",9,25,-16
31115.0,2019-11-03,"(1028.75, 1367.0]",9,17,-8
31116.0,2019-11-03,"(-1.345, 336.25]",1,1,0
31116.0,2019-11-03,"(336.25, 672.5]",10,15,-5
31116.0,2019-11-03,"(672.5, 1008.75]",22,56,-34
31116.0,2019-11-03,"(1008.75, 1345.0]",11,18,-7
31117.0,2019-11-03,"(47.721, 368.75]",1,3,-2
31117.0,2019-11-03,"(368.75, 688.5]",3,12,-9
31117.0,2019-11-03,"(688.5, 1008.25]",6,11,-5
31117.0,2019-11-03,"(1008.25, 1328.0]",5,11,-6
31118.0,2019-11-03,"(144.904, 420.0]",1,1,0
31118.0,2019-11-03,"(420.0, 694.0]",3,12,-9
31118.0,2019-11-03,"(694.0, 968.0]",5,16,-11
31118.0,2019-11-03,"(968.0, 1242.0]",10,13,-3
31119.0,2019-11-03,"(27.609, 376.75]",1,7,-6
31119.0,2019-11-03,"(376.75, 724.5]",12,28,-16
31119.0,2019-11-03,"(724.5, 1072.25]",19,40,-21
31119.0,2019-11-03,"(1072.25, 1420.0]",14,17,-3
31120.0,2019-11-03,"(78.69, 407.5]",2,2,0
31120.0,2019-11-03,"(407.5, 735.0]",6,18,-12
31120.0,2019-11-03,"(735.0, 1062.5]",13,26,-13
31120.0,2019-11-03,"(1062.5, 1390.0]",10,15,-5
31121.0,2019-11-03,"(9.601, 360.75]",3,4,-1
31121.0,2019-11-03,"(360.75, 710.5]",9,18,-9
31121.0,2019-11-03,"(710.5, 1060.25]",17,36,-19
31121.0,2019-11-03,"(1060.25, 1410.0]",6,13,-7
31122.0,2019-11-03,"(13.744, 329.0]",2,2,0
31122.0,2019-11-03,"(329.0, 643.0]",8,17,-9
31122.0,2019-11-03,"(643.0, 957.0]",2,11,-9
31122.0,2019-11-03,"(957.0, 1271.0]",8,14,-6
31123.0,2019-11-03,"(607.25, 778.5]",1,4,-3
31123.0,2019-11-03,"(778.5, 949.75]",2,11,-9
31123.0,2019-11-03,"(949.75, 1121.0]",2,4,-2
31124.0,2019-11-03,"(19.639, 361.25]",1,7,-6
31124.0,2019-11-03,"(361.25, 701.5]",6,23,-17
31124.0,2019-11-03,"(701.5, 1041.75]",18,54,-36
31124.0,2019-11-03,"(1041.75, 1382.0]",11,33,-22
31125.0,2019-11-03,"(9.608, 359.0]",1,2,-1
31125.0,2019-11-03,"(359.0, 707.0]",13,32,-19
31125.0,2019-11-03,"(707.0, 1055.0]",40,75,-35
31125.0,2019-11-03,"(1055.0, 1403.0]",13,19,-6
31126.0,2019-11-03,"(-1.411, 352.75]",3,4,-1
31126.0,2019-11-03,"(352.75, 705.5]",4,12,-8
31126.0,2019-11-03,"(705.5, 1058.25]",19,33,-14
31126.0,2019-11-03,"(1058.25, 1411.0]",12,21,-9
31127.0,2019-11-03,"(2.57, 361.5]",1,1,0
31127.0,2019-11-03,"(361.5, 719.0]",12,21,-9
31127.0,2019-11-03,"(719.0, 1076.5]",7,15,-8
31127.0,2019-11-03,"(1076.5, 1434.0]",7,15,-8
31128.0,2019-11-03,"(70.683, 401.25]",1,4,-3
31128.0,2019-11-03,"(401.25, 730.5]",22,38,-16
31128.0,2019-11-03,"(730.5, 1059.75]",29,47,-18
31128.0,2019-11-03,"(1059.75, 1389.0]",8,17,-9
31129.0,2019-11-03,"(31.801, 332.75]",3,3,0
31129.0,2019-11-03,"(332.75, 632.5]",5,10,-5
31129.0,2019-11-03,"(632.5, 932.25]",25,46,-21
31129.0,2019-11-03,"(932.25, 1232.0]",9,20,-11
31130.0,2019-11-03,"(212.859, 499.25]",1,2,-1
31130.0,2019-11-03,"(499.25, 784.5]",4,15,-11
31130.0,2019-11-03,"(784.5, 1069.75]",5,12,-7
31130.0,2019-11-03,"(1069.75, 1355.0]",5,9,-4
31131.0,2019-11-03,"(62.629, 406.75]",5,6,-1
31131.0,2019-11-03,"(406.75, 749.5]",2,10,-8
31131.0,2019-11-03,"(749.5, 1092.25]",5,11,-6
31131.0,2019-11-03,"(1092.25, 1435.0]",4,6,-2
31200.0,2019-11-03,"(29.652, 368.0]",4,7,-3
31200.0,2019-11-03,"(368.0, 705.0]",55,86,-31
31200.0,2019-11-03,"(705.0, 1042.0]",60,108,-48
31200.0,2019-11-03,"(1042.0, 1379.0]",14,33,-19
31201.0,2019-11-03,"(3.611, 352.25]",1,5,-4
31201.0,2019-11-03,"(352.25, 699.5]",29,46,-17
31201.0,2019-11-03,"(699.5, 1046.75]",24,50,-26
31201.0,2019-11-03,"(1046.75, 1394.0]",33,59,-26
31202.0,2019-11-03,"(7.607, 357.25]",2,7,-5
31202.0,2019-11-03,"(357.25, 705.5]",18,26,-8
31202.0,2019-11-03,"(705.5, 1053.75]",29,62,-33
31202.0,2019-11-03,"(1053.75, 1402.0]",15,31,-16
31203.0,2019-11-03,"(18.58, 375.0]",4,8,-4
31203.0,2019-11-03,"(375.0, 730.0]",17,36,-19
31203.0,2019-11-03,"(730.0, 1085.0]",65,105,-40
31203.0,2019-11-03,"(1085.0, 1440.0]",18,41,-23
31204.0,2019-11-03,"(71.634, 414.5]",2,3,-1
31204.0,2019-11-03,"(414.5, 756.0]",4,8,-4
31204.0,2019-11-03,"(756.0, 1097.5]",9,19,-10
31204.0,2019-11-03,"(1097.5, 1439.0]",3,5,-2
31205.0,2019-11-03,"(474.098, 700.5]",11,18,-7
31205.0,2019-11-03,"(700.5, 926.0]",6,10,-4
31205.0,2019-11-03,"(926.0, 1151.5]",8,18,-10
31205.0,2019-11-03,"(1151.5, 1377.0]",3,9,-6
31206.0,2019-11-03,"(576.259, 762.25]",1,5,-4
31206.0,2019-11-03,"(762.25, 947.5]",1,3,-2
31207.0,2019-11-03,"(643.399, 794.25]",1,4,-3
31207.0,2019-11-03,"(1094.75, 1245.0]",2,3,-1
31208.0,2019-11-03,"(580.537, 696.75]",3,4,-1
31208.0,2019-11-03,"(696.75, 812.5]",3,5,-2
31208.0,2019-11-03,"(812.5, 928.25]",7,9,-2
31208.0,2019-11-03,"(928.25, 1044.0]",3,4,-1
31209.0,2019-11-03,"(435.314, 607.5]",2,9,-7
31209.0,2019-11-03,"(607.5, 779.0]",6,8,-2
31209.0,2019-11-03,"(779.0, 950.5]",10,13,-3
31209.0,2019-11-03,"(950.5, 1122.0]",1,4,-3
31211.0,2019-11-03,"(600.487, 729.25]",4,7,-3
31211.0,2019-11-03,"(729.25, 857.5]",3,3,0
31211.0,2019-11-03,"(985.75, 1114.0]",1,1,0
31212.0,2019-11-03,"(114.706, 439.5]",2,2,0
31212.0,2019-11-03,"(439.5, 763.0]",13,32,-19
31212.0,2019-11-03,"(763.0, 1086.5]",15,30,-15
31212.0,2019-11-03,"(1086.5, 1410.0]",3,5,-2
31213.0,2019-11-03,"(18.678, 350.5]",1,3,-2
31213.0,2019-11-03,"(350.5, 681.0]",8,13,-5
31213.0,2019-11-03,"(681.0, 1011.5]",16,28,-12
31213.0,2019-11-03,"(1011.5, 1342.0]",3,11,-8
31214.0,2019-11-03,"(10.577, 367.75]",3,8,-5
31214.0,2019-11-03,"(367.75, 723.5]",20,36,-16
31214.0,2019-11-03,"(723.5, 1079.25]",30,64,-34
31214.0,2019-11-03,"(1079.25, 1435.0]",22,42,-20
31215.0,2019-11-03,"(533.206, 732.5]",5,10,-5
31215.0,2019-11-03,"(732.5, 931.0]",18,30,-12
31215.0,2019-11-03,"(931.0, 1129.5]",10,18,-8
31215.0,2019-11-03,"(1129.5, 1328.0]",2,5,-3
31216.0,2019-11-03,"(521.162, 731.5]",1,4,-3
31216.0,2019-11-03,"(731.5, 941.0]",5,5,0
31216.0,2019-11-03,"(941.0, 1150.5]",5,8,-3
31216.0,2019-11-03,"(1150.5, 1360.0]",2,3,-1
31217.0,2019-11-03,"(684.0, 999.0]",8,1,7
31217.0,2019-11-03,"(999.0, 1314.0]",3,11,-8
31218.0,2019-11-03,"(522.138, 738.5]",9,15,-6
31218.0,2019-11-03,"(738.5, 954.0]",11,24,-13
31218.0,2019-11-03,"(954.0, 1169.5]",5,8,-3
31219.0,2019-11-03,"(790.561, 900.75]",14,21,-7
31219.0,2019-11-03,"(900.75, 1010.5]",5,14,-9
31219.0,2019-11-03,"(1010.5, 1120.25]",1,4,-3
31220.0,2019-11-03,"(680.5, 897.0]",1,1,0
31220.0,2019-11-03,"(897.0, 1113.5]",1,1,0
31220.0,2019-11-03,"(1113.5, 1330.0]",1,1,0
31221.0,2019-11-03,"(2.695, 330.25]",3,5,-2
31221.0,2019-11-03,"(330.25, 656.5]",7,8,-1
31221.0,2019-11-03,"(656.5, 982.75]",12,23,-11
31221.0,2019-11-03,"(982.75, 1309.0]",5,9,-4
31222.0,2019-11-03,"(3.648, 343.0]",3,3,0
31222.0,2019-11-03,"(343.0, 681.0]",5,7,-2
31222.0,2019-11-03,"(681.0, 1019.0]",9,17,-8
31222.0,2019-11-03,"(1019.0, 1357.0]",6,18,-12
31223.0,2019-11-03,"(28.65, 367.5]",6,8,-2
31223.0,2019-11-03,"(367.5, 705.0]",10,18,-8
31223.0,2019-11-03,"(705.0, 1042.5]",14,37,-23
31223.0,2019-11-03,"(1042.5, 1380.0]",9,18,-9
31224.0,2019-11-03,"(527.355, 689.25]",4,4,0
31224.0,2019-11-03,"(689.25, 850.5]",3,8,-5
31224.0,2019-11-03,"(850.5, 1011.75]",4,6,-2
31224.0,2019-11-03,"(1011.75, 1173.0]",3,4,-1
31225.0,2019-11-03,"(4.675, 337.25]",1,1,0
31225.0,2019-11-03,"(337.25, 668.5]",13,18,-5
31225.0,2019-11-03,"(668.5, 999.75]",27,43,-16
31225.0,2019-11-03,"(999.75, 1331.0]",12,28,-16
31226.0,2019-11-03,"(98.913, 371.75]",1,1,0
31226.0,2019-11-03,"(371.75, 643.5]",2,3,-1
31226.0,2019-11-03,"(643.5, 915.25]",12,24,-12
31226.0,2019-11-03,"(915.25, 1187.0]",5,12,-7
31227.0,2019-11-03,"(476.133, 693.75]",2,4,-2
31227.0,2019-11-03,"(693.75, 910.5]",9,17,-8
31227.0,2019-11-03,"(910.5, 1127.25]",5,9,-4
31227.0,2019-11-03,"(1127.25, 1344.0]",1,2,-1
31228.0,2019-11-03,"(528.208, 727.0]",9,14,-5
31228.0,2019-11-03,"(727.0, 925.0]",23,34,-11
31228.0,2019-11-03,"(925.0, 1123.0]",21,31,-10
31228.0,2019-11-03,"(1123.0, 1321.0]",6,16,-10
31229.0,2019-11-03,"(3.651, 342.25]",7,11,-4
31229.0,2019-11-03,"(342.25, 679.5]",18,43,-25
31229.0,2019-11-03,"(679.5, 1016.75]",30,54,-24
31229.0,2019-11-03,"(1016.75, 1354.0]",16,33,-17
31230.0,2019-11-03,"(367.5, 692.0]",4,1,3
31230.0,2019-11-03,"(692.0, 1016.5]",23,15,8
31230.0,2019-11-03,"(1016.5, 1341.0]",3,35,-32
31231.0,2019-11-03,"(650.25, 770.5]",6,1,5
31231.0,2019-11-03,"(770.5, 890.75]",1,7,-6
31232.0,2019-11-03,"(-1.411, 352.75]",1,3,-2
31232.0,2019-11-03,"(352.75, 705.5]",16,19,-3
31232.0,2019-11-03,"(705.5, 1058.25]",20,42,-22
31232.0,2019-11-03,"(1058.25, 1411.0]",12,25,-13
31233.0,2019-11-03,"(463.089, 691.75]",2,5,-3
31233.0,2019-11-03,"(691.75, 919.5]",6,9,-3
31233.0,2019-11-03,"(919.5, 1147.25]",2,4,-2
31233.0,2019-11-03,"(1147.25, 1375.0]",1,4,-3
31234.0,2019-11-03,"(553.188, 757.0]",8,22,-14
31234.0,2019-11-03,"(757.0, 960.0]",6,11,-5
31234.0,2019-11-03,"(960.0, 1163.0]",9,19,-10
31234.0,2019-11-03,"(1163.0, 1366.0]",4,5,-1
31235.0,2019-11-03,"(461.283, 641.25]",1,4,-3
31235.0,2019-11-03,"(641.25, 820.5]",1,2,-1
31235.0,2019-11-03,"(820.5, 999.75]",6,10,-4
31235.0,2019-11-03,"(999.75, 1179.0]",1,5,-4
31236.0,2019-11-03,"(383.0, 711.0]",17,1,16
31236.0,2019-11-03,"(711.0, 1039.0]",15,29,-14
31236.0,2019-11-03,"(1039.0, 1367.0]",8,27,-19
31237.0,2019-11-03,"(399.25, 731.5]",12,1,11
31237.0,2019-11-03,"(731.5, 1063.75]",16,31,-15
31237.0,2019-11-03,"(1063.75, 1396.0]",12,28,-16
31238.0,2019-11-03,"(435.062, 670.5]",1,3,-2
31238.0,2019-11-03,"(670.5, 905.0]",3,9,-6
31238.0,2019-11-03,"(905.0, 1139.5]",14,18,-4
31238.0,2019-11-03,"(1139.5, 1374.0]",1,3,-2
31239.0,2019-11-03,"(455.126, 674.5]",4,6,-2
31239.0,2019-11-03,"(674.5, 893.0]",14,29,-15
31239.0,2019-11-03,"(893.0, 1111.5]",11,18,-7
31239.0,2019-11-03,"(1111.5, 1330.0]",2,7,-5
31240.0,2019-11-03,"(439.443, 579.25]",8,12,-4
31240.0,2019-11-03,"(579.25, 718.5]",8,14,-6
31240.0,2019-11-03,"(718.5, 857.75]",10,15,-5
31240.0,2019-11-03,"(857.75, 997.0]",9,29,-20
31241.0,2019-11-03,"(27.629, 371.75]",6,8,-2
31241.0,2019-11-03,"(371.75, 714.5]",8,24,-16
31241.0,2019-11-03,"(714.5, 1057.25]",22,40,-18
31241.0,2019-11-03,"(1057.25, 1400.0]",20,26,-6
31242.0,2019-11-03,"(390.25, 735.5]",4,2,2
31242.0,2019-11-03,"(735.5, 1080.75]",1,4,-3
31242.0,2019-11-03,"(1080.75, 1426.0]",3,10,-7
31243.0,2019-11-03,"(453.081, 683.75]",6,15,-9
31243.0,2019-11-03,"(683.75, 913.5]",21,24,-3
31243.0,2019-11-03,"(913.5, 1143.25]",9,10,-1
31243.0,2019-11-03,"(1143.25, 1373.0]",2,4,-2
31244.0,2019-11-03,"(29.668, 364.0]",2,3,-1
31244.0,2019-11-03,"(364.0, 697.0]",1,5,-4
31244.0,2019-11-03,"(697.0, 1030.0]",13,20,-7
31244.0,2019-11-03,"(1030.0, 1363.0]",4,9,-5
31245.0,2019-11-03,"(13.618, 360.5]",2,7,-5
31245.0,2019-11-03,"(360.5, 706.0]",13,22,-9
31245.0,2019-11-03,"(706.0, 1051.5]",22,45,-23
31245.0,2019-11-03,"(1051.5, 1397.0]",4,7,-3
31246.0,2019-11-03,"(326.75, 651.5]",8,1,7
31246.0,2019-11-03,"(651.5, 976.25]",43,12,31
31246.0,2019-11-03,"(976.25, 1301.0]",10,71,-61
31247.0,2019-11-03,"(27.852, 316.0]",1,2,-1
31247.0,2019-11-03,"(316.0, 603.0]",8,13,-5
31247.0,2019-11-03,"(603.0, 890.0]",57,107,-50
31247.0,2019-11-03,"(890.0, 1177.0]",53,101,-48
31248.0,2019-11-03,"(340.75, 630.5]",10,1,9
31248.0,2019-11-03,"(630.5, 920.25]",43,17,26
31248.0,2019-11-03,"(920.25, 1210.0]",29,93,-64
31249.0,2019-11-03,"(12.865, 297.75]",9,9,0
31249.0,2019-11-03,"(297.75, 581.5]",4,8,-4
31249.0,2019-11-03,"(581.5, 865.25]",20,42,-22
31249.0,2019-11-03,"(865.25, 1149.0]",28,45,-17
31250.0,2019-11-03,"(742.5, 940.0]",3,3,0
31250.0,2019-11-03,"(940.0, 1137.5]",2,5,-3
31250.0,2019-11-03,"(1137.5, 1335.0]",2,2,0
31251.0,2019-11-03,"(6.661, 342.75]",3,3,0
31251.0,2019-11-03,"(342.75, 677.5]",4,6,-2
31251.0,2019-11-03,"(677.5, 1012.25]",4,17,-13
31251.0,2019-11-03,"(1012.25, 1347.0]",13,18,-5
31252.0,2019-11-03,"(530.239, 721.25]",5,5,0
31252.0,2019-11-03,"(911.5, 1101.75]",5,3,2
31252.0,2019-11-03,"(1101.75, 1292.0]",5,6,-1
31253.0,2019-11-03,"(575.22, 771.0]",2,5,-3
31253.0,2019-11-03,"(771.0, 966.0]",4,7,-3
31253.0,2019-11-03,"(966.0, 1161.0]",2,7,-5
31254.0,2019-11-03,"(60.766, 370.5]",1,2,-1
31254.0,2019-11-03,"(370.5, 679.0]",3,4,-1
31254.0,2019-11-03,"(679.0, 987.5]",8,16,-8
31254.0,2019-11-03,"(987.5, 1296.0]",4,5,-1
31255.0,2019-11-03,"(512.119, 733.25]",7,14,-7
31255.0,2019-11-03,"(733.25, 953.5]",3,5,-2
31255.0,2019-11-03,"(953.5, 1173.75]",1,4,-3
31255.0,2019-11-03,"(1173.75, 1394.0]",1,2,-1
31256.0,2019-11-03,"(382.5, 710.0]",11,1,10
31256.0,2019-11-03,"(710.0, 1037.5]",24,16,8
31256.0,2019-11-03,"(1037.5, 1365.0]",7,43,-36
31257.0,2019-11-03,"(-1.391, 347.75]",1,3,-2
31257.0,2019-11-03,"(347.75, 695.5]",7,16,-9
31257.0,2019-11-03,"(695.5, 1043.25]",25,38,-13
31257.0,2019-11-03,"(1043.25, 1391.0]",13,28,-15
31258.0,2019-11-03,"(349.75, 679.5]",21,2,19
31258.0,2019-11-03,"(679.5, 1009.25]",50,30,20
31258.0,2019-11-03,"(1009.25, 1339.0]",30,118,-88
31259.0,2019-11-03,"(615.229, 808.75]",3,6,-3
31259.0,2019-11-03,"(1001.5, 1194.25]",1,2,-1
31259.0,2019-11-03,"(1194.25, 1387.0]",1,1,0
31260.0,2019-11-03,"(335.0, 666.0]",2,1,1
31260.0,2019-11-03,"(666.0, 997.0]",3,7,-4
31260.0,2019-11-03,"(997.0, 1328.0]",5,13,-8
31261.0,2019-11-03,"(648.75, 778.5]",2,3,-1
31261.0,2019-11-03,"(778.5, 908.25]",2,4,-2
31261.0,2019-11-03,"(908.25, 1038.0]",1,3,-2
31262.0,2019-11-03,"(353.031, 596.25]",4,6,-2
31262.0,2019-11-03,"(596.25, 838.5]",5,9,-4
31262.0,2019-11-03,"(838.5, 1080.75]",4,8,-4
31262.0,2019-11-03,"(1080.75, 1323.0]",1,7,-6
31263.0,2019-11-03,"(486.05, 724.5]",9,24,-15
31263.0,2019-11-03,"(724.5, 962.0]",11,21,-10
31263.0,2019-11-03,"(962.0, 1199.5]",10,16,-6
31263.0,2019-11-03,"(1199.5, 1437.0]",5,8,-3
31264.0,2019-11-03,"(74.671, 408.25]",1,1,0
31264.0,2019-11-03,"(408.25, 740.5]",7,8,-1
31264.0,2019-11-03,"(740.5, 1072.75]",11,19,-8
31264.0,2019-11-03,"(1072.75, 1405.0]",3,6,-3
31265.0,2019-11-03,"(380.25, 713.5]",14,1,13
31265.0,2019-11-03,"(713.5, 1046.75]",17,26,-9
31265.0,2019-11-03,"(1046.75, 1380.0]",16,35,-19
31266.0,2019-11-03,"(33.653, 371.75]",6,9,-3
31266.0,2019-11-03,"(371.75, 708.5]",10,29,-19
31266.0,2019-11-03,"(708.5, 1045.25]",18,40,-22
31266.0,2019-11-03,"(1045.25, 1382.0]",19,29,-10
31267.0,2019-11-03,"(231.835, 524.25]",2,3,-1
31267.0,2019-11-03,"(524.25, 815.5]",9,22,-13
31267.0,2019-11-03,"(815.5, 1106.75]",8,21,-13
31267.0,2019-11-03,"(1106.75, 1398.0]",9,14,-5
31268.0,2019-11-03,"(25.649, 364.75]",4,8,-4
31268.0,2019-11-03,"(364.75, 702.5]",13,26,-13
31268.0,2019-11-03,"(702.5, 1040.25]",17,42,-25
31268.0,2019-11-03,"(1040.25, 1378.0]",21,31,-10
31269.0,2019-11-03,"(370.014, 617.5]",4,12,-8
31269.0,2019-11-03,"(617.5, 864.0]",4,10,-6
31269.0,2019-11-03,"(864.0, 1110.5]",9,13,-4
31269.0,2019-11-03,"(1110.5, 1357.0]",2,7,-5
31270.0,2019-11-03,"(325.75, 650.5]",2,2,0
31270.0,2019-11-03,"(650.5, 975.25]",13,2,11
31270.0,2019-11-03,"(975.25, 1300.0]",6,25,-19
31271.0,2019-11-03,"(379.239, 570.25]",2,3,-1
31271.0,2019-11-03,"(570.25, 760.5]",15,28,-13
31271.0,2019-11-03,"(760.5, 950.75]",18,44,-26
31271.0,2019-11-03,"(950.75, 1141.0]",14,30,-16
31272.0,2019-11-03,"(605.52, 726.0]",9,14,-5
31272.0,2019-11-03,"(726.0, 846.0]",7,13,-6
31272.0,2019-11-03,"(846.0, 966.0]",8,20,-12
31272.0,2019-11-03,"(966.0, 1086.0]",14,21,-7
31273.0,2019-11-03,"(431.162, 641.5]",4,9,-5
31273.0,2019-11-03,"(641.5, 851.0]",3,5,-2
31273.0,2019-11-03,"(851.0, 1060.5]",7,7,0
31273.0,2019-11-03,"(1060.5, 1270.0]",1,2,-1
31274.0,2019-11-03,"(564.17, 772.5]",5,7,-2
31274.0,2019-11-03,"(772.5, 980.0]",6,13,-7
31274.0,2019-11-03,"(980.0, 1187.5]",4,6,-2
31274.0,2019-11-03,"(1187.5, 1395.0]",3,5,-2
31275.0,2019-11-03,"(382.02, 628.0]",6,12,-6
31275.0,2019-11-03,"(628.0, 873.0]",11,15,-4
31275.0,2019-11-03,"(873.0, 1118.0]",12,24,-12
31275.0,2019-11-03,"(1118.0, 1363.0]",4,12,-8
31276.0,2019-11-03,"(456.136, 673.0]",1,2,-1
31276.0,2019-11-03,"(673.0, 889.0]",3,4,-1
31276.0,2019-11-03,"(889.0, 1105.0]",2,5,-3
31276.0,2019-11-03,"(1105.0, 1321.0]",3,4,-1
31277.0,2019-11-03,"(84.931, 353.25]",1,2,-1
31277.0,2019-11-03,"(353.25, 620.5]",2,8,-6
31277.0,2019-11-03,"(620.5, 887.75]",27,54,-27
31277.0,2019-11-03,"(887.75, 1155.0]",14,28,-14
31278.0,2019-11-03,"(7.738, 324.5]",2,2,0
31278.0,2019-11-03,"(324.5, 640.0]",4,16,-12
31278.0,2019-11-03,"(640.0, 955.5]",24,42,-18
31278.0,2019-11-03,"(955.5, 1271.0]",13,21,-8
31279.0,2019-11-03,"(722.438, 863.5]",4,7,-3
31279.0,2019-11-03,"(863.5, 1004.0]",1,2,-1
31279.0,2019-11-03,"(1004.0, 1144.5]",5,5,0
31279.0,2019-11-03,"(1144.5, 1285.0]",1,2,-1
31280.0,2019-11-03,"(410.75, 718.5]",7,3,4
31280.0,2019-11-03,"(718.5, 1026.25]",20,18,2
31280.0,2019-11-03,"(1026.25, 1334.0]",5,41,-36
31000.0,2019-11-04,"(54.897, 331.75]",1,2,-1
31000.0,2019-11-04,"(607.5, 883.25]",1,1,0
31000.0,2019-11-04,"(883.25, 1159.0]",5,2,3
31001.0,2019-11-04,"(341.146, 555.5]",1,3,-2
31001.0,2019-11-04,"(769.0, 982.5]",2,1,1
31001.0,2019-11-04,"(982.5, 1196.0]",1,2,-1
31002.0,2019-11-04,"(463.326, 632.5]",5,9,-4
31002.0,2019-11-04,"(632.5, 801.0]",1,1,0
31002.0,2019-11-04,"(801.0, 969.5]",3,3,0
31002.0,2019-11-04,"(969.5, 1138.0]",4,6,-2
31003.0,2019-11-04,"(380.052, 618.0]",5,9,-4
31003.0,2019-11-04,"(618.0, 855.0]",4,9,-5
31003.0,2019-11-04,"(855.0, 1092.0]",5,9,-4
31004.0,2019-11-04,"(914.0, 1090.0]",3,2,1
31004.0,2019-11-04,"(1090.0, 1266.0]",2,4,-2
31005.0,2019-11-04,"(382.987, 637.25]",5,8,-3
31005.0,2019-11-04,"(637.25, 890.5]",1,4,-3
31005.0,2019-11-04,"(890.5, 1143.75]",7,15,-8
31006.0,2019-11-04,"(644.5, 890.25]",1,1,0
31006.0,2019-11-04,"(890.25, 1136.0]",2,1,1
31007.0,2019-11-04,"(363.932, 632.0]",9,19,-10
31007.0,2019-11-04,"(632.0, 899.0]",2,5,-3
31007.0,2019-11-04,"(899.0, 1166.0]",17,38,-21
31007.0,2019-11-04,"(1166.0, 1433.0]",1,5,-4
31009.0,2019-11-04,"(432.298, 608.5]",4,4,0
31009.0,2019-11-04,"(959.5, 1135.0]",4,2,2
31010.0,2019-11-04,"(429.099, 655.25]",1,2,-1
31010.0,2019-11-04,"(655.25, 880.5]",1,2,-1
31010.0,2019-11-04,"(880.5, 1105.75]",3,6,-3
31010.0,2019-11-04,"(1105.75, 1331.0]",2,4,-2
31011.0,2019-11-04,"(345.136, 562.0]",4,5,-1
31011.0,2019-11-04,"(562.0, 778.0]",3,5,-2
31011.0,2019-11-04,"(778.0, 994.0]",2,5,-3
31011.0,2019-11-04,"(994.0, 1210.0]",5,10,-5
31012.0,2019-11-04,"(367.285, 546.75]",7,7,0
31012.0,2019-11-04,"(546.75, 725.5]",1,2,-1
31012.0,2019-11-04,"(904.25, 1083.0]",4,17,-13
31013.0,2019-11-04,"(732.0, 909.0]",1,3,-2
31013.0,2019-11-04,"(909.0, 1086.0]",3,1,2
31014.0,2019-11-04,"(318.966, 578.5]",25,34,-9
31014.0,2019-11-04,"(578.5, 837.0]",13,23,-10
31014.0,2019-11-04,"(837.0, 1095.5]",21,41,-20
31014.0,2019-11-04,"(1095.5, 1354.0]",4,10,-6
31015.0,2019-11-04,"(305.953, 568.75]",16,18,-2
31015.0,2019-11-04,"(568.75, 830.5]",3,7,-4
31015.0,2019-11-04,"(830.5, 1092.25]",7,16,-9
31015.0,2019-11-04,"(1092.25, 1354.0]",6,9,-3
31016.0,2019-11-04,"(431.152, 644.0]",10,19,-9
31016.0,2019-11-04,"(644.0, 856.0]",6,6,0
31016.0,2019-11-04,"(856.0, 1068.0]",5,9,-4
31016.0,2019-11-04,"(1068.0, 1280.0]",2,4,-2
31017.0,2019-11-04,"(473.078, 704.5]",8,12,-4
31017.0,2019-11-04,"(935.0, 1165.5]",1,5,-4
31017.0,2019-11-04,"(1165.5, 1396.0]",2,4,-2
31018.0,2019-11-04,"(960.0, 1128.0]",7,3,4
31019.0,2019-11-04,"(671.364, 831.0]",2,3,-1
31019.0,2019-11-04,"(990.0, 1149.0]",1,3,-2
31020.0,2019-11-04,"(710.75, 926.5]",1,1,0
31020.0,2019-11-04,"(926.5, 1142.25]",3,3,0
31020.0,2019-11-04,"(1142.25, 1358.0]",1,4,-3
31021.0,2019-11-04,"(505.231, 698.25]",2,6,-4
31021.0,2019-11-04,"(890.5, 1082.75]",2,8,-6
31021.0,2019-11-04,"(1082.75, 1275.0]",4,7,-3
31022.0,2019-11-04,"(510.293, 687.75]",1,6,-5
31022.0,2019-11-04,"(687.75, 864.5]",2,4,-2
31022.0,2019-11-04,"(864.5, 1041.25]",1,3,-2
31022.0,2019-11-04,"(1041.25, 1218.0]",2,9,-7
31023.0,2019-11-04,"(526.184, 731.0]",1,1,0
31023.0,2019-11-04,"(731.0, 935.0]",2,3,-1
31023.0,2019-11-04,"(935.0, 1139.0]",4,6,-2
31024.0,2019-11-04,"(460.126, 679.5]",8,17,-9
31024.0,2019-11-04,"(898.0, 1116.5]",3,1,2
31024.0,2019-11-04,"(1116.5, 1335.0]",3,7,-4
31025.0,2019-11-04,"(509.171, 717.25]",2,4,-2
31025.0,2019-11-04,"(924.5, 1131.75]",1,2,-1
31025.0,2019-11-04,"(1131.75, 1339.0]",1,1,0
31026.0,2019-11-04,"(645.0, 809.0]",2,3,-1
31026.0,2019-11-04,"(973.0, 1137.0]",2,4,-2
31027.0,2019-11-04,"(469.325, 638.75]",2,4,-2
31027.0,2019-11-04,"(976.25, 1145.0]",3,1,2
31028.0,2019-11-04,"(421.308, 595.0]",1,1,0
31029.0,2019-11-04,"(672.75, 892.5]",1,12,-11
31029.0,2019-11-04,"(892.5, 1112.25]",3,4,-1
31029.0,2019-11-04,"(1112.25, 1332.0]",4,4,0
31030.0,2019-11-04,"(919.0, 1155.5]",6,11,-5
31030.0,2019-11-04,"(1155.5, 1392.0]",3,2,1
31031.0,2019-11-04,"(665.0, 852.0]",1,4,-3
31031.0,2019-11-04,"(852.0, 1039.0]",3,4,-1
31031.0,2019-11-04,"(1039.0, 1226.0]",5,6,-1
31032.0,2019-11-04,"(711.519, 832.25]",1,2,-1
31032.0,2019-11-04,"(952.5, 1072.75]",1,2,-1
31032.0,2019-11-04,"(1072.75, 1193.0]",1,1,0
31033.0,2019-11-04,"(773.728, 842.0]",1,1,0
31033.0,2019-11-04,"(910.0, 978.0]",3,1,2
31033.0,2019-11-04,"(978.0, 1046.0]",1,6,-5
31034.0,2019-11-04,"(458.45, 596.5]",2,6,-4
31034.0,2019-11-04,"(871.5, 1009.0]",1,2,-1
31035.0,2019-11-04,"(335.071, 568.25]",1,3,-2
31035.0,2019-11-04,"(568.25, 800.5]",2,4,-2
31035.0,2019-11-04,"(800.5, 1032.75]",3,3,0
31035.0,2019-11-04,"(1032.75, 1265.0]",3,9,-6
31036.0,2019-11-04,"(451.291, 629.25]",1,7,-6
31036.0,2019-11-04,"(629.25, 806.5]",1,1,0
31036.0,2019-11-04,"(806.5, 983.75]",2,2,0
31036.0,2019-11-04,"(983.75, 1161.0]",2,3,-1
31037.0,2019-11-04,"(318.918, 590.5]",13,18,-5
31037.0,2019-11-04,"(590.5, 861.0]",3,9,-6
31037.0,2019-11-04,"(861.0, 1131.5]",7,25,-18
31037.0,2019-11-04,"(1131.5, 1402.0]",1,3,-2
31038.0,2019-11-04,"(461.118, 682.5]",3,4,-1
31038.0,2019-11-04,"(682.5, 903.0]",2,4,-2
31038.0,2019-11-04,"(903.0, 1123.5]",1,3,-2
31038.0,2019-11-04,"(1123.5, 1344.0]",1,4,-3
31039.0,2019-11-04,"(456.244, 646.0]",4,13,-9
31039.0,2019-11-04,"(646.0, 835.0]",1,3,-2
31039.0,2019-11-04,"(835.0, 1024.0]",3,7,-4
31039.0,2019-11-04,"(1024.0, 1213.0]",1,6,-5
31040.0,2019-11-04,"(437.109, 660.75]",4,6,-2
31040.0,2019-11-04,"(660.75, 883.5]",3,5,-2
31040.0,2019-11-04,"(883.5, 1106.25]",1,3,-2
31040.0,2019-11-04,"(1106.25, 1329.0]",1,4,-3
31041.0,2019-11-04,"(456.215, 653.25]",5,6,-1
31041.0,2019-11-04,"(653.25, 849.5]",15,24,-9
31041.0,2019-11-04,"(1045.75, 1242.0]",2,1,1
31042.0,2019-11-04,"(305.5, 551.0]",7,1,6
31042.0,2019-11-04,"(551.0, 796.5]",3,9,-6
31042.0,2019-11-04,"(796.5, 1042.0]",2,8,-6
31043.0,2019-11-04,"(411.158, 622.5]",2,3,-1
31043.0,2019-11-04,"(622.5, 833.0]",1,6,-5
31043.0,2019-11-04,"(1043.5, 1254.0]",3,1,2
31044.0,2019-11-04,"(539.479, 670.25]",2,2,0
31044.0,2019-11-04,"(800.5, 930.75]",1,1,0
31044.0,2019-11-04,"(930.75, 1061.0]",2,4,-2
31045.0,2019-11-04,"(496.124, 716.0]",4,6,-2
31045.0,2019-11-04,"(935.0, 1154.0]",3,3,0
31046.0,2019-11-04,"(397.324, 567.0]",1,4,-3
31046.0,2019-11-04,"(736.0, 905.0]",1,1,0
31046.0,2019-11-04,"(905.0, 1074.0]",2,2,0
31047.0,2019-11-04,"(361.061, 596.75]",14,27,-13
31047.0,2019-11-04,"(596.75, 831.5]",6,12,-6
31047.0,2019-11-04,"(831.5, 1066.25]",7,17,-10
31047.0,2019-11-04,"(1066.25, 1301.0]",3,12,-9
31048.0,2019-11-04,"(233.997, 485.75]",1,2,-1
31048.0,2019-11-04,"(485.75, 736.5]",2,7,-5
31048.0,2019-11-04,"(736.5, 987.25]",2,3,-1
31048.0,2019-11-04,"(987.25, 1238.0]",3,15,-12
31049.0,2019-11-04,"(508.413, 655.75]",1,4,-3
31050.0,2019-11-04,"(346.241, 536.75]",1,5,-4
31050.0,2019-11-04,"(726.5, 916.25]",1,1,0
31050.0,2019-11-04,"(916.25, 1106.0]",1,1,0
31051.0,2019-11-04,"(935.75, 1146.0]",6,2,4
31052.0,2019-11-04,"(376.971, 635.25]",5,8,-3
31052.0,2019-11-04,"(635.25, 892.5]",2,3,-1
31052.0,2019-11-04,"(892.5, 1149.75]",1,3,-2
31052.0,2019-11-04,"(1149.75, 1407.0]",1,1,0
31053.0,2019-11-04,"(663.0, 994.5]",2,1,1
31053.0,2019-11-04,"(994.5, 1326.0]",2,2,0
,,,,2.0,
31055.0,2019-11-04,"(493.337, 659.75]",2,4,-2
31055.0,2019-11-04,"(991.25, 1157.0]",3,1,2
31056.0,2019-11-04,"(37.888, 317.0]",1,1,0
31056.0,2019-11-04,"(873.0, 1151.0]",3,1,2
31057.0,2019-11-04,"(928.0, 1107.5]",1,1,0
31057.0,2019-11-04,"(1107.5, 1287.0]",2,1,1
31058.0,2019-11-04,"(580.226, 774.5]",1,2,-1
31058.0,2019-11-04,"(968.0, 1161.5]",1,1,0
31059.0,2019-11-04,"(887.5, 1126.25]",3,3,0
31059.0,2019-11-04,"(1126.25, 1365.0]",2,3,-1
31060.0,2019-11-04,"(663.0, 982.5]",1,1,0
31060.0,2019-11-04,"(982.5, 1302.0]",3,3,0
31061.0,2019-11-04,"(490.217, 686.75]",1,2,-1
31061.0,2019-11-04,"(1078.25, 1274.0]",1,2,-1
31062.0,2019-11-04,"(565.47, 698.5]",3,6,-3
31062.0,2019-11-04,"(698.5, 831.0]",3,6,-3
31062.0,2019-11-04,"(963.5, 1096.0]",1,2,-1
31063.0,2019-11-04,"(1254.0, 1286.0]",1,1,0
31064.0,2019-11-04,"(447.288, 626.0]",4,9,-5
31064.0,2019-11-04,"(626.0, 804.0]",6,12,-6
31064.0,2019-11-04,"(804.0, 982.0]",2,4,-2
31064.0,2019-11-04,"(982.0, 1160.0]",5,10,-5
31065.0,2019-11-04,"(884.75, 1036.0]",2,3,-1
31066.0,2019-11-04,"(896.0, 1108.5]",1,2,-1
31066.0,2019-11-04,"(1108.5, 1321.0]",1,2,-1
31067.0,2019-11-04,"(416.103, 641.25]",1,3,-2
31067.0,2019-11-04,"(865.5, 1089.75]",1,1,0
31067.0,2019-11-04,"(1089.75, 1314.0]",2,3,-1
31068.0,2019-11-04,"(556.194, 758.5]",2,5,-3
31068.0,2019-11-04,"(758.5, 960.0]",1,2,-1
31068.0,2019-11-04,"(960.0, 1161.5]",4,6,-2
31068.0,2019-11-04,"(1161.5, 1363.0]",3,3,0
31069.0,2019-11-04,"(417.186, 621.5]",2,7,-5
31069.0,2019-11-04,"(621.5, 825.0]",2,3,-1
31069.0,2019-11-04,"(825.0, 1028.5]",4,6,-2
31069.0,2019-11-04,"(1028.5, 1232.0]",3,4,-1
31070.0,2019-11-04,"(453.121, 673.75]",1,4,-3
31070.0,2019-11-04,"(673.75, 893.5]",1,3,-2
31070.0,2019-11-04,"(893.5, 1113.25]",5,7,-2
31070.0,2019-11-04,"(1113.25, 1333.0]",1,3,-2
31071.0,2019-11-04,"(415.016, 662.0]",4,10,-6
31071.0,2019-11-04,"(662.0, 908.0]",5,8,-3
31071.0,2019-11-04,"(908.0, 1154.0]",10,15,-5
31071.0,2019-11-04,"(1154.0, 1400.0]",3,3,0
31072.0,2019-11-04,"(982.25, 1152.0]",1,1,0
31073.0,2019-11-04,"(443.375, 600.25]",1,4,-3
31073.0,2019-11-04,"(912.75, 1069.0]",1,2,-1
31074.0,2019-11-04,"(938.75, 1089.0]",3,1,2
31075.0,2019-11-04,"(164.028, 408.0]",1,1,0
31075.0,2019-11-04,"(894.0, 1137.0]",4,3,1
31076.0,2019-11-04,"(416.315, 588.25]",1,1,0
31076.0,2019-11-04,"(930.75, 1102.0]",2,3,-1
31077.0,2019-11-04,"(496.385, 650.75]",5,10,-5
31077.0,2019-11-04,"(650.75, 804.5]",8,16,-8
31077.0,2019-11-04,"(804.5, 958.25]",3,4,-1
31077.0,2019-11-04,"(958.25, 1112.0]",8,13,-5
31078.0,2019-11-04,"(464.308, 638.0]",7,9,-2
31078.0,2019-11-04,"(984.0, 1157.0]",1,7,-6
31079.0,2019-11-04,"(21.61, 370.5]",1,1,0
31079.0,2019-11-04,"(718.0, 1065.5]",3,7,-4
31079.0,2019-11-04,"(1065.5, 1413.0]",10,4,6
31080.0,2019-11-04,"(398.012, 646.0]",1,10,-9
31080.0,2019-11-04,"(893.0, 1140.0]",3,4,-1
31080.0,2019-11-04,"(1140.0, 1387.0]",2,2,0
31081.0,2019-11-04,"(461.144, 676.0]",1,2,-1
31081.0,2019-11-04,"(890.0, 1104.0]",1,1,0
31082.0,2019-11-04,"(448.33, 616.5]",2,2,0
31082.0,2019-11-04,"(951.5, 1119.0]",2,3,-1
31083.0,2019-11-04,"(651.0, 842.0]",2,2,0
31083.0,2019-11-04,"(842.0, 1033.0]",3,5,-2
31083.0,2019-11-04,"(1033.0, 1224.0]",3,3,0
31084.0,2019-11-04,"(454.215, 651.25]",6,6,0
31085.0,2019-11-04,"(402.305, 576.75]",1,3,-2
31085.0,2019-11-04,"(924.25, 1098.0]",2,3,-1
31086.0,2019-11-04,"(633.5, 853.0]",1,4,-3
31086.0,2019-11-04,"(853.0, 1072.5]",1,2,-1
31086.0,2019-11-04,"(1072.5, 1292.0]",3,1,2
31087.0,2019-11-04,"(620.75, 784.5]",1,1,0
31087.0,2019-11-04,"(784.5, 948.25]",1,1,0
31087.0,2019-11-04,"(948.25, 1112.0]",4,2,2
31088.0,2019-11-04,"(195.834, 488.5]",1,1,0
31088.0,2019-11-04,"(488.5, 780.0]",1,5,-4
31088.0,2019-11-04,"(780.0, 1071.5]",7,8,-1
31088.0,2019-11-04,"(1071.5, 1363.0]",3,4,-1
31089.0,2019-11-04,"(479.169, 687.75]",12,16,-4
31089.0,2019-11-04,"(687.75, 895.5]",4,9,-5
31089.0,2019-11-04,"(895.5, 1103.25]",2,16,-14
31090.0,2019-11-04,"(731.5, 883.25]",1,2,-1
31090.0,2019-11-04,"(883.25, 1035.0]",1,2,-1
31091.0,2019-11-04,"(969.5, 1138.0]",5,5,0
31092.0,2019-11-04,"(613.5, 818.0]",1,1,0
31093.0,2019-11-04,"(598.5, 797.0]",1,6,-5
31093.0,2019-11-04,"(995.5, 1194.0]",1,3,-2
31094.0,2019-11-04,"(585.151, 798.25]",2,2,0
31094.0,2019-11-04,"(1010.5, 1222.75]",2,2,0
31094.0,2019-11-04,"(1222.75, 1435.0]",1,2,-1
31095.0,2019-11-04,"(860.0, 957.0]",1,1,0
31096.0,2019-11-04,"(744.0, 864.0]",1,1,0
31096.0,2019-11-04,"(984.0, 1104.0]",1,1,0
31097.0,2019-11-04,"(471.121, 691.75]",3,4,-1
31097.0,2019-11-04,"(911.5, 1131.25]",3,4,-1
31098.0,2019-11-04,"(437.267, 621.25]",8,15,-7
31098.0,2019-11-04,"(621.25, 804.5]",1,3,-2
31098.0,2019-11-04,"(804.5, 987.75]",1,1,0
31098.0,2019-11-04,"(987.75, 1171.0]",5,10,-5
31099.0,2019-11-04,"(794.5, 967.75]",1,1,0
31099.0,2019-11-04,"(967.75, 1141.0]",1,1,0
31100.0,2019-11-04,"(353.75, 706.5]",12,2,10
31100.0,2019-11-04,"(706.5, 1059.25]",4,14,-10
31100.0,2019-11-04,"(1059.25, 1412.0]",2,18,-16
31101.0,2019-11-04,"(339.907, 614.25]",10,44,-34
31101.0,2019-11-04,"(614.25, 887.5]",16,37,-21
31101.0,2019-11-04,"(887.5, 1160.75]",54,74,-20
31101.0,2019-11-04,"(1160.75, 1434.0]",13,27,-14
31102.0,2019-11-04,"(245.847, 535.25]",2,20,-18
31102.0,2019-11-04,"(535.25, 823.5]",1,6,-5
31102.0,2019-11-04,"(823.5, 1111.75]",11,20,-9
31102.0,2019-11-04,"(1111.75, 1400.0]",16,24,-8
31103.0,2019-11-04,"(21.625, 366.75]",3,5,-2
31103.0,2019-11-04,"(366.75, 710.5]",4,41,-37
31103.0,2019-11-04,"(710.5, 1054.25]",7,30,-23
31103.0,2019-11-04,"(1054.25, 1398.0]",12,28,-16
31104.0,2019-11-04,"(271.885, 551.75]",6,21,-15
31104.0,2019-11-04,"(551.75, 830.5]",1,2,-1
31104.0,2019-11-04,"(830.5, 1109.25]",12,32,-20
31104.0,2019-11-04,"(1109.25, 1388.0]",20,33,-13
31105.0,2019-11-04,"(383.25, 706.5]",2,2,0
31105.0,2019-11-04,"(1029.75, 1353.0]",5,12,-7
31106.0,2019-11-04,"(446.143, 661.25]",2,16,-14
31106.0,2019-11-04,"(875.5, 1089.75]",2,2,0
31106.0,2019-11-04,"(1089.75, 1304.0]",3,3,0
31107.0,2019-11-04,"(1.616, 349.0]",1,2,-1
31107.0,2019-11-04,"(349.0, 695.0]",1,26,-25
31107.0,2019-11-04,"(695.0, 1041.0]",10,18,-8
31107.0,2019-11-04,"(1041.0, 1387.0]",20,30,-10
31108.0,2019-11-04,"(362.004, 612.0]",11,29,-18
31108.0,2019-11-04,"(612.0, 861.0]",5,11,-6
31108.0,2019-11-04,"(861.0, 1110.0]",32,52,-20
31108.0,2019-11-04,"(1110.0, 1359.0]",26,35,-9
31109.0,2019-11-04,"(366.99, 620.5]",11,25,-14
31109.0,2019-11-04,"(620.5, 873.0]",5,9,-4
31109.0,2019-11-04,"(873.0, 1125.5]",21,33,-12
31109.0,2019-11-04,"(1125.5, 1378.0]",8,10,-2
31110.0,2019-11-04,"(341.907, 616.25]",27,58,-31
31110.0,2019-11-04,"(616.25, 889.5]",8,20,-12
31110.0,2019-11-04,"(889.5, 1162.75]",24,46,-22
31110.0,2019-11-04,"(1162.75, 1436.0]",9,18,-9
31111.0,2019-11-04,"(8.672, 342.0]",1,2,-1
31111.0,2019-11-04,"(342.0, 674.0]",5,18,-13
31111.0,2019-11-04,"(674.0, 1006.0]",3,6,-3
31111.0,2019-11-04,"(1006.0, 1338.0]",16,24,-8
31112.0,2019-11-04,"(364.096, 591.0]",2,8,-6
31112.0,2019-11-04,"(591.0, 817.0]",4,8,-4
31112.0,2019-11-04,"(817.0, 1043.0]",4,5,-1
31112.0,2019-11-04,"(1043.0, 1269.0]",4,6,-2
31113.0,2019-11-04,"(307.907, 582.25]",1,6,-5
31113.0,2019-11-04,"(855.5, 1128.75]",5,9,-4
31113.0,2019-11-04,"(1128.75, 1402.0]",9,16,-7
31114.0,2019-11-04,"(24.627, 369.25]",1,1,0
31114.0,2019-11-04,"(369.25, 712.5]",3,32,-29
31114.0,2019-11-04,"(712.5, 1055.75]",13,26,-13
31114.0,2019-11-04,"(1055.75, 1399.0]",25,36,-11
31115.0,2019-11-04,"(596.75, 845.5]",2,11,-9
31115.0,2019-11-04,"(845.5, 1094.25]",8,3,5
31115.0,2019-11-04,"(1094.25, 1343.0]",15,15,0
31116.0,2019-11-04,"(45.659, 382.25]",5,8,-3
31116.0,2019-11-04,"(382.25, 717.5]",5,18,-13
31116.0,2019-11-04,"(717.5, 1052.75]",17,25,-8
31116.0,2019-11-04,"(1052.75, 1388.0]",26,33,-7
31117.0,2019-11-04,"(308.929, 577.75]",5,19,-14
31117.0,2019-11-04,"(577.75, 845.5]",2,4,-2
31117.0,2019-11-04,"(845.5, 1113.25]",9,14,-5
31117.0,2019-11-04,"(1113.25, 1381.0]",7,15,-8
31118.0,2019-11-04,"(376.175, 583.25]",4,21,-17
31118.0,2019-11-04,"(583.25, 789.5]",1,2,-1
31118.0,2019-11-04,"(789.5, 995.75]",3,5,-2
31118.0,2019-11-04,"(995.75, 1202.0]",18,23,-5
31119.0,2019-11-04,"(14.611, 363.25]",1,1,0
31119.0,2019-11-04,"(363.25, 710.5]",5,20,-15
31119.0,2019-11-04,"(710.5, 1057.75]",11,17,-6
31119.0,2019-11-04,"(1057.75, 1405.0]",21,34,-13
31120.0,2019-11-04,"(397.002, 647.5]",2,13,-11
31120.0,2019-11-04,"(647.5, 897.0]",2,5,-3
31120.0,2019-11-04,"(897.0, 1146.5]",12,14,-2
31120.0,2019-11-04,"(1146.5, 1396.0]",9,12,-3
31121.0,2019-11-04,"(398.25, 730.5]",13,5,8
31121.0,2019-11-04,"(730.5, 1062.75]",6,20,-14
31121.0,2019-11-04,"(1062.75, 1395.0]",8,15,-7
31122.0,2019-11-04,"(34.675, 367.25]",3,5,-2
31122.0,2019-11-04,"(367.25, 698.5]",1,17,-16
31122.0,2019-11-04,"(698.5, 1029.75]",4,7,-3
31122.0,2019-11-04,"(1029.75, 1361.0]",12,26,-14
31123.0,2019-11-04,"(730.25, 958.5]",1,8,-7
31123.0,2019-11-04,"(958.5, 1186.75]",5,3,2
31123.0,2019-11-04,"(1186.75, 1415.0]",8,13,-5
31124.0,2019-11-04,"(359.932, 628.0]",16,54,-38
31124.0,2019-11-04,"(628.0, 895.0]",9,29,-20
31124.0,2019-11-04,"(895.0, 1162.0]",23,67,-44
31124.0,2019-11-04,"(1162.0, 1429.0]",12,34,-22
31125.0,2019-11-04,"(57.658, 394.5]",3,7,-4
31125.0,2019-11-04,"(394.5, 730.0]",3,17,-14
31125.0,2019-11-04,"(730.0, 1065.5]",17,21,-4
31125.0,2019-11-04,"(1065.5, 1401.0]",26,41,-15
31126.0,2019-11-04,"(61.683, 392.25]",2,4,-2
31126.0,2019-11-04,"(392.25, 721.5]",4,17,-13
31126.0,2019-11-04,"(721.5, 1050.75]",14,20,-6
31126.0,2019-11-04,"(1050.75, 1380.0]",23,35,-12
31127.0,2019-11-04,"(468.12, 689.0]",20,26,-6
31127.0,2019-11-04,"(689.0, 909.0]",7,14,-7
31127.0,2019-11-04,"(909.0, 1129.0]",13,30,-17
31127.0,2019-11-04,"(1129.0, 1349.0]",7,15,-8
31128.0,2019-11-04,"(20.623, 366.25]",1,2,-1
31128.0,2019-11-04,"(366.25, 710.5]",38,67,-29
31128.0,2019-11-04,"(710.5, 1054.75]",28,49,-21
31128.0,2019-11-04,"(1054.75, 1399.0]",21,42,-21
31129.0,2019-11-04,"(338.937, 605.75]",12,13,-1
31129.0,2019-11-04,"(605.75, 871.5]",8,13,-5
31129.0,2019-11-04,"(871.5, 1137.25]",5,19,-14
31130.0,2019-11-04,"(390.031, 633.25]",3,15,-12
31130.0,2019-11-04,"(633.25, 875.5]",4,9,-5
31130.0,2019-11-04,"(875.5, 1117.75]",6,10,-4
31130.0,2019-11-04,"(1117.75, 1360.0]",16,25,-9
31131.0,2019-11-04,"(588.5, 854.0]",1,14,-13
31131.0,2019-11-04,"(854.0, 1119.5]",3,2,1
31131.0,2019-11-04,"(1119.5, 1385.0]",7,11,-4
31200.0,2019-11-04,"(14.583, 370.25]",1,3,-2
31200.0,2019-11-04,"(370.25, 724.5]",41,63,-22
31200.0,2019-11-04,"(724.5, 1078.75]",30,65,-35
31200.0,2019-11-04,"(1078.75, 1433.0]",22,55,-33
31201.0,2019-11-04,"(19.669, 353.75]",3,4,-1
31201.0,2019-11-04,"(353.75, 686.5]",23,59,-36
31201.0,2019-11-04,"(686.5, 1019.25]",40,69,-29
31201.0,2019-11-04,"(1019.25, 1352.0]",47,93,-46
31202.0,2019-11-04,"(342.932, 611.0]",9,28,-19
31202.0,2019-11-04,"(611.0, 878.0]",8,12,-4
31202.0,2019-11-04,"(878.0, 1145.0]",31,45,-14
31202.0,2019-11-04,"(1145.0, 1412.0]",12,24,-12
31203.0,2019-11-04,"(91.665, 426.75]",2,7,-5
31203.0,2019-11-04,"(426.75, 760.5]",12,32,-20
31203.0,2019-11-04,"(760.5, 1094.25]",47,75,-28
31203.0,2019-11-04,"(1094.25, 1428.0]",22,48,-26
31204.0,2019-11-04,"(61.809, 360.75]",1,1,0
31204.0,2019-11-04,"(360.75, 658.5]",8,9,-1
31204.0,2019-11-04,"(658.5, 956.25]",8,20,-12
31204.0,2019-11-04,"(956.25, 1254.0]",8,25,-17
31205.0,2019-11-04,"(39.793, 342.75]",3,4,-1
31205.0,2019-11-04,"(342.75, 644.5]",28,32,-4
31205.0,2019-11-04,"(644.5, 946.25]",19,41,-22
31205.0,2019-11-04,"(946.25, 1248.0]",20,59,-39
31206.0,2019-11-04,"(452.164, 662.0]",8,10,-2
31206.0,2019-11-04,"(662.0, 871.0]",1,2,-1
31206.0,2019-11-04,"(871.0, 1080.0]",2,10,-8
31207.0,2019-11-04,"(705.0, 899.0]",1,1,0
31207.0,2019-11-04,"(899.0, 1093.0]",3,2,1
31207.0,2019-11-04,"(1093.0, 1287.0]",3,4,-1
31208.0,2019-11-04,"(386.035, 628.25]",17,20,-3
31208.0,2019-11-04,"(869.5, 1110.75]",1,2,-1
31208.0,2019-11-04,"(1110.75, 1352.0]",3,15,-12
31209.0,2019-11-04,"(1.688, 331.0]",2,2,0
31209.0,2019-11-04,"(331.0, 659.0]",8,12,-4
31209.0,2019-11-04,"(659.0, 987.0]",5,10,-5
31209.0,2019-11-04,"(987.0, 1315.0]",11,13,-2
31211.0,2019-11-04,"(463.123, 683.25]",15,19,-4
31211.0,2019-11-04,"(683.25, 902.5]",2,5,-3
31211.0,2019-11-04,"(902.5, 1121.75]",10,21,-11
31211.0,2019-11-04,"(1121.75, 1341.0]",3,8,-5
31212.0,2019-11-04,"(314.959, 576.25]",26,36,-10
31212.0,2019-11-04,"(576.25, 836.5]",18,36,-18
31212.0,2019-11-04,"(836.5, 1096.75]",15,34,-19
31212.0,2019-11-04,"(1096.75, 1357.0]",13,25,-12
31213.0,2019-11-04,"(269.937, 536.75]",31,43,-12
31213.0,2019-11-04,"(536.75, 802.5]",8,14,-6
31213.0,2019-11-04,"(802.5, 1068.25]",19,37,-18
31213.0,2019-11-04,"(1068.25, 1334.0]",8,31,-23
31214.0,2019-11-04,"(347.927, 617.25]",9,28,-19
31214.0,2019-11-04,"(617.25, 885.5]",4,8,-4
31214.0,2019-11-04,"(885.5, 1153.75]",36,57,-21
31214.0,2019-11-04,"(1153.75, 1422.0]",13,25,-12
31215.0,2019-11-04,"(314.0, 606.0]",28,2,26
31215.0,2019-11-04,"(606.0, 898.0]",12,31,-19
31215.0,2019-11-04,"(898.0, 1190.0]",7,16,-9
31216.0,2019-11-04,"(323.223, 518.25]",10,11,-1
31216.0,2019-11-04,"(518.25, 712.5]",9,14,-5
31216.0,2019-11-04,"(712.5, 906.75]",7,17,-10
31216.0,2019-11-04,"(906.75, 1101.0]",7,30,-23
31217.0,2019-11-04,"(350.191, 553.25]",13,15,-2
31217.0,2019-11-04,"(553.25, 755.5]",6,7,-1
31217.0,2019-11-04,"(755.5, 957.75]",6,14,-8
31217.0,2019-11-04,"(957.75, 1160.0]",3,11,-8
31218.0,2019-11-04,"(386.992, 640.0]",15,27,-12
31218.0,2019-11-04,"(640.0, 892.0]",10,17,-7
31218.0,2019-11-04,"(892.0, 1144.0]",16,34,-18
31219.0,2019-11-04,"(442.26, 628.0]",16,16,0
31219.0,2019-11-04,"(628.0, 813.0]",3,4,-1
31219.0,2019-11-04,"(813.0, 998.0]",9,21,-12
31220.0,2019-11-04,"(323.241, 513.75]",16,20,-4
31220.0,2019-11-04,"(703.5, 893.25]",3,7,-4
31220.0,2019-11-04,"(893.25, 1083.0]",3,19,-16
31221.0,2019-11-04,"(387.25, 715.5]",32,1,31
31221.0,2019-11-04,"(715.5, 1043.75]",14,35,-21
31221.0,2019-11-04,"(1043.75, 1372.0]",6,27,-21
31222.0,2019-11-04,"(337.129, 555.75]",18,19,-1
31222.0,2019-11-04,"(555.75, 773.5]",5,8,-3
31222.0,2019-11-04,"(773.5, 991.25]",6,13,-7
31222.0,2019-11-04,"(991.25, 1209.0]",4,26,-22
31223.0,2019-11-04,"(117.716, 440.0]",3,4,-1
31223.0,2019-11-04,"(440.0, 761.0]",9,34,-25
31223.0,2019-11-04,"(761.0, 1082.0]",8,24,-16
31223.0,2019-11-04,"(1082.0, 1403.0]",13,23,-10
31224.0,2019-11-04,"(416.071, 649.25]",23,28,-5
31224.0,2019-11-04,"(649.25, 881.5]",1,6,-5
31224.0,2019-11-04,"(881.5, 1113.75]",2,19,-17
31224.0,2019-11-04,"(1113.75, 1346.0]",3,6,-3
31225.0,2019-11-04,"(65.769, 374.75]",4,4,0
31225.0,2019-11-04,"(374.75, 682.5]",11,18,-7
31225.0,2019-11-04,"(682.5, 990.25]",15,30,-15
31225.0,2019-11-04,"(990.25, 1298.0]",8,18,-10
31226.0,2019-11-04,"(435.111, 658.25]",4,11,-7
31226.0,2019-11-04,"(658.25, 880.5]",2,4,-2
31226.0,2019-11-04,"(880.5, 1102.75]",8,16,-8
31226.0,2019-11-04,"(1102.75, 1325.0]",2,6,-4
31227.0,2019-11-04,"(199.762, 510.5]",14,17,-3
31227.0,2019-11-04,"(510.5, 820.0]",49,57,-8
31227.0,2019-11-04,"(820.0, 1129.5]",9,21,-12
31227.0,2019-11-04,"(1129.5, 1439.0]",2,4,-2
31228.0,2019-11-04,"(154.749, 468.75]",6,8,-2
31228.0,2019-11-04,"(468.75, 781.5]",35,53,-18
31228.0,2019-11-04,"(781.5, 1094.25]",36,66,-30
31228.0,2019-11-04,"(1094.25, 1407.0]",26,56,-30
31229.0,2019-11-04,"(18.65, 357.5]",1,5,-4
31229.0,2019-11-04,"(357.5, 695.0]",10,47,-37
31229.0,2019-11-04,"(695.0, 1032.5]",25,42,-17
31229.0,2019-11-04,"(1032.5, 1370.0]",45,69,-24
31230.0,2019-11-04,"(333.991, 587.25]",39,51,-12
31230.0,2019-11-04,"(587.25, 839.5]",21,31,-10
31230.0,2019-11-04,"(839.5, 1091.75]",18,48,-30
31230.0,2019-11-04,"(1091.75, 1344.0]",3,15,-12
31231.0,2019-11-04,"(386.972, 645.0]",27,30,-3
31231.0,2019-11-04,"(645.0, 902.0]",6,10,-4
31231.0,2019-11-04,"(902.0, 1159.0]",17,48,-31
31231.0,2019-11-04,"(1159.0, 1416.0]",7,11,-4
31232.0,2019-11-04,"(153.762, 464.5]",4,6,-2
31232.0,2019-11-04,"(464.5, 774.0]",21,29,-8
31232.0,2019-11-04,"(774.0, 1083.5]",27,54,-27
31232.0,2019-11-04,"(1083.5, 1393.0]",18,46,-28
31233.0,2019-11-04,"(358.925, 628.75]",47,57,-10
31233.0,2019-11-04,"(628.75, 897.5]",14,20,-6
31233.0,2019-11-04,"(897.5, 1166.25]",13,44,-31
31233.0,2019-11-04,"(1166.25, 1435.0]",1,2,-1
31234.0,2019-11-04,"(354.033, 596.75]",20,35,-15
31234.0,2019-11-04,"(596.75, 838.5]",8,17,-9
31234.0,2019-11-04,"(838.5, 1080.25]",14,26,-12
31234.0,2019-11-04,"(1080.25, 1322.0]",11,30,-19
31235.0,2019-11-04,"(482.129, 700.75]",13,16,-3
31235.0,2019-11-04,"(700.75, 918.5]",7,10,-3
31235.0,2019-11-04,"(918.5, 1136.25]",6,14,-8
31235.0,2019-11-04,"(1136.25, 1354.0]",3,4,-1
31236.0,2019-11-04,"(359.0, 711.0]",22,2,20
31236.0,2019-11-04,"(711.0, 1063.0]",21,31,-10
31236.0,2019-11-04,"(1063.0, 1415.0]",10,46,-36
31237.0,2019-11-04,"(380.943, 646.25]",13,25,-12
31237.0,2019-11-04,"(646.25, 910.5]",16,28,-12
31237.0,2019-11-04,"(910.5, 1174.75]",10,21,-11
31237.0,2019-11-04,"(1174.75, 1439.0]",9,14,-5
31238.0,2019-11-04,"(384.217, 580.75]",8,9,-1
31238.0,2019-11-04,"(580.75, 776.5]",1,4,-3
31238.0,2019-11-04,"(776.5, 972.25]",4,14,-10
31238.0,2019-11-04,"(972.25, 1168.0]",8,32,-24
31239.0,2019-11-04,"(350.088, 579.0]",20,24,-4
31239.0,2019-11-04,"(579.0, 807.0]",8,15,-7
31239.0,2019-11-04,"(807.0, 1035.0]",7,18,-11
31239.0,2019-11-04,"(1035.0, 1263.0]",7,35,-28
31240.0,2019-11-04,"(419.356, 581.0]",1,3,-2
31240.0,2019-11-04,"(581.0, 742.0]",8,10,-2
31240.0,2019-11-04,"(742.0, 903.0]",6,7,-1
31240.0,2019-11-04,"(903.0, 1064.0]",1,3,-2
31241.0,2019-11-04,"(28.635, 371.25]",1,4,-3
31241.0,2019-11-04,"(371.25, 712.5]",33,73,-40
31241.0,2019-11-04,"(712.5, 1053.75]",14,41,-27
31241.0,2019-11-04,"(1053.75, 1395.0]",19,49,-30
31242.0,2019-11-04,"(400.304, 575.0]",26,28,-2
31242.0,2019-11-04,"(575.0, 749.0]",9,12,-3
31242.0,2019-11-04,"(749.0, 923.0]",5,12,-7
31242.0,2019-11-04,"(923.0, 1097.0]",6,34,-28
31243.0,2019-11-04,"(345.99, 599.5]",29,36,-7
31243.0,2019-11-04,"(599.5, 852.0]",10,20,-10
31243.0,2019-11-04,"(852.0, 1104.5]",14,45,-31
31243.0,2019-11-04,"(1104.5, 1357.0]",3,16,-13
31244.0,2019-11-04,"(396.058, 632.5]",19,30,-11
31244.0,2019-11-04,"(632.5, 868.0]",5,12,-7
31244.0,2019-11-04,"(868.0, 1103.5]",10,31,-21
31244.0,2019-11-04,"(1103.5, 1339.0]",8,10,-2
31245.0,2019-11-04,"(385.035, 627.25]",10,23,-13
31245.0,2019-11-04,"(627.25, 868.5]",7,12,-5
31245.0,2019-11-04,"(868.5, 1109.75]",15,32,-17
31245.0,2019-11-04,"(1109.75, 1351.0]",8,18,-10
31246.0,2019-11-04,"(396.032, 639.0]",17,24,-7
31246.0,2019-11-04,"(639.0, 881.0]",9,15,-6
31246.0,2019-11-04,"(881.0, 1123.0]",20,44,-24
31246.0,2019-11-04,"(1123.0, 1365.0]",12,18,-6
31247.0,2019-11-04,"(343.004, 593.0]",18,25,-7
31247.0,2019-11-04,"(593.0, 842.0]",33,62,-29
31247.0,2019-11-04,"(842.0, 1091.0]",24,50,-26
31247.0,2019-11-04,"(1091.0, 1340.0]",8,14,-6
31248.0,2019-11-04,"(347.18, 553.0]",18,22,-4
31248.0,2019-11-04,"(553.0, 758.0]",8,14,-6
31248.0,2019-11-04,"(758.0, 963.0]",14,35,-21
31248.0,2019-11-04,"(963.0, 1168.0]",18,37,-19
31249.0,2019-11-04,"(408.074, 640.5]",8,12,-4
31249.0,2019-11-04,"(640.5, 872.0]",15,28,-13
31249.0,2019-11-04,"(872.0, 1103.5]",9,25,-16
31249.0,2019-11-04,"(1103.5, 1335.0]",2,4,-2
31250.0,2019-11-04,"(338.959, 600.25]",19,23,-4
31250.0,2019-11-04,"(600.25, 860.5]",2,6,-4
31250.0,2019-11-04,"(860.5, 1120.75]",6,27,-21
31250.0,2019-11-04,"(1120.75, 1381.0]",2,6,-4
31251.0,2019-11-04,"(244.854, 532.5]",15,31,-16
31251.0,2019-11-04,"(532.5, 819.0]",10,27,-17
31251.0,2019-11-04,"(819.0, 1105.5]",18,34,-16
31251.0,2019-11-04,"(1105.5, 1392.0]",12,21,-9
31252.0,2019-11-04,"(372.222, 567.5]",16,17,-1
31252.0,2019-11-04,"(567.5, 762.0]",1,2,-1
31252.0,2019-11-04,"(956.5, 1151.0]",3,5,-2
31253.0,2019-11-04,"(387.138, 603.5]",19,20,-1
31253.0,2019-11-04,"(603.5, 819.0]",6,10,-4
31253.0,2019-11-04,"(819.0, 1034.5]",7,18,-11
31253.0,2019-11-04,"(1034.5, 1250.0]",2,17,-15
31254.0,2019-11-04,"(348.018, 594.5]",20,23,-3
31254.0,2019-11-04,"(594.5, 840.0]",7,12,-5
31254.0,2019-11-04,"(840.0, 1085.5]",6,26,-20
31254.0,2019-11-04,"(1085.5, 1331.0]",3,9,-6
31255.0,2019-11-04,"(358.923, 629.25]",10,14,-4
31255.0,2019-11-04,"(629.25, 898.5]",8,18,-10
31255.0,2019-11-04,"(898.5, 1167.75]",12,31,-19
31255.0,2019-11-04,"(1167.75, 1437.0]",4,7,-3
31256.0,2019-11-04,"(282.031, 525.25]",11,14,-3
31256.0,2019-11-04,"(525.25, 767.5]",8,17,-9
31256.0,2019-11-04,"(767.5, 1009.75]",5,9,-4
31256.0,2019-11-04,"(1009.75, 1252.0]",9,25,-16
31257.0,2019-11-04,"(50.693, 378.75]",2,4,-2
31257.0,2019-11-04,"(378.75, 705.5]",14,26,-12
31257.0,2019-11-04,"(705.5, 1032.25]",13,26,-13
31257.0,2019-11-04,"(1032.25, 1359.0]",13,40,-27
31258.0,2019-11-04,"(541.233, 733.75]",17,41,-24
31258.0,2019-11-04,"(733.75, 925.5]",26,51,-25
31258.0,2019-11-04,"(925.5, 1117.25]",9,20,-11
31258.0,2019-11-04,"(1117.25, 1309.0]",5,8,-3
31259.0,2019-11-04,"(449.012, 697.0]",14,14,0
31259.0,2019-11-04,"(697.0, 944.0]",3,7,-4
31259.0,2019-11-04,"(944.0, 1191.0]",2,17,-15
31259.0,2019-11-04,"(1191.0, 1438.0]",2,4,-2
31260.0,2019-11-04,"(331.988, 586.0]",20,28,-8
31260.0,2019-11-04,"(586.0, 839.0]",3,4,-1
31260.0,2019-11-04,"(839.0, 1092.0]",10,30,-20
31260.0,2019-11-04,"(1092.0, 1345.0]",6,17,-11
31261.0,2019-11-04,"(422.395, 574.25]",17,19,-2
31261.0,2019-11-04,"(574.25, 725.5]",2,11,-9
31261.0,2019-11-04,"(725.5, 876.75]",1,5,-4
31262.0,2019-11-04,"(321.231, 514.25]",8,11,-3
31262.0,2019-11-04,"(514.25, 706.5]",8,13,-5
31262.0,2019-11-04,"(706.5, 898.75]",9,13,-4
31262.0,2019-11-04,"(898.75, 1091.0]",8,21,-13
31263.0,2019-11-04,"(319.033, 561.75]",18,31,-13
31263.0,2019-11-04,"(561.75, 803.5]",8,18,-10
31263.0,2019-11-04,"(803.5, 1045.25]",14,27,-13
31263.0,2019-11-04,"(1045.25, 1287.0]",6,23,-17
31264.0,2019-11-04,"(407.0, 718.0]",18,1,17
31264.0,2019-11-04,"(718.0, 1029.0]",5,23,-18
31264.0,2019-11-04,"(1029.0, 1340.0]",9,17,-8
31265.0,2019-11-04,"(3.578, 360.5]",2,4,-2
31265.0,2019-11-04,"(360.5, 716.0]",19,53,-34
31265.0,2019-11-04,"(716.0, 1071.5]",24,42,-18
31265.0,2019-11-04,"(1071.5, 1427.0]",21,35,-14
31266.0,2019-11-04,"(49.666, 384.5]",3,10,-7
31266.0,2019-11-04,"(384.5, 718.0]",9,26,-17
31266.0,2019-11-04,"(718.0, 1051.5]",15,27,-12
31266.0,2019-11-04,"(1051.5, 1385.0]",29,45,-16
31267.0,2019-11-04,"(391.5, 735.0]",36,2,34
31267.0,2019-11-04,"(735.0, 1078.5]",24,72,-48
31267.0,2019-11-04,"(1078.5, 1422.0]",21,49,-28
31268.0,2019-11-04,"(339.04, 580.0]",10,35,-25
31268.0,2019-11-04,"(580.0, 820.0]",2,2,0
31268.0,2019-11-04,"(820.0, 1060.0]",13,24,-11
31268.0,2019-11-04,"(1060.0, 1300.0]",19,29,-10
31269.0,2019-11-04,"(368.25, 716.5]",7,1,6
31269.0,2019-11-04,"(716.5, 1064.75]",13,13,0
31269.0,2019-11-04,"(1064.75, 1413.0]",10,28,-18
31270.0,2019-11-04,"(384.21, 582.5]",21,29,-8
31270.0,2019-11-04,"(582.5, 780.0]",3,10,-7
31270.0,2019-11-04,"(780.0, 977.5]",9,15,-6
31270.0,2019-11-04,"(977.5, 1175.0]",13,31,-18
31271.0,2019-11-04,"(383.962, 644.5]",19,23,-4
31271.0,2019-11-04,"(644.5, 904.0]",13,23,-10
31271.0,2019-11-04,"(904.0, 1163.5]",15,43,-28
31271.0,2019-11-04,"(1163.5, 1423.0]",1,7,-6
31272.0,2019-11-04,"(19.632, 363.0]",1,2,-1
31272.0,2019-11-04,"(363.0, 705.0]",30,35,-5
31272.0,2019-11-04,"(705.0, 1047.0]",17,48,-31
31272.0,2019-11-04,"(1047.0, 1389.0]",2,8,-6
31273.0,2019-11-04,"(437.094, 664.5]",3,8,-5
31273.0,2019-11-04,"(664.5, 891.0]",3,5,-2
31273.0,2019-11-04,"(891.0, 1117.5]",1,3,-2
31273.0,2019-11-04,"(1117.5, 1344.0]",2,3,-1
31274.0,2019-11-04,"(347.001, 597.75]",18,19,-1
31274.0,2019-11-04,"(597.75, 847.5]",4,8,-4
31274.0,2019-11-04,"(847.5, 1097.25]",9,25,-16
31274.0,2019-11-04,"(1097.25, 1347.0]",6,21,-15
31275.0,2019-11-04,"(294.919, 566.25]",28,36,-8
31275.0,2019-11-04,"(566.25, 836.5]",16,29,-13
31275.0,2019-11-04,"(836.5, 1106.75]",17,42,-25
31275.0,2019-11-04,"(1106.75, 1377.0]",9,19,-10
31276.0,2019-11-04,"(376.033, 618.75]",14,17,-3
31276.0,2019-11-04,"(618.75, 860.5]",8,18,-10
31276.0,2019-11-04,"(860.5, 1102.25]",7,23,-16
31276.0,2019-11-04,"(1102.25, 1344.0]",4,8,-4
31277.0,2019-11-04,"(407.148, 621.0]",34,41,-7
31277.0,2019-11-04,"(621.0, 834.0]",3,8,-5
31277.0,2019-11-04,"(834.0, 1047.0]",18,41,-23
31277.0,2019-11-04,"(1047.0, 1260.0]",9,31,-22
31278.0,2019-11-04,"(423.078, 654.5]",7,28,-21
31278.0,2019-11-04,"(654.5, 885.0]",7,11,-4
31278.0,2019-11-04,"(885.0, 1115.5]",17,23,-6
31278.0,2019-11-04,"(1115.5, 1346.0]",13,22,-9
31279.0,2019-11-04,"(382.252, 570.0]",20,23,-3
31279.0,2019-11-04,"(570.0, 757.0]",12,16,-4
31279.0,2019-11-04,"(757.0, 944.0]",5,12,-7
31279.0,2019-11-04,"(944.0, 1131.0]",8,34,-26
31280.0,2019-11-04,"(355.053, 592.75]",4,16,-12
31280.0,2019-11-04,"(592.75, 829.5]",3,5,-2
31280.0,2019-11-04,"(829.5, 1066.25]",4,8,-4
31280.0,2019-11-04,"(1066.25, 1303.0]",23,27,-4
31000.0,2019-11-05,"(491.434, 633.5]",2,4,-2
31000.0,2019-11-05,"(775.0, 916.5]",1,2,-1
31000.0,2019-11-05,"(916.5, 1058.0]",1,1,0
31001.0,2019-11-05,"(566.294, 743.5]",1,2,-1
31001.0,2019-11-05,"(920.0, 1096.5]",3,5,-2
31001.0,2019-11-05,"(1096.5, 1273.0]",1,2,-1
31002.0,2019-11-05,"(381.206, 580.5]",7,12,-5
31002.0,2019-11-05,"(580.5, 779.0]",2,3,-1
31002.0,2019-11-05,"(779.0, 977.5]",2,6,-4
31002.0,2019-11-05,"(977.5, 1176.0]",3,5,-2
31003.0,2019-11-05,"(372.051, 610.25]",4,7,-3
31003.0,2019-11-05,"(610.25, 847.5]",1,2,-1
31003.0,2019-11-05,"(847.5, 1084.75]",2,5,-3
31003.0,2019-11-05,"(1084.75, 1322.0]",3,7,-4
31004.0,2019-11-05,"(889.5, 1087.25]",1,3,-2
31004.0,2019-11-05,"(1087.25, 1285.0]",2,2,0
31005.0,2019-11-05,"(427.159, 638.25]",5,9,-4
31005.0,2019-11-05,"(638.25, 848.5]",1,3,-2
31005.0,2019-11-05,"(848.5, 1058.75]",6,11,-5
31005.0,2019-11-05,"(1058.75, 1269.0]",2,5,-3
31006.0,2019-11-05,"(-1.109, 277.25]",1,1,0
31006.0,2019-11-05,"(554.5, 831.75]",1,2,-1
31006.0,2019-11-05,"(831.75, 1109.0]",3,4,-1
31007.0,2019-11-05,"(329.035, 571.25]",12,31,-19
31007.0,2019-11-05,"(571.25, 812.5]",11,20,-9
31007.0,2019-11-05,"(812.5, 1053.75]",8,19,-11
31007.0,2019-11-05,"(1053.75, 1295.0]",7,20,-13
31009.0,2019-11-05,"(428.25, 616.5]",7,8,-1
31009.0,2019-11-05,"(616.5, 804.0]",1,2,-1
31009.0,2019-11-05,"(991.5, 1179.0]",2,6,-4
31010.0,2019-11-05,"(484.126, 703.5]",1,5,-4
31010.0,2019-11-05,"(703.5, 922.0]",1,1,0
31010.0,2019-11-05,"(922.0, 1140.5]",2,2,0
31010.0,2019-11-05,"(1140.5, 1359.0]",4,9,-5
31011.0,2019-11-05,"(324.991, 578.25]",9,14,-5
31011.0,2019-11-05,"(578.25, 830.5]",6,7,-1
31011.0,2019-11-05,"(830.5, 1082.75]",2,8,-6
31011.0,2019-11-05,"(1082.75, 1335.0]",4,10,-6
31012.0,2019-11-05,"(358.178, 564.5]",9,10,-1
31012.0,2019-11-05,"(564.5, 770.0]",1,3,-2
31012.0,2019-11-05,"(770.0, 975.5]",2,6,-4
31012.0,2019-11-05,"(975.5, 1181.0]",1,8,-7
31013.0,2019-11-05,"(648.0, 857.0]",2,5,-3
31013.0,2019-11-05,"(857.0, 1066.0]",4,3,1
31013.0,2019-11-05,"(1066.0, 1275.0]",3,9,-6
31014.0,2019-11-05,"(382.034, 624.5]",26,30,-4
31014.0,2019-11-05,"(624.5, 866.0]",8,11,-3
31014.0,2019-11-05,"(866.0, 1107.5]",14,29,-15
31014.0,2019-11-05,"(1107.5, 1349.0]",6,10,-4
31015.0,2019-11-05,"(305.985, 560.75]",13,14,-1
31015.0,2019-11-05,"(560.75, 814.5]",3,6,-3
31015.0,2019-11-05,"(814.5, 1068.25]",5,11,-6
31015.0,2019-11-05,"(1068.25, 1322.0]",3,6,-3
31016.0,2019-11-05,"(302.027, 546.25]",6,12,-6
31016.0,2019-11-05,"(546.25, 789.5]",4,7,-3
31016.0,2019-11-05,"(789.5, 1032.75]",4,8,-4
31016.0,2019-11-05,"(1032.75, 1276.0]",6,15,-9
31017.0,2019-11-05,"(380.5, 634.0]",1,1,0
31017.0,2019-11-05,"(887.5, 1141.0]",1,4,-3
31018.0,2019-11-05,"(982.5, 1181.0]",5,6,-1
31019.0,2019-11-05,"(868.533, 985.75]",1,2,-1
31019.0,2019-11-05,"(985.75, 1102.5]",1,1,0
31020.0,2019-11-05,"(610.36, 771.0]",1,2,-1
31020.0,2019-11-05,"(931.0, 1091.0]",4,5,-1
31020.0,2019-11-05,"(1091.0, 1251.0]",1,6,-5
31021.0,2019-11-05,"(366.05, 604.5]",1,7,-6
31021.0,2019-11-05,"(842.0, 1079.5]",3,3,0
31021.0,2019-11-05,"(1079.5, 1317.0]",3,6,-3
31022.0,2019-11-05,"(404.1, 630.0]",1,5,-4
31022.0,2019-11-05,"(630.0, 855.0]",2,4,-2
31022.0,2019-11-05,"(855.0, 1080.0]",1,3,-2
31022.0,2019-11-05,"(1080.0, 1305.0]",5,11,-6
31023.0,2019-11-05,"(385.979, 642.25]",1,4,-3
31023.0,2019-11-05,"(897.5, 1152.75]",3,8,-5
31023.0,2019-11-05,"(1152.75, 1408.0]",1,7,-6
31024.0,2019-11-05,"(424.038, 665.5]",6,15,-9
31024.0,2019-11-05,"(665.5, 906.0]",3,5,-2
31024.0,2019-11-05,"(906.0, 1146.5]",10,17,-7
31024.0,2019-11-05,"(1146.5, 1387.0]",1,8,-7
31025.0,2019-11-05,"(428.289, 606.75]",4,7,-3
31025.0,2019-11-05,"(606.75, 784.5]",1,4,-3
31026.0,2019-11-05,"(370.0, 707.0]",3,1,2
31026.0,2019-11-05,"(707.0, 1044.0]",3,7,-4
31026.0,2019-11-05,"(1044.0, 1381.0]",2,5,-3
31027.0,2019-11-05,"(723.0, 911.5]",2,3,-1
31027.0,2019-11-05,"(911.5, 1100.0]",2,3,-1
31028.0,2019-11-05,"(446.173, 653.75]",2,2,0
31028.0,2019-11-05,"(860.5, 1067.25]",1,3,-2
31028.0,2019-11-05,"(1067.25, 1274.0]",2,4,-2
31029.0,2019-11-05,"(667.0, 890.0]",2,10,-8
31029.0,2019-11-05,"(890.0, 1113.0]",7,4,3
31029.0,2019-11-05,"(1113.0, 1336.0]",2,7,-5
31030.0,2019-11-05,"(643.25, 835.5]",2,6,-4
31030.0,2019-11-05,"(835.5, 1027.75]",2,3,-1
31030.0,2019-11-05,"(1027.75, 1220.0]",5,3,2
31031.0,2019-11-05,"(1020.25, 1204.0]",4,3,1
31032.0,2019-11-05,"(602.0, 755.0]",1,1,0
31032.0,2019-11-05,"(908.0, 1061.0]",4,2,2
31033.0,2019-11-05,"(486.112, 709.0]",1,3,-2
31033.0,2019-11-05,"(709.0, 931.0]",2,5,-3
31033.0,2019-11-05,"(931.0, 1153.0]",3,4,-1
31034.0,2019-11-05,"(411.0, 662.0]",2,6,-4
31034.0,2019-11-05,"(662.0, 912.0]",2,3,-1
31034.0,2019-11-05,"(912.0, 1162.0]",2,6,-4
31034.0,2019-11-05,"(1162.0, 1412.0]",2,2,0
31035.0,2019-11-05,"(134.713, 457.75]",1,2,-1
31035.0,2019-11-05,"(457.75, 779.5]",2,4,-2
31035.0,2019-11-05,"(779.5, 1101.25]",2,6,-4
31035.0,2019-11-05,"(1101.25, 1423.0]",4,6,-2
31036.0,2019-11-05,"(921.5, 1164.75]",7,7,0
31036.0,2019-11-05,"(1164.75, 1408.0]",2,1,1
31037.0,2019-11-05,"(411.031, 654.25]",21,30,-9
31037.0,2019-11-05,"(654.25, 896.5]",4,9,-5
31037.0,2019-11-05,"(896.5, 1138.75]",6,22,-16
31037.0,2019-11-05,"(1138.75, 1381.0]",2,10,-8
31038.0,2019-11-05,"(391.048, 630.0]",1,2,-1
31038.0,2019-11-05,"(630.0, 868.0]",2,5,-3
31038.0,2019-11-05,"(868.0, 1106.0]",3,5,-2
31038.0,2019-11-05,"(1106.0, 1344.0]",2,4,-2
31039.0,2019-11-05,"(358.027, 602.25]",4,11,-7
31039.0,2019-11-05,"(602.25, 845.5]",1,5,-4
31039.0,2019-11-05,"(845.5, 1088.75]",6,11,-5
31039.0,2019-11-05,"(1088.75, 1332.0]",6,11,-5
31040.0,2019-11-05,"(457.124, 677.0]",5,5,0
31040.0,2019-11-05,"(677.0, 896.0]",2,4,-2
31040.0,2019-11-05,"(896.0, 1115.0]",2,5,-3
31041.0,2019-11-05,"(444.236, 636.0]",2,3,-1
31041.0,2019-11-05,"(636.0, 827.0]",2,2,0
31041.0,2019-11-05,"(827.0, 1018.0]",2,3,-1
31041.0,2019-11-05,"(1018.0, 1209.0]",5,7,-2
31042.0,2019-11-05,"(438.074, 670.5]",13,15,-2
31042.0,2019-11-05,"(670.5, 902.0]",3,7,-4
31042.0,2019-11-05,"(902.0, 1133.5]",2,11,-9
31042.0,2019-11-05,"(1133.5, 1365.0]",2,5,-3
31043.0,2019-11-05,"(488.274, 670.5]",2,3,-1
31043.0,2019-11-05,"(670.5, 852.0]",1,5,-4
31043.0,2019-11-05,"(852.0, 1033.5]",1,2,-1
31043.0,2019-11-05,"(1033.5, 1215.0]",2,4,-2
31044.0,2019-11-05,"(640.5, 843.0]",2,2,0
31044.0,2019-11-05,"(1045.5, 1248.0]",3,4,-1
31045.0,2019-11-05,"(500.157, 711.75]",1,2,-1
31045.0,2019-11-05,"(711.75, 922.5]",1,2,-1
31045.0,2019-11-05,"(922.5, 1133.25]",2,2,0
31045.0,2019-11-05,"(1133.25, 1344.0]",1,1,0
,,,,1.0,
,,,,1.0,
31047.0,2019-11-05,"(350.971, 609.25]",9,17,-8
31047.0,2019-11-05,"(609.25, 866.5]",10,12,-2
31047.0,2019-11-05,"(866.5, 1123.75]",9,26,-17
31047.0,2019-11-05,"(1123.75, 1381.0]",4,12,-8
31048.0,2019-11-05,"(402.047, 641.25]",4,7,-3
31048.0,2019-11-05,"(641.25, 879.5]",1,1,0
31048.0,2019-11-05,"(879.5, 1117.75]",2,7,-5
31049.0,2019-11-05,"(353.014, 600.5]",1,4,-3
31049.0,2019-11-05,"(600.5, 847.0]",1,2,-1
31049.0,2019-11-05,"(847.0, 1093.5]",2,5,-3
31049.0,2019-11-05,"(1093.5, 1340.0]",4,7,-3
31050.0,2019-11-05,"(841.5, 951.0]",1,1,0
31051.0,2019-11-05,"(5.686, 335.5]",1,2,-1
31051.0,2019-11-05,"(664.0, 992.5]",5,6,-1
31051.0,2019-11-05,"(992.5, 1321.0]",7,6,1
31052.0,2019-11-05,"(311.071, 544.25]",3,6,-3
31052.0,2019-11-05,"(776.5, 1008.75]",1,3,-2
31052.0,2019-11-05,"(1008.75, 1241.0]",7,1,6
31053.0,2019-11-05,"(863.5, 1013.75]",1,2,-1
31053.0,2019-11-05,"(1013.75, 1164.0]",1,2,-1
31054.0,2019-11-05,"(931.782, 986.5]",1,2,-1
31054.0,2019-11-05,"(1041.0, 1095.5]",1,1,0
31054.0,2019-11-05,"(1095.5, 1150.0]",1,1,0
31055.0,2019-11-05,"(728.0, 917.5]",3,2,1
31055.0,2019-11-05,"(917.5, 1107.0]",3,1,2
31056.0,2019-11-05,"(27.6, 379.0]",1,1,0
31056.0,2019-11-05,"(729.0, 1079.0]",2,2,0
31056.0,2019-11-05,"(1079.0, 1429.0]",2,3,-1
31057.0,2019-11-05,"(731.351, 894.25]",1,1,0
31057.0,2019-11-05,"(894.25, 1056.5]",1,1,0
31057.0,2019-11-05,"(1218.75, 1381.0]",2,3,-1
,,,,2.0,
31059.0,2019-11-05,"(344.172, 552.0]",1,5,-4
31059.0,2019-11-05,"(759.0, 966.0]",2,1,1
31059.0,2019-11-05,"(966.0, 1173.0]",3,3,0
31060.0,2019-11-05,"(365.75, 716.5]",1,1,0
31060.0,2019-11-05,"(716.5, 1067.25]",3,1,2
31060.0,2019-11-05,"(1067.25, 1418.0]",3,8,-5
31061.0,2019-11-05,"(517.0, 523.0]",1,1,0
31062.0,2019-11-05,"(558.39, 711.5]",2,4,-2
31062.0,2019-11-05,"(711.5, 864.0]",3,5,-2
31062.0,2019-11-05,"(864.0, 1016.5]",4,6,-2
31062.0,2019-11-05,"(1016.5, 1169.0]",2,4,-2
31063.0,2019-11-05,"(829.805, 878.75]",1,2,-1
31063.0,2019-11-05,"(878.75, 927.5]",1,1,0
31064.0,2019-11-05,"(444.282, 624.5]",4,8,-4
31064.0,2019-11-05,"(624.5, 804.0]",3,9,-6
31064.0,2019-11-05,"(804.0, 983.5]",4,7,-3
31064.0,2019-11-05,"(983.5, 1163.0]",4,8,-4
31065.0,2019-11-05,"(554.25, 746.5]",1,3,-2
31065.0,2019-11-05,"(938.75, 1131.0]",2,1,1
31066.0,2019-11-05,"(863.75, 989.0]",2,2,0
31067.0,2019-11-05,"(379.003, 629.25]",2,6,-4
31067.0,2019-11-05,"(878.5, 1127.75]",2,3,-1
31067.0,2019-11-05,"(1127.75, 1377.0]",2,3,-1
31068.0,2019-11-05,"(495.151, 708.25]",1,2,-1
31068.0,2019-11-05,"(920.5, 1132.75]",1,2,-1
31068.0,2019-11-05,"(1132.75, 1345.0]",2,2,0
31069.0,2019-11-05,"(438.127, 657.25]",2,9,-7
31069.0,2019-11-05,"(657.25, 875.5]",1,1,0
31069.0,2019-11-05,"(875.5, 1093.75]",3,5,-2
31069.0,2019-11-05,"(1093.75, 1312.0]",5,5,0
31070.0,2019-11-05,"(814.25, 1006.5]",2,2,0
31070.0,2019-11-05,"(1198.75, 1391.0]",2,3,-1
31071.0,2019-11-05,"(320.089, 548.75]",3,11,-8
31071.0,2019-11-05,"(548.75, 776.5]",5,9,-4
31071.0,2019-11-05,"(776.5, 1004.25]",8,16,-8
31071.0,2019-11-05,"(1004.25, 1232.0]",10,14,-4
,,,,2.0,
31073.0,2019-11-05,"(495.424, 640.0]",2,2,0
31073.0,2019-11-05,"(640.0, 784.0]",1,2,-1
31073.0,2019-11-05,"(928.0, 1072.0]",2,1,1
31074.0,2019-11-05,"(739.0, 924.0]",1,4,-3
31074.0,2019-11-05,"(924.0, 1109.0]",8,1,7
31075.0,2019-11-05,"(901.5, 1084.25]",1,1,0
31075.0,2019-11-05,"(1084.25, 1267.0]",1,2,-1
31076.0,2019-11-05,"(423.306, 597.5]",1,2,-1
31076.0,2019-11-05,"(944.5, 1118.0]",1,2,-1
31077.0,2019-11-05,"(200.993, 453.75]",1,1,0
31077.0,2019-11-05,"(453.75, 705.5]",6,14,-8
31077.0,2019-11-05,"(705.5, 957.25]",8,15,-7
31077.0,2019-11-05,"(957.25, 1209.0]",7,9,-2
31078.0,2019-11-05,"(403.267, 587.25]",10,11,-1
31078.0,2019-11-05,"(587.25, 770.5]",2,2,0
31079.0,2019-11-05,"(37.649, 376.75]",1,1,0
31079.0,2019-11-05,"(376.75, 714.5]",2,12,-10
31079.0,2019-11-05,"(714.5, 1052.25]",4,5,-1
31079.0,2019-11-05,"(1052.25, 1390.0]",6,10,-4
31080.0,2019-11-05,"(2.571, 361.25]",1,1,0
31080.0,2019-11-05,"(361.25, 718.5]",2,12,-10
31080.0,2019-11-05,"(718.5, 1075.75]",6,10,-4
31080.0,2019-11-05,"(1075.75, 1433.0]",7,8,-1
31081.0,2019-11-05,"(409.33, 577.5]",3,4,-1
31081.0,2019-11-05,"(745.0, 912.5]",1,1,0
31081.0,2019-11-05,"(912.5, 1080.0]",2,1,1
31082.0,2019-11-05,"(683.5, 776.0]",1,1,0
31083.0,2019-11-05,"(783.0, 977.0]",1,2,-1
31083.0,2019-11-05,"(977.0, 1171.0]",4,2,2
31084.0,2019-11-05,"(535.183, 740.25]",6,8,-2
31084.0,2019-11-05,"(740.25, 944.5]",4,6,-2
31084.0,2019-11-05,"(944.5, 1148.75]",1,7,-6
31084.0,2019-11-05,"(1148.75, 1353.0]",1,2,-1
31085.0,2019-11-05,"(251.25, 502.5]",1,1,0
31085.0,2019-11-05,"(502.5, 753.75]",1,1,0
31085.0,2019-11-05,"(753.75, 1005.0]",2,1,1
31086.0,2019-11-05,"(348.09, 576.5]",2,3,-1
31086.0,2019-11-05,"(576.5, 804.0]",1,4,-3
31086.0,2019-11-05,"(1031.5, 1259.0]",1,3,-2
31087.0,2019-11-05,"(708.5, 847.25]",1,1,0
31087.0,2019-11-05,"(847.25, 986.0]",1,2,-1
31088.0,2019-11-05,"(456.057, 692.75]",1,7,-6
31088.0,2019-11-05,"(692.75, 928.5]",1,3,-2
31088.0,2019-11-05,"(928.5, 1164.25]",7,10,-3
31088.0,2019-11-05,"(1164.25, 1400.0]",3,3,0
31089.0,2019-11-05,"(384.024, 629.0]",15,23,-8
31089.0,2019-11-05,"(629.0, 873.0]",3,9,-6
31089.0,2019-11-05,"(873.0, 1117.0]",4,19,-15
31089.0,2019-11-05,"(1117.0, 1361.0]",3,5,-2
31090.0,2019-11-05,"(932.5, 1085.0]",2,1,1
31091.0,2019-11-05,"(849.0, 1047.0]",1,4,-3
31091.0,2019-11-05,"(1047.0, 1245.0]",4,1,3
31092.0,2019-11-05,"(1346.925, 1365.75]",1,1,0
31093.0,2019-11-05,"(396.267, 580.25]",3,10,-7
31093.0,2019-11-05,"(946.75, 1130.0]",4,1,3
31094.0,2019-11-05,"(548.551, 661.25]",1,2,-1
31094.0,2019-11-05,"(885.75, 998.0]",1,2,-1
,,,,1.0,
,,,,1.0,
31096.0,2019-11-05,"(863.5, 1051.75]",5,3,2
31096.0,2019-11-05,"(1051.75, 1240.0]",2,1,1
31097.0,2019-11-05,"(535.151, 748.25]",3,4,-1
31097.0,2019-11-05,"(748.25, 960.5]",1,2,-1
31097.0,2019-11-05,"(960.5, 1172.75]",2,6,-4
31097.0,2019-11-05,"(1172.75, 1385.0]",2,3,-1
31098.0,2019-11-05,"(415.115, 637.25]",7,20,-13
31098.0,2019-11-05,"(637.25, 858.5]",3,7,-4
31098.0,2019-11-05,"(858.5, 1079.75]",6,13,-7
31098.0,2019-11-05,"(1079.75, 1301.0]",3,7,-4
31099.0,2019-11-05,"(765.5, 991.75]",1,2,-1
31099.0,2019-11-05,"(991.75, 1218.0]",2,3,-1
31100.0,2019-11-05,"(419.996, 672.0]",18,22,-4
31100.0,2019-11-05,"(672.0, 923.0]",3,11,-8
31100.0,2019-11-05,"(923.0, 1174.0]",13,36,-23
31100.0,2019-11-05,"(1174.0, 1425.0]",1,2,-1
31101.0,2019-11-05,"(6.574, 364.5]",5,9,-4
31101.0,2019-11-05,"(364.5, 721.0]",15,48,-33
31101.0,2019-11-05,"(721.0, 1077.5]",45,70,-25
31101.0,2019-11-05,"(1077.5, 1434.0]",45,68,-23
31102.0,2019-11-05,"(40.697, 367.75]",1,5,-4
31102.0,2019-11-05,"(367.75, 693.5]",2,20,-18
31102.0,2019-11-05,"(693.5, 1019.25]",1,9,-8
31102.0,2019-11-05,"(1019.25, 1345.0]",16,23,-7
31103.0,2019-11-05,"(31.653, 369.75]",1,2,-1
31103.0,2019-11-05,"(369.75, 706.5]",1,36,-35
31103.0,2019-11-05,"(706.5, 1043.25]",7,30,-23
31103.0,2019-11-05,"(1043.25, 1380.0]",11,24,-13
31104.0,2019-11-05,"(348.914, 621.5]",3,20,-17
31104.0,2019-11-05,"(621.5, 893.0]",6,11,-5
31104.0,2019-11-05,"(893.0, 1164.5]",19,32,-13
31104.0,2019-11-05,"(1164.5, 1436.0]",16,30,-14
31105.0,2019-11-05,"(390.054, 627.5]",3,21,-18
31105.0,2019-11-05,"(627.5, 864.0]",1,10,-9
31105.0,2019-11-05,"(864.0, 1100.5]",3,8,-5
31105.0,2019-11-05,"(1100.5, 1337.0]",7,13,-6
31106.0,2019-11-05,"(456.299, 632.25]",1,20,-19
31106.0,2019-11-05,"(982.75, 1158.0]",4,2,2
31107.0,2019-11-05,"(356.967, 616.25]",2,16,-14
31107.0,2019-11-05,"(616.25, 874.5]",7,13,-6
31107.0,2019-11-05,"(874.5, 1132.75]",15,25,-10
31107.0,2019-11-05,"(1132.75, 1391.0]",11,18,-7
31108.0,2019-11-05,"(367.961, 628.75]",12,42,-30
31108.0,2019-11-05,"(628.75, 888.5]",12,21,-9
31108.0,2019-11-05,"(888.5, 1148.25]",32,51,-19
31108.0,2019-11-05,"(1148.25, 1408.0]",16,24,-8
31109.0,2019-11-05,"(114.746, 429.5]",3,4,-1
31109.0,2019-11-05,"(429.5, 743.0]",8,30,-22
31109.0,2019-11-05,"(743.0, 1056.5]",17,23,-6
31109.0,2019-11-05,"(1056.5, 1370.0]",12,22,-10
31110.0,2019-11-05,"(352.947, 617.25]",19,42,-23
31110.0,2019-11-05,"(617.25, 880.5]",12,23,-11
31110.0,2019-11-05,"(880.5, 1143.75]",21,42,-21
31110.0,2019-11-05,"(1143.75, 1407.0]",14,23,-9
31111.0,2019-11-05,"(127.727, 447.25]",5,10,-5
31111.0,2019-11-05,"(447.25, 765.5]",8,25,-17
31111.0,2019-11-05,"(765.5, 1083.75]",11,15,-4
31111.0,2019-11-05,"(1083.75, 1402.0]",11,20,-9
31112.0,2019-11-05,"(347.959, 609.25]",1,4,-3
31112.0,2019-11-05,"(609.25, 869.5]",5,6,-1
31112.0,2019-11-05,"(869.5, 1129.75]",3,5,-2
31112.0,2019-11-05,"(1129.75, 1390.0]",1,1,0
31113.0,2019-11-05,"(565.0, 816.0]",2,15,-13
31113.0,2019-11-05,"(816.0, 1067.0]",10,5,5
31113.0,2019-11-05,"(1067.0, 1318.0]",9,14,-5
31114.0,2019-11-05,"(21.614, 369.5]",4,5,-1
31114.0,2019-11-05,"(369.5, 716.0]",4,29,-25
31114.0,2019-11-05,"(716.0, 1062.5]",13,26,-13
31114.0,2019-11-05,"(1062.5, 1409.0]",30,42,-12
31115.0,2019-11-05,"(656.25, 897.5]",1,19,-18
31115.0,2019-11-05,"(897.5, 1138.75]",11,2,9
31115.0,2019-11-05,"(1138.75, 1380.0]",14,21,-7
31116.0,2019-11-05,"(377.021, 622.75]",1,19,-18
31116.0,2019-11-05,"(622.75, 867.5]",8,13,-5
31116.0,2019-11-05,"(867.5, 1112.25]",19,23,-4
31116.0,2019-11-05,"(1112.25, 1357.0]",12,16,-4
31117.0,2019-11-05,"(305.867, 590.25]",5,23,-18
31117.0,2019-11-05,"(590.25, 873.5]",1,13,-12
31117.0,2019-11-05,"(873.5, 1156.75]",15,28,-13
31117.0,2019-11-05,"(1156.75, 1440.0]",7,13,-6
31118.0,2019-11-05,"(367.002, 617.5]",3,20,-17
31118.0,2019-11-05,"(617.5, 867.0]",2,3,-1
31118.0,2019-11-05,"(867.0, 1116.5]",12,16,-4
31118.0,2019-11-05,"(1116.5, 1366.0]",11,14,-3
31119.0,2019-11-05,"(332.932, 601.0]",2,16,-14
31119.0,2019-11-05,"(601.0, 868.0]",4,7,-3
31119.0,2019-11-05,"(868.0, 1135.0]",18,26,-8
31119.0,2019-11-05,"(1135.0, 1402.0]",10,17,-7
31120.0,2019-11-05,"(154.799, 456.25]",3,6,-3
31120.0,2019-11-05,"(456.25, 756.5]",2,20,-18
31120.0,2019-11-05,"(756.5, 1056.75]",7,10,-3
31120.0,2019-11-05,"(1056.75, 1357.0]",15,19,-4
31121.0,2019-11-05,"(393.956, 656.0]",16,26,-10
31121.0,2019-11-05,"(656.0, 917.0]",3,9,-6
31121.0,2019-11-05,"(917.0, 1178.0]",9,22,-13
31121.0,2019-11-05,"(1178.0, 1439.0]",3,8,-5
31122.0,2019-11-05,"(302.924, 573.0]",1,12,-11
31122.0,2019-11-05,"(573.0, 842.0]",2,3,-1
31122.0,2019-11-05,"(842.0, 1111.0]",3,5,-2
31122.0,2019-11-05,"(1111.0, 1380.0]",11,19,-8
31123.0,2019-11-05,"(356.997, 608.75]",1,12,-11
31123.0,2019-11-05,"(859.5, 1110.25]",8,14,-6
31123.0,2019-11-05,"(1110.25, 1361.0]",7,12,-5
31124.0,2019-11-05,"(397.977, 654.75]",16,54,-38
31124.0,2019-11-05,"(654.75, 910.5]",11,42,-31
31124.0,2019-11-05,"(910.5, 1166.25]",22,63,-41
31124.0,2019-11-05,"(1166.25, 1422.0]",14,38,-24
31125.0,2019-11-05,"(170.767, 480.25]",7,26,-19
31125.0,2019-11-05,"(480.25, 788.5]",4,10,-6
31125.0,2019-11-05,"(788.5, 1096.75]",24,36,-12
31125.0,2019-11-05,"(1096.75, 1405.0]",12,19,-7
31126.0,2019-11-05,"(347.043, 587.25]",4,26,-22
31126.0,2019-11-05,"(587.25, 826.5]",9,17,-8
31126.0,2019-11-05,"(826.5, 1065.75]",16,21,-5
31126.0,2019-11-05,"(1065.75, 1305.0]",17,28,-11
31127.0,2019-11-05,"(417.151, 630.25]",16,22,-6
31127.0,2019-11-05,"(630.25, 842.5]",14,23,-9
31127.0,2019-11-05,"(842.5, 1054.75]",4,18,-14
31127.0,2019-11-05,"(1054.75, 1267.0]",10,25,-15
31128.0,2019-11-05,"(38.627, 383.25]",3,5,-2
31128.0,2019-11-05,"(383.25, 726.5]",36,60,-24
31128.0,2019-11-05,"(726.5, 1069.75]",22,39,-17
31128.0,2019-11-05,"(1069.75, 1413.0]",15,32,-17
31129.0,2019-11-05,"(51.824, 347.0]",2,4,-2
31129.0,2019-11-05,"(347.0, 641.0]",22,27,-5
31129.0,2019-11-05,"(641.0, 935.0]",7,14,-7
31129.0,2019-11-05,"(935.0, 1229.0]",7,21,-14
31130.0,2019-11-05,"(337.974, 595.5]",6,19,-13
31130.0,2019-11-05,"(595.5, 852.0]",5,12,-7
31130.0,2019-11-05,"(852.0, 1108.5]",8,13,-5
31130.0,2019-11-05,"(1108.5, 1365.0]",18,26,-8
31131.0,2019-11-05,"(366.983, 622.25]",1,20,-19
31131.0,2019-11-05,"(622.25, 876.5]",2,3,-1
31131.0,2019-11-05,"(876.5, 1130.75]",8,15,-7
31131.0,2019-11-05,"(1130.75, 1385.0]",6,8,-2
31200.0,2019-11-05,"(336.94, 603.0]",35,61,-26
31200.0,2019-11-05,"(603.0, 868.0]",16,31,-15
31200.0,2019-11-05,"(868.0, 1133.0]",26,50,-24
31200.0,2019-11-05,"(1133.0, 1398.0]",11,29,-18
31201.0,2019-11-05,"(5.588, 360.0]",2,5,-3
31201.0,2019-11-05,"(360.0, 713.0]",26,62,-36
31201.0,2019-11-05,"(713.0, 1066.0]",40,62,-22
31201.0,2019-11-05,"(1066.0, 1419.0]",36,70,-34
31202.0,2019-11-05,"(370.0, 711.0]",15,3,12
31202.0,2019-11-05,"(711.0, 1052.0]",19,33,-14
31202.0,2019-11-05,"(1052.0, 1393.0]",22,35,-13
31203.0,2019-11-05,"(369.003, 619.25]",9,29,-20
31203.0,2019-11-05,"(619.25, 868.5]",14,28,-14
31203.0,2019-11-05,"(868.5, 1117.75]",34,49,-15
31203.0,2019-11-05,"(1117.75, 1367.0]",21,34,-13
31204.0,2019-11-05,"(52.622, 398.5]",1,1,0
31204.0,2019-11-05,"(398.5, 743.0]",19,25,-6
31204.0,2019-11-05,"(743.0, 1087.5]",7,28,-21
31204.0,2019-11-05,"(1087.5, 1432.0]",6,11,-5
31205.0,2019-11-05,"(411.167, 620.25]",36,38,-2
31205.0,2019-11-05,"(620.25, 828.5]",6,11,-5
31205.0,2019-11-05,"(828.5, 1036.75]",12,27,-15
31205.0,2019-11-05,"(1036.75, 1245.0]",14,39,-25
31206.0,2019-11-05,"(389.293, 566.75]",10,10,0
31206.0,2019-11-05,"(743.5, 920.25]",2,1,1
31206.0,2019-11-05,"(920.25, 1097.0]",2,5,-3
31207.0,2019-11-05,"(842.5, 1095.25]",2,8,-6
31207.0,2019-11-05,"(1095.25, 1348.0]",3,1,2
31208.0,2019-11-05,"(314.02, 560.0]",14,16,-2
31208.0,2019-11-05,"(560.0, 805.0]",7,16,-9
31208.0,2019-11-05,"(805.0, 1050.0]",2,18,-16
31208.0,2019-11-05,"(1050.0, 1295.0]",6,11,-5
31209.0,2019-11-05,"(381.998, 633.5]",4,6,-2
31209.0,2019-11-05,"(633.5, 884.0]",6,8,-2
31209.0,2019-11-05,"(884.0, 1134.5]",2,4,-2
31209.0,2019-11-05,"(1134.5, 1385.0]",2,3,-1
31211.0,2019-11-05,"(397.159, 608.25]",10,13,-3
31211.0,2019-11-05,"(608.25, 818.5]",1,4,-3
31211.0,2019-11-05,"(818.5, 1028.75]",8,10,-2
31211.0,2019-11-05,"(1028.75, 1239.0]",4,13,-9
31212.0,2019-11-05,"(348.944, 614.0]",47,64,-17
31212.0,2019-11-05,"(614.0, 878.0]",17,30,-13
31212.0,2019-11-05,"(878.0, 1142.0]",17,38,-21
31212.0,2019-11-05,"(1142.0, 1406.0]",7,13,-6
31213.0,2019-11-05,"(260.853, 548.75]",31,40,-9
31213.0,2019-11-05,"(548.75, 835.5]",11,24,-13
31213.0,2019-11-05,"(835.5, 1122.25]",22,52,-30
31213.0,2019-11-05,"(1122.25, 1409.0]",11,26,-15
31214.0,2019-11-05,"(10.604, 361.0]",1,3,-2
31214.0,2019-11-05,"(361.0, 710.0]",7,28,-21
31214.0,2019-11-05,"(710.0, 1059.0]",21,40,-19
31214.0,2019-11-05,"(1059.0, 1408.0]",33,51,-18
31215.0,2019-11-05,"(377.946, 642.5]",31,36,-5
31215.0,2019-11-05,"(642.5, 906.0]",15,21,-6
31215.0,2019-11-05,"(906.0, 1169.5]",14,36,-22
31216.0,2019-11-05,"(434.205, 633.75]",25,25,0
31216.0,2019-11-05,"(633.75, 832.5]",5,8,-3
31216.0,2019-11-05,"(832.5, 1031.25]",5,11,-6
31216.0,2019-11-05,"(1031.25, 1230.0]",8,30,-22
31217.0,2019-11-05,"(314.992, 568.0]",13,14,-1
31217.0,2019-11-05,"(568.0, 820.0]",2,7,-5
31217.0,2019-11-05,"(820.0, 1072.0]",8,25,-17
31217.0,2019-11-05,"(1072.0, 1324.0]",3,7,-4
31218.0,2019-11-05,"(315.147, 529.25]",21,37,-16
31218.0,2019-11-05,"(529.25, 742.5]",9,19,-10
31218.0,2019-11-05,"(742.5, 955.75]",7,12,-5
31218.0,2019-11-05,"(955.75, 1169.0]",21,40,-19
31219.0,2019-11-05,"(349.935, 617.25]",21,21,0
31219.0,2019-11-05,"(617.25, 883.5]",11,17,-6
31219.0,2019-11-05,"(883.5, 1149.75]",10,24,-14
31219.0,2019-11-05,"(1149.75, 1416.0]",2,10,-8
31220.0,2019-11-05,"(314.292, 492.0]",12,15,-3
31220.0,2019-11-05,"(492.0, 669.0]",7,8,-1
31220.0,2019-11-05,"(669.0, 846.0]",2,9,-7
31220.0,2019-11-05,"(846.0, 1023.0]",4,18,-14
31221.0,2019-11-05,"(366.189, 569.75]",28,30,-2
31221.0,2019-11-05,"(569.75, 772.5]",13,21,-8
31221.0,2019-11-05,"(772.5, 975.25]",10,16,-6
31221.0,2019-11-05,"(975.25, 1178.0]",15,42,-27
31222.0,2019-11-05,"(373.199, 574.25]",22,26,-4
31222.0,2019-11-05,"(774.5, 974.75]",2,6,-4
31222.0,2019-11-05,"(974.75, 1175.0]",4,24,-20
31223.0,2019-11-05,"(10.627, 355.25]",1,3,-2
31223.0,2019-11-05,"(355.25, 698.5]",16,43,-27
31223.0,2019-11-05,"(698.5, 1041.75]",15,31,-16
31223.0,2019-11-05,"(1041.75, 1385.0]",23,41,-18
31224.0,2019-11-05,"(402.154, 614.5]",20,21,-1
31224.0,2019-11-05,"(614.5, 826.0]",1,2,-1
31224.0,2019-11-05,"(826.0, 1037.5]",2,18,-16
31224.0,2019-11-05,"(1037.5, 1249.0]",5,15,-10
31225.0,2019-11-05,"(424.05, 662.5]",8,18,-10
31225.0,2019-11-05,"(662.5, 900.0]",21,25,-4
31225.0,2019-11-05,"(900.0, 1137.5]",13,24,-11
31225.0,2019-11-05,"(1137.5, 1375.0]",3,10,-7
31226.0,2019-11-05,"(322.911, 596.25]",3,8,-5
31226.0,2019-11-05,"(596.25, 868.5]",2,6,-4
31226.0,2019-11-05,"(868.5, 1140.75]",6,12,-6
31226.0,2019-11-05,"(1140.75, 1413.0]",4,9,-5
31227.0,2019-11-05,"(446.243, 636.25]",51,59,-8
31227.0,2019-11-05,"(636.25, 825.5]",13,20,-7
31227.0,2019-11-05,"(825.5, 1014.75]",10,19,-9
31227.0,2019-11-05,"(1014.75, 1204.0]",9,37,-28
31228.0,2019-11-05,"(12.575, 370.25]",4,7,-3
31228.0,2019-11-05,"(370.25, 726.5]",27,47,-20
31228.0,2019-11-05,"(726.5, 1082.75]",25,52,-27
31228.0,2019-11-05,"(1082.75, 1439.0]",24,50,-26
31229.0,2019-11-05,"(167.736, 485.0]",11,40,-29
31229.0,2019-11-05,"(485.0, 801.0]",17,38,-21
31229.0,2019-11-05,"(801.0, 1117.0]",50,80,-30
31229.0,2019-11-05,"(1117.0, 1433.0]",26,52,-26
31230.0,2019-11-05,"(407.078, 638.5]",60,74,-14
31230.0,2019-11-05,"(638.5, 869.0]",24,34,-10
31230.0,2019-11-05,"(869.0, 1099.5]",21,49,-28
31230.0,2019-11-05,"(1099.5, 1330.0]",5,12,-7
31231.0,2019-11-05,"(318.2, 519.0]",19,23,-4
31231.0,2019-11-05,"(519.0, 719.0]",19,24,-5
31231.0,2019-11-05,"(719.0, 919.0]",10,14,-4
31231.0,2019-11-05,"(919.0, 1119.0]",10,33,-23
31232.0,2019-11-05,"(70.695, 398.25]",1,2,-1
31232.0,2019-11-05,"(398.25, 724.5]",25,30,-5
31232.0,2019-11-05,"(724.5, 1050.75]",12,30,-18
31232.0,2019-11-05,"(1050.75, 1377.0]",15,41,-26
31233.0,2019-11-05,"(5.701, 331.75]",1,3,-2
31233.0,2019-11-05,"(331.75, 656.5]",66,73,-7
31233.0,2019-11-05,"(656.5, 981.25]",15,30,-15
31233.0,2019-11-05,"(981.25, 1306.0]",11,35,-24
31234.0,2019-11-05,"(399.014, 646.5]",21,39,-18
31234.0,2019-11-05,"(646.5, 893.0]",9,12,-3
31234.0,2019-11-05,"(893.0, 1139.5]",22,42,-20
31234.0,2019-11-05,"(1139.5, 1386.0]",7,25,-18
31235.0,2019-11-05,"(382.992, 636.0]",12,14,-2
31235.0,2019-11-05,"(636.0, 888.0]",8,10,-2
31235.0,2019-11-05,"(888.0, 1140.0]",4,13,-9
31236.0,2019-11-05,"(408.013, 655.75]",18,23,-5
31236.0,2019-11-05,"(655.75, 902.5]",10,20,-10
31236.0,2019-11-05,"(902.5, 1149.25]",12,30,-18
31236.0,2019-11-05,"(1149.25, 1396.0]",2,11,-9
31237.0,2019-11-05,"(12.588, 367.0]",1,2,-1
31237.0,2019-11-05,"(367.0, 720.0]",14,30,-16
31237.0,2019-11-05,"(720.0, 1073.0]",21,39,-18
31237.0,2019-11-05,"(1073.0, 1426.0]",12,31,-19
31238.0,2019-11-05,"(331.015, 578.25]",26,31,-5
31238.0,2019-11-05,"(578.25, 824.5]",8,16,-8
31238.0,2019-11-05,"(824.5, 1070.75]",8,35,-27
31238.0,2019-11-05,"(1070.75, 1317.0]",9,20,-11
31239.0,2019-11-05,"(335.056, 572.0]",26,30,-4
31239.0,2019-11-05,"(572.0, 808.0]",3,8,-5
31239.0,2019-11-05,"(808.0, 1044.0]",12,21,-9
31239.0,2019-11-05,"(1044.0, 1280.0]",8,32,-24
31240.0,2019-11-05,"(377.384, 532.0]",2,4,-2
31240.0,2019-11-05,"(532.0, 686.0]",6,11,-5
31240.0,2019-11-05,"(686.0, 840.0]",3,6,-3
31240.0,2019-11-05,"(840.0, 994.0]",1,3,-2
31241.0,2019-11-05,"(36.604, 387.0]",3,6,-3
31241.0,2019-11-05,"(387.0, 736.0]",31,77,-46
31241.0,2019-11-05,"(736.0, 1085.0]",18,47,-29
31241.0,2019-11-05,"(1085.0, 1434.0]",25,60,-35
31242.0,2019-11-05,"(409.297, 585.75]",28,29,-1
31242.0,2019-11-05,"(585.75, 761.5]",1,5,-4
31242.0,2019-11-05,"(761.5, 937.25]",5,11,-6
31242.0,2019-11-05,"(937.25, 1113.0]",4,31,-27
31243.0,2019-11-05,"(350.015, 597.25]",36,45,-9
31243.0,2019-11-05,"(597.25, 843.5]",9,13,-4
31243.0,2019-11-05,"(843.5, 1089.75]",15,48,-33
31243.0,2019-11-05,"(1089.75, 1336.0]",1,14,-13
31244.0,2019-11-05,"(180.845, 470.75]",6,13,-7
31244.0,2019-11-05,"(470.75, 759.5]",20,37,-17
31244.0,2019-11-05,"(759.5, 1048.25]",13,31,-18
31244.0,2019-11-05,"(1048.25, 1337.0]",14,21,-7
31245.0,2019-11-05,"(386.964, 647.0]",12,28,-16
31245.0,2019-11-05,"(647.0, 906.0]",7,12,-5
31245.0,2019-11-05,"(906.0, 1165.0]",22,43,-21
31245.0,2019-11-05,"(1165.0, 1424.0]",11,18,-7
31246.0,2019-11-05,"(7.569, 366.75]",1,1,0
31246.0,2019-11-05,"(366.75, 724.5]",29,51,-22
31246.0,2019-11-05,"(724.5, 1082.25]",16,34,-18
31246.0,2019-11-05,"(1082.25, 1440.0]",15,30,-15
31247.0,2019-11-05,"(423.172, 631.0]",18,27,-9
31247.0,2019-11-05,"(631.0, 838.0]",19,45,-26
31247.0,2019-11-05,"(838.0, 1045.0]",22,57,-35
31247.0,2019-11-05,"(1045.0, 1252.0]",5,11,-6
31248.0,2019-11-05,"(346.097, 572.75]",14,26,-12
31248.0,2019-11-05,"(572.75, 798.5]",8,18,-10
31248.0,2019-11-05,"(798.5, 1024.25]",24,43,-19
31248.0,2019-11-05,"(1024.25, 1250.0]",10,16,-6
31249.0,2019-11-05,"(370.14, 586.0]",16,31,-15
31249.0,2019-11-05,"(586.0, 801.0]",10,22,-12
31249.0,2019-11-05,"(801.0, 1016.0]",6,14,-8
31249.0,2019-11-05,"(1016.0, 1231.0]",17,28,-11
31250.0,2019-11-05,"(417.041, 657.75]",25,31,-6
31250.0,2019-11-05,"(657.75, 897.5]",3,9,-6
31250.0,2019-11-05,"(897.5, 1137.25]",9,33,-24
31250.0,2019-11-05,"(1137.25, 1377.0]",4,8,-4
31251.0,2019-11-05,"(244.821, 540.75]",20,41,-21
31251.0,2019-11-05,"(540.75, 835.5]",12,23,-11
31251.0,2019-11-05,"(835.5, 1130.25]",15,35,-20
31251.0,2019-11-05,"(1130.25, 1425.0]",13,23,-10
31252.0,2019-11-05,"(401.148, 615.0]",20,22,-2
31252.0,2019-11-05,"(615.0, 828.0]",2,6,-4
31252.0,2019-11-05,"(828.0, 1041.0]",7,18,-11
31252.0,2019-11-05,"(1041.0, 1254.0]",4,20,-16
31253.0,2019-11-05,"(389.231, 582.25]",24,25,-1
31253.0,2019-11-05,"(582.25, 774.5]",7,15,-8
31253.0,2019-11-05,"(774.5, 966.75]",2,3,-1
31253.0,2019-11-05,"(966.75, 1159.0]",5,32,-27
31254.0,2019-11-05,"(412.176, 619.0]",22,25,-3
31254.0,2019-11-05,"(619.0, 825.0]",8,12,-4
31254.0,2019-11-05,"(825.0, 1031.0]",1,13,-12
31254.0,2019-11-05,"(1031.0, 1237.0]",4,19,-15
31255.0,2019-11-05,"(363.119, 584.25]",17,25,-8
31255.0,2019-11-05,"(584.25, 804.5]",8,14,-6
31255.0,2019-11-05,"(804.5, 1024.75]",6,16,-10
31255.0,2019-11-05,"(1024.75, 1245.0]",7,21,-14
31256.0,2019-11-05,"(297.95, 561.5]",14,17,-3
31256.0,2019-11-05,"(561.5, 824.0]",8,16,-8
31256.0,2019-11-05,"(824.0, 1086.5]",7,22,-15
31256.0,2019-11-05,"(1086.5, 1349.0]",14,31,-17
31257.0,2019-11-05,"(4.603, 355.25]",1,2,-1
31257.0,2019-11-05,"(355.25, 704.5]",27,45,-18
31257.0,2019-11-05,"(704.5, 1053.75]",24,47,-23
31257.0,2019-11-05,"(1053.75, 1403.0]",17,40,-23
31258.0,2019-11-05,"(341.074, 573.5]",5,9,-4
31258.0,2019-11-05,"(573.5, 805.0]",8,17,-9
31258.0,2019-11-05,"(805.0, 1036.5]",14,36,-22
31258.0,2019-11-05,"(1036.5, 1268.0]",4,11,-7
31259.0,2019-11-05,"(403.145, 617.75]",14,15,-1
31259.0,2019-11-05,"(831.5, 1045.25]",2,2,0
31259.0,2019-11-05,"(1045.25, 1259.0]",2,8,-6
31260.0,2019-11-05,"(349.956, 612.0]",24,34,-10
31260.0,2019-11-05,"(612.0, 873.0]",2,3,-1
31260.0,2019-11-05,"(873.0, 1134.0]",11,32,-21
31260.0,2019-11-05,"(1134.0, 1395.0]",7,15,-8
31261.0,2019-11-05,"(438.007, 687.25]",16,18,-2
31261.0,2019-11-05,"(687.25, 935.5]",3,8,-5
31261.0,2019-11-05,"(935.5, 1183.75]",2,11,-9
31262.0,2019-11-05,"(324.168, 533.0]",10,11,-1
31262.0,2019-11-05,"(533.0, 741.0]",6,8,-2
31262.0,2019-11-05,"(741.0, 949.0]",4,6,-2
31262.0,2019-11-05,"(949.0, 1157.0]",5,25,-20
31263.0,2019-11-05,"(357.059, 593.25]",32,56,-24
31263.0,2019-11-05,"(593.25, 828.5]",12,19,-7
31263.0,2019-11-05,"(828.5, 1063.75]",15,34,-19
31263.0,2019-11-05,"(1063.75, 1299.0]",10,26,-16
31264.0,2019-11-05,"(418.099, 644.25]",21,29,-8
31264.0,2019-11-05,"(644.25, 869.5]",10,18,-8
31264.0,2019-11-05,"(869.5, 1094.75]",4,14,-10
31264.0,2019-11-05,"(1094.75, 1320.0]",7,15,-8
31265.0,2019-11-05,"(48.614, 396.5]",3,5,-2
31265.0,2019-11-05,"(396.5, 743.0]",18,43,-25
31265.0,2019-11-05,"(743.0, 1089.5]",20,34,-14
31265.0,2019-11-05,"(1089.5, 1436.0]",25,50,-25
31266.0,2019-11-05,"(26.605, 376.75]",2,7,-5
31266.0,2019-11-05,"(376.75, 725.5]",8,36,-28
31266.0,2019-11-05,"(725.5, 1074.25]",16,32,-16
31266.0,2019-11-05,"(1074.25, 1423.0]",27,46,-19
31267.0,2019-11-05,"(10.647, 350.25]",2,4,-2
31267.0,2019-11-05,"(350.25, 688.5]",35,66,-31
31267.0,2019-11-05,"(688.5, 1026.75]",19,36,-17
31267.0,2019-11-05,"(1026.75, 1365.0]",22,59,-37
31268.0,2019-11-05,"(123.745, 438.75]",5,11,-6
31268.0,2019-11-05,"(438.75, 752.5]",14,52,-38
31268.0,2019-11-05,"(752.5, 1066.25]",15,27,-12
31268.0,2019-11-05,"(1066.25, 1380.0]",32,50,-18
31269.0,2019-11-05,"(289.867, 574.25]",10,17,-7
31269.0,2019-11-05,"(574.25, 857.5]",11,25,-14
31269.0,2019-11-05,"(857.5, 1140.75]",10,22,-12
31269.0,2019-11-05,"(1140.75, 1424.0]",3,11,-8
31270.0,2019-11-05,"(4.675, 337.25]",1,2,-1
31270.0,2019-11-05,"(337.25, 668.5]",25,39,-14
31270.0,2019-11-05,"(668.5, 999.75]",12,25,-13
31270.0,2019-11-05,"(999.75, 1331.0]",11,29,-18
31271.0,2019-11-05,"(386.96, 648.0]",26,32,-6
31271.0,2019-11-05,"(648.0, 908.0]",6,13,-7
31271.0,2019-11-05,"(908.0, 1168.0]",18,45,-27
31272.0,2019-11-05,"(1.738, 318.5]",2,3,-1
31272.0,2019-11-05,"(318.5, 634.0]",33,37,-4
31272.0,2019-11-05,"(634.0, 949.5]",9,27,-18
31272.0,2019-11-05,"(949.5, 1265.0]",6,17,-11
31273.0,2019-11-05,"(351.982, 607.5]",1,5,-4
31273.0,2019-11-05,"(607.5, 862.0]",5,9,-4
31273.0,2019-11-05,"(862.0, 1116.5]",6,9,-3
31273.0,2019-11-05,"(1116.5, 1371.0]",3,4,-1
31274.0,2019-11-05,"(331.0, 616.0]",17,1,16
31274.0,2019-11-05,"(616.0, 901.0]",7,21,-14
31274.0,2019-11-05,"(901.0, 1186.0]",7,12,-5
31275.0,2019-11-05,"(29.689, 358.75]",5,7,-2
31275.0,2019-11-05,"(358.75, 686.5]",26,52,-26
31275.0,2019-11-05,"(686.5, 1014.25]",16,31,-15
31275.0,2019-11-05,"(1014.25, 1342.0]",19,43,-24
31276.0,2019-11-05,"(404.182, 609.5]",32,36,-4
31276.0,2019-11-05,"(609.5, 814.0]",4,15,-11
31276.0,2019-11-05,"(814.0, 1018.5]",9,23,-14
31276.0,2019-11-05,"(1018.5, 1223.0]",7,21,-14
31277.0,2019-11-05,"(330.216, 527.0]",33,37,-4
31277.0,2019-11-05,"(527.0, 723.0]",17,27,-10
31277.0,2019-11-05,"(723.0, 919.0]",26,44,-18
31277.0,2019-11-05,"(919.0, 1115.0]",6,30,-24
31278.0,2019-11-05,"(66.695, 394.25]",1,1,0
31278.0,2019-11-05,"(394.25, 720.5]",11,40,-29
31278.0,2019-11-05,"(720.5, 1046.75]",9,15,-6
31278.0,2019-11-05,"(1046.75, 1373.0]",28,44,-16
31279.0,2019-11-05,"(374.177, 580.75]",24,25,-1
31279.0,2019-11-05,"(580.75, 786.5]",4,12,-8
31279.0,2019-11-05,"(786.5, 992.25]",12,26,-14
31279.0,2019-11-05,"(992.25, 1198.0]",8,33,-25
31280.0,2019-11-05,"(40.639, 382.25]",1,4,-3
31280.0,2019-11-05,"(382.25, 722.5]",9,29,-20
31280.0,2019-11-05,"(722.5, 1062.75]",8,16,-8
31280.0,2019-11-05,"(1062.75, 1403.0]",12,16,-4
31000.0,2019-11-06,"(949.25, 1101.0]",3,1,2
31001.0,2019-11-06,"(1150.75, 1192.0]",1,3,-2
31002.0,2019-11-06,"(462.194, 664.5]",4,6,-2
31002.0,2019-11-06,"(664.5, 866.0]",1,1,0
31002.0,2019-11-06,"(866.0, 1067.5]",4,11,-7
31002.0,2019-11-06,"(1067.5, 1269.0]",1,3,-2
31003.0,2019-11-06,"(545.461, 680.75]",5,9,-4
31003.0,2019-11-06,"(680.75, 815.5]",1,3,-2
31003.0,2019-11-06,"(815.5, 950.25]",1,1,0
31003.0,2019-11-06,"(950.25, 1085.0]",5,10,-5
31004.0,2019-11-06,"(657.0, 871.0]",1,4,-3
31004.0,2019-11-06,"(871.0, 1085.0]",2,3,-1
31004.0,2019-11-06,"(1085.0, 1299.0]",3,3,0
31005.0,2019-11-06,"(393.098, 619.5]",6,10,-4
31005.0,2019-11-06,"(619.5, 845.0]",7,8,-1
31005.0,2019-11-06,"(845.0, 1070.5]",5,14,-9
31005.0,2019-11-06,"(1070.5, 1296.0]",4,11,-7
31006.0,2019-11-06,"(850.0, 1078.0]",5,3,2
31006.0,2019-11-06,"(1078.0, 1306.0]",6,1,5
31007.0,2019-11-06,"(353.937, 620.75]",15,33,-18
31007.0,2019-11-06,"(620.75, 886.5]",3,6,-3
31007.0,2019-11-06,"(886.5, 1152.25]",12,27,-15
31007.0,2019-11-06,"(1152.25, 1418.0]",5,8,-3
31009.0,2019-11-06,"(429.162, 639.5]",4,4,0
31009.0,2019-11-06,"(1058.5, 1268.0]",2,1,1
31010.0,2019-11-06,"(548.144, 763.0]",2,5,-3
31010.0,2019-11-06,"(763.0, 977.0]",2,3,-1
31010.0,2019-11-06,"(977.0, 1191.0]",2,3,-1
31010.0,2019-11-06,"(1191.0, 1405.0]",1,4,-3
31011.0,2019-11-06,"(314.035, 556.25]",6,7,-1
31011.0,2019-11-06,"(556.25, 797.5]",6,9,-3
31011.0,2019-11-06,"(797.5, 1038.75]",3,7,-4
31011.0,2019-11-06,"(1038.75, 1280.0]",4,8,-4
31012.0,2019-11-06,"(358.232, 551.0]",8,9,-1
31012.0,2019-11-06,"(551.0, 743.0]",2,3,-1
31012.0,2019-11-06,"(743.0, 935.0]",1,1,0
31012.0,2019-11-06,"(935.0, 1127.0]",2,9,-7
31013.0,2019-11-06,"(972.0, 1157.0]",7,6,1
31014.0,2019-11-06,"(391.017, 637.75]",30,37,-7
31014.0,2019-11-06,"(637.75, 883.5]",7,12,-5
31014.0,2019-11-06,"(883.5, 1129.25]",8,21,-13
31014.0,2019-11-06,"(1129.25, 1375.0]",5,10,-5
31015.0,2019-11-06,"(8.602, 359.5]",2,2,0
31015.0,2019-11-06,"(359.5, 709.0]",14,16,-2
31015.0,2019-11-06,"(709.0, 1058.5]",8,15,-7
31016.0,2019-11-06,"(282.916, 555.0]",8,14,-6
31016.0,2019-11-06,"(555.0, 826.0]",1,5,-4
31016.0,2019-11-06,"(826.0, 1097.0]",9,13,-4
31016.0,2019-11-06,"(1097.0, 1368.0]",4,10,-6
31017.0,2019-11-06,"(471.071, 704.25]",5,8,-3
31017.0,2019-11-06,"(704.25, 936.5]",1,4,-3
31017.0,2019-11-06,"(1168.75, 1401.0]",2,7,-5
31018.0,2019-11-06,"(397.269, 580.75]",2,8,-6
31018.0,2019-11-06,"(763.5, 946.25]",1,2,-1
31018.0,2019-11-06,"(946.25, 1129.0]",5,7,-2
31019.0,2019-11-06,"(1011.5, 1173.75]",2,2,0
31019.0,2019-11-06,"(1173.75, 1336.0]",2,2,0
31020.0,2019-11-06,"(482.0, 713.0]",2,1,1
31020.0,2019-11-06,"(713.0, 944.0]",1,1,0
31021.0,2019-11-06,"(376.173, 583.75]",1,6,-5
31021.0,2019-11-06,"(583.75, 790.5]",2,3,-1
31021.0,2019-11-06,"(790.5, 997.25]",1,2,-1
31021.0,2019-11-06,"(997.25, 1204.0]",1,4,-3
31022.0,2019-11-06,"(21.644, 362.0]",1,1,0
31022.0,2019-11-06,"(362.0, 701.0]",4,8,-4
31022.0,2019-11-06,"(701.0, 1040.0]",10,16,-6
31022.0,2019-11-06,"(1040.0, 1379.0]",3,14,-11
31023.0,2019-11-06,"(406.139, 622.25]",2,4,-2
31023.0,2019-11-06,"(622.25, 837.5]",2,4,-2
31023.0,2019-11-06,"(837.5, 1052.75]",1,2,-1
31023.0,2019-11-06,"(1052.75, 1268.0]",1,6,-5
31024.0,2019-11-06,"(411.077, 642.75]",7,14,-7
31024.0,2019-11-06,"(642.75, 873.5]",2,6,-4
31024.0,2019-11-06,"(873.5, 1104.25]",3,8,-5
31024.0,2019-11-06,"(1104.25, 1335.0]",2,4,-2
31025.0,2019-11-06,"(493.202, 693.5]",1,2,-1
31025.0,2019-11-06,"(1092.5, 1292.0]",3,1,2
31026.0,2019-11-06,"(26.693, 354.75]",1,2,-1
31026.0,2019-11-06,"(354.75, 681.5]",2,3,-1
31026.0,2019-11-06,"(681.5, 1008.25]",1,3,-2
31026.0,2019-11-06,"(1008.25, 1335.0]",2,8,-6
31027.0,2019-11-06,"(554.4, 705.0]",1,3,-2
31027.0,2019-11-06,"(855.0, 1005.0]",1,3,-2
31027.0,2019-11-06,"(1005.0, 1155.0]",2,3,-1
31028.0,2019-11-06,"(431.067, 665.25]",3,3,0
31028.0,2019-11-06,"(898.5, 1131.75]",1,1,0
31029.0,2019-11-06,"(663.5, 918.0]",1,10,-9
31029.0,2019-11-06,"(918.0, 1172.5]",6,3,3
31029.0,2019-11-06,"(1172.5, 1427.0]",4,7,-3
31030.0,2019-11-06,"(440.036, 682.0]",2,12,-10
31030.0,2019-11-06,"(923.0, 1164.0]",7,3,4
31030.0,2019-11-06,"(1164.0, 1405.0]",2,10,-8
31031.0,2019-11-06,"(610.5, 868.0]",1,6,-5
31031.0,2019-11-06,"(868.0, 1125.5]",1,1,0
31031.0,2019-11-06,"(1125.5, 1383.0]",3,5,-2
31032.0,2019-11-06,"(638.0, 865.0]",1,2,-1
31032.0,2019-11-06,"(1092.0, 1319.0]",2,4,-2
31033.0,2019-11-06,"(1011.75, 1349.0]",2,1,1
31034.0,2019-11-06,"(393.097, 619.75]",2,6,-4
31034.0,2019-11-06,"(619.75, 845.5]",1,1,0
31034.0,2019-11-06,"(845.5, 1071.25]",1,5,-4
31034.0,2019-11-06,"(1071.25, 1297.0]",2,5,-3
31035.0,2019-11-06,"(423.16, 634.0]",1,6,-5
31035.0,2019-11-06,"(844.0, 1054.0]",2,5,-3
31035.0,2019-11-06,"(1054.0, 1264.0]",2,6,-4
31036.0,2019-11-06,"(409.154, 621.5]",1,7,-6
31036.0,2019-11-06,"(833.0, 1044.5]",2,3,-1
31036.0,2019-11-06,"(1044.5, 1256.0]",3,3,0
31037.0,2019-11-06,"(413.01, 661.5]",20,26,-6
31037.0,2019-11-06,"(661.5, 909.0]",3,5,-2
31037.0,2019-11-06,"(909.0, 1156.5]",8,21,-13
31037.0,2019-11-06,"(1156.5, 1404.0]",1,5,-4
31038.0,2019-11-06,"(385.043, 625.25]",3,6,-3
31038.0,2019-11-06,"(864.5, 1103.75]",2,2,0
31038.0,2019-11-06,"(1103.75, 1343.0]",1,3,-2
31039.0,2019-11-06,"(460.209, 658.75]",4,13,-9
31039.0,2019-11-06,"(658.75, 856.5]",5,6,-1
31039.0,2019-11-06,"(856.5, 1054.25]",2,5,-3
31039.0,2019-11-06,"(1054.25, 1252.0]",2,6,-4
31040.0,2019-11-06,"(460.134, 677.5]",4,5,-1
31040.0,2019-11-06,"(677.5, 894.0]",1,1,0
31040.0,2019-11-06,"(1110.5, 1327.0]",1,2,-1
31041.0,2019-11-06,"(430.179, 636.25]",3,4,-1
31041.0,2019-11-06,"(636.25, 841.5]",1,2,-1
31041.0,2019-11-06,"(841.5, 1046.75]",2,3,-1
31041.0,2019-11-06,"(1046.75, 1252.0]",1,4,-3
31042.0,2019-11-06,"(441.094, 668.5]",12,15,-3
31042.0,2019-11-06,"(668.5, 895.0]",2,4,-2
31042.0,2019-11-06,"(895.0, 1121.5]",2,14,-12
31043.0,2019-11-06,"(412.308, 586.0]",1,2,-1
31043.0,2019-11-06,"(759.0, 932.0]",3,5,-2
31043.0,2019-11-06,"(932.0, 1105.0]",3,5,-2
31044.0,2019-11-06,"(564.265, 748.75]",3,5,-2
31044.0,2019-11-06,"(748.75, 932.5]",1,1,0
31044.0,2019-11-06,"(1116.25, 1300.0]",1,2,-1
31045.0,2019-11-06,"(12.948, 277.0]",1,1,0
31045.0,2019-11-06,"(540.0, 803.0]",2,1,1
31045.0,2019-11-06,"(803.0, 1066.0]",3,3,0
31046.0,2019-11-06,"(396.296, 573.0]",2,5,-3
31046.0,2019-11-06,"(573.0, 749.0]",1,3,-2
31046.0,2019-11-06,"(749.0, 925.0]",1,3,-2
31046.0,2019-11-06,"(925.0, 1101.0]",3,5,-2
31047.0,2019-11-06,"(402.076, 634.0]",11,23,-12
31047.0,2019-11-06,"(634.0, 865.0]",5,6,-1
31047.0,2019-11-06,"(865.0, 1096.0]",5,19,-14
31047.0,2019-11-06,"(1096.0, 1327.0]",4,13,-9
31048.0,2019-11-06,"(474.277, 655.75]",5,7,-2
31048.0,2019-11-06,"(836.5, 1017.25]",3,1,2
31048.0,2019-11-06,"(1017.25, 1198.0]",3,4,-1
31049.0,2019-11-06,"(667.25, 863.5]",1,4,-3
31049.0,2019-11-06,"(863.5, 1059.75]",2,1,1
31049.0,2019-11-06,"(1059.75, 1256.0]",1,5,-4
31050.0,2019-11-06,"(709.0, 860.5]",1,5,-4
31050.0,2019-11-06,"(860.5, 1012.0]",2,1,1
31051.0,2019-11-06,"(521.25, 738.5]",1,3,-2
31051.0,2019-11-06,"(738.5, 955.75]",4,4,0
31051.0,2019-11-06,"(955.75, 1173.0]",3,7,-4
31052.0,2019-11-06,"(506.324, 676.0]",3,4,-1
31052.0,2019-11-06,"(676.0, 845.0]",1,1,0
31052.0,2019-11-06,"(1014.0, 1183.0]",2,6,-4
31053.0,2019-11-06,"(1187.75, 1339.0]",2,1,1
,,,,2.0,
31055.0,2019-11-06,"(345.213, 542.75]",2,5,-3
31055.0,2019-11-06,"(542.75, 739.5]",1,2,-1
31055.0,2019-11-06,"(739.5, 936.25]",1,2,-1
31055.0,2019-11-06,"(936.25, 1133.0]",5,7,-2
31056.0,2019-11-06,"(472.396, 624.0]",1,2,-1
31056.0,2019-11-06,"(926.0, 1077.0]",1,3,-2
31057.0,2019-11-06,"(774.744, 839.0]",1,1,0
31057.0,2019-11-06,"(839.0, 903.0]",1,2,-1
31057.0,2019-11-06,"(967.0, 1031.0]",1,2,-1
,,,,1.0,
,,,,1.0,
31059.0,2019-11-06,"(909.5, 1074.0]",2,1,1
31060.0,2019-11-06,"(899.0, 984.0]",1,1,0
31061.0,2019-11-06,"(504.489, 632.75]",1,2,-1
31061.0,2019-11-06,"(888.25, 1016.0]",1,1,0
31062.0,2019-11-06,"(450.417, 596.75]",1,2,-1
31062.0,2019-11-06,"(596.75, 742.5]",2,2,0
31062.0,2019-11-06,"(742.5, 888.25]",1,4,-3
31062.0,2019-11-06,"(888.25, 1034.0]",4,9,-5
31063.0,2019-11-06,"(688.5, 918.0]",1,1,0
31064.0,2019-11-06,"(433.258, 619.5]",4,9,-5
31064.0,2019-11-06,"(619.5, 805.0]",1,2,-1
31064.0,2019-11-06,"(805.0, 990.5]",3,6,-3
31064.0,2019-11-06,"(990.5, 1176.0]",6,12,-6
31065.0,2019-11-06,"(573.75, 775.5]",1,3,-2
31065.0,2019-11-06,"(977.25, 1179.0]",3,2,1
31066.0,2019-11-06,"(575.5, 619.75]",1,2,-1
31066.0,2019-11-06,"(619.75, 664.0]",1,1,0
31067.0,2019-11-06,"(415.069, 648.75]",2,5,-3
31067.0,2019-11-06,"(881.5, 1114.25]",2,4,-2
31067.0,2019-11-06,"(1114.25, 1347.0]",1,1,0
31068.0,2019-11-06,"(966.0, 1160.0]",3,1,2
31068.0,2019-11-06,"(1160.0, 1354.0]",1,1,0
31069.0,2019-11-06,"(350.5, 682.0]",1,1,0
31069.0,2019-11-06,"(682.0, 1013.5]",3,8,-5
31069.0,2019-11-06,"(1013.5, 1345.0]",7,4,3
31070.0,2019-11-06,"(940.75, 1087.0]",2,3,-1
31071.0,2019-11-06,"(308.045, 547.75]",3,8,-5
31071.0,2019-11-06,"(547.75, 786.5]",2,6,-4
31071.0,2019-11-06,"(786.5, 1025.25]",8,13,-5
31071.0,2019-11-06,"(1025.25, 1264.0]",5,14,-9
31072.0,2019-11-06,"(747.0, 884.0]",1,2,-1
31073.0,2019-11-06,"(454.368, 613.0]",1,1,0
31073.0,2019-11-06,"(929.0, 1087.0]",4,8,-4
31074.0,2019-11-06,"(421.146, 635.5]",1,3,-2
31074.0,2019-11-06,"(635.5, 849.0]",1,2,-1
31074.0,2019-11-06,"(1062.5, 1276.0]",3,2,1
31075.0,2019-11-06,"(615.5, 781.0]",1,2,-1
31075.0,2019-11-06,"(946.5, 1112.0]",3,2,1
31076.0,2019-11-06,"(422.086, 651.5]",1,1,0
31076.0,2019-11-06,"(651.5, 880.0]",1,2,-1
31076.0,2019-11-06,"(880.0, 1108.5]",2,2,0
31076.0,2019-11-06,"(1108.5, 1337.0]",1,3,-2
31077.0,2019-11-06,"(481.072, 714.0]",2,10,-8
31077.0,2019-11-06,"(714.0, 946.0]",11,18,-7
31077.0,2019-11-06,"(946.0, 1178.0]",12,22,-10
31077.0,2019-11-06,"(1178.0, 1410.0]",2,2,0
31078.0,2019-11-06,"(464.41, 612.5]",8,8,0
31078.0,2019-11-06,"(612.5, 760.0]",1,5,-4
31079.0,2019-11-06,"(57.654, 395.5]",1,1,0
31079.0,2019-11-06,"(395.5, 732.0]",1,12,-11
31079.0,2019-11-06,"(1068.5, 1405.0]",5,5,0
31080.0,2019-11-06,"(23.904, 299.0]",1,1,0
31080.0,2019-11-06,"(847.0, 1121.0]",5,8,-3
31081.0,2019-11-06,"(557.435, 699.25]",2,3,-1
31081.0,2019-11-06,"(699.25, 840.5]",2,3,-1
31081.0,2019-11-06,"(981.75, 1123.0]",2,1,1
31082.0,2019-11-06,"(718.515, 840.25]",1,2,-1
31082.0,2019-11-06,"(1082.75, 1204.0]",2,1,1
31083.0,2019-11-06,"(400.251, 588.25]",1,4,-3
31083.0,2019-11-06,"(775.5, 962.75]",1,3,-2
31083.0,2019-11-06,"(962.75, 1150.0]",4,5,-1
31084.0,2019-11-06,"(336.5, 665.0]",5,1,4
31084.0,2019-11-06,"(665.0, 993.5]",2,7,-5
31084.0,2019-11-06,"(993.5, 1322.0]",3,5,-2
31085.0,2019-11-06,"(401.287, 580.25]",1,4,-3
31085.0,2019-11-06,"(936.75, 1115.0]",3,1,2
31086.0,2019-11-06,"(759.5, 941.75]",1,3,-2
31086.0,2019-11-06,"(941.75, 1124.0]",6,2,4
31087.0,2019-11-06,"(417.328, 586.0]",3,5,-2
31087.0,2019-11-06,"(922.0, 1090.0]",5,6,-1
31088.0,2019-11-06,"(661.0, 915.0]",2,4,-2
31088.0,2019-11-06,"(915.0, 1169.0]",9,4,5
31088.0,2019-11-06,"(1169.0, 1423.0]",3,10,-7
31089.0,2019-11-06,"(478.271, 661.25]",10,17,-7
31089.0,2019-11-06,"(661.25, 843.5]",3,6,-3
31089.0,2019-11-06,"(843.5, 1025.75]",1,6,-5
31089.0,2019-11-06,"(1025.75, 1208.0]",5,11,-6
31090.0,2019-11-06,"(725.0, 879.0]",1,2,-1
31090.0,2019-11-06,"(879.0, 1033.0]",1,2,-1
31091.0,2019-11-06,"(826.5, 1026.75]",1,3,-2
31091.0,2019-11-06,"(1026.75, 1227.0]",6,1,5
31092.0,2019-11-06,"(863.25, 1005.0]",1,1,0
31093.0,2019-11-06,"(606.5, 812.0]",1,7,-6
31093.0,2019-11-06,"(812.0, 1017.5]",1,1,0
31093.0,2019-11-06,"(1017.5, 1223.0]",2,4,-2
31094.0,2019-11-06,"(846.748, 910.0]",1,2,-1
31095.0,2019-11-06,"(952.75, 980.5]",1,2,-1
31095.0,2019-11-06,"(1008.25, 1036.0]",1,1,0
31096.0,2019-11-06,"(795.0, 1060.0]",2,1,1
31097.0,2019-11-06,"(432.027, 676.25]",2,3,-1
31097.0,2019-11-06,"(676.25, 919.5]",1,3,-2
31097.0,2019-11-06,"(919.5, 1162.75]",5,9,-4
31098.0,2019-11-06,"(412.117, 633.75]",9,15,-6
31098.0,2019-11-06,"(854.5, 1075.25]",8,12,-4
31098.0,2019-11-06,"(1075.25, 1296.0]",2,8,-6
31099.0,2019-11-06,"(453.349, 616.75]",1,3,-2
31099.0,2019-11-06,"(942.25, 1105.0]",3,3,0
31100.0,2019-11-06,"(409.008, 658.0]",18,22,-4
31100.0,2019-11-06,"(658.0, 906.0]",7,7,0
31100.0,2019-11-06,"(906.0, 1154.0]",5,24,-19
31100.0,2019-11-06,"(1154.0, 1402.0]",1,2,-1
31101.0,2019-11-06,"(14.597, 366.75]",1,7,-6
31101.0,2019-11-06,"(366.75, 717.5]",18,55,-37
31101.0,2019-11-06,"(717.5, 1068.25]",33,64,-31
31101.0,2019-11-06,"(1068.25, 1419.0]",45,78,-33
31102.0,2019-11-06,"(353.135, 570.25]",3,31,-28
31102.0,2019-11-06,"(786.5, 1002.75]",2,11,-9
31102.0,2019-11-06,"(1002.75, 1219.0]",15,20,-5
31103.0,2019-11-06,"(34.646, 374.5]",2,8,-6
31103.0,2019-11-06,"(374.5, 713.0]",1,36,-35
31103.0,2019-11-06,"(713.0, 1051.5]",6,31,-25
31103.0,2019-11-06,"(1051.5, 1390.0]",14,30,-16
31104.0,2019-11-06,"(341.25, 681.5]",5,7,-2
31104.0,2019-11-06,"(681.5, 1021.75]",6,13,-7
31104.0,2019-11-06,"(1021.75, 1362.0]",28,13,15
31105.0,2019-11-06,"(432.142, 647.5]",4,25,-21
31105.0,2019-11-06,"(862.0, 1076.5]",2,5,-3
31105.0,2019-11-06,"(1076.5, 1291.0]",2,11,-9
31106.0,2019-11-06,"(428.239, 619.25]",3,20,-17
31106.0,2019-11-06,"(619.25, 809.5]",1,8,-7
31106.0,2019-11-06,"(999.75, 1190.0]",4,2,2
31107.0,2019-11-06,"(388.008, 637.0]",3,24,-21
31107.0,2019-11-06,"(637.0, 885.0]",2,4,-2
31107.0,2019-11-06,"(885.0, 1133.0]",20,30,-10
31107.0,2019-11-06,"(1133.0, 1381.0]",14,24,-10
31108.0,2019-11-06,"(75.661, 411.75]",2,7,-5
31108.0,2019-11-06,"(411.75, 746.5]",17,44,-27
31108.0,2019-11-06,"(746.5, 1081.25]",35,59,-24
31108.0,2019-11-06,"(1081.25, 1416.0]",22,31,-9
31109.0,2019-11-06,"(371.25, 726.5]",12,2,10
31109.0,2019-11-06,"(726.5, 1081.75]",17,33,-16
31109.0,2019-11-06,"(1081.75, 1437.0]",20,31,-11
31110.0,2019-11-06,"(349.959, 611.25]",23,51,-28
31110.0,2019-11-06,"(611.25, 871.5]",4,8,-4
31110.0,2019-11-06,"(871.5, 1131.75]",24,42,-18
31110.0,2019-11-06,"(1131.75, 1392.0]",11,24,-13
31111.0,2019-11-06,"(12.615, 360.25]",1,1,0
31111.0,2019-11-06,"(360.25, 706.5]",13,34,-21
31111.0,2019-11-06,"(706.5, 1052.75]",11,17,-6
31111.0,2019-11-06,"(1052.75, 1399.0]",19,35,-16
31112.0,2019-11-06,"(351.246, 540.5]",2,4,-2
31112.0,2019-11-06,"(729.0, 917.5]",1,6,-5
31112.0,2019-11-06,"(917.5, 1106.0]",4,5,-1
31113.0,2019-11-06,"(313.931, 582.25]",2,22,-20
31113.0,2019-11-06,"(582.25, 849.5]",3,4,-1
31113.0,2019-11-06,"(849.5, 1116.75]",9,15,-6
31113.0,2019-11-06,"(1116.75, 1384.0]",11,21,-10
31114.0,2019-11-06,"(379.99, 633.5]",1,23,-22
31114.0,2019-11-06,"(633.5, 886.0]",10,22,-12
31114.0,2019-11-06,"(886.0, 1138.5]",22,30,-8
31114.0,2019-11-06,"(1138.5, 1391.0]",8,16,-8
31115.0,2019-11-06,"(343.975, 601.25]",2,23,-21
31115.0,2019-11-06,"(601.25, 857.5]",1,9,-8
31115.0,2019-11-06,"(857.5, 1113.75]",7,12,-5
31115.0,2019-11-06,"(1113.75, 1370.0]",9,13,-4
31116.0,2019-11-06,"(14.635, 357.25]",1,3,-2
31116.0,2019-11-06,"(357.25, 698.5]",8,30,-22
31116.0,2019-11-06,"(698.5, 1039.75]",9,12,-3
31116.0,2019-11-06,"(1039.75, 1381.0]",32,47,-15
31117.0,2019-11-06,"(278.035, 520.25]",1,16,-15
31117.0,2019-11-06,"(520.25, 761.5]",4,8,-4
31117.0,2019-11-06,"(761.5, 1002.75]",4,6,-2
31117.0,2019-11-06,"(1002.75, 1244.0]",19,25,-6
31118.0,2019-11-06,"(4.659, 341.25]",2,2,0
31118.0,2019-11-06,"(341.25, 676.5]",5,23,-18
31118.0,2019-11-06,"(676.5, 1011.75]",1,4,-3
31118.0,2019-11-06,"(1011.75, 1347.0]",18,23,-5
31119.0,2019-11-06,"(-0.396, 350.0]",1,2,-1
31119.0,2019-11-06,"(350.0, 699.0]",10,33,-23
31119.0,2019-11-06,"(699.0, 1048.0]",6,12,-6
31119.0,2019-11-06,"(1048.0, 1397.0]",26,40,-14
31120.0,2019-11-06,"(75.709, 399.75]",2,3,-1
31120.0,2019-11-06,"(399.75, 722.5]",4,25,-21
31120.0,2019-11-06,"(722.5, 1045.25]",3,7,-4
31120.0,2019-11-06,"(1045.25, 1368.0]",17,26,-9
31121.0,2019-11-06,"(2.619, 349.25]",1,1,0
31121.0,2019-11-06,"(349.25, 694.5]",14,29,-15
31121.0,2019-11-06,"(694.5, 1039.75]",5,12,-7
31121.0,2019-11-06,"(1039.75, 1385.0]",11,29,-18
31122.0,2019-11-06,"(163.74, 480.0]",2,6,-4
31122.0,2019-11-06,"(480.0, 795.0]",1,17,-16
31122.0,2019-11-06,"(795.0, 1110.0]",13,23,-10
31122.0,2019-11-06,"(1110.0, 1425.0]",12,22,-10
31123.0,2019-11-06,"(297.892, 576.0]",2,19,-17
31123.0,2019-11-06,"(576.0, 853.0]",1,2,-1
31123.0,2019-11-06,"(853.0, 1130.0]",6,10,-4
31123.0,2019-11-06,"(1130.0, 1407.0]",4,9,-5
31124.0,2019-11-06,"(328.902, 604.5]",18,49,-31
31124.0,2019-11-06,"(604.5, 879.0]",9,31,-22
31124.0,2019-11-06,"(879.0, 1153.5]",25,64,-39
31124.0,2019-11-06,"(1153.5, 1428.0]",21,49,-28
31125.0,2019-11-06,"(22.595, 375.25]",2,7,-5
31125.0,2019-11-06,"(375.25, 726.5]",8,30,-22
31125.0,2019-11-06,"(726.5, 1077.75]",20,26,-6
31125.0,2019-11-06,"(1077.75, 1429.0]",23,41,-18
31126.0,2019-11-06,"(308.977, 565.75]",7,32,-25
31126.0,2019-11-06,"(565.75, 821.5]",6,25,-19
31126.0,2019-11-06,"(821.5, 1077.25]",16,26,-10
31126.0,2019-11-06,"(1077.25, 1333.0]",15,29,-14
31127.0,2019-11-06,"(377.0, 628.0]",19,23,-4
31127.0,2019-11-06,"(628.0, 878.0]",7,17,-10
31127.0,2019-11-06,"(878.0, 1128.0]",15,35,-20
31127.0,2019-11-06,"(1128.0, 1378.0]",7,21,-14
31128.0,2019-11-06,"(-0.426, 357.5]",5,8,-3
31128.0,2019-11-06,"(357.5, 714.0]",34,54,-20
31128.0,2019-11-06,"(714.0, 1070.5]",23,40,-17
31128.0,2019-11-06,"(1070.5, 1427.0]",13,32,-19
31129.0,2019-11-06,"(421.084, 651.0]",18,18,0
31129.0,2019-11-06,"(651.0, 880.0]",18,32,-14
31129.0,2019-11-06,"(880.0, 1109.0]",8,23,-15
31129.0,2019-11-06,"(1109.0, 1338.0]",3,10,-7
31130.0,2019-11-06,"(2.702, 328.5]",1,1,0
31130.0,2019-11-06,"(328.5, 653.0]",5,25,-20
31130.0,2019-11-06,"(653.0, 977.5]",2,5,-3
31130.0,2019-11-06,"(977.5, 1302.0]",10,18,-8
31131.0,2019-11-06,"(642.25, 902.5]",4,14,-10
31131.0,2019-11-06,"(902.5, 1162.75]",9,6,3
31131.0,2019-11-06,"(1162.75, 1423.0]",3,15,-12
31200.0,2019-11-06,"(24.714, 347.5]",1,2,-1
31200.0,2019-11-06,"(347.5, 669.0]",37,65,-28
31200.0,2019-11-06,"(669.0, 990.5]",28,61,-33
31200.0,2019-11-06,"(990.5, 1312.0]",34,74,-40
31201.0,2019-11-06,"(41.604, 392.0]",5,7,-2
31201.0,2019-11-06,"(392.0, 741.0]",22,52,-30
31201.0,2019-11-06,"(741.0, 1090.0]",44,85,-41
31201.0,2019-11-06,"(1090.0, 1439.0]",27,53,-26
31202.0,2019-11-06,"(348.919, 620.25]",11,27,-16
31202.0,2019-11-06,"(620.25, 890.5]",13,24,-11
31202.0,2019-11-06,"(890.5, 1160.75]",38,54,-16
31202.0,2019-11-06,"(1160.75, 1431.0]",7,27,-20
31203.0,2019-11-06,"(39.622, 385.5]",1,4,-3
31203.0,2019-11-06,"(385.5, 730.0]",9,34,-25
31203.0,2019-11-06,"(730.0, 1074.5]",21,38,-17
31203.0,2019-11-06,"(1074.5, 1419.0]",31,58,-27
31204.0,2019-11-06,"(399.973, 657.75]",19,26,-7
31204.0,2019-11-06,"(657.75, 914.5]",10,19,-9
31204.0,2019-11-06,"(914.5, 1171.25]",7,27,-20
31204.0,2019-11-06,"(1171.25, 1428.0]",2,3,-1
31205.0,2019-11-06,"(451.094, 678.5]",41,48,-7
31205.0,2019-11-06,"(678.5, 905.0]",23,39,-16
31205.0,2019-11-06,"(905.0, 1131.5]",16,37,-21
31205.0,2019-11-06,"(1131.5, 1358.0]",3,20,-17
31206.0,2019-11-06,"(58.785, 363.75]",1,1,0
31206.0,2019-11-06,"(363.75, 667.5]",9,9,0
31206.0,2019-11-06,"(667.5, 971.25]",2,7,-5
31206.0,2019-11-06,"(971.25, 1275.0]",3,9,-6
31207.0,2019-11-06,"(511.158, 722.5]",1,9,-8
31207.0,2019-11-06,"(722.5, 933.0]",1,1,0
31207.0,2019-11-06,"(933.0, 1143.5]",2,7,-5
31207.0,2019-11-06,"(1143.5, 1354.0]",6,7,-1
31208.0,2019-11-06,"(344.957, 606.75]",19,24,-5
31208.0,2019-11-06,"(606.75, 867.5]",10,18,-8
31208.0,2019-11-06,"(867.5, 1128.25]",8,22,-14
31208.0,2019-11-06,"(1128.25, 1389.0]",2,4,-2
31209.0,2019-11-06,"(457.164, 667.0]",1,6,-5
31209.0,2019-11-06,"(667.0, 876.0]",3,8,-5
31209.0,2019-11-06,"(876.0, 1085.0]",2,6,-4
31209.0,2019-11-06,"(1085.0, 1294.0]",3,4,-1
31211.0,2019-11-06,"(413.032, 656.0]",10,16,-6
31211.0,2019-11-06,"(656.0, 898.0]",4,6,-2
31211.0,2019-11-06,"(898.0, 1140.0]",10,21,-11
31211.0,2019-11-06,"(1140.0, 1382.0]",1,7,-6
31212.0,2019-11-06,"(331.929, 600.75]",29,43,-14
31212.0,2019-11-06,"(600.75, 868.5]",12,26,-14
31212.0,2019-11-06,"(868.5, 1136.25]",13,33,-20
31212.0,2019-11-06,"(1136.25, 1404.0]",12,26,-14
31213.0,2019-11-06,"(280.894, 558.5]",32,42,-10
31213.0,2019-11-06,"(558.5, 835.0]",17,37,-20
31213.0,2019-11-06,"(835.0, 1111.5]",24,54,-30
31213.0,2019-11-06,"(1111.5, 1388.0]",6,14,-8
31214.0,2019-11-06,"(4.588, 359.0]",1,5,-4
31214.0,2019-11-06,"(359.0, 712.0]",9,30,-21
31214.0,2019-11-06,"(712.0, 1065.0]",32,54,-22
31214.0,2019-11-06,"(1065.0, 1418.0]",29,46,-17
31215.0,2019-11-06,"(353.75, 694.5]",32,1,31
31215.0,2019-11-06,"(694.5, 1035.25]",11,37,-26
31215.0,2019-11-06,"(1035.25, 1376.0]",5,16,-11
31216.0,2019-11-06,"(448.183, 653.25]",29,30,-1
31216.0,2019-11-06,"(653.25, 857.5]",8,12,-4
31216.0,2019-11-06,"(857.5, 1061.75]",3,14,-11
31216.0,2019-11-06,"(1061.75, 1266.0]",4,20,-16
31217.0,2019-11-06,"(314.153, 526.75]",13,14,-1
31217.0,2019-11-06,"(526.75, 738.5]",8,11,-3
31217.0,2019-11-06,"(738.5, 950.25]",7,15,-8
31217.0,2019-11-06,"(950.25, 1162.0]",3,16,-13
31218.0,2019-11-06,"(313.055, 550.25]",21,44,-23
31218.0,2019-11-06,"(550.25, 786.5]",10,18,-8
31218.0,2019-11-06,"(786.5, 1022.75]",16,31,-15
31218.0,2019-11-06,"(1022.75, 1259.0]",12,27,-15
31219.0,2019-11-06,"(377.978, 634.5]",20,20,0
31219.0,2019-11-06,"(634.5, 890.0]",12,21,-9
31219.0,2019-11-06,"(890.0, 1145.5]",2,5,-3
31219.0,2019-11-06,"(1145.5, 1401.0]",3,6,-3
31220.0,2019-11-06,"(328.186, 532.5]",20,25,-5
31220.0,2019-11-06,"(532.5, 736.0]",3,7,-4
31220.0,2019-11-06,"(736.0, 939.5]",3,8,-5
31220.0,2019-11-06,"(939.5, 1143.0]",2,15,-13
31221.0,2019-11-06,"(2.802, 303.5]",1,2,-1
31221.0,2019-11-06,"(303.5, 603.0]",37,42,-5
31221.0,2019-11-06,"(603.0, 902.5]",15,32,-17
31221.0,2019-11-06,"(902.5, 1202.0]",15,40,-25
31222.0,2019-11-06,"(383.021, 628.75]",21,23,-2
31222.0,2019-11-06,"(628.75, 873.5]",4,10,-6
31222.0,2019-11-06,"(873.5, 1118.25]",8,20,-12
31222.0,2019-11-06,"(1118.25, 1363.0]",3,5,-2
31223.0,2019-11-06,"(34.606, 384.5]",2,2,0
31223.0,2019-11-06,"(384.5, 733.0]",13,45,-32
31223.0,2019-11-06,"(733.0, 1081.5]",19,37,-18
31223.0,2019-11-06,"(1081.5, 1430.0]",10,24,-14
31224.0,2019-11-06,"(420.007, 669.25]",19,23,-4
31224.0,2019-11-06,"(669.25, 917.5]",4,9,-5
31224.0,2019-11-06,"(917.5, 1165.75]",11,36,-25
31224.0,2019-11-06,"(1165.75, 1414.0]",3,6,-3
31225.0,2019-11-06,"(345.75, 661.5]",15,1,14
31225.0,2019-11-06,"(661.5, 977.25]",13,24,-11
31225.0,2019-11-06,"(977.25, 1293.0]",26,22,4
31226.0,2019-11-06,"(437.095, 664.25]",7,17,-10
31226.0,2019-11-06,"(664.25, 890.5]",6,10,-4
31226.0,2019-11-06,"(890.5, 1116.75]",6,12,-6
31226.0,2019-11-06,"(1116.75, 1343.0]",3,7,-4
31227.0,2019-11-06,"(439.217, 635.75]",60,67,-7
31227.0,2019-11-06,"(635.75, 831.5]",12,23,-11
31227.0,2019-11-06,"(831.5, 1027.25]",9,21,-12
31227.0,2019-11-06,"(1027.25, 1223.0]",7,25,-18
31228.0,2019-11-06,"(1.612, 350.0]",2,4,-2
31228.0,2019-11-06,"(350.0, 697.0]",26,39,-13
31228.0,2019-11-06,"(697.0, 1044.0]",22,45,-23
31228.0,2019-11-06,"(1044.0, 1391.0]",25,52,-27
31229.0,2019-11-06,"(5.627, 350.25]",3,4,-1
31229.0,2019-11-06,"(350.25, 693.5]",15,50,-35
31229.0,2019-11-06,"(693.5, 1036.75]",33,64,-31
31229.0,2019-11-06,"(1036.75, 1380.0]",48,69,-21
31230.0,2019-11-06,"(381.045, 620.75]",54,65,-11
31230.0,2019-11-06,"(620.75, 859.5]",16,27,-11
31230.0,2019-11-06,"(859.5, 1098.25]",14,39,-25
31230.0,2019-11-06,"(1098.25, 1337.0]",11,23,-12
31231.0,2019-11-06,"(318.122, 538.5]",24,25,-1
31231.0,2019-11-06,"(538.5, 758.0]",10,17,-7
31231.0,2019-11-06,"(758.0, 977.5]",8,19,-11
31231.0,2019-11-06,"(977.5, 1197.0]",15,41,-26
31232.0,2019-11-06,"(80.724, 401.0]",3,6,-3
31232.0,2019-11-06,"(401.0, 720.0]",31,44,-13
31232.0,2019-11-06,"(720.0, 1039.0]",21,44,-23
31232.0,2019-11-06,"(1039.0, 1358.0]",24,48,-24
31233.0,2019-11-06,"(346.912, 620.0]",58,63,-5
31233.0,2019-11-06,"(620.0, 892.0]",10,18,-8
31233.0,2019-11-06,"(892.0, 1164.0]",9,29,-20
31233.0,2019-11-06,"(1164.0, 1436.0]",4,7,-3
31234.0,2019-11-06,"(159.748, 474.0]",5,7,-2
31234.0,2019-11-06,"(474.0, 787.0]",16,36,-20
31234.0,2019-11-06,"(787.0, 1100.0]",20,36,-16
31234.0,2019-11-06,"(1100.0, 1413.0]",16,31,-15
31235.0,2019-11-06,"(355.254, 542.5]",6,8,-2
31235.0,2019-11-06,"(542.5, 729.0]",8,13,-5
31235.0,2019-11-06,"(729.0, 915.5]",7,16,-9
31235.0,2019-11-06,"(915.5, 1102.0]",4,10,-6
31236.0,2019-11-06,"(451.296, 628.0]",20,23,-3
31236.0,2019-11-06,"(628.0, 804.0]",8,16,-8
31236.0,2019-11-06,"(804.0, 980.0]",13,22,-9
31236.0,2019-11-06,"(980.0, 1156.0]",8,26,-18
31237.0,2019-11-06,"(323.889, 602.75]",11,19,-8
31237.0,2019-11-06,"(602.75, 880.5]",20,35,-15
31237.0,2019-11-06,"(880.5, 1158.25]",21,38,-17
31237.0,2019-11-06,"(1158.25, 1436.0]",7,19,-12
31238.0,2019-11-06,"(423.188, 627.0]",24,25,-1
31238.0,2019-11-06,"(627.0, 830.0]",7,15,-8
31238.0,2019-11-06,"(830.0, 1033.0]",3,17,-14
31238.0,2019-11-06,"(1033.0, 1236.0]",8,25,-17
31239.0,2019-11-06,"(333.003, 583.25]",28,36,-8
31239.0,2019-11-06,"(583.25, 832.5]",14,18,-4
31239.0,2019-11-06,"(832.5, 1081.75]",6,34,-28
31239.0,2019-11-06,"(1081.75, 1331.0]",9,16,-7
31240.0,2019-11-06,"(421.195, 623.25]",1,2,-1
31240.0,2019-11-06,"(623.25, 824.5]",10,21,-11
31240.0,2019-11-06,"(824.5, 1025.75]",11,28,-17
31240.0,2019-11-06,"(1025.75, 1227.0]",5,8,-3
31241.0,2019-11-06,"(410.75, 733.5]",35,6,29
31241.0,2019-11-06,"(733.5, 1056.25]",10,81,-71
31241.0,2019-11-06,"(1056.25, 1379.0]",18,28,-10
31242.0,2019-11-06,"(405.195, 607.25]",32,38,-6
31242.0,2019-11-06,"(607.25, 808.5]",5,9,-4
31242.0,2019-11-06,"(808.5, 1009.75]",9,17,-8
31242.0,2019-11-06,"(1009.75, 1211.0]",4,13,-9
31243.0,2019-11-06,"(308.071, 541.25]",21,25,-4
31243.0,2019-11-06,"(541.25, 773.5]",9,12,-3
31243.0,2019-11-06,"(773.5, 1005.75]",9,20,-11
31243.0,2019-11-06,"(1005.75, 1238.0]",7,33,-26
31244.0,2019-11-06,"(11.629, 355.75]",1,3,-2
31244.0,2019-11-06,"(355.75, 698.5]",22,33,-11
31244.0,2019-11-06,"(698.5, 1041.25]",8,27,-19
31244.0,2019-11-06,"(1041.25, 1384.0]",12,20,-8
31245.0,2019-11-06,"(119.702, 445.5]",4,7,-3
31245.0,2019-11-06,"(445.5, 770.0]",17,42,-25
31245.0,2019-11-06,"(770.0, 1094.5]",20,39,-19
31245.0,2019-11-06,"(1094.5, 1419.0]",11,26,-15
31246.0,2019-11-06,"(348.992, 602.0]",16,22,-6
31246.0,2019-11-06,"(602.0, 854.0]",12,21,-9
31246.0,2019-11-06,"(854.0, 1106.0]",32,53,-21
31246.0,2019-11-06,"(1106.0, 1358.0]",9,26,-17
31247.0,2019-11-06,"(429.211, 627.25]",18,29,-11
31247.0,2019-11-06,"(627.25, 824.5]",22,36,-14
31247.0,2019-11-06,"(824.5, 1021.75]",20,46,-26
31247.0,2019-11-06,"(1021.75, 1219.0]",8,17,-9
31248.0,2019-11-06,"(344.052, 582.0]",17,25,-8
31248.0,2019-11-06,"(582.0, 819.0]",13,25,-12
31248.0,2019-11-06,"(819.0, 1056.0]",19,49,-30
31248.0,2019-11-06,"(1056.0, 1293.0]",19,26,-7
31249.0,2019-11-06,"(417.275, 599.25]",10,19,-9
31249.0,2019-11-06,"(599.25, 780.5]",12,20,-8
31249.0,2019-11-06,"(780.5, 961.75]",8,19,-11
31249.0,2019-11-06,"(961.75, 1143.0]",18,38,-20
31250.0,2019-11-06,"(399.991, 653.25]",23,32,-9
31250.0,2019-11-06,"(653.25, 905.5]",9,13,-4
31250.0,2019-11-06,"(905.5, 1157.75]",2,23,-21
31250.0,2019-11-06,"(1157.75, 1410.0]",3,6,-3
31251.0,2019-11-06,"(246.862, 532.5]",12,24,-12
31251.0,2019-11-06,"(532.5, 817.0]",17,32,-15
31251.0,2019-11-06,"(817.0, 1101.5]",19,40,-21
31251.0,2019-11-06,"(1101.5, 1386.0]",3,7,-4
31252.0,2019-11-06,"(373.045, 612.75]",18,18,0
31252.0,2019-11-06,"(612.75, 851.5]",5,11,-6
31252.0,2019-11-06,"(851.5, 1090.25]",8,24,-16
31252.0,2019-11-06,"(1090.25, 1329.0]",3,15,-12
31253.0,2019-11-06,"(376.153, 588.75]",25,27,-2
31253.0,2019-11-06,"(588.75, 800.5]",15,23,-8
31253.0,2019-11-06,"(800.5, 1012.25]",6,15,-9
31253.0,2019-11-06,"(1012.25, 1224.0]",5,29,-24
31254.0,2019-11-06,"(341.966, 601.5]",28,32,-4
31254.0,2019-11-06,"(601.5, 860.0]",5,15,-10
31254.0,2019-11-06,"(860.0, 1118.5]",5,23,-18
31254.0,2019-11-06,"(1118.5, 1377.0]",2,12,-10
31255.0,2019-11-06,"(366.067, 600.25]",34,47,-13
31255.0,2019-11-06,"(600.25, 833.5]",6,13,-7
31255.0,2019-11-06,"(833.5, 1066.75]",11,22,-11
31255.0,2019-11-06,"(1066.75, 1300.0]",9,21,-12
31256.0,2019-11-06,"(289.005, 538.75]",15,18,-3
31256.0,2019-11-06,"(538.75, 787.5]",6,10,-4
31256.0,2019-11-06,"(787.5, 1036.25]",7,17,-10
31256.0,2019-11-06,"(1036.25, 1285.0]",7,25,-18
31257.0,2019-11-06,"(104.702, 430.5]",3,5,-2
31257.0,2019-11-06,"(430.5, 755.0]",22,35,-13
31257.0,2019-11-06,"(755.0, 1079.5]",27,60,-33
31257.0,2019-11-06,"(1079.5, 1404.0]",20,47,-27
31258.0,2019-11-06,"(322.077, 553.75]",13,28,-15
31258.0,2019-11-06,"(553.75, 784.5]",5,10,-5
31258.0,2019-11-06,"(784.5, 1015.25]",27,49,-22
31258.0,2019-11-06,"(1015.25, 1246.0]",13,34,-21
31259.0,2019-11-06,"(451.2, 652.0]",13,17,-4
31259.0,2019-11-06,"(652.0, 852.0]",6,7,-1
31259.0,2019-11-06,"(852.0, 1052.0]",2,8,-6
31259.0,2019-11-06,"(1052.0, 1252.0]",1,8,-7
31260.0,2019-11-06,"(35.608, 385.0]",2,2,0
31260.0,2019-11-06,"(385.0, 733.0]",18,25,-7
31260.0,2019-11-06,"(733.0, 1081.0]",10,35,-25
31260.0,2019-11-06,"(1081.0, 1429.0]",5,10,-5
31261.0,2019-11-06,"(416.426, 560.5]",13,13,0
31261.0,2019-11-06,"(847.5, 991.0]",2,2,0
31262.0,2019-11-06,"(313.042, 553.5]",11,13,-2
31262.0,2019-11-06,"(553.5, 793.0]",6,12,-6
31262.0,2019-11-06,"(793.0, 1032.5]",8,13,-5
31262.0,2019-11-06,"(1032.5, 1272.0]",6,24,-18
31263.0,2019-11-06,"(362.964, 623.0]",28,45,-17
31263.0,2019-11-06,"(623.0, 882.0]",8,17,-9
31263.0,2019-11-06,"(882.0, 1141.0]",9,24,-15
31263.0,2019-11-06,"(1141.0, 1400.0]",5,11,-6
31264.0,2019-11-06,"(355.981, 611.75]",22,27,-5
31264.0,2019-11-06,"(611.75, 866.5]",4,9,-5
31264.0,2019-11-06,"(866.5, 1121.25]",7,15,-8
31264.0,2019-11-06,"(1121.25, 1376.0]",1,5,-4
31265.0,2019-11-06,"(394.966, 654.5]",23,51,-28
31265.0,2019-11-06,"(654.5, 913.0]",7,13,-6
31265.0,2019-11-06,"(913.0, 1171.5]",29,48,-19
31265.0,2019-11-06,"(1171.5, 1430.0]",10,22,-12
31266.0,2019-11-06,"(74.663, 410.25]",1,13,-12
31266.0,2019-11-06,"(410.25, 744.5]",5,23,-18
31266.0,2019-11-06,"(744.5, 1078.75]",20,39,-19
31266.0,2019-11-06,"(1078.75, 1413.0]",29,49,-20
31267.0,2019-11-06,"(344.907, 619.25]",29,47,-18
31267.0,2019-11-06,"(619.25, 892.5]",19,29,-10
31267.0,2019-11-06,"(892.5, 1165.75]",14,39,-25
31267.0,2019-11-06,"(1165.75, 1439.0]",11,20,-9
31268.0,2019-11-06,"(24.633, 367.75]",2,3,-1
31268.0,2019-11-06,"(367.75, 709.5]",12,38,-26
31268.0,2019-11-06,"(709.5, 1051.25]",12,22,-10
31268.0,2019-11-06,"(1051.25, 1393.0]",26,37,-11
31269.0,2019-11-06,"(377.956, 640.0]",13,24,-11
31269.0,2019-11-06,"(640.0, 901.0]",13,31,-18
31269.0,2019-11-06,"(901.0, 1162.0]",6,12,-6
31269.0,2019-11-06,"(1162.0, 1423.0]",3,9,-6
31270.0,2019-11-06,"(385.982, 641.5]",24,32,-8
31270.0,2019-11-06,"(641.5, 896.0]",10,22,-12
31270.0,2019-11-06,"(896.0, 1150.5]",14,30,-16
31270.0,2019-11-06,"(1150.5, 1405.0]",6,11,-5
31271.0,2019-11-06,"(403.09, 631.5]",18,22,-4
31271.0,2019-11-06,"(631.5, 859.0]",23,45,-22
31271.0,2019-11-06,"(859.0, 1086.5]",17,38,-21
31271.0,2019-11-06,"(1086.5, 1314.0]",5,15,-10
31272.0,2019-11-06,"(236.848, 526.0]",22,27,-5
31272.0,2019-11-06,"(526.0, 814.0]",23,33,-10
31272.0,2019-11-06,"(814.0, 1102.0]",6,31,-25
31272.0,2019-11-06,"(1102.0, 1390.0]",2,10,-8
31273.0,2019-11-06,"(363.219, 559.25]",1,4,-3
31273.0,2019-11-06,"(559.25, 754.5]",1,2,-1
31273.0,2019-11-06,"(754.5, 949.75]",9,17,-8
31273.0,2019-11-06,"(949.75, 1145.0]",3,4,-1
31274.0,2019-11-06,"(372.231, 565.25]",20,24,-4
31274.0,2019-11-06,"(565.25, 757.5]",8,9,-1
31274.0,2019-11-06,"(757.5, 949.75]",4,6,-2
31274.0,2019-11-06,"(949.75, 1142.0]",4,20,-16
31275.0,2019-11-06,"(286.924, 557.0]",29,43,-14
31275.0,2019-11-06,"(557.0, 826.0]",18,33,-15
31275.0,2019-11-06,"(826.0, 1095.0]",27,53,-26
31275.0,2019-11-06,"(1095.0, 1364.0]",9,19,-10
31276.0,2019-11-06,"(424.329, 592.75]",27,32,-5
31276.0,2019-11-06,"(592.75, 760.5]",4,9,-5
31276.0,2019-11-06,"(760.5, 928.25]",7,15,-8
31276.0,2019-11-06,"(928.25, 1096.0]",8,17,-9
31277.0,2019-11-06,"(445.178, 651.5]",32,34,-2
31277.0,2019-11-06,"(651.5, 857.0]",15,20,-5
31277.0,2019-11-06,"(857.0, 1062.5]",16,45,-29
31277.0,2019-11-06,"(1062.5, 1268.0]",1,5,-4
31278.0,2019-11-06,"(409.976, 667.0]",6,26,-20
31278.0,2019-11-06,"(667.0, 923.0]",8,14,-6
31278.0,2019-11-06,"(923.0, 1179.0]",26,43,-17
31278.0,2019-11-06,"(1179.0, 1435.0]",14,21,-7
31279.0,2019-11-06,"(373.216, 570.0]",25,28,-3
31279.0,2019-11-06,"(570.0, 766.0]",4,11,-7
31279.0,2019-11-06,"(766.0, 962.0]",6,10,-4
31279.0,2019-11-06,"(962.0, 1158.0]",8,38,-30
31280.0,2019-11-06,"(348.98, 605.0]",4,23,-19
31280.0,2019-11-06,"(605.0, 860.0]",5,8,-3
31280.0,2019-11-06,"(860.0, 1115.0]",10,13,-3
31280.0,2019-11-06,"(1115.0, 1370.0]",17,22,-5
31000.0,2019-11-07,"(635.5, 776.0]",1,2,-1
31000.0,2019-11-07,"(916.5, 1057.0]",1,3,-2
31001.0,2019-11-07,"(837.75, 1117.0]",1,1,0
31002.0,2019-11-07,"(391.263, 576.25]",4,7,-3
31002.0,2019-11-07,"(576.25, 760.5]",3,7,-4
31002.0,2019-11-07,"(760.5, 944.75]",3,4,-1
31002.0,2019-11-07,"(944.75, 1129.0]",3,6,-3
31003.0,2019-11-07,"(392.306, 566.5]",9,13,-4
31003.0,2019-11-07,"(566.5, 740.0]",1,2,-1
31003.0,2019-11-07,"(740.0, 913.5]",1,1,0
31003.0,2019-11-07,"(913.5, 1087.0]",4,7,-3
31004.0,2019-11-07,"(1139.5, 1375.0]",1,3,-2
31005.0,2019-11-07,"(435.063, 670.25]",8,10,-2
31005.0,2019-11-07,"(670.25, 904.5]",2,5,-3
31005.0,2019-11-07,"(904.5, 1138.75]",2,2,0
31006.0,2019-11-07,"(153.995, 406.25]",1,2,-1
31006.0,2019-11-07,"(657.5, 908.75]",1,4,-3
31006.0,2019-11-07,"(908.75, 1160.0]",3,4,-1
31007.0,2019-11-07,"(353.915, 626.25]",12,30,-18
31007.0,2019-11-07,"(626.25, 897.5]",6,10,-4
31007.0,2019-11-07,"(897.5, 1168.75]",7,15,-8
31007.0,2019-11-07,"(1168.75, 1440.0]",5,5,0
31009.0,2019-11-07,"(427.207, 626.25]",9,11,-2
31009.0,2019-11-07,"(824.5, 1022.75]",1,1,0
31010.0,2019-11-07,"(459.445, 598.75]",3,4,-1
31010.0,2019-11-07,"(598.75, 737.5]",1,1,0
31010.0,2019-11-07,"(737.5, 876.25]",3,6,-3
31010.0,2019-11-07,"(876.25, 1015.0]",1,2,-1
31011.0,2019-11-07,"(331.034, 573.5]",6,9,-3
31011.0,2019-11-07,"(573.5, 815.0]",1,2,-1
31011.0,2019-11-07,"(1056.5, 1298.0]",2,5,-3
31012.0,2019-11-07,"(358.27, 541.5]",7,8,-1
31013.0,2019-11-07,"(431.434, 573.5]",1,6,-5
31013.0,2019-11-07,"(856.5, 998.0]",1,1,0
31014.0,2019-11-07,"(347.043, 587.25]",37,50,-13
31014.0,2019-11-07,"(587.25, 826.5]",6,14,-8
31014.0,2019-11-07,"(826.5, 1065.75]",12,18,-6
31014.0,2019-11-07,"(1065.75, 1305.0]",3,5,-2
31015.0,2019-11-07,"(305.988, 560.0]",8,9,-1
31015.0,2019-11-07,"(560.0, 813.0]",2,3,-1
31015.0,2019-11-07,"(813.0, 1066.0]",5,12,-7
31015.0,2019-11-07,"(1066.0, 1319.0]",2,5,-3
31016.0,2019-11-07,"(426.051, 664.25]",9,17,-8
31016.0,2019-11-07,"(664.25, 901.5]",7,10,-3
31016.0,2019-11-07,"(901.5, 1138.75]",1,3,-2
31016.0,2019-11-07,"(1138.75, 1376.0]",2,3,-1
31017.0,2019-11-07,"(408.066, 642.5]",4,8,-4
31018.0,2019-11-07,"(655.5, 867.0]",1,5,-4
31018.0,2019-11-07,"(1078.5, 1290.0]",3,1,2
31019.0,2019-11-07,"(608.5, 738.0]",1,3,-2
31020.0,2019-11-07,"(634.5, 682.0]",1,1,0
31021.0,2019-11-07,"(694.75, 907.5]",2,1,1
31021.0,2019-11-07,"(907.5, 1120.25]",3,3,0
31021.0,2019-11-07,"(1120.25, 1333.0]",1,5,-4
31022.0,2019-11-07,"(350.133, 567.75]",5,10,-5
31022.0,2019-11-07,"(567.75, 784.5]",3,3,0
31022.0,2019-11-07,"(784.5, 1001.25]",2,4,-2
31022.0,2019-11-07,"(1001.25, 1218.0]",1,4,-3
31023.0,2019-11-07,"(512.111, 735.25]",1,2,-1
31023.0,2019-11-07,"(735.25, 957.5]",1,5,-4
31023.0,2019-11-07,"(957.5, 1179.75]",2,3,-1
31024.0,2019-11-07,"(410.16, 621.0]",9,15,-6
31024.0,2019-11-07,"(621.0, 831.0]",2,3,-1
31024.0,2019-11-07,"(831.0, 1041.0]",2,6,-4
31024.0,2019-11-07,"(1041.0, 1251.0]",1,6,-5
31025.0,2019-11-07,"(789.0, 1052.0]",2,1,1
31026.0,2019-11-07,"(803.0, 1001.0]",1,1,0
31026.0,2019-11-07,"(1001.0, 1199.0]",1,1,0
31027.0,2019-11-07,"(773.0, 932.0]",1,2,-1
31027.0,2019-11-07,"(932.0, 1091.0]",3,1,2
31028.0,2019-11-07,"(405.054, 642.5]",1,2,-1
31029.0,2019-11-07,"(694.5, 857.0]",1,7,-6
31029.0,2019-11-07,"(857.0, 1019.5]",1,2,-1
31029.0,2019-11-07,"(1019.5, 1182.0]",2,1,1
31030.0,2019-11-07,"(989.75, 1160.0]",2,6,-4
31031.0,2019-11-07,"(862.0, 1118.0]",2,3,-1
31032.0,2019-11-07,"(877.5, 1007.75]",1,2,-1
31032.0,2019-11-07,"(1007.75, 1138.0]",1,1,0
31033.0,2019-11-07,"(369.75, 493.0]",1,1,0
31034.0,2019-11-07,"(464.041, 704.75]",4,10,-6
31034.0,2019-11-07,"(1184.25, 1424.0]",1,1,0
31035.0,2019-11-07,"(231.153, 443.75]",1,3,-2
31035.0,2019-11-07,"(443.75, 655.5]",2,3,-1
31035.0,2019-11-07,"(867.25, 1079.0]",1,4,-3
31036.0,2019-11-07,"(926.75, 1098.0]",2,4,-2
31037.0,2019-11-07,"(416.019, 662.25]",16,25,-9
31037.0,2019-11-07,"(662.25, 907.5]",4,10,-6
31037.0,2019-11-07,"(907.5, 1152.75]",2,10,-8
31038.0,2019-11-07,"(876.5, 1107.75]",1,1,0
31038.0,2019-11-07,"(1107.75, 1339.0]",1,1,0
31039.0,2019-11-07,"(473.192, 676.0]",1,7,-6
31039.0,2019-11-07,"(676.0, 878.0]",2,2,0
31039.0,2019-11-07,"(878.0, 1080.0]",1,4,-3
31040.0,2019-11-07,"(455.435, 597.25]",4,5,-1
31040.0,2019-11-07,"(597.25, 738.5]",2,3,-1
31041.0,2019-11-07,"(454.527, 573.25]",2,3,-1
31041.0,2019-11-07,"(573.25, 691.5]",1,1,0
31042.0,2019-11-07,"(472.127, 691.25]",8,10,-2
31042.0,2019-11-07,"(691.25, 909.5]",2,4,-2
31042.0,2019-11-07,"(909.5, 1127.75]",3,6,-3
31042.0,2019-11-07,"(1127.75, 1346.0]",3,3,0
31043.0,2019-11-07,"(435.384, 590.0]",2,4,-2
31043.0,2019-11-07,"(744.0, 898.0]",1,2,-1
31043.0,2019-11-07,"(898.0, 1052.0]",1,2,-1
31044.0,2019-11-07,"(485.538, 601.5]",1,2,-1
31044.0,2019-11-07,"(601.5, 717.0]",2,3,-1
31045.0,2019-11-07,"(508.166, 717.5]",2,4,-2
31045.0,2019-11-07,"(717.5, 926.0]",2,3,-1
31046.0,2019-11-07,"(601.25, 669.5]",1,1,0
31046.0,2019-11-07,"(737.75, 806.0]",1,1,0
31047.0,2019-11-07,"(351.183, 556.25]",14,24,-10
31047.0,2019-11-07,"(556.25, 760.5]",4,7,-3
31047.0,2019-11-07,"(760.5, 964.75]",2,7,-5
31047.0,2019-11-07,"(964.75, 1169.0]",5,11,-6
31048.0,2019-11-07,"(455.292, 633.0]",3,7,-4
31048.0,2019-11-07,"(633.0, 810.0]",1,2,-1
31048.0,2019-11-07,"(810.0, 987.0]",1,2,-1
31048.0,2019-11-07,"(987.0, 1164.0]",4,9,-5
31049.0,2019-11-07,"(538.415, 685.25]",3,3,0
31050.0,2019-11-07,"(955.75, 1103.0]",1,2,-1
31051.0,2019-11-07,"(303.03, 546.5]",1,7,-6
31051.0,2019-11-07,"(546.5, 789.0]",2,3,-1
31051.0,2019-11-07,"(789.0, 1031.5]",2,6,-4
31051.0,2019-11-07,"(1031.5, 1274.0]",3,3,0
31052.0,2019-11-07,"(387.137, 603.75]",2,4,-2
31052.0,2019-11-07,"(819.5, 1035.25]",1,2,-1
31052.0,2019-11-07,"(1035.25, 1251.0]",3,1,2
31053.0,2019-11-07,"(911.0, 977.0]",1,1,0
,,,,2.0,
31055.0,2019-11-07,"(496.462, 631.5]",1,3,-2
31055.0,2019-11-07,"(766.0, 900.5]",1,1,0
31055.0,2019-11-07,"(900.5, 1035.0]",3,3,0
31056.0,2019-11-07,"(649.75, 872.5]",1,2,-1
31056.0,2019-11-07,"(1095.25, 1318.0]",2,1,1
31057.0,2019-11-07,"(625.719, 696.25]",1,2,-1
31057.0,2019-11-07,"(836.75, 907.0]",1,1,0
31058.0,2019-11-07,"(1125.0, 1145.0]",1,1,0
31059.0,2019-11-07,"(616.0, 820.0]",1,1,0
31059.0,2019-11-07,"(1024.0, 1228.0]",2,1,1
31060.0,2019-11-07,"(691.75, 896.5]",1,1,0
31060.0,2019-11-07,"(896.5, 1101.25]",4,2,2
31061.0,2019-11-07,"(569.5, 596.25]",1,1,0
31062.0,2019-11-07,"(361.368, 520.0]",3,6,-3
31062.0,2019-11-07,"(520.0, 678.0]",5,7,-2
31062.0,2019-11-07,"(836.0, 994.0]",2,2,0
31063.0,2019-11-07,"(726.0, 968.0]",2,1,1
31064.0,2019-11-07,"(491.456, 628.0]",7,14,-7
31064.0,2019-11-07,"(628.0, 764.0]",1,2,-1
31064.0,2019-11-07,"(764.0, 900.0]",1,2,-1
31064.0,2019-11-07,"(900.0, 1036.0]",4,8,-4
31065.0,2019-11-07,"(857.0, 993.0]",3,3,0
31066.0,2019-11-07,"(525.853, 562.75]",2,3,-1
31066.0,2019-11-07,"(599.5, 636.25]",2,1,1
31067.0,2019-11-07,"(645.5, 870.0]",1,2,-1
31067.0,2019-11-07,"(870.0, 1094.5]",1,2,-1
31067.0,2019-11-07,"(1094.5, 1319.0]",2,1,1
31068.0,2019-11-07,"(112.738, 429.5]",1,1,0
31068.0,2019-11-07,"(429.5, 745.0]",1,3,-2
31068.0,2019-11-07,"(1060.5, 1376.0]",1,3,-2
31069.0,2019-11-07,"(437.149, 650.75]",1,9,-8
31069.0,2019-11-07,"(650.75, 863.5]",2,2,0
31069.0,2019-11-07,"(863.5, 1076.25]",1,3,-2
31069.0,2019-11-07,"(1076.25, 1289.0]",2,2,0
31070.0,2019-11-07,"(715.25, 924.5]",1,2,-1
31070.0,2019-11-07,"(924.5, 1133.75]",1,2,-1
31070.0,2019-11-07,"(1133.75, 1343.0]",2,2,0
31071.0,2019-11-07,"(324.117, 545.75]",2,9,-7
31071.0,2019-11-07,"(545.75, 766.5]",4,5,-1
31071.0,2019-11-07,"(766.5, 987.25]",3,5,-2
31071.0,2019-11-07,"(987.25, 1208.0]",3,3,0
,,,,1.0,
,,,,1.0,
31073.0,2019-11-07,"(452.399, 603.25]",3,5,-2
31073.0,2019-11-07,"(753.5, 903.75]",2,1,1
31073.0,2019-11-07,"(903.75, 1054.0]",1,2,-1
31074.0,2019-11-07,"(713.0, 945.0]",1,2,-1
31074.0,2019-11-07,"(945.0, 1177.0]",1,3,-2
31074.0,2019-11-07,"(1177.0, 1409.0]",2,1,1
,,,,1.0,
,,,,1.0,
31076.0,2019-11-07,"(417.19, 620.5]",1,1,0
31076.0,2019-11-07,"(1025.5, 1228.0]",1,2,-1
31077.0,2019-11-07,"(83.743, 399.25]",1,2,-1
31077.0,2019-11-07,"(399.25, 713.5]",11,31,-20
31077.0,2019-11-07,"(713.5, 1027.75]",10,20,-10
31077.0,2019-11-07,"(1027.75, 1342.0]",3,3,0
31078.0,2019-11-07,"(474.406, 623.5]",9,9,0
31078.0,2019-11-07,"(623.5, 772.0]",1,6,-5
31079.0,2019-11-07,"(901.0, 1153.5]",1,4,-3
31079.0,2019-11-07,"(1153.5, 1406.0]",2,2,0
31080.0,2019-11-07,"(342.988, 597.0]",1,14,-13
31080.0,2019-11-07,"(597.0, 850.0]",1,2,-1
31080.0,2019-11-07,"(850.0, 1103.0]",2,2,0
31080.0,2019-11-07,"(1103.0, 1356.0]",4,4,0
31081.0,2019-11-07,"(834.484, 964.0]",2,3,-1
31082.0,2019-11-07,"(678.686, 757.5]",1,1,0
31082.0,2019-11-07,"(914.5, 993.0]",1,2,-1
31083.0,2019-11-07,"(435.332, 603.0]",1,3,-2
31083.0,2019-11-07,"(937.0, 1104.0]",3,1,2
31084.0,2019-11-07,"(505.149, 718.75]",6,9,-3
31084.0,2019-11-07,"(718.75, 931.5]",3,5,-2
31084.0,2019-11-07,"(931.5, 1144.25]",2,9,-7
31084.0,2019-11-07,"(1144.25, 1357.0]",1,1,0
31085.0,2019-11-07,"(839.5, 949.0]",1,2,-1
31086.0,2019-11-07,"(623.25, 788.5]",1,2,-1
31086.0,2019-11-07,"(788.5, 953.75]",1,1,0
31086.0,2019-11-07,"(953.75, 1119.0]",2,1,1
31087.0,2019-11-07,"(721.0, 812.0]",1,1,0
31088.0,2019-11-07,"(936.5, 1068.0]",1,1,0
31089.0,2019-11-07,"(372.033, 614.75]",7,9,-2
31089.0,2019-11-07,"(614.75, 856.5]",2,4,-2
31089.0,2019-11-07,"(856.5, 1098.25]",1,7,-6
31090.0,2019-11-07,"(702.75, 795.0]",2,1,1
31091.0,2019-11-07,"(1090.0, 1288.0]",2,3,-1
31092.0,2019-11-07,"(656.75, 847.5]",1,3,-2
31092.0,2019-11-07,"(847.5, 1038.25]",2,1,1
31092.0,2019-11-07,"(1038.25, 1229.0]",1,4,-3
31093.0,2019-11-07,"(827.5, 1028.75]",1,3,-2
31093.0,2019-11-07,"(1028.75, 1230.0]",2,4,-2
31094.0,2019-11-07,"(924.0, 1232.0]",2,1,1
,,,,1.0,
,,,,1.0,
31096.0,2019-11-07,"(938.25, 1030.0]",1,1,0
31097.0,2019-11-07,"(539.427, 683.25]",3,4,-1
31097.0,2019-11-07,"(826.5, 969.75]",1,1,0
31097.0,2019-11-07,"(969.75, 1113.0]",1,2,-1
31098.0,2019-11-07,"(402.138, 618.5]",9,14,-5
31098.0,2019-11-07,"(618.5, 834.0]",2,3,-1
31098.0,2019-11-07,"(834.0, 1049.5]",3,8,-5
31099.0,2019-11-07,"(993.5, 1165.0]",2,2,0
31100.0,2019-11-07,"(432.217, 628.75]",26,31,-5
31100.0,2019-11-07,"(628.75, 824.5]",2,3,-1
31100.0,2019-11-07,"(824.5, 1020.25]",5,11,-6
31100.0,2019-11-07,"(1020.25, 1216.0]",2,8,-6
31101.0,2019-11-07,"(10.592, 364.0]",3,7,-4
31101.0,2019-11-07,"(364.0, 716.0]",11,37,-26
31101.0,2019-11-07,"(716.0, 1068.0]",30,43,-13
31101.0,2019-11-07,"(1068.0, 1420.0]",17,22,-5
31102.0,2019-11-07,"(319.913, 592.75]",2,29,-27
31102.0,2019-11-07,"(592.75, 864.5]",1,9,-8
31102.0,2019-11-07,"(864.5, 1136.25]",8,15,-7
31102.0,2019-11-07,"(1136.25, 1408.0]",7,9,-2
31103.0,2019-11-07,"(150.737, 467.75]",3,12,-9
31103.0,2019-11-07,"(467.75, 783.5]",1,34,-33
31103.0,2019-11-07,"(783.5, 1099.25]",9,28,-19
31103.0,2019-11-07,"(1099.25, 1415.0]",2,6,-4
31104.0,2019-11-07,"(12.647, 352.25]",1,4,-3
31104.0,2019-11-07,"(352.25, 690.5]",5,29,-24
31104.0,2019-11-07,"(690.5, 1028.75]",11,18,-7
31104.0,2019-11-07,"(1028.75, 1367.0]",15,25,-10
31105.0,2019-11-07,"(404.976, 662.0]",2,20,-18
31105.0,2019-11-07,"(662.0, 918.0]",1,3,-2
31105.0,2019-11-07,"(918.0, 1174.0]",2,4,-2
31105.0,2019-11-07,"(1174.0, 1430.0]",2,5,-3
31106.0,2019-11-07,"(453.035, 695.25]",1,14,-13
31106.0,2019-11-07,"(1177.75, 1419.0]",1,2,-1
31107.0,2019-11-07,"(8.635, 351.25]",1,2,-1
31107.0,2019-11-07,"(351.25, 692.5]",5,25,-20
31107.0,2019-11-07,"(692.5, 1033.75]",7,18,-11
31107.0,2019-11-07,"(1033.75, 1375.0]",11,15,-4
31108.0,2019-11-07,"(375.004, 625.0]",9,31,-22
31108.0,2019-11-07,"(625.0, 874.0]",9,18,-9
31108.0,2019-11-07,"(874.0, 1123.0]",16,28,-12
31108.0,2019-11-07,"(1123.0, 1372.0]",14,16,-2
31109.0,2019-11-07,"(29.594, 382.5]",2,3,-1
31109.0,2019-11-07,"(382.5, 734.0]",5,19,-14
31109.0,2019-11-07,"(734.0, 1085.5]",16,24,-8
31109.0,2019-11-07,"(1085.5, 1437.0]",8,12,-4
31110.0,2019-11-07,"(13.683, 344.25]",3,3,0
31110.0,2019-11-07,"(344.25, 673.5]",22,48,-26
31110.0,2019-11-07,"(673.5, 1002.75]",22,40,-18
31110.0,2019-11-07,"(1002.75, 1332.0]",9,21,-12
31111.0,2019-11-07,"(17.597, 369.75]",1,4,-3
31111.0,2019-11-07,"(369.75, 720.5]",9,24,-15
31111.0,2019-11-07,"(720.5, 1071.25]",10,15,-5
31111.0,2019-11-07,"(1071.25, 1422.0]",15,27,-12
31112.0,2019-11-07,"(23.843, 314.25]",1,1,0
31112.0,2019-11-07,"(314.25, 603.5]",3,11,-8
31112.0,2019-11-07,"(603.5, 892.75]",2,2,0
31112.0,2019-11-07,"(892.75, 1182.0]",5,6,-1
31113.0,2019-11-07,"(92.723, 413.25]",2,12,-10
31113.0,2019-11-07,"(413.25, 732.5]",4,17,-13
31113.0,2019-11-07,"(732.5, 1051.75]",4,14,-10
31113.0,2019-11-07,"(1051.75, 1371.0]",6,12,-6
31114.0,2019-11-07,"(431.006, 680.5]",1,29,-28
31114.0,2019-11-07,"(680.5, 929.0]",9,20,-11
31114.0,2019-11-07,"(929.0, 1177.5]",13,20,-7
31114.0,2019-11-07,"(1177.5, 1426.0]",13,24,-11
31115.0,2019-11-07,"(245.899, 522.25]",2,21,-19
31115.0,2019-11-07,"(522.25, 797.5]",2,11,-9
31115.0,2019-11-07,"(797.5, 1072.75]",6,7,-1
31115.0,2019-11-07,"(1072.75, 1348.0]",8,14,-6
31116.0,2019-11-07,"(58.641, 399.75]",3,7,-4
31116.0,2019-11-07,"(399.75, 739.5]",9,33,-24
31116.0,2019-11-07,"(739.5, 1079.25]",16,23,-7
31116.0,2019-11-07,"(1079.25, 1419.0]",13,18,-5
31117.0,2019-11-07,"(354.02, 600.0]",3,15,-12
31117.0,2019-11-07,"(600.0, 845.0]",4,15,-11
31117.0,2019-11-07,"(845.0, 1090.0]",4,11,-7
31117.0,2019-11-07,"(1090.0, 1335.0]",7,10,-3
31118.0,2019-11-07,"(398.022, 643.5]",1,17,-16
31118.0,2019-11-07,"(888.0, 1132.5]",9,6,3
31118.0,2019-11-07,"(1132.5, 1377.0]",9,11,-2
31119.0,2019-11-07,"(41.701, 367.75]",3,4,-1
31119.0,2019-11-07,"(367.75, 692.5]",8,29,-21
31119.0,2019-11-07,"(692.5, 1017.25]",9,18,-9
31119.0,2019-11-07,"(1017.25, 1342.0]",19,25,-6
31120.0,2019-11-07,"(34.709, 358.75]",1,1,0
31120.0,2019-11-07,"(358.75, 681.5]",4,26,-22
31120.0,2019-11-07,"(681.5, 1004.25]",6,10,-4
31120.0,2019-11-07,"(1004.25, 1327.0]",7,8,-1
31121.0,2019-11-07,"(11.622, 357.5]",1,3,-2
31121.0,2019-11-07,"(357.5, 702.0]",13,23,-10
31121.0,2019-11-07,"(702.0, 1046.5]",6,13,-7
31121.0,2019-11-07,"(1046.5, 1391.0]",4,16,-12
31122.0,2019-11-07,"(21.591, 375.25]",1,2,-1
31122.0,2019-11-07,"(375.25, 727.5]",2,19,-17
31122.0,2019-11-07,"(727.5, 1079.75]",7,12,-5
31122.0,2019-11-07,"(1079.75, 1432.0]",6,13,-7
31123.0,2019-11-07,"(3.656, 341.0]",5,6,-1
31123.0,2019-11-07,"(677.0, 1013.0]",3,18,-15
31123.0,2019-11-07,"(1013.0, 1349.0]",6,13,-7
31124.0,2019-11-07,"(2.581, 358.75]",2,3,-1
31124.0,2019-11-07,"(358.75, 713.5]",29,69,-40
31124.0,2019-11-07,"(713.5, 1068.25]",15,48,-33
31124.0,2019-11-07,"(1068.25, 1423.0]",10,34,-24
31125.0,2019-11-07,"(11.574, 369.5]",2,3,-1
31125.0,2019-11-07,"(369.5, 726.0]",6,30,-24
31125.0,2019-11-07,"(726.0, 1082.5]",24,36,-12
31125.0,2019-11-07,"(1082.5, 1439.0]",10,16,-6
31126.0,2019-11-07,"(330.895, 608.25]",5,29,-24
31126.0,2019-11-07,"(608.25, 884.5]",5,16,-11
31126.0,2019-11-07,"(884.5, 1160.75]",13,20,-7
31126.0,2019-11-07,"(1160.75, 1437.0]",10,13,-3
31127.0,2019-11-07,"(380.966, 640.5]",13,21,-8
31127.0,2019-11-07,"(640.5, 899.0]",15,29,-14
31127.0,2019-11-07,"(899.0, 1157.5]",12,21,-9
31127.0,2019-11-07,"(1157.5, 1416.0]",2,9,-7
31128.0,2019-11-07,"(77.705, 402.75]",4,5,-1
31128.0,2019-11-07,"(402.75, 726.5]",39,56,-17
31128.0,2019-11-07,"(726.5, 1050.25]",17,31,-14
31128.0,2019-11-07,"(1050.25, 1374.0]",5,16,-11
31129.0,2019-11-07,"(426.159, 637.25]",17,20,-3
31129.0,2019-11-07,"(637.25, 847.5]",11,21,-10
31129.0,2019-11-07,"(847.5, 1057.75]",10,22,-12
31129.0,2019-11-07,"(1057.75, 1268.0]",1,1,0
31130.0,2019-11-07,"(9.731, 328.25]",1,1,0
31130.0,2019-11-07,"(328.25, 645.5]",6,25,-19
31130.0,2019-11-07,"(645.5, 962.75]",8,15,-7
31130.0,2019-11-07,"(962.75, 1280.0]",3,9,-6
31131.0,2019-11-07,"(13.703, 339.25]",1,1,0
31131.0,2019-11-07,"(663.5, 987.75]",5,17,-12
31131.0,2019-11-07,"(987.75, 1312.0]",3,8,-5
31200.0,2019-11-07,"(336.99, 590.5]",33,49,-16
31200.0,2019-11-07,"(590.5, 843.0]",17,31,-14
31200.0,2019-11-07,"(843.0, 1095.5]",17,32,-15
31200.0,2019-11-07,"(1095.5, 1348.0]",11,31,-20
31201.0,2019-11-07,"(294.909, 568.75]",19,44,-25
31201.0,2019-11-07,"(568.75, 841.5]",28,48,-20
31201.0,2019-11-07,"(841.5, 1114.25]",28,49,-21
31201.0,2019-11-07,"(1114.25, 1387.0]",9,25,-16
31202.0,2019-11-07,"(366.25, 723.5]",11,1,10
31202.0,2019-11-07,"(723.5, 1080.75]",29,22,7
31202.0,2019-11-07,"(1080.75, 1438.0]",11,46,-35
31203.0,2019-11-07,"(3.576, 361.0]",2,4,-2
31203.0,2019-11-07,"(361.0, 717.0]",13,32,-19
31203.0,2019-11-07,"(717.0, 1073.0]",28,43,-15
31203.0,2019-11-07,"(1073.0, 1429.0]",14,27,-13
31204.0,2019-11-07,"(4.596, 357.0]",1,2,-1
31204.0,2019-11-07,"(357.0, 708.0]",16,21,-5
31204.0,2019-11-07,"(708.0, 1059.0]",10,34,-24
31204.0,2019-11-07,"(1059.0, 1410.0]",4,7,-3
31205.0,2019-11-07,"(423.049, 661.75]",42,51,-9
31205.0,2019-11-07,"(661.75, 899.5]",14,25,-11
31205.0,2019-11-07,"(899.5, 1137.25]",9,25,-16
31205.0,2019-11-07,"(1137.25, 1375.0]",2,10,-8
31206.0,2019-11-07,"(382.336, 549.0]",13,13,0
31206.0,2019-11-07,"(881.0, 1047.0]",4,2,2
31207.0,2019-11-07,"(535.25, 731.5]",3,7,-4
31207.0,2019-11-07,"(731.5, 927.75]",3,6,-3
31207.0,2019-11-07,"(927.75, 1124.0]",1,5,-4
31208.0,2019-11-07,"(315.179, 521.25]",14,17,-3
31208.0,2019-11-07,"(521.25, 726.5]",2,2,0
31208.0,2019-11-07,"(726.5, 931.75]",5,10,-5
31208.0,2019-11-07,"(931.75, 1137.0]",2,8,-6
31209.0,2019-11-07,"(410.213, 607.75]",3,4,-1
31209.0,2019-11-07,"(607.75, 804.5]",1,2,-1
31209.0,2019-11-07,"(804.5, 1001.25]",3,7,-4
31209.0,2019-11-07,"(1001.25, 1198.0]",2,3,-1
31211.0,2019-11-07,"(392.063, 627.25]",16,24,-8
31211.0,2019-11-07,"(627.25, 861.5]",2,7,-5
31211.0,2019-11-07,"(861.5, 1095.75]",6,8,-2
31211.0,2019-11-07,"(1095.75, 1330.0]",5,10,-5
31212.0,2019-11-07,"(8.648, 348.0]",1,2,-1
31212.0,2019-11-07,"(348.0, 686.0]",40,61,-21
31212.0,2019-11-07,"(686.0, 1024.0]",19,36,-17
31212.0,2019-11-07,"(1024.0, 1362.0]",9,16,-7
31213.0,2019-11-07,"(274.973, 532.75]",29,39,-10
31213.0,2019-11-07,"(532.75, 789.5]",16,31,-15
31213.0,2019-11-07,"(789.5, 1046.25]",13,21,-8
31213.0,2019-11-07,"(1046.25, 1303.0]",5,14,-9
31214.0,2019-11-07,"(-1.41, 352.5]",1,2,-1
31214.0,2019-11-07,"(352.5, 705.0]",9,36,-27
31214.0,2019-11-07,"(705.0, 1057.5]",20,35,-15
31214.0,2019-11-07,"(1057.5, 1410.0]",12,23,-11
31215.0,2019-11-07,"(346.982, 602.5]",32,39,-7
31215.0,2019-11-07,"(602.5, 857.0]",9,13,-4
31215.0,2019-11-07,"(857.0, 1111.5]",7,18,-11
31215.0,2019-11-07,"(1111.5, 1366.0]",2,7,-5
31216.0,2019-11-07,"(438.029, 681.75]",22,24,-2
31216.0,2019-11-07,"(681.75, 924.5]",4,11,-7
31216.0,2019-11-07,"(924.5, 1167.25]",7,22,-15
31216.0,2019-11-07,"(1167.25, 1410.0]",1,8,-7
31217.0,2019-11-07,"(316.984, 572.0]",13,15,-2
31217.0,2019-11-07,"(572.0, 826.0]",6,8,-2
31217.0,2019-11-07,"(826.0, 1080.0]",1,10,-9
31218.0,2019-11-07,"(328.096, 555.0]",22,44,-22
31218.0,2019-11-07,"(555.0, 781.0]",7,12,-5
31218.0,2019-11-07,"(781.0, 1007.0]",7,13,-6
31218.0,2019-11-07,"(1007.0, 1233.0]",4,9,-5
31219.0,2019-11-07,"(346.088, 575.0]",17,20,-3
31219.0,2019-11-07,"(575.0, 803.0]",7,10,-3
31219.0,2019-11-07,"(803.0, 1031.0]",8,19,-11
31220.0,2019-11-07,"(314.153, 526.75]",15,16,-1
31220.0,2019-11-07,"(526.75, 738.5]",2,6,-4
31220.0,2019-11-07,"(738.5, 950.25]",3,7,-4
31220.0,2019-11-07,"(950.25, 1162.0]",5,20,-15
31221.0,2019-11-07,"(386.048, 625.0]",32,37,-5
31221.0,2019-11-07,"(625.0, 863.0]",15,31,-16
31221.0,2019-11-07,"(863.0, 1101.0]",11,34,-23
31221.0,2019-11-07,"(1101.0, 1339.0]",4,10,-6
31222.0,2019-11-07,"(426.145, 640.75]",19,21,-2
31222.0,2019-11-07,"(640.75, 854.5]",12,24,-12
31222.0,2019-11-07,"(854.5, 1068.25]",5,12,-7
31223.0,2019-11-07,"(88.658, 425.5]",3,4,-1
31223.0,2019-11-07,"(425.5, 761.0]",20,53,-33
31223.0,2019-11-07,"(761.0, 1096.5]",15,29,-14
31223.0,2019-11-07,"(1096.5, 1432.0]",3,9,-6
31224.0,2019-11-07,"(427.06, 663.0]",23,27,-4
31224.0,2019-11-07,"(663.0, 898.0]",7,20,-13
31224.0,2019-11-07,"(898.0, 1133.0]",6,12,-6
31225.0,2019-11-07,"(390.002, 640.5]",7,14,-7
31225.0,2019-11-07,"(640.5, 890.0]",8,12,-4
31225.0,2019-11-07,"(890.0, 1139.5]",7,15,-8
31225.0,2019-11-07,"(1139.5, 1389.0]",2,6,-4
31226.0,2019-11-07,"(267.883, 548.25]",6,12,-6
31226.0,2019-11-07,"(548.25, 827.5]",2,7,-5
31226.0,2019-11-07,"(827.5, 1106.75]",4,9,-5
31226.0,2019-11-07,"(1106.75, 1386.0]",2,4,-2
31227.0,2019-11-07,"(415.176, 622.0]",79,86,-7
31227.0,2019-11-07,"(622.0, 828.0]",18,27,-9
31227.0,2019-11-07,"(828.0, 1034.0]",5,16,-11
31227.0,2019-11-07,"(1034.0, 1240.0]",6,19,-13
31228.0,2019-11-07,"(319.058, 555.5]",21,27,-6
31228.0,2019-11-07,"(555.5, 791.0]",16,28,-12
31228.0,2019-11-07,"(791.0, 1026.5]",17,35,-18
31228.0,2019-11-07,"(1026.5, 1262.0]",14,22,-8
31229.0,2019-11-07,"(7.601, 358.75]",3,7,-4
31229.0,2019-11-07,"(358.75, 708.5]",18,66,-48
31229.0,2019-11-07,"(708.5, 1058.25]",23,48,-25
31229.0,2019-11-07,"(1058.25, 1408.0]",19,31,-12
31230.0,2019-11-07,"(328.08, 559.0]",45,53,-8
31230.0,2019-11-07,"(559.0, 789.0]",11,21,-10
31230.0,2019-11-07,"(789.0, 1019.0]",10,25,-15
31230.0,2019-11-07,"(1019.0, 1249.0]",3,18,-15
31231.0,2019-11-07,"(115.702, 441.5]",7,8,-1
31231.0,2019-11-07,"(441.5, 766.0]",24,34,-10
31231.0,2019-11-07,"(766.0, 1090.5]",11,23,-12
31231.0,2019-11-07,"(1090.5, 1415.0]",1,2,-1
31232.0,2019-11-07,"(77.661, 413.75]",2,5,-3
31232.0,2019-11-07,"(413.75, 748.5]",23,34,-11
31232.0,2019-11-07,"(748.5, 1083.25]",16,31,-15
31232.0,2019-11-07,"(1083.25, 1418.0]",5,19,-14
31233.0,2019-11-07,"(367.5, 717.0]",68,1,67
31233.0,2019-11-07,"(717.0, 1066.5]",9,73,-64
31233.0,2019-11-07,"(1066.5, 1416.0]",5,23,-18
31234.0,2019-11-07,"(351.965, 611.75]",26,48,-22
31234.0,2019-11-07,"(611.75, 870.5]",10,17,-7
31234.0,2019-11-07,"(870.5, 1129.25]",13,21,-8
31234.0,2019-11-07,"(1129.25, 1388.0]",5,10,-5
31235.0,2019-11-07,"(523.383, 678.25]",7,7,0
31235.0,2019-11-07,"(832.5, 986.75]",3,7,-4
31235.0,2019-11-07,"(986.75, 1141.0]",3,7,-4
31236.0,2019-11-07,"(407.15, 620.5]",27,33,-6
31236.0,2019-11-07,"(620.5, 833.0]",10,27,-17
31236.0,2019-11-07,"(833.0, 1045.5]",7,27,-20
31236.0,2019-11-07,"(1045.5, 1258.0]",3,7,-4
31237.0,2019-11-07,"(7.579, 364.25]",3,4,-1
31237.0,2019-11-07,"(364.25, 719.5]",15,29,-14
31237.0,2019-11-07,"(719.5, 1074.75]",15,31,-16
31237.0,2019-11-07,"(1074.75, 1430.0]",8,14,-6
31238.0,2019-11-07,"(394.971, 653.25]",23,25,-2
31238.0,2019-11-07,"(653.25, 910.5]",6,17,-11
31238.0,2019-11-07,"(910.5, 1167.75]",6,19,-13
31238.0,2019-11-07,"(1167.75, 1425.0]",3,12,-9
31239.0,2019-11-07,"(7.636, 350.0]",1,2,-1
31239.0,2019-11-07,"(350.0, 691.0]",25,29,-4
31239.0,2019-11-07,"(691.0, 1032.0]",11,24,-13
31239.0,2019-11-07,"(1032.0, 1373.0]",7,23,-16
31240.0,2019-11-07,"(98.866, 383.5]",2,4,-2
31240.0,2019-11-07,"(383.5, 667.0]",2,4,-2
31240.0,2019-11-07,"(667.0, 950.5]",18,29,-11
31240.0,2019-11-07,"(950.5, 1234.0]",7,9,-2
31241.0,2019-11-07,"(-1.41, 352.5]",1,6,-5
31241.0,2019-11-07,"(352.5, 705.0]",27,71,-44
31241.0,2019-11-07,"(705.0, 1057.5]",15,39,-24
31241.0,2019-11-07,"(1057.5, 1410.0]",15,34,-19
31242.0,2019-11-07,"(398.075, 630.25]",29,30,-1
31242.0,2019-11-07,"(630.25, 861.5]",12,22,-10
31242.0,2019-11-07,"(861.5, 1092.75]",9,24,-15
31242.0,2019-11-07,"(1092.75, 1324.0]",1,11,-10
31243.0,2019-11-07,"(374.994, 627.5]",27,31,-4
31243.0,2019-11-07,"(627.5, 879.0]",6,9,-3
31243.0,2019-11-07,"(879.0, 1130.5]",13,36,-23
31243.0,2019-11-07,"(1130.5, 1382.0]",1,4,-3
31244.0,2019-11-07,"(106.742, 422.5]",1,4,-3
31244.0,2019-11-07,"(422.5, 737.0]",19,37,-18
31244.0,2019-11-07,"(737.0, 1051.5]",12,25,-13
31244.0,2019-11-07,"(1051.5, 1366.0]",8,15,-7
31245.0,2019-11-07,"(44.618, 391.5]",2,3,-1
31245.0,2019-11-07,"(391.5, 737.0]",13,33,-20
31245.0,2019-11-07,"(737.0, 1082.5]",22,35,-13
31245.0,2019-11-07,"(1082.5, 1428.0]",9,19,-10
31246.0,2019-11-07,"(235.933, 503.75]",8,9,-1
31246.0,2019-11-07,"(503.75, 770.5]",17,35,-18
31246.0,2019-11-07,"(770.5, 1037.25]",18,30,-12
31246.0,2019-11-07,"(1037.25, 1304.0]",13,31,-18
31247.0,2019-11-07,"(319.924, 590.0]",15,26,-11
31247.0,2019-11-07,"(590.0, 859.0]",6,15,-9
31247.0,2019-11-07,"(859.0, 1128.0]",19,27,-8
31247.0,2019-11-07,"(1128.0, 1397.0]",6,9,-3
31248.0,2019-11-07,"(344.203, 544.25]",15,23,-8
31248.0,2019-11-07,"(544.25, 743.5]",12,17,-5
31248.0,2019-11-07,"(743.5, 942.75]",7,22,-15
31248.0,2019-11-07,"(942.75, 1142.0]",13,28,-15
31249.0,2019-11-07,"(392.332, 560.0]",9,17,-8
31249.0,2019-11-07,"(560.0, 727.0]",4,7,-3
31249.0,2019-11-07,"(727.0, 894.0]",6,12,-6
31249.0,2019-11-07,"(894.0, 1061.0]",5,9,-4
31250.0,2019-11-07,"(398.074, 630.5]",22,27,-5
31250.0,2019-11-07,"(630.5, 862.0]",5,10,-5
31250.0,2019-11-07,"(862.0, 1093.5]",4,17,-13
31250.0,2019-11-07,"(1093.5, 1325.0]",1,4,-3
31251.0,2019-11-07,"(243.808, 543.0]",22,35,-13
31251.0,2019-11-07,"(543.0, 841.0]",19,34,-15
31251.0,2019-11-07,"(841.0, 1139.0]",11,22,-11
31251.0,2019-11-07,"(1139.0, 1437.0]",8,9,-1
31252.0,2019-11-07,"(399.112, 622.0]",18,19,-1
31252.0,2019-11-07,"(622.0, 844.0]",10,13,-3
31252.0,2019-11-07,"(844.0, 1066.0]",7,15,-8
31252.0,2019-11-07,"(1066.0, 1288.0]",1,10,-9
31253.0,2019-11-07,"(415.012, 663.0]",27,34,-7
31253.0,2019-11-07,"(663.0, 910.0]",4,9,-5
31253.0,2019-11-07,"(910.0, 1157.0]",6,18,-12
31253.0,2019-11-07,"(1157.0, 1404.0]",2,7,-5
31254.0,2019-11-07,"(342.035, 584.25]",19,21,-2
31254.0,2019-11-07,"(584.25, 825.5]",11,16,-5
31254.0,2019-11-07,"(825.5, 1066.75]",3,14,-11
31254.0,2019-11-07,"(1066.75, 1308.0]",1,7,-6
31255.0,2019-11-07,"(28.648, 368.0]",1,2,-1
31255.0,2019-11-07,"(368.0, 706.0]",17,29,-12
31255.0,2019-11-07,"(706.0, 1044.0]",5,10,-5
31255.0,2019-11-07,"(1044.0, 1382.0]",11,15,-4
31256.0,2019-11-07,"(288.975, 546.25]",13,13,0
31256.0,2019-11-07,"(546.25, 802.5]",2,4,-2
31256.0,2019-11-07,"(802.5, 1058.75]",7,14,-7
31256.0,2019-11-07,"(1058.75, 1315.0]",2,8,-6
31257.0,2019-11-07,"(-0.389, 348.25]",1,3,-2
31257.0,2019-11-07,"(348.25, 695.5]",26,38,-12
31257.0,2019-11-07,"(695.5, 1042.75]",14,27,-13
31257.0,2019-11-07,"(1042.75, 1390.0]",11,30,-19
31258.0,2019-11-07,"(411.25, 743.5]",13,1,12
31258.0,2019-11-07,"(743.5, 1075.75]",31,26,5
31258.0,2019-11-07,"(1075.75, 1408.0]",6,55,-49
31259.0,2019-11-07,"(409.997, 661.75]",17,18,-1
31259.0,2019-11-07,"(661.75, 912.5]",11,16,-5
31259.0,2019-11-07,"(912.5, 1163.25]",1,10,-9
31260.0,2019-11-07,"(363.96, 625.0]",21,30,-9
31260.0,2019-11-07,"(625.0, 885.0]",5,9,-4
31260.0,2019-11-07,"(885.0, 1145.0]",5,16,-11
31260.0,2019-11-07,"(1145.0, 1405.0]",3,7,-4
31261.0,2019-11-07,"(423.115, 645.25]",16,19,-3
31261.0,2019-11-07,"(645.25, 866.5]",1,3,-2
31261.0,2019-11-07,"(866.5, 1087.75]",2,9,-7
31261.0,2019-11-07,"(1087.75, 1309.0]",2,2,0
31262.0,2019-11-07,"(318.931, 587.25]",11,12,-1
31262.0,2019-11-07,"(587.25, 854.5]",7,10,-3
31262.0,2019-11-07,"(854.5, 1121.75]",4,13,-9
31262.0,2019-11-07,"(1121.75, 1389.0]",2,4,-2
31263.0,2019-11-07,"(356.998, 608.5]",31,47,-16
31263.0,2019-11-07,"(608.5, 859.0]",13,20,-7
31263.0,2019-11-07,"(859.0, 1109.5]",8,25,-17
31263.0,2019-11-07,"(1109.5, 1360.0]",1,5,-4
31264.0,2019-11-07,"(413.022, 658.5]",21,29,-8
31264.0,2019-11-07,"(658.5, 903.0]",13,24,-11
31264.0,2019-11-07,"(903.0, 1147.5]",9,19,-10
31264.0,2019-11-07,"(1147.5, 1392.0]",2,3,-1
31265.0,2019-11-07,"(10.575, 368.25]",3,5,-2
31265.0,2019-11-07,"(368.25, 724.5]",25,57,-32
31265.0,2019-11-07,"(724.5, 1080.75]",19,36,-17
31265.0,2019-11-07,"(1080.75, 1437.0]",14,25,-11
31266.0,2019-11-07,"(44.627, 389.25]",4,10,-6
31266.0,2019-11-07,"(389.25, 732.5]",10,28,-18
31266.0,2019-11-07,"(732.5, 1075.75]",24,46,-22
31266.0,2019-11-07,"(1075.75, 1419.0]",16,25,-9
31267.0,2019-11-07,"(1.613, 349.75]",1,1,0
31267.0,2019-11-07,"(349.75, 696.5]",39,66,-27
31267.0,2019-11-07,"(696.5, 1043.25]",23,43,-20
31267.0,2019-11-07,"(1043.25, 1390.0]",13,28,-15
31268.0,2019-11-07,"(24.595, 377.25]",6,9,-3
31268.0,2019-11-07,"(377.25, 728.5]",13,47,-34
31268.0,2019-11-07,"(728.5, 1079.75]",10,15,-5
31268.0,2019-11-07,"(1079.75, 1431.0]",15,22,-7
31269.0,2019-11-07,"(377.003, 627.25]",11,20,-9
31269.0,2019-11-07,"(627.25, 876.5]",5,7,-2
31269.0,2019-11-07,"(876.5, 1125.75]",8,18,-10
31269.0,2019-11-07,"(1125.75, 1375.0]",4,8,-4
31270.0,2019-11-07,"(428.074, 660.5]",18,24,-6
31270.0,2019-11-07,"(660.5, 892.0]",6,13,-7
31270.0,2019-11-07,"(892.0, 1123.5]",12,21,-9
31270.0,2019-11-07,"(1123.5, 1355.0]",2,3,-1
31271.0,2019-11-07,"(381.126, 600.5]",16,19,-3
31271.0,2019-11-07,"(600.5, 819.0]",5,12,-7
31271.0,2019-11-07,"(819.0, 1037.5]",9,17,-8
31271.0,2019-11-07,"(1037.5, 1256.0]",2,8,-6
31272.0,2019-11-07,"(301.917, 573.75]",35,38,-3
31272.0,2019-11-07,"(573.75, 844.5]",10,13,-3
31272.0,2019-11-07,"(844.5, 1115.25]",4,28,-24
31272.0,2019-11-07,"(1115.25, 1386.0]",1,2,-1
31273.0,2019-11-07,"(351.302, 526.5]",2,7,-5
31273.0,2019-11-07,"(526.5, 701.0]",2,2,0
31273.0,2019-11-07,"(701.0, 875.5]",5,10,-5
31273.0,2019-11-07,"(875.5, 1050.0]",2,3,-1
31274.0,2019-11-07,"(392.961, 653.75]",20,24,-4
31274.0,2019-11-07,"(653.75, 913.5]",4,7,-3
31274.0,2019-11-07,"(913.5, 1173.25]",10,20,-10
31274.0,2019-11-07,"(1173.25, 1433.0]",1,7,-6
31275.0,2019-11-07,"(-1.393, 348.25]",3,3,0
31275.0,2019-11-07,"(348.25, 696.5]",24,43,-19
31275.0,2019-11-07,"(696.5, 1044.75]",25,45,-20
31275.0,2019-11-07,"(1044.75, 1393.0]",7,20,-13
31276.0,2019-11-07,"(408.056, 645.0]",25,28,-3
31276.0,2019-11-07,"(645.0, 881.0]",9,17,-8
31276.0,2019-11-07,"(881.0, 1117.0]",2,16,-14
31276.0,2019-11-07,"(1117.0, 1353.0]",4,11,-7
31277.0,2019-11-07,"(382.957, 644.75]",42,48,-6
31277.0,2019-11-07,"(644.75, 905.5]",23,34,-11
31277.0,2019-11-07,"(905.5, 1166.25]",7,26,-19
31278.0,2019-11-07,"(377.011, 625.25]",7,31,-24
31278.0,2019-11-07,"(625.25, 872.5]",8,17,-9
31278.0,2019-11-07,"(872.5, 1119.75]",10,17,-7
31278.0,2019-11-07,"(1119.75, 1367.0]",6,8,-2
31279.0,2019-11-07,"(468.26, 654.0]",26,29,-3
31279.0,2019-11-07,"(654.0, 839.0]",6,13,-7
31279.0,2019-11-07,"(839.0, 1024.0]",11,23,-12
31279.0,2019-11-07,"(1024.0, 1209.0]",5,20,-15
31280.0,2019-11-07,"(19.597, 371.75]",1,2,-1
31280.0,2019-11-07,"(371.75, 722.5]",7,34,-27
31280.0,2019-11-07,"(722.5, 1073.25]",5,8,-3
31280.0,2019-11-07,"(1073.25, 1424.0]",12,15,-3
31000.0,2019-11-08,"(739.5, 872.75]",1,1,0
31000.0,2019-11-08,"(872.75, 1006.0]",1,2,-1
31001.0,2019-11-08,"(963.0, 1122.0]",1,2,-1
31002.0,2019-11-08,"(390.085, 619.75]",4,7,-3
31002.0,2019-11-08,"(848.5, 1077.25]",3,1,2
31002.0,2019-11-08,"(1077.25, 1306.0]",2,7,-5
31003.0,2019-11-08,"(568.0, 815.0]",2,2,0
31003.0,2019-11-08,"(815.0, 1062.0]",1,3,-2
31003.0,2019-11-08,"(1062.0, 1309.0]",2,1,1
31004.0,2019-11-08,"(661.527, 780.25]",1,2,-1
31004.0,2019-11-08,"(898.5, 1016.75]",2,2,0
31004.0,2019-11-08,"(1016.75, 1135.0]",1,2,-1
31005.0,2019-11-08,"(438.237, 629.75]",3,5,-2
31005.0,2019-11-08,"(629.75, 820.5]",4,7,-3
31005.0,2019-11-08,"(820.5, 1011.25]",1,3,-2
31005.0,2019-11-08,"(1011.25, 1202.0]",1,7,-6
31006.0,2019-11-08,"(638.75, 898.5]",1,2,-1
31006.0,2019-11-08,"(898.5, 1158.25]",4,1,3
31006.0,2019-11-08,"(1158.25, 1418.0]",1,4,-3
31007.0,2019-11-08,"(426.077, 657.75]",5,18,-13
31007.0,2019-11-08,"(657.75, 888.5]",4,9,-5
31007.0,2019-11-08,"(888.5, 1119.25]",14,25,-11
31007.0,2019-11-08,"(1119.25, 1350.0]",2,5,-3
31009.0,2019-11-08,"(430.193, 632.75]",4,5,-1
31009.0,2019-11-08,"(632.75, 834.5]",2,2,0
31009.0,2019-11-08,"(1036.25, 1238.0]",1,2,-1
31010.0,2019-11-08,"(688.5, 750.0]",1,1,0
31011.0,2019-11-08,"(312.076, 544.0]",8,9,-1
31011.0,2019-11-08,"(544.0, 775.0]",1,4,-3
31011.0,2019-11-08,"(775.0, 1006.0]",2,8,-6
31011.0,2019-11-08,"(1006.0, 1237.0]",4,7,-3
31012.0,2019-11-08,"(543.512, 666.0]",4,4,0
31012.0,2019-11-08,"(910.0, 1032.0]",1,1,0
31013.0,2019-11-08,"(784.25, 997.5]",1,2,-1
31013.0,2019-11-08,"(997.5, 1210.75]",3,3,0
31013.0,2019-11-08,"(1210.75, 1424.0]",4,5,-1
31014.0,2019-11-08,"(344.954, 607.5]",18,25,-7
31014.0,2019-11-08,"(607.5, 869.0]",8,13,-5
31014.0,2019-11-08,"(869.0, 1130.5]",9,13,-4
31014.0,2019-11-08,"(1130.5, 1392.0]",3,5,-2
31015.0,2019-11-08,"(97.782, 403.5]",2,2,0
31015.0,2019-11-08,"(403.5, 708.0]",12,13,-1
31015.0,2019-11-08,"(708.0, 1012.5]",4,9,-5
31015.0,2019-11-08,"(1012.5, 1317.0]",7,7,0
31016.0,2019-11-08,"(482.168, 691.0]",3,8,-5
31016.0,2019-11-08,"(691.0, 899.0]",2,2,0
31016.0,2019-11-08,"(899.0, 1107.0]",1,2,-1
31017.0,2019-11-08,"(448.126, 667.5]",4,5,-1
31017.0,2019-11-08,"(667.5, 886.0]",2,4,-2
31017.0,2019-11-08,"(1104.5, 1323.0]",1,5,-4
31018.0,2019-11-08,"(810.0, 989.5]",2,5,-3
31018.0,2019-11-08,"(989.5, 1169.0]",4,1,3
31019.0,2019-11-08,"(1039.0, 1176.0]",1,2,-1
31019.0,2019-11-08,"(1176.0, 1313.0]",1,1,0
31020.0,2019-11-08,"(566.0, 832.5]",1,1,0
31021.0,2019-11-08,"(389.094, 616.5]",2,5,-3
31021.0,2019-11-08,"(616.5, 843.0]",3,7,-4
31021.0,2019-11-08,"(843.0, 1069.5]",2,5,-3
31021.0,2019-11-08,"(1069.5, 1296.0]",3,5,-2
31022.0,2019-11-08,"(414.096, 641.0]",2,4,-2
31022.0,2019-11-08,"(867.0, 1093.0]",5,1,4
31022.0,2019-11-08,"(1093.0, 1319.0]",2,12,-10
31023.0,2019-11-08,"(453.026, 697.5]",1,1,0
31023.0,2019-11-08,"(697.5, 941.0]",1,1,0
31023.0,2019-11-08,"(941.0, 1184.5]",1,2,-1
31024.0,2019-11-08,"(431.125, 650.75]",4,6,-2
31024.0,2019-11-08,"(650.75, 869.5]",4,7,-3
31024.0,2019-11-08,"(869.5, 1088.25]",2,5,-3
31025.0,2019-11-08,"(624.192, 827.0]",2,4,-2
31025.0,2019-11-08,"(1231.0, 1433.0]",1,1,0
31026.0,2019-11-08,"(624.75, 770.5]",1,1,0
31026.0,2019-11-08,"(916.25, 1062.0]",1,1,0
,,,,1.0,
,,,,3.0,
,,,,1.0,
31028.0,2019-11-08,"(458.066, 692.5]",1,3,-2
31028.0,2019-11-08,"(926.0, 1159.5]",2,3,-1
31028.0,2019-11-08,"(1159.5, 1393.0]",1,4,-3
31029.0,2019-11-08,"(471.18, 677.0]",1,11,-10
31029.0,2019-11-08,"(882.0, 1087.0]",3,1,2
31029.0,2019-11-08,"(1087.0, 1292.0]",3,3,0
31030.0,2019-11-08,"(33.604, 384.0]",1,1,0
31030.0,2019-11-08,"(384.0, 733.0]",1,11,-10
31030.0,2019-11-08,"(733.0, 1082.0]",5,6,-1
31030.0,2019-11-08,"(1082.0, 1431.0]",3,4,-1
31031.0,2019-11-08,"(603.5, 854.0]",1,5,-4
31032.0,2019-11-08,"(803.0, 976.0]",1,3,-2
31032.0,2019-11-08,"(976.0, 1149.0]",1,2,-1
31032.0,2019-11-08,"(1149.0, 1322.0]",1,2,-1
,,,,1.0,
,,,,1.0,
31034.0,2019-11-08,"(452.344, 617.0]",1,3,-2
31034.0,2019-11-08,"(617.0, 781.0]",3,4,-1
31034.0,2019-11-08,"(781.0, 945.0]",1,3,-2
31034.0,2019-11-08,"(945.0, 1109.0]",3,4,-1
31035.0,2019-11-08,"(58.748, 373.0]",1,2,-1
31035.0,2019-11-08,"(999.0, 1312.0]",2,2,0
31036.0,2019-11-08,"(758.5, 925.75]",1,4,-3
31036.0,2019-11-08,"(925.75, 1093.0]",2,2,0
31037.0,2019-11-08,"(415.055, 652.25]",11,16,-5
31037.0,2019-11-08,"(652.25, 888.5]",1,4,-3
31037.0,2019-11-08,"(888.5, 1124.75]",2,10,-8
31037.0,2019-11-08,"(1124.75, 1361.0]",3,5,-2
31038.0,2019-11-08,"(521.302, 696.5]",1,3,-2
31038.0,2019-11-08,"(871.0, 1045.5]",2,3,-1
31038.0,2019-11-08,"(1045.5, 1220.0]",1,3,-2
31039.0,2019-11-08,"(471.158, 682.5]",6,13,-7
31039.0,2019-11-08,"(682.5, 893.0]",2,5,-3
31039.0,2019-11-08,"(893.0, 1103.5]",3,9,-6
31039.0,2019-11-08,"(1103.5, 1314.0]",4,5,-1
31040.0,2019-11-08,"(475.438, 616.5]",1,1,0
31040.0,2019-11-08,"(616.5, 757.0]",2,3,-1
31041.0,2019-11-08,"(515.422, 660.5]",6,6,0
31041.0,2019-11-08,"(660.5, 805.0]",1,2,-1
31041.0,2019-11-08,"(949.5, 1094.0]",3,5,-2
31042.0,2019-11-08,"(378.114, 600.5]",8,10,-2
31042.0,2019-11-08,"(822.0, 1043.5]",3,2,1
31042.0,2019-11-08,"(1043.5, 1265.0]",1,14,-13
31043.0,2019-11-08,"(454.331, 622.25]",2,2,0
31043.0,2019-11-08,"(789.5, 956.75]",1,2,-1
31044.0,2019-11-08,"(456.368, 615.0]",4,5,-1
31044.0,2019-11-08,"(615.0, 773.0]",1,1,0
31044.0,2019-11-08,"(931.0, 1089.0]",2,2,0
31045.0,2019-11-08,"(419.374, 576.5]",2,3,-1
31045.0,2019-11-08,"(889.5, 1046.0]",3,8,-5
31046.0,2019-11-08,"(821.25, 963.0]",1,3,-2
31047.0,2019-11-08,"(351.077, 582.75]",14,20,-6
31047.0,2019-11-08,"(582.75, 813.5]",2,7,-5
31047.0,2019-11-08,"(813.5, 1044.25]",6,13,-7
31047.0,2019-11-08,"(1044.25, 1275.0]",8,19,-11
31048.0,2019-11-08,"(773.639, 864.25]",1,1,0
31048.0,2019-11-08,"(954.5, 1044.75]",1,2,-1
31048.0,2019-11-08,"(1044.75, 1135.0]",1,3,-2
31049.0,2019-11-08,"(542.609, 640.75]",1,2,-1
31049.0,2019-11-08,"(738.5, 836.25]",2,1,1
31050.0,2019-11-08,"(22.508, 146.0]",1,2,-1
31050.0,2019-11-08,"(269.0, 392.0]",1,1,0
31051.0,2019-11-08,"(693.5, 887.25]",1,4,-3
31051.0,2019-11-08,"(887.25, 1081.0]",4,1,3
31052.0,2019-11-08,"(384.128, 603.0]",4,6,-2
31052.0,2019-11-08,"(821.0, 1039.0]",1,4,-3
31052.0,2019-11-08,"(1039.0, 1257.0]",3,9,-6
31053.0,2019-11-08,"(1188.5, 1417.0]",1,1,0
,,,,2.0,
31055.0,2019-11-08,"(466.406, 615.5]",1,3,-2
31055.0,2019-11-08,"(615.5, 764.0]",1,1,0
31055.0,2019-11-08,"(912.5, 1061.0]",3,4,-1
31056.0,2019-11-08,"(940.75, 1106.0]",1,2,-1
31057.0,2019-11-08,"(892.5, 1190.0]",1,1,0
,,,,2.0,
31059.0,2019-11-08,"(632.725, 701.75]",1,1,0
31060.0,2019-11-08,"(516.423, 661.25]",2,2,0
31060.0,2019-11-08,"(949.75, 1094.0]",1,1,0
31061.0,2019-11-08,"(396.0, 528.0]",1,1,0
31062.0,2019-11-08,"(756.0, 1008.0]",1,1,0
31063.0,2019-11-08,"(771.791, 824.25]",1,1,0
31063.0,2019-11-08,"(928.75, 981.0]",1,1,0
31064.0,2019-11-08,"(484.429, 627.75]",2,5,-3
31064.0,2019-11-08,"(627.75, 770.5]",3,5,-2
31064.0,2019-11-08,"(913.25, 1056.0]",3,6,-3
31065.0,2019-11-08,"(114.202, 314.5]",1,1,0
31065.0,2019-11-08,"(713.5, 913.0]",1,1,0
31066.0,2019-11-08,"(737.0, 871.5]",2,1,1
31067.0,2019-11-08,"(1114.871, 1147.25]",1,1,0
31067.0,2019-11-08,"(1211.75, 1244.0]",1,2,-1
31068.0,2019-11-08,"(963.0, 1147.5]",3,1,2
31068.0,2019-11-08,"(1147.5, 1332.0]",1,6,-5
31069.0,2019-11-08,"(434.136, 651.0]",1,5,-4
31069.0,2019-11-08,"(867.0, 1083.0]",2,1,1
31069.0,2019-11-08,"(1083.0, 1299.0]",2,3,-1
31070.0,2019-11-08,"(1040.0, 1110.0]",1,2,-1
31070.0,2019-11-08,"(1180.0, 1250.0]",1,1,0
31071.0,2019-11-08,"(304.938, 571.5]",5,12,-7
31071.0,2019-11-08,"(571.5, 837.0]",4,7,-3
31071.0,2019-11-08,"(837.0, 1102.5]",8,14,-6
31071.0,2019-11-08,"(1102.5, 1368.0]",2,3,-1
,,,,1.0,
,,,,1.0,
31073.0,2019-11-08,"(465.518, 586.5]",1,3,-2
31073.0,2019-11-08,"(586.5, 707.0]",1,1,0
31073.0,2019-11-08,"(707.0, 827.5]",1,1,0
31073.0,2019-11-08,"(827.5, 948.0]",2,4,-2
31074.0,2019-11-08,"(846.764, 906.0]",1,1,0
31074.0,2019-11-08,"(1024.0, 1083.0]",2,1,1
31075.0,2019-11-08,"(440.326, 609.5]",1,2,-1
31075.0,2019-11-08,"(946.5, 1115.0]",1,1,0
31076.0,2019-11-08,"(1054.0, 1067.0]",1,1,0
31077.0,2019-11-08,"(543.145, 757.75]",11,15,-4
31077.0,2019-11-08,"(757.75, 971.5]",6,8,-2
31077.0,2019-11-08,"(1185.25, 1399.0]",2,1,1
31078.0,2019-11-08,"(503.417, 649.75]",5,5,0
31078.0,2019-11-08,"(795.5, 941.25]",1,5,-4
31078.0,2019-11-08,"(941.25, 1087.0]",1,3,-2
31079.0,2019-11-08,"(482.091, 710.25]",1,5,-4
31079.0,2019-11-08,"(710.25, 937.5]",2,5,-3
31079.0,2019-11-08,"(937.5, 1164.75]",2,5,-3
31079.0,2019-11-08,"(1164.75, 1392.0]",3,4,-1
31080.0,2019-11-08,"(411.246, 600.5]",2,12,-10
31080.0,2019-11-08,"(600.5, 789.0]",1,1,0
31080.0,2019-11-08,"(977.5, 1166.0]",2,2,0
31081.0,2019-11-08,"(935.0, 1124.0]",4,2,2
,,,,2.0,
31083.0,2019-11-08,"(770.5, 954.75]",1,4,-3
31083.0,2019-11-08,"(954.75, 1139.0]",4,1,3
31084.0,2019-11-08,"(548.241, 738.75]",2,2,0
31084.0,2019-11-08,"(928.5, 1118.25]",2,1,1
31084.0,2019-11-08,"(1118.25, 1308.0]",2,3,-1
31085.0,2019-11-08,"(400.259, 586.25]",1,5,-4
31085.0,2019-11-08,"(771.5, 956.75]",1,2,-1
31085.0,2019-11-08,"(956.75, 1142.0]",2,2,0
31086.0,2019-11-08,"(456.178, 662.5]",1,2,-1
31086.0,2019-11-08,"(662.5, 868.0]",1,3,-2
31086.0,2019-11-08,"(868.0, 1073.5]",1,1,0
31086.0,2019-11-08,"(1073.5, 1279.0]",3,3,0
31087.0,2019-11-08,"(1080.5, 1107.25]",1,2,-1
31088.0,2019-11-08,"(512.434, 654.5]",1,1,0
31088.0,2019-11-08,"(937.5, 1079.0]",3,4,-1
31089.0,2019-11-08,"(392.25, 737.5]",9,1,8
31089.0,2019-11-08,"(737.5, 1082.75]",5,12,-7
31089.0,2019-11-08,"(1082.75, 1428.0]",3,11,-8
31090.0,2019-11-08,"(293.5, 587.0]",1,1,0
31090.0,2019-11-08,"(880.5, 1174.0]",1,1,0
31091.0,2019-11-08,"(874.5, 1109.25]",2,4,-2
31091.0,2019-11-08,"(1109.25, 1344.0]",4,2,2
31092.0,2019-11-08,"(484.398, 635.5]",1,3,-2
31092.0,2019-11-08,"(786.0, 936.5]",1,2,-1
31092.0,2019-11-08,"(936.5, 1087.0]",1,2,-1
31093.0,2019-11-08,"(880.0, 1038.0]",1,4,-3
31094.0,2019-11-08,"(424.0, 636.0]",1,1,0
31094.0,2019-11-08,"(636.0, 848.0]",1,1,0
,,,,1.0,
,,,,1.0,
31096.0,2019-11-08,"(736.5, 982.0]",1,1,0
31097.0,2019-11-08,"(442.322, 612.5]",4,5,-1
31097.0,2019-11-08,"(782.0, 951.5]",1,2,-1
31097.0,2019-11-08,"(951.5, 1121.0]",2,8,-6
31098.0,2019-11-08,"(393.31, 566.5]",2,7,-5
31098.0,2019-11-08,"(566.5, 739.0]",2,3,-1
31098.0,2019-11-08,"(739.0, 911.5]",2,2,0
31098.0,2019-11-08,"(911.5, 1084.0]",8,10,-2
31099.0,2019-11-08,"(800.5, 972.75]",1,2,-1
31099.0,2019-11-08,"(972.75, 1145.0]",2,2,0
31100.0,2019-11-08,"(432.077, 663.75]",13,13,0
31100.0,2019-11-08,"(663.75, 894.5]",3,8,-5
31100.0,2019-11-08,"(894.5, 1125.25]",4,15,-11
31100.0,2019-11-08,"(1125.25, 1356.0]",1,5,-4
31101.0,2019-11-08,"(368.944, 634.0]",10,49,-39
31101.0,2019-11-08,"(634.0, 898.0]",20,32,-12
31101.0,2019-11-08,"(898.0, 1162.0]",40,57,-17
31101.0,2019-11-08,"(1162.0, 1426.0]",11,26,-15
31102.0,2019-11-08,"(357.25, 709.5]",3,3,0
31102.0,2019-11-08,"(709.5, 1061.75]",5,26,-21
31102.0,2019-11-08,"(1061.75, 1414.0]",5,19,-14
31103.0,2019-11-08,"(5.625, 350.75]",2,3,-1
31103.0,2019-11-08,"(350.75, 694.5]",4,36,-32
31103.0,2019-11-08,"(694.5, 1038.25]",11,31,-20
31103.0,2019-11-08,"(1038.25, 1382.0]",6,20,-14
31104.0,2019-11-08,"(16.614, 364.5]",1,4,-3
31104.0,2019-11-08,"(364.5, 711.0]",5,28,-23
31104.0,2019-11-08,"(711.0, 1057.5]",15,29,-14
31104.0,2019-11-08,"(1057.5, 1404.0]",23,33,-10
31105.0,2019-11-08,"(625.0, 851.0]",5,10,-5
31105.0,2019-11-08,"(1077.0, 1303.0]",2,11,-9
31106.0,2019-11-08,"(413.013, 660.75]",1,13,-12
31106.0,2019-11-08,"(660.75, 907.5]",2,4,-2
31106.0,2019-11-08,"(907.5, 1154.25]",1,3,-2
31106.0,2019-11-08,"(1154.25, 1401.0]",1,1,0
31107.0,2019-11-08,"(366.001, 616.75]",6,27,-21
31107.0,2019-11-08,"(616.75, 866.5]",4,9,-5
31107.0,2019-11-08,"(866.5, 1116.25]",11,27,-16
31107.0,2019-11-08,"(1116.25, 1366.0]",9,15,-6
31108.0,2019-11-08,"(343.913, 616.75]",10,34,-24
31108.0,2019-11-08,"(616.75, 888.5]",19,32,-13
31108.0,2019-11-08,"(888.5, 1160.25]",21,37,-16
31108.0,2019-11-08,"(1160.25, 1432.0]",10,14,-4
31109.0,2019-11-08,"(35.632, 379.0]",1,2,-1
31109.0,2019-11-08,"(379.0, 721.0]",8,24,-16
31109.0,2019-11-08,"(721.0, 1063.0]",16,27,-11
31109.0,2019-11-08,"(1063.0, 1405.0]",15,24,-9
31110.0,2019-11-08,"(322.89, 601.5]",24,45,-21
31110.0,2019-11-08,"(601.5, 879.0]",12,25,-13
31110.0,2019-11-08,"(879.0, 1156.5]",19,41,-22
31110.0,2019-11-08,"(1156.5, 1434.0]",4,9,-5
31111.0,2019-11-08,"(41.61, 390.5]",4,5,-1
31111.0,2019-11-08,"(390.5, 738.0]",6,20,-14
31111.0,2019-11-08,"(738.0, 1085.5]",14,23,-9
31111.0,2019-11-08,"(1085.5, 1433.0]",8,12,-4
31112.0,2019-11-08,"(321.197, 522.75]",2,3,-1
31112.0,2019-11-08,"(522.75, 723.5]",2,5,-3
31112.0,2019-11-08,"(723.5, 924.25]",2,4,-2
31112.0,2019-11-08,"(924.25, 1125.0]",4,5,-1
31113.0,2019-11-08,"(3.566, 363.5]",1,2,-1
31113.0,2019-11-08,"(363.5, 722.0]",1,23,-22
31113.0,2019-11-08,"(722.0, 1080.5]",8,20,-12
31113.0,2019-11-08,"(1080.5, 1439.0]",9,18,-9
31114.0,2019-11-08,"(15.587, 370.25]",2,5,-3
31114.0,2019-11-08,"(370.25, 723.5]",4,28,-24
31114.0,2019-11-08,"(723.5, 1076.75]",17,28,-11
31114.0,2019-11-08,"(1076.75, 1430.0]",12,23,-11
31115.0,2019-11-08,"(2.619, 349.25]",1,2,-1
31115.0,2019-11-08,"(349.25, 694.5]",4,25,-21
31115.0,2019-11-08,"(694.5, 1039.75]",6,17,-11
31115.0,2019-11-08,"(1039.75, 1385.0]",9,18,-9
31116.0,2019-11-08,"(40.651, 379.25]",3,5,-2
31116.0,2019-11-08,"(379.25, 716.5]",11,43,-32
31116.0,2019-11-08,"(716.5, 1053.75]",20,29,-9
31116.0,2019-11-08,"(1053.75, 1391.0]",9,12,-3
31117.0,2019-11-08,"(320.91, 594.5]",2,14,-12
31117.0,2019-11-08,"(594.5, 867.0]",3,10,-7
31117.0,2019-11-08,"(867.0, 1139.5]",7,17,-10
31117.0,2019-11-08,"(1139.5, 1412.0]",6,10,-4
31118.0,2019-11-08,"(478.055, 715.25]",5,24,-19
31118.0,2019-11-08,"(715.25, 951.5]",3,7,-4
31118.0,2019-11-08,"(951.5, 1187.75]",12,17,-5
31118.0,2019-11-08,"(1187.75, 1424.0]",2,4,-2
31119.0,2019-11-08,"(248.844, 539.0]",4,21,-17
31119.0,2019-11-08,"(539.0, 828.0]",5,8,-3
31119.0,2019-11-08,"(828.0, 1117.0]",18,32,-14
31119.0,2019-11-08,"(1117.0, 1406.0]",5,10,-5
31120.0,2019-11-08,"(423.027, 667.25]",1,13,-12
31120.0,2019-11-08,"(667.25, 910.5]",3,3,0
31120.0,2019-11-08,"(910.5, 1153.75]",6,14,-8
31120.0,2019-11-08,"(1153.75, 1397.0]",9,12,-3
31121.0,2019-11-08,"(412.996, 665.0]",15,24,-9
31121.0,2019-11-08,"(665.0, 916.0]",2,2,0
31121.0,2019-11-08,"(916.0, 1167.0]",6,15,-9
31122.0,2019-11-08,"(16.734, 334.5]",2,3,-1
31122.0,2019-11-08,"(651.0, 967.5]",6,7,-1
31122.0,2019-11-08,"(967.5, 1284.0]",12,14,-2
31123.0,2019-11-08,"(887.0, 1145.5]",4,16,-12
31123.0,2019-11-08,"(1145.5, 1404.0]",2,1,1
31124.0,2019-11-08,"(358.923, 629.25]",16,33,-17
31124.0,2019-11-08,"(629.25, 898.5]",15,36,-21
31124.0,2019-11-08,"(898.5, 1167.75]",28,60,-32
31124.0,2019-11-08,"(1167.75, 1437.0]",10,32,-22
31125.0,2019-11-08,"(3.598, 355.5]",1,4,-3
31125.0,2019-11-08,"(355.5, 706.0]",6,26,-20
31125.0,2019-11-08,"(706.0, 1056.5]",24,33,-9
31125.0,2019-11-08,"(1056.5, 1407.0]",17,28,-11
31126.0,2019-11-08,"(326.933, 594.75]",8,33,-25
31126.0,2019-11-08,"(594.75, 861.5]",5,26,-21
31126.0,2019-11-08,"(861.5, 1128.25]",14,29,-15
31126.0,2019-11-08,"(1128.25, 1395.0]",9,11,-2
31127.0,2019-11-08,"(41.652, 380.0]",1,1,0
31127.0,2019-11-08,"(380.0, 717.0]",18,28,-10
31127.0,2019-11-08,"(717.0, 1054.0]",17,34,-17
31127.0,2019-11-08,"(1054.0, 1391.0]",9,22,-13
31128.0,2019-11-08,"(305.901, 581.75]",18,25,-7
31128.0,2019-11-08,"(581.75, 856.5]",18,27,-9
31128.0,2019-11-08,"(856.5, 1131.25]",12,29,-17
31128.0,2019-11-08,"(1131.25, 1406.0]",11,14,-3
31129.0,2019-11-08,"(492.056, 729.0]",12,15,-3
31129.0,2019-11-08,"(729.0, 965.0]",9,16,-7
31129.0,2019-11-08,"(965.0, 1201.0]",4,9,-5
31129.0,2019-11-08,"(1201.0, 1437.0]",1,3,-2
31130.0,2019-11-08,"(136.957, 398.75]",1,1,0
31130.0,2019-11-08,"(398.75, 659.5]",2,11,-9
31130.0,2019-11-08,"(659.5, 920.25]",2,5,-3
31130.0,2019-11-08,"(920.25, 1181.0]",17,22,-5
31131.0,2019-11-08,"(433.034, 675.5]",2,13,-11
31131.0,2019-11-08,"(675.5, 917.0]",2,6,-4
31131.0,2019-11-08,"(917.0, 1158.5]",2,8,-6
31131.0,2019-11-08,"(1158.5, 1400.0]",2,5,-3
31200.0,2019-11-08,"(10.58, 367.0]",3,8,-5
31200.0,2019-11-08,"(367.0, 722.0]",45,64,-19
31200.0,2019-11-08,"(722.0, 1077.0]",23,48,-25
31200.0,2019-11-08,"(1077.0, 1432.0]",18,39,-21
31201.0,2019-11-08,"(65.657, 402.75]",3,4,-1
31201.0,2019-11-08,"(402.75, 738.5]",24,50,-26
31201.0,2019-11-08,"(738.5, 1074.25]",47,78,-31
31201.0,2019-11-08,"(1074.25, 1410.0]",23,42,-19
31202.0,2019-11-08,"(316.88, 598.0]",5,22,-17
31202.0,2019-11-08,"(598.0, 878.0]",16,23,-7
31202.0,2019-11-08,"(878.0, 1158.0]",21,37,-16
31202.0,2019-11-08,"(1158.0, 1438.0]",4,9,-5
31203.0,2019-11-08,"(376.25, 721.5]",12,3,9
31203.0,2019-11-08,"(721.5, 1066.75]",39,32,7
31203.0,2019-11-08,"(1066.75, 1412.0]",16,69,-53
31204.0,2019-11-08,"(31.606, 381.5]",2,2,0
31204.0,2019-11-08,"(381.5, 730.0]",14,23,-9
31204.0,2019-11-08,"(730.0, 1078.5]",9,25,-16
31204.0,2019-11-08,"(1078.5, 1427.0]",7,12,-5
31205.0,2019-11-08,"(72.666, 407.5]",1,3,-2
31205.0,2019-11-08,"(407.5, 741.0]",34,43,-9
31205.0,2019-11-08,"(741.0, 1074.5]",12,27,-15
31205.0,2019-11-08,"(1074.5, 1408.0]",7,22,-15
31206.0,2019-11-08,"(387.146, 601.5]",6,6,0
31206.0,2019-11-08,"(815.0, 1028.5]",3,2,1
31207.0,2019-11-08,"(865.0, 1049.0]",1,6,-5
31208.0,2019-11-08,"(346.952, 610.0]",11,19,-8
31208.0,2019-11-08,"(610.0, 872.0]",4,8,-4
31208.0,2019-11-08,"(872.0, 1134.0]",5,10,-5
31208.0,2019-11-08,"(1134.0, 1396.0]",1,4,-3
31209.0,2019-11-08,"(457.176, 664.0]",2,5,-3
31209.0,2019-11-08,"(664.0, 870.0]",3,5,-2
31209.0,2019-11-08,"(1076.0, 1282.0]",2,3,-1
31211.0,2019-11-08,"(471.1, 697.0]",8,9,-1
31211.0,2019-11-08,"(697.0, 922.0]",3,5,-2
31211.0,2019-11-08,"(922.0, 1147.0]",6,15,-9
31211.0,2019-11-08,"(1147.0, 1372.0]",3,6,-3
31212.0,2019-11-08,"(341.25, 655.5]",34,1,33
31212.0,2019-11-08,"(655.5, 969.75]",14,50,-36
31212.0,2019-11-08,"(969.75, 1284.0]",9,33,-24
31213.0,2019-11-08,"(296.958, 558.5]",23,31,-8
31213.0,2019-11-08,"(558.5, 819.0]",11,21,-10
31213.0,2019-11-08,"(819.0, 1079.5]",13,25,-12
31213.0,2019-11-08,"(1079.5, 1340.0]",10,23,-13
31214.0,2019-11-08,"(96.697, 423.75]",1,5,-4
31214.0,2019-11-08,"(423.75, 749.5]",10,39,-29
31214.0,2019-11-08,"(749.5, 1075.25]",27,43,-16
31214.0,2019-11-08,"(1075.25, 1401.0]",14,24,-10
31215.0,2019-11-08,"(381.963, 642.25]",27,28,-1
31215.0,2019-11-08,"(642.25, 901.5]",5,11,-6
31215.0,2019-11-08,"(901.5, 1160.75]",13,22,-9
31215.0,2019-11-08,"(1160.75, 1420.0]",1,10,-9
31216.0,2019-11-08,"(486.125, 705.75]",18,21,-3
31216.0,2019-11-08,"(705.75, 924.5]",3,8,-5
31216.0,2019-11-08,"(924.5, 1143.25]",7,24,-17
31216.0,2019-11-08,"(1143.25, 1362.0]",2,6,-4
31217.0,2019-11-08,"(373.218, 569.5]",9,10,-1
31217.0,2019-11-08,"(765.0, 960.5]",7,3,4
31217.0,2019-11-08,"(960.5, 1156.0]",1,12,-11
31218.0,2019-11-08,"(320.896, 598.0]",12,23,-11
31218.0,2019-11-08,"(598.0, 874.0]",4,7,-3
31218.0,2019-11-08,"(874.0, 1150.0]",8,15,-7
31219.0,2019-11-08,"(435.37, 593.5]",10,10,0
31219.0,2019-11-08,"(593.5, 751.0]",8,11,-3
31219.0,2019-11-08,"(751.0, 908.5]",8,13,-5
31219.0,2019-11-08,"(908.5, 1066.0]",8,22,-14
31220.0,2019-11-08,"(380.257, 566.75]",15,16,-1
31220.0,2019-11-08,"(752.5, 938.25]",2,1,1
31220.0,2019-11-08,"(938.25, 1124.0]",1,10,-9
31221.0,2019-11-08,"(63.632, 407.0]",3,4,-1
31221.0,2019-11-08,"(407.0, 749.0]",32,35,-3
31221.0,2019-11-08,"(749.0, 1091.0]",23,44,-21
31221.0,2019-11-08,"(1091.0, 1433.0]",6,16,-10
31222.0,2019-11-08,"(66.752, 380.0]",1,1,0
31222.0,2019-11-08,"(380.0, 692.0]",16,18,-2
31222.0,2019-11-08,"(692.0, 1004.0]",11,23,-12
31222.0,2019-11-08,"(1004.0, 1316.0]",4,21,-17
31223.0,2019-11-08,"(0.584, 356.0]",1,5,-4
31223.0,2019-11-08,"(356.0, 710.0]",20,42,-22
31223.0,2019-11-08,"(710.0, 1064.0]",12,29,-17
31223.0,2019-11-08,"(1064.0, 1418.0]",13,20,-7
31224.0,2019-11-08,"(476.091, 704.25]",21,24,-3
31224.0,2019-11-08,"(704.25, 931.5]",2,4,-2
31224.0,2019-11-08,"(931.5, 1158.75]",4,19,-15
31224.0,2019-11-08,"(1158.75, 1386.0]",1,6,-5
31225.0,2019-11-08,"(406.123, 626.25]",14,22,-8
31225.0,2019-11-08,"(626.25, 845.5]",5,11,-6
31225.0,2019-11-08,"(845.5, 1064.75]",5,13,-8
31225.0,2019-11-08,"(1064.75, 1284.0]",5,14,-9
31226.0,2019-11-08,"(388.055, 625.25]",6,12,-6
31226.0,2019-11-08,"(625.25, 861.5]",3,4,-1
31226.0,2019-11-08,"(861.5, 1097.75]",6,14,-8
31226.0,2019-11-08,"(1097.75, 1334.0]",2,6,-4
31227.0,2019-11-08,"(426.079, 657.25]",47,49,-2
31227.0,2019-11-08,"(657.25, 887.5]",13,29,-16
31227.0,2019-11-08,"(887.5, 1117.75]",11,27,-16
31227.0,2019-11-08,"(1117.75, 1348.0]",3,6,-3
31228.0,2019-11-08,"(0.584, 356.0]",1,2,-1
31228.0,2019-11-08,"(356.0, 710.0]",21,33,-12
31228.0,2019-11-08,"(710.0, 1064.0]",28,43,-15
31228.0,2019-11-08,"(1064.0, 1418.0]",17,37,-20
31229.0,2019-11-08,"(18.588, 373.0]",3,7,-4
31229.0,2019-11-08,"(373.0, 726.0]",15,58,-43
31229.0,2019-11-08,"(726.0, 1079.0]",45,68,-23
31229.0,2019-11-08,"(1079.0, 1432.0]",24,44,-20
31230.0,2019-11-08,"(366.01, 614.5]",36,41,-5
31230.0,2019-11-08,"(614.5, 862.0]",10,16,-6
31230.0,2019-11-08,"(862.0, 1109.5]",15,41,-26
31230.0,2019-11-08,"(1109.5, 1357.0]",9,18,-9
31231.0,2019-11-08,"(317.909, 591.75]",16,21,-5
31231.0,2019-11-08,"(591.75, 864.5]",15,22,-7
31231.0,2019-11-08,"(864.5, 1137.25]",8,13,-5
31231.0,2019-11-08,"(1137.25, 1410.0]",1,3,-2
31232.0,2019-11-08,"(36.598, 388.5]",5,8,-3
31232.0,2019-11-08,"(388.5, 739.0]",21,27,-6
31232.0,2019-11-08,"(739.0, 1089.5]",14,33,-19
31232.0,2019-11-08,"(1089.5, 1440.0]",13,27,-14
31233.0,2019-11-08,"(8.653, 346.75]",1,3,-2
31233.0,2019-11-08,"(346.75, 683.5]",48,58,-10
31233.0,2019-11-08,"(683.5, 1020.25]",6,17,-11
31233.0,2019-11-08,"(1020.25, 1357.0]",8,16,-8
31234.0,2019-11-08,"(307.898, 584.5]",10,24,-14
31234.0,2019-11-08,"(584.5, 860.0]",11,16,-5
31234.0,2019-11-08,"(860.0, 1135.5]",25,40,-15
31234.0,2019-11-08,"(1135.5, 1411.0]",2,7,-5
31235.0,2019-11-08,"(531.478, 662.5]",7,8,-1
31235.0,2019-11-08,"(793.0, 923.5]",3,4,-1
31235.0,2019-11-08,"(923.5, 1054.0]",1,3,-2
31236.0,2019-11-08,"(86.66, 423.0]",2,3,-1
31236.0,2019-11-08,"(423.0, 758.0]",14,21,-7
31236.0,2019-11-08,"(758.0, 1093.0]",13,38,-25
31236.0,2019-11-08,"(1093.0, 1428.0]",3,10,-7
31237.0,2019-11-08,"(3.635, 346.25]",4,7,-3
31237.0,2019-11-08,"(346.25, 687.5]",8,22,-14
31237.0,2019-11-08,"(687.5, 1028.75]",27,47,-20
31237.0,2019-11-08,"(1028.75, 1370.0]",14,33,-19
31238.0,2019-11-08,"(13.714, 336.5]",1,2,-1
31238.0,2019-11-08,"(336.5, 658.0]",22,27,-5
31238.0,2019-11-08,"(658.0, 979.5]",13,31,-18
31238.0,2019-11-08,"(979.5, 1301.0]",7,30,-23
31239.0,2019-11-08,"(381.75, 667.5]",20,1,19
31239.0,2019-11-08,"(667.5, 953.25]",4,21,-17
31239.0,2019-11-08,"(953.25, 1239.0]",10,10,0
31240.0,2019-11-08,"(640.466, 774.5]",5,12,-7
31240.0,2019-11-08,"(908.0, 1041.5]",5,8,-3
31240.0,2019-11-08,"(1041.5, 1175.0]",3,5,-2
31241.0,2019-11-08,"(387.5, 731.0]",28,2,26
31241.0,2019-11-08,"(731.0, 1074.5]",19,57,-38
31241.0,2019-11-08,"(1074.5, 1418.0]",13,39,-26
31242.0,2019-11-08,"(313.905, 588.75]",22,23,-1
31242.0,2019-11-08,"(588.75, 862.5]",10,21,-11
31242.0,2019-11-08,"(862.5, 1136.25]",5,16,-11
31242.0,2019-11-08,"(1136.25, 1410.0]",1,6,-5
31243.0,2019-11-08,"(376.259, 562.25]",17,22,-5
31243.0,2019-11-08,"(562.25, 747.5]",6,10,-4
31243.0,2019-11-08,"(747.5, 932.75]",13,24,-11
31243.0,2019-11-08,"(932.75, 1118.0]",4,24,-20
31244.0,2019-11-08,"(349.994, 602.5]",16,21,-5
31244.0,2019-11-08,"(602.5, 854.0]",4,10,-6
31244.0,2019-11-08,"(854.0, 1105.5]",7,16,-9
31244.0,2019-11-08,"(1105.5, 1357.0]",3,7,-4
31245.0,2019-11-08,"(38.73, 357.5]",1,4,-3
31245.0,2019-11-08,"(357.5, 675.0]",17,32,-15
31245.0,2019-11-08,"(675.0, 992.5]",12,20,-8
31245.0,2019-11-08,"(992.5, 1310.0]",11,23,-12
31246.0,2019-11-08,"(462.077, 693.75]",21,28,-7
31246.0,2019-11-08,"(693.75, 924.5]",5,11,-6
31246.0,2019-11-08,"(924.5, 1155.25]",16,31,-15
31246.0,2019-11-08,"(1155.25, 1386.0]",5,11,-6
31247.0,2019-11-08,"(360.073, 592.75]",10,14,-4
31247.0,2019-11-08,"(592.75, 824.5]",14,25,-11
31247.0,2019-11-08,"(824.5, 1056.25]",20,37,-17
31247.0,2019-11-08,"(1056.25, 1288.0]",6,12,-6
31248.0,2019-11-08,"(386.07, 619.5]",11,18,-7
31248.0,2019-11-08,"(619.5, 852.0]",17,33,-16
31248.0,2019-11-08,"(852.0, 1084.5]",17,36,-19
31248.0,2019-11-08,"(1084.5, 1317.0]",4,7,-3
31249.0,2019-11-08,"(23.9, 300.0]",3,6,-3
31249.0,2019-11-08,"(300.0, 575.0]",6,10,-4
31249.0,2019-11-08,"(575.0, 850.0]",9,20,-11
31249.0,2019-11-08,"(850.0, 1125.0]",6,14,-8
31250.0,2019-11-08,"(390.039, 631.25]",23,27,-4
31250.0,2019-11-08,"(631.25, 871.5]",6,15,-9
31250.0,2019-11-08,"(871.5, 1111.75]",4,18,-14
31250.0,2019-11-08,"(1111.75, 1352.0]",3,11,-8
31251.0,2019-11-08,"(65.652, 404.0]",4,4,0
31251.0,2019-11-08,"(404.0, 741.0]",19,34,-15
31251.0,2019-11-08,"(741.0, 1078.0]",16,34,-18
31251.0,2019-11-08,"(1078.0, 1415.0]",7,18,-11
31252.0,2019-11-08,"(473.29, 651.5]",21,24,-3
31252.0,2019-11-08,"(651.5, 829.0]",7,14,-7
31252.0,2019-11-08,"(829.0, 1006.5]",3,12,-9
31252.0,2019-11-08,"(1006.5, 1184.0]",3,12,-9
31253.0,2019-11-08,"(374.217, 570.75]",18,20,-2
31253.0,2019-11-08,"(570.75, 766.5]",6,7,-1
31253.0,2019-11-08,"(766.5, 962.25]",3,10,-7
31253.0,2019-11-08,"(962.25, 1158.0]",2,14,-12
31254.0,2019-11-08,"(439.068, 673.0]",16,21,-5
31254.0,2019-11-08,"(673.0, 906.0]",5,13,-8
31254.0,2019-11-08,"(906.0, 1139.0]",6,19,-13
31254.0,2019-11-08,"(1139.0, 1372.0]",1,2,-1
31255.0,2019-11-08,"(356.5, 711.0]",20,1,19
31255.0,2019-11-08,"(711.0, 1065.5]",8,28,-20
31255.0,2019-11-08,"(1065.5, 1420.0]",2,20,-18
31256.0,2019-11-08,"(296.861, 582.75]",14,17,-3
31256.0,2019-11-08,"(582.75, 867.5]",9,16,-7
31256.0,2019-11-08,"(867.5, 1152.25]",4,19,-15
31256.0,2019-11-08,"(1152.25, 1437.0]",4,9,-5
31257.0,2019-11-08,"(93.706, 418.5]",4,6,-2
31257.0,2019-11-08,"(418.5, 742.0]",22,39,-17
31257.0,2019-11-08,"(742.0, 1065.5]",18,41,-23
31257.0,2019-11-08,"(1065.5, 1389.0]",9,24,-15
31258.0,2019-11-08,"(386.272, 569.0]",3,5,-2
31258.0,2019-11-08,"(569.0, 751.0]",10,18,-8
31258.0,2019-11-08,"(751.0, 933.0]",19,40,-21
31258.0,2019-11-08,"(933.0, 1115.0]",16,32,-16
31259.0,2019-11-08,"(39.623, 385.25]",3,3,0
31259.0,2019-11-08,"(385.25, 729.5]",12,12,0
31259.0,2019-11-08,"(729.5, 1073.75]",2,12,-10
31260.0,2019-11-08,"(344.12, 565.0]",15,18,-3
31260.0,2019-11-08,"(565.0, 785.0]",6,10,-4
31260.0,2019-11-08,"(1005.0, 1225.0]",2,9,-7
31261.0,2019-11-08,"(292.25, 559.5]",7,1,6
31261.0,2019-11-08,"(559.5, 826.75]",1,7,-6
31261.0,2019-11-08,"(826.75, 1094.0]",14,13,1
31262.0,2019-11-08,"(450.028, 694.0]",13,15,-2
31262.0,2019-11-08,"(694.0, 937.0]",6,9,-3
31262.0,2019-11-08,"(937.0, 1180.0]",5,13,-8
31262.0,2019-11-08,"(1180.0, 1423.0]",1,5,-4
31263.0,2019-11-08,"(431.053, 668.75]",32,39,-7
31263.0,2019-11-08,"(668.75, 905.5]",12,24,-12
31263.0,2019-11-08,"(905.5, 1142.25]",14,27,-13
31263.0,2019-11-08,"(1142.25, 1379.0]",5,11,-6
31264.0,2019-11-08,"(472.033, 714.75]",13,17,-4
31264.0,2019-11-08,"(714.75, 956.5]",6,12,-6
31264.0,2019-11-08,"(956.5, 1198.25]",8,16,-8
31264.0,2019-11-08,"(1198.25, 1440.0]",2,4,-2
31265.0,2019-11-08,"(354.935, 622.25]",17,39,-22
31265.0,2019-11-08,"(622.25, 888.5]",16,25,-9
31265.0,2019-11-08,"(888.5, 1154.75]",29,54,-25
31265.0,2019-11-08,"(1154.75, 1421.0]",9,18,-9
31266.0,2019-11-08,"(3.566, 363.5]",3,7,-4
31266.0,2019-11-08,"(363.5, 722.0]",11,44,-33
31266.0,2019-11-08,"(722.0, 1080.5]",23,45,-22
31266.0,2019-11-08,"(1080.5, 1439.0]",19,32,-13
31267.0,2019-11-08,"(375.75, 696.5]",30,1,29
31267.0,2019-11-08,"(696.5, 1017.25]",12,51,-39
31267.0,2019-11-08,"(1017.25, 1338.0]",17,23,-6
31268.0,2019-11-08,"(28.597, 380.75]",3,4,-1
31268.0,2019-11-08,"(380.75, 731.5]",18,50,-32
31268.0,2019-11-08,"(731.5, 1082.25]",16,27,-11
31268.0,2019-11-08,"(1082.25, 1433.0]",16,26,-10
31269.0,2019-11-08,"(7.664, 343.0]",1,1,0
31269.0,2019-11-08,"(343.0, 677.0]",12,28,-16
31269.0,2019-11-08,"(677.0, 1011.0]",12,23,-11
31269.0,2019-11-08,"(1011.0, 1345.0]",3,10,-7
31270.0,2019-11-08,"(382.096, 609.0]",18,24,-6
31270.0,2019-11-08,"(609.0, 835.0]",7,15,-8
31270.0,2019-11-08,"(835.0, 1061.0]",9,24,-15
31270.0,2019-11-08,"(1061.0, 1287.0]",6,15,-9
31271.0,2019-11-08,"(392.077, 623.75]",13,18,-5
31271.0,2019-11-08,"(623.75, 854.5]",13,24,-11
31271.0,2019-11-08,"(854.5, 1085.25]",3,21,-18
31271.0,2019-11-08,"(1085.25, 1316.0]",3,4,-1
31272.0,2019-11-08,"(377.251, 565.25]",17,18,-1
31272.0,2019-11-08,"(565.25, 752.5]",10,11,-1
31272.0,2019-11-08,"(752.5, 939.75]",2,10,-8
31272.0,2019-11-08,"(939.75, 1127.0]",6,19,-13
,,,,1.0,
,,,,1.0,
31274.0,2019-11-08,"(389.968, 649.0]",21,26,-5
31274.0,2019-11-08,"(649.0, 907.0]",4,7,-3
31274.0,2019-11-08,"(907.0, 1165.0]",18,29,-11
31274.0,2019-11-08,"(1165.0, 1423.0]",2,9,-7
31275.0,2019-11-08,"(26.61, 375.5]",7,8,-1
31275.0,2019-11-08,"(375.5, 723.0]",22,42,-20
31275.0,2019-11-08,"(723.0, 1070.5]",20,36,-16
31275.0,2019-11-08,"(1070.5, 1418.0]",7,17,-10
31276.0,2019-11-08,"(302.75, 584.5]",20,1,19
31276.0,2019-11-08,"(584.5, 866.25]",17,24,-7
31276.0,2019-11-08,"(866.25, 1148.0]",6,27,-21
31277.0,2019-11-08,"(442.37, 600.5]",26,31,-5
31277.0,2019-11-08,"(600.5, 758.0]",10,18,-8
31277.0,2019-11-08,"(758.0, 915.5]",9,16,-7
31277.0,2019-11-08,"(915.5, 1073.0]",8,28,-20
31278.0,2019-11-08,"(402.024, 647.0]",10,37,-27
31278.0,2019-11-08,"(647.0, 891.0]",9,14,-5
31278.0,2019-11-08,"(891.0, 1135.0]",20,30,-10
31278.0,2019-11-08,"(1135.0, 1379.0]",11,19,-8
31279.0,2019-11-08,"(394.277, 575.75]",15,18,-3
31279.0,2019-11-08,"(575.75, 756.5]",3,7,-4
31279.0,2019-11-08,"(756.5, 937.25]",3,9,-6
31279.0,2019-11-08,"(937.25, 1118.0]",2,23,-21
31280.0,2019-11-08,"(388.988, 643.0]",4,23,-19
31280.0,2019-11-08,"(643.0, 896.0]",6,13,-7
31280.0,2019-11-08,"(896.0, 1149.0]",11,13,-2
31280.0,2019-11-08,"(1149.0, 1402.0]",6,8,-2
31000.0,2019-11-09,"(765.34, 931.0]",3,4,-1
31000.0,2019-11-09,"(931.0, 1096.0]",2,4,-2
31001.0,2019-11-09,"(1036.25, 1101.5]",2,1,1
31002.0,2019-11-09,"(526.25, 701.5]",2,1,1
31002.0,2019-11-09,"(701.5, 876.75]",1,3,-2
31002.0,2019-11-09,"(876.75, 1052.0]",2,1,1
31003.0,2019-11-09,"(574.0, 646.0]",1,1,0
31003.0,2019-11-09,"(718.0, 790.0]",1,1,0
31004.0,2019-11-09,"(741.558, 852.5]",1,1,0
31004.0,2019-11-09,"(1073.5, 1184.0]",1,2,-1
31005.0,2019-11-09,"(610.416, 757.0]",1,2,-1
31005.0,2019-11-09,"(757.0, 903.0]",2,4,-2
31005.0,2019-11-09,"(903.0, 1049.0]",1,1,0
31005.0,2019-11-09,"(1049.0, 1195.0]",2,5,-3
31006.0,2019-11-09,"(654.278, 835.5]",3,6,-3
31006.0,2019-11-09,"(835.5, 1016.0]",3,4,-1
31007.0,2019-11-09,"(564.538, 680.5]",1,2,-1
31007.0,2019-11-09,"(680.5, 796.0]",1,1,0
31007.0,2019-11-09,"(796.0, 911.5]",1,4,-3
31009.0,2019-11-09,"(350.353, 512.75]",1,2,-1
31010.0,2019-11-09,"(653.699, 729.25]",1,3,-2
31010.0,2019-11-09,"(879.75, 955.0]",1,2,-1
31011.0,2019-11-09,"(352.317, 523.75]",1,1,0
31011.0,2019-11-09,"(694.5, 865.25]",1,1,0
31011.0,2019-11-09,"(865.25, 1036.0]",1,1,0
31012.0,2019-11-09,"(906.0, 1208.0]",1,1,0
31013.0,2019-11-09,"(544.162, 754.5]",1,3,-2
31013.0,2019-11-09,"(754.5, 964.0]",5,8,-3
31013.0,2019-11-09,"(964.0, 1173.5]",2,3,-1
31013.0,2019-11-09,"(1173.5, 1383.0]",2,3,-1
31014.0,2019-11-09,"(394.022, 639.5]",1,2,-1
31014.0,2019-11-09,"(639.5, 884.0]",10,16,-6
31014.0,2019-11-09,"(884.0, 1128.5]",5,14,-9
31014.0,2019-11-09,"(1128.5, 1373.0]",1,2,-1
31015.0,2019-11-09,"(367.006, 616.5]",1,3,-2
31015.0,2019-11-09,"(616.5, 865.0]",4,13,-9
31015.0,2019-11-09,"(865.0, 1113.5]",2,4,-2
31016.0,2019-11-09,"(558.25, 769.5]",1,1,0
31016.0,2019-11-09,"(980.75, 1192.0]",1,1,0
31017.0,2019-11-09,"(573.813, 620.75]",1,7,-6
31017.0,2019-11-09,"(714.25, 761.0]",1,2,-1
31018.0,2019-11-09,"(617.5, 628.0]",1,2,-1
31019.0,2019-11-09,"(545.304, 720.0]",2,5,-3
31019.0,2019-11-09,"(1068.0, 1242.0]",1,1,0
31020.0,2019-11-09,"(809.25, 871.0]",1,1,0
31021.0,2019-11-09,"(568.221, 763.75]",2,3,-1
31021.0,2019-11-09,"(763.75, 958.5]",1,1,0
31022.0,2019-11-09,"(360.961, 621.75]",2,6,-4
31022.0,2019-11-09,"(621.75, 881.5]",4,4,0
31022.0,2019-11-09,"(881.5, 1141.25]",2,9,-7
31022.0,2019-11-09,"(1141.25, 1401.0]",1,4,-3
31023.0,2019-11-09,"(448.399, 599.25]",3,4,-1
31023.0,2019-11-09,"(599.25, 749.5]",1,2,-1
31023.0,2019-11-09,"(749.5, 899.75]",5,6,-1
31023.0,2019-11-09,"(899.75, 1050.0]",1,3,-2
31024.0,2019-11-09,"(499.446, 638.5]",4,8,-4
31024.0,2019-11-09,"(638.5, 777.0]",4,7,-3
31024.0,2019-11-09,"(777.0, 915.5]",1,2,-1
31024.0,2019-11-09,"(915.5, 1054.0]",2,3,-1
,,,,2.0,
31026.0,2019-11-09,"(615.192, 818.0]",2,3,-1
31026.0,2019-11-09,"(818.0, 1020.0]",2,2,0
31027.0,2019-11-09,"(1000.742, 1065.5]",1,1,0
31027.0,2019-11-09,"(1194.5, 1259.0]",1,3,-2
,,,,1.0,
,,,,1.0,
,,,,1.0,
31029.0,2019-11-09,"(792.75, 993.5]",1,1,0
31030.0,2019-11-09,"(619.825, 663.75]",1,2,-1
31030.0,2019-11-09,"(707.5, 751.25]",1,1,0
31031.0,2019-11-09,"(818.0, 1011.0]",1,1,0
31031.0,2019-11-09,"(1204.0, 1397.0]",1,1,0
31032.0,2019-11-09,"(1224.0, 1295.0]",1,1,0
,,,,2.0,
31034.0,2019-11-09,"(501.233, 693.75]",3,4,-1
31034.0,2019-11-09,"(693.75, 885.5]",2,3,-1
31035.0,2019-11-09,"(378.079, 609.25]",1,2,-1
31035.0,2019-11-09,"(839.5, 1069.75]",2,3,-1
31035.0,2019-11-09,"(1069.75, 1300.0]",1,1,0
31036.0,2019-11-09,"(647.428, 791.0]",1,2,-1
31037.0,2019-11-09,"(420.054, 657.5]",5,6,-1
31037.0,2019-11-09,"(657.5, 894.0]",5,6,-1
31037.0,2019-11-09,"(1130.5, 1367.0]",1,4,-3
31038.0,2019-11-09,"(529.852, 567.0]",1,1,0
31039.0,2019-11-09,"(725.25, 915.5]",2,5,-3
31039.0,2019-11-09,"(915.5, 1105.75]",2,4,-2
31040.0,2019-11-09,"(488.526, 607.5]",1,1,0
31041.0,2019-11-09,"(560.595, 662.25]",6,12,-6
31041.0,2019-11-09,"(763.5, 864.75]",1,1,0
31041.0,2019-11-09,"(864.75, 966.0]",8,2,6
31042.0,2019-11-09,"(686.3, 862.0]",5,9,-4
31042.0,2019-11-09,"(862.0, 1037.0]",2,2,0
31043.0,2019-11-09,"(680.5, 767.25]",3,1,2
31043.0,2019-11-09,"(767.25, 854.0]",2,5,-3
31044.0,2019-11-09,"(700.0, 721.0]",1,1,0
31044.0,2019-11-09,"(742.0, 763.0]",1,1,0
31045.0,2019-11-09,"(627.749, 690.75]",1,2,-1
31046.0,2019-11-09,"(987.25, 1054.0]",1,1,0
31047.0,2019-11-09,"(688.353, 850.75]",3,4,-1
31047.0,2019-11-09,"(1012.5, 1174.25]",2,2,0
31048.0,2019-11-09,"(655.0, 715.5]",1,6,-5
31049.0,2019-11-09,"(479.5, 719.25]",1,1,0
31049.0,2019-11-09,"(719.25, 959.0]",2,1,1
31050.0,2019-11-09,"(1053.75, 1405.0]",1,1,0
31051.0,2019-11-09,"(1036.5, 1244.0]",1,2,-1
31052.0,2019-11-09,"(979.91, 1002.5]",3,3,0
31052.0,2019-11-09,"(1002.5, 1025.0]",1,1,0
31053.0,2019-11-09,"(141.152, 354.0]",1,1,0
,,,,2.0,
,,,,2.0,
31056.0,2019-11-09,"(501.75, 669.0]",2,1,1
31057.0,2019-11-09,"(446.25, 595.0]",1,1,0
,,,,2.0,
31059.0,2019-11-09,"(390.75, 521.0]",1,1,0
31060.0,2019-11-09,"(989.5, 997.0]",2,1,1
31061.0,2019-11-09,"(392.25, 523.0]",1,1,0
31062.0,2019-11-09,"(535.538, 651.5]",1,2,-1
31062.0,2019-11-09,"(651.5, 767.0]",3,6,-3
31062.0,2019-11-09,"(767.0, 882.5]",5,13,-8
31062.0,2019-11-09,"(882.5, 998.0]",5,6,-1
31063.0,2019-11-09,"(629.75, 657.0]",1,1,0
31064.0,2019-11-09,"(585.617, 681.75]",9,19,-10
31064.0,2019-11-09,"(777.5, 873.25]",3,6,-3
31064.0,2019-11-09,"(873.25, 969.0]",4,8,-4
31065.0,2019-11-09,"(568.5, 590.0]",1,1,0
31066.0,2019-11-09,"(879.0, 1172.0]",1,1,0
31067.0,2019-11-09,"(766.5, 1052.75]",1,1,0
31067.0,2019-11-09,"(1052.75, 1339.0]",1,1,0
31068.0,2019-11-09,"(663.693, 740.75]",1,2,-1
31068.0,2019-11-09,"(894.25, 971.0]",1,1,0
31069.0,2019-11-09,"(412.029, 655.75]",1,3,-2
31069.0,2019-11-09,"(655.75, 898.5]",1,4,-3
31069.0,2019-11-09,"(898.5, 1141.25]",1,1,0
31069.0,2019-11-09,"(1141.25, 1384.0]",3,4,-1
31070.0,2019-11-09,"(507.078, 738.5]",2,6,-4
31070.0,2019-11-09,"(738.5, 969.0]",2,3,-1
31070.0,2019-11-09,"(1199.5, 1430.0]",1,1,0
31071.0,2019-11-09,"(504.269, 687.75]",1,2,-1
31071.0,2019-11-09,"(687.75, 870.5]",3,6,-3
31071.0,2019-11-09,"(870.5, 1053.25]",4,9,-5
31071.0,2019-11-09,"(1053.25, 1236.0]",4,5,-1
,,,,2.0,
31073.0,2019-11-09,"(638.535, 755.25]",1,2,-1
31073.0,2019-11-09,"(755.25, 871.5]",1,1,0
31073.0,2019-11-09,"(987.75, 1104.0]",1,1,0
31074.0,2019-11-09,"(441.444, 581.0]",1,2,-1
,,,,1.0,
,,,,1.0,
,,,,1.0,
,,,,2.0,
31077.0,2019-11-09,"(460.087, 689.25]",8,13,-5
31077.0,2019-11-09,"(689.25, 917.5]",4,9,-5
31077.0,2019-11-09,"(917.5, 1145.75]",6,16,-10
31077.0,2019-11-09,"(1145.75, 1374.0]",4,6,-2
,,,,2.0,
31079.0,2019-11-09,"(128.764, 439.0]",1,2,-1
31079.0,2019-11-09,"(748.0, 1057.0]",1,4,-3
31079.0,2019-11-09,"(1057.0, 1366.0]",1,1,0
31080.0,2019-11-09,"(567.171, 775.25]",2,6,-4
31080.0,2019-11-09,"(775.25, 982.5]",1,3,-2
31080.0,2019-11-09,"(982.5, 1189.75]",1,2,-1
31080.0,2019-11-09,"(1189.75, 1397.0]",4,4,0
,,,,1.0,
,,,,1.0,
,,,,1.0,
,,,,4.0,
31082.0,2019-11-09,"(743.5, 806.75]",1,1,0
31083.0,2019-11-09,"(710.86, 746.0]",1,1,0
,,,,1.0,
,,,,2.0,
31085.0,2019-11-09,"(496.5, 662.0]",1,1,0
31086.0,2019-11-09,"(571.407, 720.25]",1,1,0
31086.0,2019-11-09,"(868.5, 1016.75]",1,2,-1
31086.0,2019-11-09,"(1016.75, 1165.0]",2,1,1
,,,,2.0,
31088.0,2019-11-09,"(1011.0, 1348.0]",1,1,0
31089.0,2019-11-09,"(445.085, 674.75]",3,6,-3
31089.0,2019-11-09,"(674.75, 903.5]",4,7,-3
31089.0,2019-11-09,"(903.5, 1132.25]",2,6,-4
31089.0,2019-11-09,"(1132.25, 1361.0]",1,3,-2
31090.0,2019-11-09,"(669.484, 799.0]",3,4,-1
31090.0,2019-11-09,"(1057.0, 1186.0]",1,2,-1
31091.0,2019-11-09,"(67.704, 393.0]",1,1,0
31091.0,2019-11-09,"(717.0, 1041.0]",1,1,0
31091.0,2019-11-09,"(1041.0, 1365.0]",2,2,0
31092.0,2019-11-09,"(850.25, 973.0]",1,1,0
,,,,1.0,
,,,,1.0,
,,,,2.0,
31094.0,2019-11-09,"(672.25, 751.5]",1,1,0
31094.0,2019-11-09,"(830.75, 910.0]",1,1,0
31095.0,2019-11-09,"(989.5, 1142.0]",1,3,-2
31096.0,2019-11-09,"(645.0, 860.0]",1,1,0
31097.0,2019-11-09,"(684.756, 746.0]",2,4,-2
31097.0,2019-11-09,"(746.0, 807.0]",1,1,0
31098.0,2019-11-09,"(793.518, 914.5]",3,4,-1
31099.0,2019-11-09,"(683.937, 699.75]",1,1,0
31100.0,2019-11-09,"(628.75, 863.5]",5,1,4
31100.0,2019-11-09,"(863.5, 1098.25]",4,8,-4
31100.0,2019-11-09,"(1098.25, 1333.0]",4,7,-3
31101.0,2019-11-09,"(360.25, 712.5]",28,2,26
31101.0,2019-11-09,"(712.5, 1064.75]",43,50,-7
31101.0,2019-11-09,"(1064.75, 1417.0]",17,67,-50
31102.0,2019-11-09,"(2.581, 358.75]",6,8,-2
31102.0,2019-11-09,"(713.5, 1068.25]",9,14,-5
31102.0,2019-11-09,"(1068.25, 1423.0]",7,19,-12
31103.0,2019-11-09,"(1.623, 347.25]",1,3,-2
31103.0,2019-11-09,"(347.25, 691.5]",1,18,-17
31103.0,2019-11-09,"(691.5, 1035.75]",3,15,-12
31103.0,2019-11-09,"(1035.75, 1380.0]",5,15,-10
31104.0,2019-11-09,"(8.574, 366.5]",1,6,-5
31104.0,2019-11-09,"(366.5, 723.0]",9,24,-15
31104.0,2019-11-09,"(723.0, 1079.5]",23,49,-26
31104.0,2019-11-09,"(1079.5, 1436.0]",15,29,-14
31105.0,2019-11-09,"(625.251, 813.25]",3,14,-11
31105.0,2019-11-09,"(1000.5, 1187.75]",2,2,0
31105.0,2019-11-09,"(1187.75, 1375.0]",1,5,-4
31106.0,2019-11-09,"(506.33, 674.5]",1,6,-5
31106.0,2019-11-09,"(674.5, 842.0]",2,6,-4
31107.0,2019-11-09,"(374.972, 633.0]",2,13,-11
31107.0,2019-11-09,"(633.0, 890.0]",13,29,-16
31107.0,2019-11-09,"(890.0, 1147.0]",11,22,-11
31107.0,2019-11-09,"(1147.0, 1404.0]",8,13,-5
31108.0,2019-11-09,"(-1.433, 358.25]",1,3,-2
31108.0,2019-11-09,"(358.25, 716.5]",9,23,-14
31108.0,2019-11-09,"(716.5, 1074.75]",20,31,-11
31108.0,2019-11-09,"(1074.75, 1433.0]",10,12,-2
31109.0,2019-11-09,"(6.576, 364.0]",5,8,-3
31109.0,2019-11-09,"(364.0, 720.0]",9,15,-6
31109.0,2019-11-09,"(720.0, 1076.0]",18,39,-21
31109.0,2019-11-09,"(1076.0, 1432.0]",10,16,-6
31110.0,2019-11-09,"(21.6, 373.0]",2,3,-1
31110.0,2019-11-09,"(373.0, 723.0]",12,19,-7
31110.0,2019-11-09,"(723.0, 1073.0]",11,25,-14
31110.0,2019-11-09,"(1073.0, 1423.0]",4,8,-4
31111.0,2019-11-09,"(8.589, 362.75]",1,4,-3
31111.0,2019-11-09,"(362.75, 715.5]",8,16,-8
31111.0,2019-11-09,"(715.5, 1068.25]",13,29,-16
31111.0,2019-11-09,"(1068.25, 1421.0]",9,15,-6
31112.0,2019-11-09,"(686.381, 841.75]",1,5,-4
31112.0,2019-11-09,"(841.75, 996.5]",3,4,-1
31112.0,2019-11-09,"(996.5, 1151.25]",1,1,0
31112.0,2019-11-09,"(1151.25, 1306.0]",1,1,0
31113.0,2019-11-09,"(13.622, 359.5]",1,7,-6
31113.0,2019-11-09,"(359.5, 704.0]",3,19,-16
31113.0,2019-11-09,"(704.0, 1048.5]",9,24,-15
31113.0,2019-11-09,"(1048.5, 1393.0]",6,12,-6
31114.0,2019-11-09,"(44.681, 375.75]",2,3,-1
31114.0,2019-11-09,"(375.75, 705.5]",8,17,-9
31114.0,2019-11-09,"(705.5, 1035.25]",13,34,-21
31114.0,2019-11-09,"(1035.25, 1365.0]",7,16,-9
31115.0,2019-11-09,"(0.565, 360.75]",2,4,-2
31115.0,2019-11-09,"(360.75, 719.5]",5,13,-8
31115.0,2019-11-09,"(719.5, 1078.25]",8,23,-15
31115.0,2019-11-09,"(1078.25, 1437.0]",6,15,-9
31116.0,2019-11-09,"(429.045, 668.75]",12,21,-9
31116.0,2019-11-09,"(668.75, 907.5]",11,27,-16
31116.0,2019-11-09,"(907.5, 1146.25]",7,14,-7
31116.0,2019-11-09,"(1146.25, 1385.0]",8,10,-2
31117.0,2019-11-09,"(78.696, 406.0]",1,2,-1
31117.0,2019-11-09,"(406.0, 732.0]",3,17,-14
31117.0,2019-11-09,"(732.0, 1058.0]",7,27,-20
31117.0,2019-11-09,"(1058.0, 1384.0]",2,4,-2
31118.0,2019-11-09,"(25.63, 369.5]",2,3,-1
31118.0,2019-11-09,"(369.5, 712.0]",4,8,-4
31118.0,2019-11-09,"(712.0, 1054.5]",4,15,-11
31118.0,2019-11-09,"(1054.5, 1397.0]",8,12,-4
31119.0,2019-11-09,"(29.615, 377.25]",1,2,-1
31119.0,2019-11-09,"(377.25, 723.5]",14,39,-25
31119.0,2019-11-09,"(723.5, 1069.75]",15,27,-12
31119.0,2019-11-09,"(1069.75, 1416.0]",8,15,-7
31120.0,2019-11-09,"(498.087, 727.25]",1,12,-11
31120.0,2019-11-09,"(727.25, 955.5]",7,14,-7
31120.0,2019-11-09,"(955.5, 1183.75]",8,16,-8
31120.0,2019-11-09,"(1183.75, 1412.0]",7,10,-3
31121.0,2019-11-09,"(8.577, 365.75]",2,3,-1
31121.0,2019-11-09,"(365.75, 721.5]",13,22,-9
31121.0,2019-11-09,"(721.5, 1077.25]",11,17,-6
31121.0,2019-11-09,"(1077.25, 1433.0]",7,11,-4
31122.0,2019-11-09,"(80.683, 411.25]",1,1,0
31122.0,2019-11-09,"(411.25, 740.5]",2,5,-3
31122.0,2019-11-09,"(740.5, 1069.75]",13,25,-12
31122.0,2019-11-09,"(1069.75, 1399.0]",3,10,-7
31123.0,2019-11-09,"(452.053, 689.75]",1,10,-9
31123.0,2019-11-09,"(689.75, 926.5]",7,12,-5
31123.0,2019-11-09,"(926.5, 1163.25]",4,10,-6
31123.0,2019-11-09,"(1163.25, 1400.0]",2,2,0
31124.0,2019-11-09,"(56.637, 398.75]",1,4,-3
31124.0,2019-11-09,"(398.75, 739.5]",13,30,-17
31124.0,2019-11-09,"(739.5, 1080.25]",24,68,-44
31124.0,2019-11-09,"(1080.25, 1421.0]",4,23,-19
31125.0,2019-11-09,"(464.046, 703.5]",10,30,-20
31125.0,2019-11-09,"(703.5, 942.0]",9,20,-11
31125.0,2019-11-09,"(942.0, 1180.5]",7,11,-4
31125.0,2019-11-09,"(1180.5, 1419.0]",8,10,-2
31126.0,2019-11-09,"(75.663, 411.25]",2,3,-1
31126.0,2019-11-09,"(411.25, 745.5]",2,20,-18
31126.0,2019-11-09,"(745.5, 1079.75]",10,31,-21
31126.0,2019-11-09,"(1079.75, 1414.0]",6,13,-7
31127.0,2019-11-09,"(448.044, 688.0]",4,5,-1
31127.0,2019-11-09,"(688.0, 927.0]",8,15,-7
31127.0,2019-11-09,"(927.0, 1166.0]",7,17,-10
31127.0,2019-11-09,"(1166.0, 1405.0]",3,6,-3
31128.0,2019-11-09,"(345.945, 610.75]",5,13,-8
31128.0,2019-11-09,"(610.75, 874.5]",9,17,-8
31128.0,2019-11-09,"(874.5, 1138.25]",5,13,-8
31128.0,2019-11-09,"(1138.25, 1402.0]",4,9,-5
31129.0,2019-11-09,"(109.907, 384.25]",2,2,0
31129.0,2019-11-09,"(384.25, 657.5]",2,2,0
31129.0,2019-11-09,"(657.5, 930.75]",16,26,-10
31129.0,2019-11-09,"(930.75, 1204.0]",12,24,-12
31130.0,2019-11-09,"(511.08, 742.0]",3,11,-8
31130.0,2019-11-09,"(742.0, 972.0]",5,10,-5
31130.0,2019-11-09,"(972.0, 1202.0]",7,7,0
31130.0,2019-11-09,"(1202.0, 1432.0]",7,8,-1
31131.0,2019-11-09,"(465.048, 704.0]",2,9,-7
31131.0,2019-11-09,"(704.0, 942.0]",3,12,-9
31131.0,2019-11-09,"(942.0, 1180.0]",3,8,-5
31131.0,2019-11-09,"(1180.0, 1418.0]",2,2,0
31200.0,2019-11-09,"(20.598, 372.5]",4,4,0
31200.0,2019-11-09,"(372.5, 723.0]",17,23,-6
31200.0,2019-11-09,"(723.0, 1073.5]",33,55,-22
31200.0,2019-11-09,"(1073.5, 1424.0]",16,26,-10
31201.0,2019-11-09,"(12.587, 367.25]",1,4,-3
31201.0,2019-11-09,"(367.25, 720.5]",28,51,-23
31201.0,2019-11-09,"(720.5, 1073.75]",46,87,-41
31201.0,2019-11-09,"(1073.75, 1427.0]",17,30,-13
31202.0,2019-11-09,"(384.75, 729.5]",25,5,20
31202.0,2019-11-09,"(729.5, 1074.25]",30,39,-9
31202.0,2019-11-09,"(1074.25, 1419.0]",10,53,-43
31203.0,2019-11-09,"(377.5, 722.0]",10,1,9
31203.0,2019-11-09,"(722.0, 1066.5]",28,19,9
31203.0,2019-11-09,"(1066.5, 1411.0]",15,50,-35
31204.0,2019-11-09,"(55.657, 392.75]",1,2,-1
31204.0,2019-11-09,"(392.75, 728.5]",5,12,-7
31204.0,2019-11-09,"(728.5, 1064.25]",5,11,-6
31204.0,2019-11-09,"(1064.25, 1400.0]",7,11,-4
31205.0,2019-11-09,"(377.0, 720.0]",11,2,9
31205.0,2019-11-09,"(720.0, 1063.0]",16,14,2
31205.0,2019-11-09,"(1063.0, 1406.0]",2,27,-25
31206.0,2019-11-09,"(848.725, 917.75]",2,3,-1
31207.0,2019-11-09,"(31.674, 364.5]",1,1,0
31207.0,2019-11-09,"(696.0, 1027.5]",3,2,1
31207.0,2019-11-09,"(1027.5, 1359.0]",2,9,-7
31208.0,2019-11-09,"(580.25, 781.5]",3,2,1
31208.0,2019-11-09,"(781.5, 982.75]",4,5,-1
31208.0,2019-11-09,"(982.75, 1184.0]",1,6,-5
31209.0,2019-11-09,"(533.228, 727.0]",3,6,-3
31209.0,2019-11-09,"(727.0, 920.0]",5,6,-1
31209.0,2019-11-09,"(920.0, 1113.0]",3,7,-4
31209.0,2019-11-09,"(1113.0, 1306.0]",3,3,0
31211.0,2019-11-09,"(621.5, 807.0]",1,1,0
31211.0,2019-11-09,"(807.0, 992.5]",5,1,4
31211.0,2019-11-09,"(992.5, 1178.0]",14,9,5
31212.0,2019-11-09,"(80.784, 386.0]",2,4,-2
31212.0,2019-11-09,"(386.0, 690.0]",7,10,-3
31212.0,2019-11-09,"(690.0, 994.0]",7,16,-9
31212.0,2019-11-09,"(994.0, 1298.0]",10,17,-7
31213.0,2019-11-09,"(86.806, 386.5]",1,2,-1
31213.0,2019-11-09,"(386.5, 685.0]",11,18,-7
31213.0,2019-11-09,"(685.0, 983.5]",9,11,-2
31213.0,2019-11-09,"(983.5, 1282.0]",3,6,-3
31214.0,2019-11-09,"(36.6, 388.0]",2,4,-2
31214.0,2019-11-09,"(388.0, 738.0]",9,25,-16
31214.0,2019-11-09,"(738.0, 1088.0]",29,55,-26
31214.0,2019-11-09,"(1088.0, 1438.0]",10,20,-10
31215.0,2019-11-09,"(415.086, 644.5]",4,4,0
31215.0,2019-11-09,"(644.5, 873.0]",10,16,-6
31215.0,2019-11-09,"(873.0, 1101.5]",14,21,-7
31215.0,2019-11-09,"(1101.5, 1330.0]",1,1,0
31216.0,2019-11-09,"(608.355, 770.25]",4,8,-4
31216.0,2019-11-09,"(770.25, 931.5]",4,8,-4
31216.0,2019-11-09,"(931.5, 1092.75]",6,12,-6
31216.0,2019-11-09,"(1092.75, 1254.0]",2,4,-2
31217.0,2019-11-09,"(557.332, 725.0]",1,2,-1
31217.0,2019-11-09,"(725.0, 892.0]",4,9,-5
31217.0,2019-11-09,"(892.0, 1059.0]",3,7,-4
31217.0,2019-11-09,"(1059.0, 1226.0]",2,2,0
31218.0,2019-11-09,"(643.28, 824.0]",8,17,-9
31218.0,2019-11-09,"(824.0, 1004.0]",7,12,-5
31218.0,2019-11-09,"(1004.0, 1184.0]",1,4,-3
31218.0,2019-11-09,"(1184.0, 1364.0]",1,5,-4
31219.0,2019-11-09,"(601.75, 763.5]",14,1,13
31219.0,2019-11-09,"(763.5, 925.25]",13,16,-3
31219.0,2019-11-09,"(925.25, 1087.0]",6,18,-12
31220.0,2019-11-09,"(23.762, 334.5]",4,4,0
31220.0,2019-11-09,"(644.0, 953.5]",5,9,-4
31220.0,2019-11-09,"(953.5, 1263.0]",2,3,-1
31221.0,2019-11-09,"(351.958, 613.5]",11,11,0
31221.0,2019-11-09,"(613.5, 874.0]",6,10,-4
31221.0,2019-11-09,"(874.0, 1134.5]",8,11,-3
31221.0,2019-11-09,"(1134.5, 1395.0]",4,6,-2
31222.0,2019-11-09,"(317.951, 581.25]",1,2,-1
31222.0,2019-11-09,"(581.25, 843.5]",2,5,-3
31222.0,2019-11-09,"(843.5, 1105.75]",1,3,-2
31222.0,2019-11-09,"(1105.75, 1368.0]",2,2,0
31223.0,2019-11-09,"(358.75, 695.5]",10,5,5
31223.0,2019-11-09,"(695.5, 1032.25]",11,15,-4
31223.0,2019-11-09,"(1032.25, 1369.0]",7,28,-21
31224.0,2019-11-09,"(522.151, 735.25]",9,11,-2
31224.0,2019-11-09,"(735.25, 947.5]",2,7,-5
31224.0,2019-11-09,"(1159.75, 1372.0]",3,4,-1
31225.0,2019-11-09,"(430.142, 645.5]",2,3,-1
31225.0,2019-11-09,"(645.5, 860.0]",8,16,-8
31225.0,2019-11-09,"(860.0, 1074.5]",10,17,-7
31225.0,2019-11-09,"(1074.5, 1289.0]",4,5,-1
31226.0,2019-11-09,"(498.103, 723.25]",4,6,-2
31226.0,2019-11-09,"(723.25, 947.5]",3,5,-2
31226.0,2019-11-09,"(947.5, 1171.75]",1,4,-3
31226.0,2019-11-09,"(1171.75, 1396.0]",2,3,-1
31227.0,2019-11-09,"(461.12, 682.0]",4,8,-4
31227.0,2019-11-09,"(682.0, 902.0]",12,16,-4
31227.0,2019-11-09,"(902.0, 1122.0]",7,17,-10
31227.0,2019-11-09,"(1122.0, 1342.0]",2,3,-1
31228.0,2019-11-09,"(406.0, 747.0]",16,1,15
31228.0,2019-11-09,"(747.0, 1088.0]",12,29,-17
31228.0,2019-11-09,"(1088.0, 1429.0]",15,27,-12
31229.0,2019-11-09,"(26.639, 368.25]",4,8,-4
31229.0,2019-11-09,"(368.25, 708.5]",14,38,-24
31229.0,2019-11-09,"(708.5, 1048.75]",31,67,-36
31229.0,2019-11-09,"(1048.75, 1389.0]",11,28,-17
31230.0,2019-11-09,"(484.158, 695.5]",5,11,-6
31230.0,2019-11-09,"(695.5, 906.0]",16,27,-11
31230.0,2019-11-09,"(906.0, 1116.5]",5,7,-2
31230.0,2019-11-09,"(1116.5, 1327.0]",5,11,-6
31231.0,2019-11-09,"(583.5, 802.75]",13,2,11
31231.0,2019-11-09,"(802.75, 1022.0]",4,13,-9
31232.0,2019-11-09,"(47.619, 394.25]",1,3,-2
31232.0,2019-11-09,"(394.25, 739.5]",9,16,-7
31232.0,2019-11-09,"(739.5, 1084.75]",31,52,-21
31232.0,2019-11-09,"(1084.75, 1430.0]",13,25,-12
31233.0,2019-11-09,"(401.5, 735.0]",2,1,1
31233.0,2019-11-09,"(735.0, 1068.5]",13,4,9
31233.0,2019-11-09,"(1068.5, 1402.0]",1,19,-18
31234.0,2019-11-09,"(123.713, 446.75]",2,2,0
31234.0,2019-11-09,"(446.75, 768.5]",10,20,-10
31234.0,2019-11-09,"(768.5, 1090.25]",9,21,-12
31234.0,2019-11-09,"(1090.25, 1412.0]",7,10,-3
31235.0,2019-11-09,"(446.222, 641.5]",2,3,-1
31235.0,2019-11-09,"(641.5, 836.0]",1,4,-3
31235.0,2019-11-09,"(836.0, 1030.5]",1,2,-1
31235.0,2019-11-09,"(1030.5, 1225.0]",2,7,-5
31236.0,2019-11-09,"(112.7, 439.0]",1,2,-1
31236.0,2019-11-09,"(439.0, 764.0]",9,19,-10
31236.0,2019-11-09,"(764.0, 1089.0]",12,22,-10
31236.0,2019-11-09,"(1089.0, 1414.0]",2,2,0
31237.0,2019-11-09,"(35.688, 365.0]",2,2,0
31237.0,2019-11-09,"(365.0, 693.0]",3,9,-6
31237.0,2019-11-09,"(693.0, 1021.0]",14,25,-11
31237.0,2019-11-09,"(1021.0, 1349.0]",9,17,-8
31238.0,2019-11-09,"(57.657, 394.75]",1,2,-1
31238.0,2019-11-09,"(394.75, 730.5]",2,3,-1
31238.0,2019-11-09,"(730.5, 1066.25]",4,6,-2
31238.0,2019-11-09,"(1066.25, 1402.0]",1,2,-1
31239.0,2019-11-09,"(85.762, 396.5]",1,2,-1
31239.0,2019-11-09,"(396.5, 706.0]",7,8,-1
31239.0,2019-11-09,"(706.0, 1015.5]",14,24,-10
31239.0,2019-11-09,"(1015.5, 1325.0]",5,10,-5
31240.0,2019-11-09,"(480.182, 685.5]",4,12,-8
31240.0,2019-11-09,"(685.5, 890.0]",5,9,-4
31240.0,2019-11-09,"(890.0, 1094.5]",4,7,-3
31240.0,2019-11-09,"(1094.5, 1299.0]",2,2,0
31241.0,2019-11-09,"(22.629, 366.75]",3,7,-4
31241.0,2019-11-09,"(366.75, 709.5]",6,19,-13
31241.0,2019-11-09,"(709.5, 1052.25]",13,29,-16
31241.0,2019-11-09,"(1052.25, 1395.0]",14,20,-6
31242.0,2019-11-09,"(513.155, 725.25]",3,3,0
31242.0,2019-11-09,"(725.25, 936.5]",4,10,-6
31242.0,2019-11-09,"(936.5, 1147.75]",6,12,-6
31242.0,2019-11-09,"(1147.75, 1359.0]",1,5,-4
31243.0,2019-11-09,"(323.899, 600.25]",1,3,-2
31243.0,2019-11-09,"(600.25, 875.5]",11,15,-4
31243.0,2019-11-09,"(875.5, 1150.75]",3,12,-9
31243.0,2019-11-09,"(1150.75, 1426.0]",4,9,-5
31244.0,2019-11-09,"(614.5, 910.75]",1,1,0
31244.0,2019-11-09,"(910.75, 1207.0]",2,5,-3
31245.0,2019-11-09,"(366.0, 721.0]",5,3,2
31245.0,2019-11-09,"(721.0, 1076.0]",21,14,7
31245.0,2019-11-09,"(1076.0, 1431.0]",8,38,-30
31246.0,2019-11-09,"(87.659, 424.25]",1,2,-1
31246.0,2019-11-09,"(424.25, 759.5]",13,24,-11
31246.0,2019-11-09,"(759.5, 1094.75]",25,43,-18
31246.0,2019-11-09,"(1094.75, 1430.0]",5,11,-6
31247.0,2019-11-09,"(462.324, 632.0]",12,23,-11
31247.0,2019-11-09,"(632.0, 801.0]",20,33,-13
31247.0,2019-11-09,"(801.0, 970.0]",12,33,-21
31247.0,2019-11-09,"(970.0, 1139.0]",14,22,-8
31248.0,2019-11-09,"(467.234, 659.5]",6,10,-4
31248.0,2019-11-09,"(659.5, 851.0]",21,33,-12
31248.0,2019-11-09,"(851.0, 1042.5]",19,33,-14
31248.0,2019-11-09,"(1042.5, 1234.0]",4,8,-4
31249.0,2019-11-09,"(553.174, 760.5]",11,17,-6
31249.0,2019-11-09,"(760.5, 967.0]",11,17,-6
31249.0,2019-11-09,"(967.0, 1173.5]",8,14,-6
31250.0,2019-11-09,"(613.454, 750.5]",1,3,-2
31250.0,2019-11-09,"(750.5, 887.0]",1,2,-1
31250.0,2019-11-09,"(887.0, 1023.5]",2,2,0
31250.0,2019-11-09,"(1023.5, 1160.0]",3,4,-1
31251.0,2019-11-09,"(16.618, 363.5]",3,5,-2
31251.0,2019-11-09,"(363.5, 709.0]",5,14,-9
31251.0,2019-11-09,"(709.0, 1054.5]",10,20,-10
31251.0,2019-11-09,"(1054.5, 1400.0]",4,10,-6
31252.0,2019-11-09,"(590.27, 773.5]",5,5,0
31252.0,2019-11-09,"(773.5, 956.0]",1,2,-1
31252.0,2019-11-09,"(1138.5, 1321.0]",5,2,3
31253.0,2019-11-09,"(61.641, 402.75]",1,1,0
31253.0,2019-11-09,"(402.75, 742.5]",4,5,-1
31253.0,2019-11-09,"(742.5, 1082.25]",6,12,-6
31253.0,2019-11-09,"(1082.25, 1422.0]",1,4,-3
31254.0,2019-11-09,"(526.114, 748.5]",4,5,-1
31254.0,2019-11-09,"(748.5, 970.0]",5,8,-3
31254.0,2019-11-09,"(970.0, 1191.5]",4,6,-2
31254.0,2019-11-09,"(1191.5, 1413.0]",2,2,0
31255.0,2019-11-09,"(96.67, 430.5]",1,1,0
31255.0,2019-11-09,"(430.5, 763.0]",2,5,-3
31255.0,2019-11-09,"(763.0, 1095.5]",3,5,-2
31255.0,2019-11-09,"(1095.5, 1428.0]",1,3,-2
31256.0,2019-11-09,"(389.0, 689.0]",6,1,5
31256.0,2019-11-09,"(689.0, 989.0]",23,8,15
31256.0,2019-11-09,"(989.0, 1289.0]",5,43,-38
31257.0,2019-11-09,"(448.045, 687.75]",6,11,-5
31257.0,2019-11-09,"(687.75, 926.5]",12,15,-3
31257.0,2019-11-09,"(926.5, 1165.25]",8,13,-5
31257.0,2019-11-09,"(1165.25, 1404.0]",2,11,-9
31258.0,2019-11-09,"(46.73, 365.5]",2,2,0
31258.0,2019-11-09,"(365.5, 683.0]",3,9,-6
31258.0,2019-11-09,"(683.0, 1000.5]",34,62,-28
31258.0,2019-11-09,"(1000.5, 1318.0]",10,17,-7
31259.0,2019-11-09,"(726.799, 777.25]",6,9,-3
31260.0,2019-11-09,"(596.172, 804.0]",1,6,-5
31260.0,2019-11-09,"(804.0, 1011.0]",3,4,-1
31260.0,2019-11-09,"(1011.0, 1218.0]",1,4,-3
31260.0,2019-11-09,"(1218.0, 1425.0]",2,2,0
31261.0,2019-11-09,"(657.801, 707.75]",2,4,-2
31261.0,2019-11-09,"(807.25, 857.0]",1,1,0
31262.0,2019-11-09,"(99.685, 429.75]",1,3,-2
31262.0,2019-11-09,"(429.75, 758.5]",10,12,-2
31262.0,2019-11-09,"(758.5, 1087.25]",11,26,-15
31262.0,2019-11-09,"(1087.25, 1416.0]",4,8,-4
31263.0,2019-11-09,"(447.212, 645.0]",3,6,-3
31263.0,2019-11-09,"(645.0, 842.0]",9,11,-2
31263.0,2019-11-09,"(842.0, 1039.0]",5,16,-11
31263.0,2019-11-09,"(1039.0, 1236.0]",4,15,-11
31264.0,2019-11-09,"(529.132, 747.0]",6,10,-4
31264.0,2019-11-09,"(747.0, 964.0]",9,12,-3
31264.0,2019-11-09,"(1181.0, 1398.0]",2,5,-3
31265.0,2019-11-09,"(420.035, 662.25]",6,12,-6
31265.0,2019-11-09,"(662.25, 903.5]",9,25,-16
31265.0,2019-11-09,"(903.5, 1144.75]",13,23,-10
31265.0,2019-11-09,"(1144.75, 1386.0]",9,15,-6
31266.0,2019-11-09,"(18.648, 358.0]",3,4,-1
31266.0,2019-11-09,"(358.0, 696.0]",3,16,-13
31266.0,2019-11-09,"(696.0, 1034.0]",24,43,-19
31266.0,2019-11-09,"(1034.0, 1372.0]",11,19,-8
31267.0,2019-11-09,"(473.063, 708.25]",7,15,-8
31267.0,2019-11-09,"(708.25, 942.5]",8,19,-11
31267.0,2019-11-09,"(942.5, 1176.75]",7,17,-10
31267.0,2019-11-09,"(1176.75, 1411.0]",4,8,-4
31268.0,2019-11-09,"(25.592, 379.0]",2,4,-2
31268.0,2019-11-09,"(379.0, 731.0]",14,21,-7
31268.0,2019-11-09,"(731.0, 1083.0]",15,24,-9
31268.0,2019-11-09,"(1083.0, 1435.0]",18,27,-9
31269.0,2019-11-09,"(543.214, 740.5]",10,16,-6
31269.0,2019-11-09,"(740.5, 937.0]",3,9,-6
31269.0,2019-11-09,"(937.0, 1133.5]",3,8,-5
31269.0,2019-11-09,"(1133.5, 1330.0]",5,9,-4
31270.0,2019-11-09,"(323.931, 592.25]",5,5,0
31270.0,2019-11-09,"(592.25, 859.5]",7,8,-1
31270.0,2019-11-09,"(859.5, 1126.75]",9,15,-6
31270.0,2019-11-09,"(1126.75, 1394.0]",3,4,-1
31271.0,2019-11-09,"(505.546, 619.5]",3,4,-1
31271.0,2019-11-09,"(619.5, 733.0]",4,5,-1
31271.0,2019-11-09,"(733.0, 846.5]",5,13,-8
31271.0,2019-11-09,"(846.5, 960.0]",5,13,-8
31272.0,2019-11-09,"(552.351, 715.25]",6,7,-1
31272.0,2019-11-09,"(715.25, 877.5]",8,12,-4
31272.0,2019-11-09,"(877.5, 1039.75]",22,37,-15
31272.0,2019-11-09,"(1039.75, 1202.0]",2,5,-3
31273.0,2019-11-09,"(615.253, 802.75]",1,4,-3
31273.0,2019-11-09,"(802.75, 989.5]",1,2,-1
31273.0,2019-11-09,"(989.5, 1176.25]",1,3,-2
31273.0,2019-11-09,"(1176.25, 1363.0]",2,2,0
31274.0,2019-11-09,"(580.188, 784.0]",8,13,-5
31274.0,2019-11-09,"(784.0, 987.0]",5,7,-2
31274.0,2019-11-09,"(987.0, 1190.0]",3,6,-3
31274.0,2019-11-09,"(1190.0, 1393.0]",3,6,-3
31275.0,2019-11-09,"(0.63, 344.5]",4,5,-1
31275.0,2019-11-09,"(344.5, 687.0]",13,20,-7
31275.0,2019-11-09,"(687.0, 1029.5]",14,28,-14
31275.0,2019-11-09,"(1029.5, 1372.0]",11,17,-6
31276.0,2019-11-09,"(411.08, 642.0]",2,3,-1
31276.0,2019-11-09,"(642.0, 872.0]",4,7,-3
31276.0,2019-11-09,"(872.0, 1102.0]",3,3,0
31277.0,2019-11-09,"(487.28, 668.0]",5,6,-1
31277.0,2019-11-09,"(668.0, 848.0]",8,15,-7
31277.0,2019-11-09,"(848.0, 1028.0]",13,24,-11
31277.0,2019-11-09,"(1028.0, 1208.0]",2,9,-7
31278.0,2019-11-09,"(41.629, 385.75]",1,2,-1
31278.0,2019-11-09,"(385.75, 728.5]",13,27,-14
31278.0,2019-11-09,"(728.5, 1071.25]",14,29,-15
31278.0,2019-11-09,"(1071.25, 1414.0]",5,11,-6
31279.0,2019-11-09,"(988.75, 1099.5]",2,2,0
31280.0,2019-11-09,"(60.719, 382.25]",1,1,0
31280.0,2019-11-09,"(382.25, 702.5]",7,22,-15
31280.0,2019-11-09,"(702.5, 1022.75]",8,14,-6
31280.0,2019-11-09,"(1022.75, 1343.0]",2,6,-4
31000.0,2019-11-10,"(98.041, 338.75]",2,2,0
31000.0,2019-11-10,"(578.5, 818.25]",4,2,2
31000.0,2019-11-10,"(818.25, 1058.0]",1,4,-3
31001.0,2019-11-10,"(64.765, 374.75]",2,5,-3
31001.0,2019-11-10,"(683.5, 992.25]",3,4,-1
31001.0,2019-11-10,"(992.25, 1301.0]",1,5,-4
31002.0,2019-11-10,"(802.603, 902.25]",4,6,-2
31002.0,2019-11-10,"(902.25, 1001.5]",2,5,-3
31002.0,2019-11-10,"(1100.75, 1200.0]",2,1,1
31003.0,2019-11-10,"(470.377, 626.75]",1,4,-3
31003.0,2019-11-10,"(626.75, 782.5]",3,4,-1
31003.0,2019-11-10,"(938.25, 1094.0]",2,3,-1
31004.0,2019-11-10,"(788.697, 864.75]",1,5,-4
31004.0,2019-11-10,"(1016.25, 1092.0]",2,2,0
31005.0,2019-11-10,"(648.5, 970.75]",6,1,5
31005.0,2019-11-10,"(970.75, 1293.0]",6,1,5
31006.0,2019-11-10,"(528.216, 725.0]",5,7,-2
31006.0,2019-11-10,"(725.0, 921.0]",2,3,-1
31006.0,2019-11-10,"(921.0, 1117.0]",1,2,-1
31007.0,2019-11-10,"(487.322, 657.5]",1,3,-2
31007.0,2019-11-10,"(657.5, 827.0]",3,7,-4
31007.0,2019-11-10,"(827.0, 996.5]",1,4,-3
31007.0,2019-11-10,"(996.5, 1166.0]",2,4,-2
31009.0,2019-11-10,"(940.5, 1032.75]",1,2,-1
31010.0,2019-11-10,"(631.293, 808.75]",6,11,-5
31010.0,2019-11-10,"(808.75, 985.5]",4,7,-3
31010.0,2019-11-10,"(1162.25, 1339.0]",1,1,0
31011.0,2019-11-10,"(458.356, 620.0]",2,4,-2
31011.0,2019-11-10,"(620.0, 781.0]",2,3,-1
31011.0,2019-11-10,"(781.0, 942.0]",1,1,0
31011.0,2019-11-10,"(942.0, 1103.0]",1,1,0
,,,,2.0,
31013.0,2019-11-10,"(622.303, 797.25]",4,8,-4
31013.0,2019-11-10,"(1145.75, 1320.0]",1,1,0
31014.0,2019-11-10,"(11.837, 303.75]",1,1,0
31014.0,2019-11-10,"(303.75, 594.5]",1,1,0
31014.0,2019-11-10,"(594.5, 885.25]",11,19,-8
31014.0,2019-11-10,"(885.25, 1176.0]",2,6,-4
31015.0,2019-11-10,"(654.347, 818.25]",5,7,-2
31015.0,2019-11-10,"(818.25, 981.5]",5,9,-4
31015.0,2019-11-10,"(981.5, 1144.75]",1,1,0
31015.0,2019-11-10,"(1144.75, 1308.0]",4,4,0
31016.0,2019-11-10,"(906.0, 1033.0]",1,2,-1
31016.0,2019-11-10,"(1033.0, 1160.0]",8,2,6
31017.0,2019-11-10,"(571.294, 748.5]",3,5,-2
31017.0,2019-11-10,"(748.5, 925.0]",2,8,-6
31017.0,2019-11-10,"(925.0, 1101.5]",1,2,-1
31018.0,2019-11-10,"(660.369, 818.75]",2,6,-4
31018.0,2019-11-10,"(818.75, 976.5]",1,3,-2
31018.0,2019-11-10,"(1134.25, 1292.0]",1,1,0
31019.0,2019-11-10,"(669.637, 760.75]",2,2,0
31019.0,2019-11-10,"(760.75, 851.5]",1,1,0
31019.0,2019-11-10,"(851.5, 942.25]",1,4,-3
31020.0,2019-11-10,"(557.239, 748.25]",1,4,-3
31020.0,2019-11-10,"(748.25, 938.5]",1,2,-1
31021.0,2019-11-10,"(747.75, 830.0]",1,1,0
31022.0,2019-11-10,"(561.361, 721.75]",3,4,-1
31022.0,2019-11-10,"(721.75, 881.5]",1,4,-3
31022.0,2019-11-10,"(881.5, 1041.25]",1,2,-1
31022.0,2019-11-10,"(1041.25, 1201.0]",2,5,-3
31023.0,2019-11-10,"(418.75, 720.5]",4,1,3
31023.0,2019-11-10,"(720.5, 1022.25]",1,5,-4
31023.0,2019-11-10,"(1022.25, 1324.0]",2,3,-1
31024.0,2019-11-10,"(452.23, 645.5]",1,3,-2
31024.0,2019-11-10,"(645.5, 838.0]",4,5,-1
31024.0,2019-11-10,"(838.0, 1030.5]",2,5,-3
31024.0,2019-11-10,"(1030.5, 1223.0]",4,7,-3
31025.0,2019-11-10,"(969.0, 1264.0]",1,1,0
31026.0,2019-11-10,"(358.402, 508.5]",1,1,0
31026.0,2019-11-10,"(807.5, 957.0]",2,3,-1
31027.0,2019-11-10,"(764.25, 1019.0]",4,1,3
31028.0,2019-11-10,"(629.671, 712.25]",3,6,-3
31029.0,2019-11-10,"(607.583, 712.25]",1,3,-2
31029.0,2019-11-10,"(712.25, 816.5]",2,4,-2
31029.0,2019-11-10,"(920.75, 1025.0]",3,1,2
31030.0,2019-11-10,"(507.435, 649.25]",1,3,-2
31030.0,2019-11-10,"(931.75, 1073.0]",1,4,-3
31031.0,2019-11-10,"(670.835, 712.25]",1,4,-3
31031.0,2019-11-10,"(753.5, 794.75]",1,1,0
31031.0,2019-11-10,"(794.75, 836.0]",1,1,0
31032.0,2019-11-10,"(962.0, 1018.0]",2,1,1
31032.0,2019-11-10,"(1018.0, 1074.0]",1,3,-2
,,,,1.0,
,,,,1.0,
31034.0,2019-11-10,"(125.7, 452.0]",1,1,0
31034.0,2019-11-10,"(452.0, 777.0]",1,5,-4
31034.0,2019-11-10,"(777.0, 1102.0]",2,6,-4
31034.0,2019-11-10,"(1102.0, 1427.0]",3,6,-3
31035.0,2019-11-10,"(863.0, 1123.0]",5,1,4
31035.0,2019-11-10,"(1123.0, 1383.0]",4,2,2
31036.0,2019-11-10,"(728.83, 771.5]",1,1,0
31036.0,2019-11-10,"(856.5, 899.0]",1,2,-1
31037.0,2019-11-10,"(662.5, 970.25]",7,1,6
31037.0,2019-11-10,"(970.25, 1278.0]",1,18,-17
31038.0,2019-11-10,"(709.5, 773.0]",1,1,0
31038.0,2019-11-10,"(836.5, 900.0]",2,1,1
31039.0,2019-11-10,"(624.558, 735.5]",1,3,-2
31039.0,2019-11-10,"(735.5, 846.0]",2,8,-6
31039.0,2019-11-10,"(846.0, 956.5]",2,2,0
31039.0,2019-11-10,"(956.5, 1067.0]",4,6,-2
31040.0,2019-11-10,"(669.418, 815.5]",1,2,-1
31040.0,2019-11-10,"(815.5, 961.0]",1,1,0
31041.0,2019-11-10,"(727.513, 849.75]",7,11,-4
31041.0,2019-11-10,"(849.75, 971.5]",6,7,-1
31041.0,2019-11-10,"(971.5, 1093.25]",1,6,-5
31041.0,2019-11-10,"(1093.25, 1215.0]",2,4,-2
31042.0,2019-11-10,"(672.363, 832.25]",3,7,-4
31042.0,2019-11-10,"(832.25, 991.5]",11,12,-1
31042.0,2019-11-10,"(1150.75, 1310.0]",1,2,-1
31043.0,2019-11-10,"(915.25, 1036.0]",2,1,1
31044.0,2019-11-10,"(749.345, 913.75]",5,6,-1
31045.0,2019-11-10,"(673.409, 821.75]",1,1,0
31045.0,2019-11-10,"(1117.25, 1265.0]",1,1,0
31046.0,2019-11-10,"(758.75, 829.5]",3,2,1
31046.0,2019-11-10,"(829.5, 900.25]",1,4,-3
31046.0,2019-11-10,"(900.25, 971.0]",1,1,0
31047.0,2019-11-10,"(557.279, 738.25]",5,8,-3
31047.0,2019-11-10,"(738.25, 918.5]",1,3,-2
31048.0,2019-11-10,"(1033.5, 1197.0]",1,2,-1
31049.0,2019-11-10,"(455.429, 598.75]",1,1,0
31049.0,2019-11-10,"(598.75, 741.5]",1,1,0
,,,,1.0,
,,,,1.0,
31051.0,2019-11-10,"(627.5, 710.0]",1,1,0
31051.0,2019-11-10,"(792.5, 875.0]",1,3,-2
31052.0,2019-11-10,"(752.75, 771.5]",1,1,0
31053.0,2019-11-10,"(15.172, 223.0]",1,1,0
,,,,2.0,
31055.0,2019-11-10,"(706.86, 742.0]",1,2,-1
31056.0,2019-11-10,"(602.629, 695.75]",2,4,-2
31056.0,2019-11-10,"(695.75, 788.5]",3,4,-1
31057.0,2019-11-10,"(800.394, 952.5]",5,9,-4
31057.0,2019-11-10,"(1255.5, 1407.0]",1,1,0
,,,,2.0,
31059.0,2019-11-10,"(872.0, 953.0]",1,1,0
31060.0,2019-11-10,"(582.593, 684.75]",1,1,0
31060.0,2019-11-10,"(684.75, 786.5]",2,4,-2
31060.0,2019-11-10,"(786.5, 888.25]",2,2,0
31060.0,2019-11-10,"(888.25, 990.0]",1,6,-5
31061.0,2019-11-10,"(631.228, 825.0]",1,1,0
31062.0,2019-11-10,"(603.456, 740.0]",7,14,-7
31062.0,2019-11-10,"(740.0, 876.0]",7,16,-9
31062.0,2019-11-10,"(876.0, 1012.0]",9,23,-14
31062.0,2019-11-10,"(1012.0, 1148.0]",8,14,-6
31063.0,2019-11-10,"(842.985, 846.75]",1,2,-1
31063.0,2019-11-10,"(850.5, 854.25]",1,1,0
31064.0,2019-11-10,"(556.514, 678.5]",2,4,-2
31064.0,2019-11-10,"(678.5, 800.0]",9,18,-9
31064.0,2019-11-10,"(800.0, 921.5]",19,40,-21
31064.0,2019-11-10,"(921.5, 1043.0]",4,9,-5
31065.0,2019-11-10,"(794.5, 981.0]",2,4,-2
31065.0,2019-11-10,"(981.0, 1167.5]",1,2,-1
31066.0,2019-11-10,"(17.058, 253.5]",1,2,-1
31066.0,2019-11-10,"(724.5, 960.0]",3,7,-4
31067.0,2019-11-10,"(887.946, 901.5]",2,3,-1
31067.0,2019-11-10,"(928.5, 942.0]",1,1,0
31068.0,2019-11-10,"(732.396, 884.0]",2,5,-3
31068.0,2019-11-10,"(884.0, 1035.0]",2,2,0
31068.0,2019-11-10,"(1186.0, 1337.0]",1,1,0
31069.0,2019-11-10,"(683.503, 808.25]",1,3,-2
31069.0,2019-11-10,"(808.25, 932.5]",1,2,-1
31069.0,2019-11-10,"(1056.75, 1181.0]",1,1,0
31070.0,2019-11-10,"(867.0, 972.5]",1,1,0
31070.0,2019-11-10,"(972.5, 1078.0]",2,1,1
31071.0,2019-11-10,"(429.335, 596.25]",5,7,-2
31071.0,2019-11-10,"(596.25, 762.5]",2,8,-6
31071.0,2019-11-10,"(762.5, 928.75]",3,4,-1
31071.0,2019-11-10,"(928.75, 1095.0]",1,2,-1
,,,,2.0,
,,,,2.0,
31074.0,2019-11-10,"(1028.0, 1059.0]",1,1,0
31075.0,2019-11-10,"(783.0, 932.0]",2,1,1
31075.0,2019-11-10,"(932.0, 1081.0]",1,3,-2
,,,,1.0,
,,,,3.0,
,,,,1.0,
31077.0,2019-11-10,"(559.253, 746.75]",4,12,-8
31077.0,2019-11-10,"(746.75, 933.5]",4,8,-4
31077.0,2019-11-10,"(933.5, 1120.25]",4,7,-3
31077.0,2019-11-10,"(1120.25, 1307.0]",1,1,0
31078.0,2019-11-10,"(600.75, 801.0]",2,1,1
31079.0,2019-11-10,"(746.0, 1034.5]",4,1,3
31079.0,2019-11-10,"(1034.5, 1323.0]",4,2,2
31080.0,2019-11-10,"(573.172, 781.0]",3,9,-6
31080.0,2019-11-10,"(781.0, 988.0]",1,3,-2
31080.0,2019-11-10,"(988.0, 1195.0]",2,3,-1
31080.0,2019-11-10,"(1195.0, 1402.0]",1,1,0
31081.0,2019-11-10,"(880.0, 1012.0]",2,1,1
31082.0,2019-11-10,"(821.682, 901.5]",1,2,-1
31082.0,2019-11-10,"(1060.5, 1140.0]",2,4,-2
31083.0,2019-11-10,"(665.253, 852.75]",2,3,-1
31083.0,2019-11-10,"(852.75, 1039.5]",2,7,-5
31083.0,2019-11-10,"(1039.5, 1226.25]",3,3,0
31083.0,2019-11-10,"(1226.25, 1413.0]",1,2,-1
31084.0,2019-11-10,"(98.769, 407.75]",1,1,0
31085.0,2019-11-10,"(697.415, 844.25]",2,4,-2
31085.0,2019-11-10,"(844.25, 990.5]",1,2,-1
31085.0,2019-11-10,"(1136.75, 1283.0]",1,1,0
31086.0,2019-11-10,"(701.583, 806.25]",2,2,0
31086.0,2019-11-10,"(806.25, 910.5]",1,2,-1
31087.0,2019-11-10,"(765.0, 772.0]",1,2,-1
,,,,1.0,
,,,,1.0,
31089.0,2019-11-10,"(466.278, 647.5]",1,3,-2
31089.0,2019-11-10,"(647.5, 828.0]",1,4,-3
31089.0,2019-11-10,"(828.0, 1008.5]",2,7,-5
31089.0,2019-11-10,"(1008.5, 1189.0]",2,4,-2
31090.0,2019-11-10,"(626.338, 792.5]",1,2,-1
31090.0,2019-11-10,"(792.5, 958.0]",1,3,-2
31090.0,2019-11-10,"(1123.5, 1289.0]",1,2,-1
31091.0,2019-11-10,"(568.255, 755.25]",1,3,-2
31091.0,2019-11-10,"(755.25, 941.5]",1,5,-4
31091.0,2019-11-10,"(941.5, 1127.75]",1,2,-1
31091.0,2019-11-10,"(1127.75, 1314.0]",2,2,0
31092.0,2019-11-10,"(91.12, 312.0]",1,1,0
31092.0,2019-11-10,"(752.0, 972.0]",1,2,-1
31093.0,2019-11-10,"(815.776, 872.0]",1,3,-2
31093.0,2019-11-10,"(928.0, 984.0]",1,1,0
31094.0,2019-11-10,"(743.835, 785.25]",1,1,0
,,,,1.0,
,,,,2.0,
31096.0,2019-11-10,"(909.75, 1064.5]",1,1,0
31096.0,2019-11-10,"(1219.25, 1374.0]",1,2,-1
31097.0,2019-11-10,"(689.65, 777.5]",2,3,-1
31097.0,2019-11-10,"(865.0, 952.5]",1,1,0
31097.0,2019-11-10,"(952.5, 1040.0]",2,4,-2
31098.0,2019-11-10,"(703.0, 717.0]",4,2,2
31099.0,2019-11-10,"(627.634, 719.5]",1,1,0
31099.0,2019-11-10,"(902.5, 994.0]",1,3,-2
31100.0,2019-11-10,"(634.25, 822.5]",1,9,-8
31100.0,2019-11-10,"(822.5, 1010.0]",6,10,-4
31100.0,2019-11-10,"(1010.0, 1197.5]",2,10,-8
31101.0,2019-11-10,"(0.569, 359.75]",3,13,-10
31101.0,2019-11-10,"(359.75, 717.5]",27,44,-17
31101.0,2019-11-10,"(717.5, 1075.25]",51,95,-44
31101.0,2019-11-10,"(1075.25, 1433.0]",21,42,-21
31102.0,2019-11-10,"(23.587, 378.25]",3,9,-6
31102.0,2019-11-10,"(378.25, 731.5]",4,14,-10
31102.0,2019-11-10,"(731.5, 1084.75]",7,26,-19
31102.0,2019-11-10,"(1084.75, 1438.0]",6,11,-5
31103.0,2019-11-10,"(351.0, 680.0]",6,3,3
31103.0,2019-11-10,"(680.0, 1009.0]",11,19,-8
31103.0,2019-11-10,"(1009.0, 1338.0]",5,50,-45
31104.0,2019-11-10,"(42.668, 377.0]",1,7,-6
31104.0,2019-11-10,"(377.0, 710.0]",7,15,-8
31104.0,2019-11-10,"(710.0, 1043.0]",19,33,-14
31104.0,2019-11-10,"(1043.0, 1376.0]",12,37,-25
31105.0,2019-11-10,"(84.719, 406.25]",4,5,-1
31105.0,2019-11-10,"(406.25, 726.5]",1,8,-7
31105.0,2019-11-10,"(726.5, 1046.75]",4,21,-17
31105.0,2019-11-10,"(1046.75, 1367.0]",1,5,-4
31106.0,2019-11-10,"(77.799, 379.25]",1,3,-2
31106.0,2019-11-10,"(679.5, 979.75]",1,1,0
31106.0,2019-11-10,"(979.75, 1280.0]",3,6,-3
31107.0,2019-11-10,"(88.724, 409.0]",3,4,-1
31107.0,2019-11-10,"(409.0, 728.0]",3,12,-9
31107.0,2019-11-10,"(728.0, 1047.0]",15,32,-17
31107.0,2019-11-10,"(1047.0, 1366.0]",12,18,-6
31108.0,2019-11-10,"(5.672, 339.0]",5,5,0
31108.0,2019-11-10,"(339.0, 671.0]",6,18,-12
31108.0,2019-11-10,"(671.0, 1003.0]",12,33,-21
31108.0,2019-11-10,"(1003.0, 1335.0]",22,32,-10
31109.0,2019-11-10,"(32.609, 381.75]",1,5,-4
31109.0,2019-11-10,"(381.75, 729.5]",12,26,-14
31109.0,2019-11-10,"(729.5, 1077.25]",21,34,-13
31109.0,2019-11-10,"(1077.25, 1425.0]",13,28,-15
31110.0,2019-11-10,"(163.755, 476.25]",3,4,-1
31110.0,2019-11-10,"(476.25, 787.5]",15,32,-17
31110.0,2019-11-10,"(787.5, 1098.75]",15,28,-13
31110.0,2019-11-10,"(1098.75, 1410.0]",7,15,-8
31111.0,2019-11-10,"(60.644, 401.0]",2,8,-6
31111.0,2019-11-10,"(401.0, 740.0]",3,8,-5
31111.0,2019-11-10,"(740.0, 1079.0]",9,16,-7
31111.0,2019-11-10,"(1079.0, 1418.0]",16,26,-10
31112.0,2019-11-10,"(650.365, 809.75]",7,15,-8
31112.0,2019-11-10,"(809.75, 968.5]",3,4,-1
31112.0,2019-11-10,"(968.5, 1127.25]",3,9,-6
31112.0,2019-11-10,"(1127.25, 1286.0]",3,3,0
31113.0,2019-11-10,"(79.701, 405.75]",2,3,-1
31113.0,2019-11-10,"(405.75, 730.5]",3,14,-11
31113.0,2019-11-10,"(730.5, 1055.25]",12,34,-22
31113.0,2019-11-10,"(1055.25, 1380.0]",4,11,-7
31114.0,2019-11-10,"(8.59, 362.5]",4,10,-6
31114.0,2019-11-10,"(362.5, 715.0]",17,34,-17
31114.0,2019-11-10,"(715.0, 1067.5]",21,51,-30
31114.0,2019-11-10,"(1067.5, 1420.0]",10,21,-11
31115.0,2019-11-10,"(-1.427, 356.75]",2,4,-2
31115.0,2019-11-10,"(713.5, 1070.25]",7,10,-3
31115.0,2019-11-10,"(1070.25, 1427.0]",4,12,-8
31116.0,2019-11-10,"(35.709, 359.75]",4,6,-2
31116.0,2019-11-10,"(359.75, 682.5]",5,12,-7
31116.0,2019-11-10,"(682.5, 1005.25]",22,42,-20
31116.0,2019-11-10,"(1005.25, 1328.0]",5,10,-5
31117.0,2019-11-10,"(464.08, 695.0]",6,15,-9
31117.0,2019-11-10,"(695.0, 925.0]",5,13,-8
31117.0,2019-11-10,"(925.0, 1155.0]",4,9,-5
31117.0,2019-11-10,"(1155.0, 1385.0]",7,10,-3
31118.0,2019-11-10,"(38.618, 385.5]",4,4,0
31118.0,2019-11-10,"(385.5, 731.0]",2,11,-9
31118.0,2019-11-10,"(731.0, 1076.5]",9,16,-7
31118.0,2019-11-10,"(1076.5, 1422.0]",3,7,-4
31119.0,2019-11-10,"(32.628, 377.0]",2,7,-5
31119.0,2019-11-10,"(377.0, 720.0]",7,13,-6
31119.0,2019-11-10,"(720.0, 1063.0]",20,36,-16
31119.0,2019-11-10,"(1063.0, 1406.0]",10,19,-9
31120.0,2019-11-10,"(138.758, 450.5]",1,3,-2
31120.0,2019-11-10,"(450.5, 761.0]",5,13,-8
31120.0,2019-11-10,"(761.0, 1071.5]",8,21,-13
31120.0,2019-11-10,"(1071.5, 1382.0]",11,19,-8
31121.0,2019-11-10,"(462.045, 701.75]",2,8,-6
31121.0,2019-11-10,"(701.75, 940.5]",6,12,-6
31121.0,2019-11-10,"(940.5, 1179.25]",3,4,-1
31121.0,2019-11-10,"(1179.25, 1418.0]",2,5,-3
31122.0,2019-11-10,"(125.704, 451.0]",1,1,0
31122.0,2019-11-10,"(451.0, 775.0]",9,20,-11
31122.0,2019-11-10,"(775.0, 1099.0]",8,17,-9
31122.0,2019-11-10,"(1099.0, 1423.0]",4,9,-5
31123.0,2019-11-10,"(10.691, 339.25]",1,1,0
31123.0,2019-11-10,"(339.25, 666.5]",1,5,-4
31123.0,2019-11-10,"(666.5, 993.75]",2,9,-7
31123.0,2019-11-10,"(993.75, 1321.0]",6,12,-6
31124.0,2019-11-10,"(384.25, 733.5]",17,1,16
31124.0,2019-11-10,"(733.5, 1082.75]",23,31,-8
31124.0,2019-11-10,"(1082.75, 1432.0]",9,77,-68
31125.0,2019-11-10,"(39.628, 384.0]",4,5,-1
31125.0,2019-11-10,"(384.0, 727.0]",16,44,-28
31125.0,2019-11-10,"(727.0, 1070.0]",23,48,-25
31125.0,2019-11-10,"(1070.0, 1413.0]",20,33,-13
31126.0,2019-11-10,"(12.642, 353.5]",2,4,-2
31126.0,2019-11-10,"(353.5, 693.0]",5,21,-16
31126.0,2019-11-10,"(693.0, 1032.5]",16,32,-16
31126.0,2019-11-10,"(1032.5, 1372.0]",18,32,-14
31127.0,2019-11-10,"(482.072, 715.0]",10,16,-6
31127.0,2019-11-10,"(715.0, 947.0]",8,17,-9
31127.0,2019-11-10,"(947.0, 1179.0]",10,19,-9
31127.0,2019-11-10,"(1179.0, 1411.0]",6,10,-4
31128.0,2019-11-10,"(71.662, 407.5]",1,2,-1
31128.0,2019-11-10,"(407.5, 742.0]",9,17,-8
31128.0,2019-11-10,"(742.0, 1076.5]",18,33,-15
31128.0,2019-11-10,"(1076.5, 1411.0]",7,10,-3
31129.0,2019-11-10,"(435.033, 677.75]",17,19,-2
31129.0,2019-11-10,"(677.75, 919.5]",23,43,-20
31129.0,2019-11-10,"(919.5, 1161.25]",23,41,-18
31129.0,2019-11-10,"(1161.25, 1403.0]",4,10,-6
31130.0,2019-11-10,"(522.186, 726.5]",3,8,-5
31130.0,2019-11-10,"(726.5, 930.0]",5,13,-8
31130.0,2019-11-10,"(930.0, 1133.5]",5,12,-7
31130.0,2019-11-10,"(1133.5, 1337.0]",3,5,-2
31131.0,2019-11-10,"(52.627, 397.25]",4,5,-1
31131.0,2019-11-10,"(397.25, 740.5]",2,14,-12
31131.0,2019-11-10,"(740.5, 1083.75]",6,18,-12
31131.0,2019-11-10,"(1083.75, 1427.0]",2,4,-2
31200.0,2019-11-10,"(7.609, 356.75]",3,9,-6
31200.0,2019-11-10,"(356.75, 704.5]",45,63,-18
31200.0,2019-11-10,"(704.5, 1052.25]",47,87,-40
31200.0,2019-11-10,"(1052.25, 1400.0]",21,35,-14
31201.0,2019-11-10,"(17.594, 370.5]",2,5,-3
31201.0,2019-11-10,"(370.5, 722.0]",35,63,-28
31201.0,2019-11-10,"(722.0, 1073.5]",52,101,-49
31201.0,2019-11-10,"(1073.5, 1425.0]",19,42,-23
31202.0,2019-11-10,"(351.0, 693.0]",11,3,8
31202.0,2019-11-10,"(693.0, 1035.0]",35,15,20
31202.0,2019-11-10,"(1035.0, 1377.0]",13,64,-51
31203.0,2019-11-10,"(2.576, 360.0]",2,4,-2
31203.0,2019-11-10,"(360.0, 716.0]",10,22,-12
31203.0,2019-11-10,"(716.0, 1072.0]",35,58,-23
31203.0,2019-11-10,"(1072.0, 1428.0]",24,38,-14
31204.0,2019-11-10,"(41.683, 372.25]",1,2,-1
31204.0,2019-11-10,"(372.25, 701.5]",4,9,-5
31204.0,2019-11-10,"(701.5, 1030.75]",9,18,-9
31204.0,2019-11-10,"(1030.75, 1360.0]",8,13,-5
31205.0,2019-11-10,"(538.229, 731.75]",10,11,-1
31205.0,2019-11-10,"(731.75, 924.5]",9,15,-6
31205.0,2019-11-10,"(924.5, 1117.25]",4,9,-5
31205.0,2019-11-10,"(1117.25, 1310.0]",2,10,-8
31206.0,2019-11-10,"(859.562, 969.5]",2,5,-3
31207.0,2019-11-10,"(695.439, 836.25]",3,8,-5
31207.0,2019-11-10,"(836.25, 976.5]",1,6,-5
31207.0,2019-11-10,"(976.5, 1116.75]",1,2,-1
31207.0,2019-11-10,"(1116.75, 1257.0]",4,5,-1
31208.0,2019-11-10,"(65.738, 382.5]",1,1,0
31208.0,2019-11-10,"(382.5, 698.0]",1,2,-1
31208.0,2019-11-10,"(698.0, 1013.5]",4,7,-3
31208.0,2019-11-10,"(1013.5, 1329.0]",1,2,-1
31209.0,2019-11-10,"(688.5, 1022.25]",14,1,13
31209.0,2019-11-10,"(1022.25, 1356.0]",2,3,-1
31211.0,2019-11-10,"(561.272, 744.0]",2,3,-1
31211.0,2019-11-10,"(744.0, 926.0]",5,16,-11
31211.0,2019-11-10,"(926.0, 1108.0]",8,8,0
31211.0,2019-11-10,"(1108.0, 1290.0]",2,8,-6
31212.0,2019-11-10,"(131.763, 442.25]",2,3,-1
31212.0,2019-11-10,"(442.25, 751.5]",9,18,-9
31212.0,2019-11-10,"(751.5, 1060.75]",14,27,-13
31212.0,2019-11-10,"(1060.75, 1370.0]",3,9,-6
31213.0,2019-11-10,"(353.138, 569.5]",1,3,-2
31213.0,2019-11-10,"(569.5, 785.0]",4,5,-1
31213.0,2019-11-10,"(785.0, 1000.5]",7,17,-10
31213.0,2019-11-10,"(1000.5, 1216.0]",4,7,-3
31214.0,2019-11-10,"(1.572, 360.0]",1,2,-1
31214.0,2019-11-10,"(360.0, 717.0]",27,46,-19
31214.0,2019-11-10,"(717.0, 1074.0]",36,68,-32
31214.0,2019-11-10,"(1074.0, 1431.0]",17,33,-16
31215.0,2019-11-10,"(543.296, 720.0]",4,9,-5
31215.0,2019-11-10,"(720.0, 896.0]",4,4,0
31215.0,2019-11-10,"(896.0, 1072.0]",15,24,-9
31215.0,2019-11-10,"(1072.0, 1248.0]",4,6,-2
31216.0,2019-11-10,"(505.107, 729.25]",2,7,-5
31216.0,2019-11-10,"(729.25, 952.5]",5,10,-5
31216.0,2019-11-10,"(952.5, 1175.75]",2,5,-3
31216.0,2019-11-10,"(1175.75, 1399.0]",1,3,-2
31217.0,2019-11-10,"(578.498, 704.5]",2,5,-3
31217.0,2019-11-10,"(704.5, 830.0]",1,7,-6
31217.0,2019-11-10,"(830.0, 955.5]",4,9,-5
31217.0,2019-11-10,"(955.5, 1081.0]",5,5,0
31218.0,2019-11-10,"(514.16, 725.0]",3,9,-6
31218.0,2019-11-10,"(725.0, 935.0]",17,27,-10
31218.0,2019-11-10,"(935.0, 1145.0]",4,8,-4
31218.0,2019-11-10,"(1145.0, 1355.0]",2,3,-1
31219.0,2019-11-10,"(339.124, 559.0]",1,2,-1
31219.0,2019-11-10,"(559.0, 778.0]",17,29,-12
31219.0,2019-11-10,"(778.0, 997.0]",28,55,-27
31220.0,2019-11-10,"(401.418, 547.5]",1,2,-1
31220.0,2019-11-10,"(693.0, 838.5]",1,1,0
31221.0,2019-11-10,"(349.019, 595.25]",2,3,-1
31221.0,2019-11-10,"(595.25, 840.5]",2,8,-6
31221.0,2019-11-10,"(840.5, 1085.75]",10,17,-7
31221.0,2019-11-10,"(1085.75, 1331.0]",1,6,-5
31222.0,2019-11-10,"(316.12, 537.0]",1,2,-1
31222.0,2019-11-10,"(537.0, 757.0]",6,11,-5
31222.0,2019-11-10,"(757.0, 977.0]",15,21,-6
31222.0,2019-11-10,"(977.0, 1197.0]",6,12,-6
31223.0,2019-11-10,"(42.667, 377.25]",1,4,-3
31223.0,2019-11-10,"(377.25, 710.5]",14,20,-6
31223.0,2019-11-10,"(710.5, 1043.75]",11,33,-22
31223.0,2019-11-10,"(1043.75, 1377.0]",5,11,-6
31224.0,2019-11-10,"(30.705, 355.75]",1,3,-2
31224.0,2019-11-10,"(355.75, 679.5]",1,4,-3
31224.0,2019-11-10,"(679.5, 1003.25]",7,10,-3
31224.0,2019-11-10,"(1003.25, 1327.0]",1,6,-5
31225.0,2019-11-10,"(341.75, 676.5]",6,1,5
31225.0,2019-11-10,"(676.5, 1011.25]",25,8,17
31225.0,2019-11-10,"(1011.25, 1346.0]",10,41,-31
31226.0,2019-11-10,"(709.449, 847.75]",1,4,-3
31226.0,2019-11-10,"(847.75, 985.5]",3,4,-1
31226.0,2019-11-10,"(985.5, 1123.25]",1,2,-1
31226.0,2019-11-10,"(1123.25, 1261.0]",3,6,-3
31227.0,2019-11-10,"(35.773, 343.75]",2,2,0
31227.0,2019-11-10,"(343.75, 650.5]",3,4,-1
31227.0,2019-11-10,"(650.5, 957.25]",8,20,-12
31227.0,2019-11-10,"(957.25, 1264.0]",13,29,-16
31228.0,2019-11-10,"(378.0, 723.0]",9,1,8
31228.0,2019-11-10,"(723.0, 1068.0]",35,13,22
31228.0,2019-11-10,"(1068.0, 1413.0]",17,59,-42
31229.0,2019-11-10,"(6.584, 362.0]",4,9,-5
31229.0,2019-11-10,"(362.0, 716.0]",15,38,-23
31229.0,2019-11-10,"(716.0, 1070.0]",35,60,-25
31229.0,2019-11-10,"(1070.0, 1424.0]",19,35,-16
31230.0,2019-11-10,"(400.225, 594.75]",4,8,-4
31230.0,2019-11-10,"(594.75, 788.5]",13,14,-1
31230.0,2019-11-10,"(788.5, 982.25]",22,34,-12
31230.0,2019-11-10,"(982.25, 1176.0]",9,33,-24
31231.0,2019-11-10,"(472.38, 628.0]",1,2,-1
31231.0,2019-11-10,"(628.0, 783.0]",37,60,-23
31231.0,2019-11-10,"(783.0, 938.0]",17,23,-6
31231.0,2019-11-10,"(938.0, 1093.0]",7,9,-2
31232.0,2019-11-10,"(65.671, 399.25]",1,2,-1
31232.0,2019-11-10,"(399.25, 731.5]",13,18,-5
31232.0,2019-11-10,"(731.5, 1063.75]",34,62,-28
31232.0,2019-11-10,"(1063.75, 1396.0]",11,21,-10
31233.0,2019-11-10,"(47.625, 392.75]",2,3,-1
31233.0,2019-11-10,"(392.75, 736.5]",12,23,-11
31233.0,2019-11-10,"(736.5, 1080.25]",3,7,-4
31233.0,2019-11-10,"(1080.25, 1424.0]",4,6,-2
31234.0,2019-11-10,"(60.654, 398.5]",3,5,-2
31234.0,2019-11-10,"(398.5, 735.0]",10,20,-10
31234.0,2019-11-10,"(735.0, 1071.5]",12,28,-16
31234.0,2019-11-10,"(1071.5, 1408.0]",10,15,-5
31235.0,2019-11-10,"(501.104, 726.0]",15,17,-2
31235.0,2019-11-10,"(726.0, 950.0]",10,31,-21
31235.0,2019-11-10,"(950.0, 1174.0]",1,7,-6
31235.0,2019-11-10,"(1174.0, 1398.0]",2,3,-1
31236.0,2019-11-10,"(536.216, 733.0]",13,20,-7
31236.0,2019-11-10,"(733.0, 929.0]",6,15,-9
31236.0,2019-11-10,"(929.0, 1125.0]",17,23,-6
31236.0,2019-11-10,"(1125.0, 1321.0]",1,6,-5
31237.0,2019-11-10,"(364.0, 712.0]",12,1,11
31237.0,2019-11-10,"(712.0, 1060.0]",24,26,-2
31237.0,2019-11-10,"(1060.0, 1408.0]",9,40,-31
31238.0,2019-11-10,"(51.876, 334.0]",1,1,0
31238.0,2019-11-10,"(334.0, 615.0]",2,3,-1
31238.0,2019-11-10,"(615.0, 896.0]",5,8,-3
31238.0,2019-11-10,"(896.0, 1177.0]",7,9,-2
31239.0,2019-11-10,"(381.75, 729.5]",6,1,5
31239.0,2019-11-10,"(729.5, 1077.25]",14,11,3
31239.0,2019-11-10,"(1077.25, 1425.0]",2,23,-21
31240.0,2019-11-10,"(427.24, 618.0]",3,16,-13
31240.0,2019-11-10,"(618.0, 808.0]",21,38,-17
31240.0,2019-11-10,"(808.0, 998.0]",17,31,-14
31240.0,2019-11-10,"(998.0, 1188.0]",6,12,-6
31241.0,2019-11-10,"(199.805, 499.75]",1,2,-1
31241.0,2019-11-10,"(499.75, 798.5]",8,33,-25
31241.0,2019-11-10,"(798.5, 1097.25]",32,46,-14
31241.0,2019-11-10,"(1097.25, 1396.0]",12,20,-8
31242.0,2019-11-10,"(298.985, 553.75]",2,2,0
31242.0,2019-11-10,"(553.75, 807.5]",2,8,-6
31242.0,2019-11-10,"(807.5, 1061.25]",3,5,-2
31242.0,2019-11-10,"(1061.25, 1315.0]",1,2,-1
31243.0,2019-11-10,"(17.942, 283.5]",1,1,0
31243.0,2019-11-10,"(283.5, 548.0]",3,4,-1
31243.0,2019-11-10,"(548.0, 812.5]",12,23,-11
31243.0,2019-11-10,"(812.5, 1077.0]",11,21,-10
31244.0,2019-11-10,"(56.674, 389.5]",1,2,-1
31244.0,2019-11-10,"(389.5, 721.0]",1,3,-2
31244.0,2019-11-10,"(721.0, 1052.5]",15,19,-4
31244.0,2019-11-10,"(1052.5, 1384.0]",13,23,-10
31245.0,2019-11-10,"(6.591, 360.25]",1,3,-2
31245.0,2019-11-10,"(360.25, 712.5]",7,19,-12
31245.0,2019-11-10,"(712.5, 1064.75]",23,37,-14
31245.0,2019-11-10,"(1064.75, 1417.0]",5,13,-8
31246.0,2019-11-10,"(35.714, 358.5]",1,4,-3
31246.0,2019-11-10,"(358.5, 680.0]",14,19,-5
31246.0,2019-11-10,"(680.0, 1001.5]",17,39,-22
31246.0,2019-11-10,"(1001.5, 1323.0]",13,26,-13
31247.0,2019-11-10,"(406.006, 655.5]",22,30,-8
31247.0,2019-11-10,"(655.5, 904.0]",39,74,-35
31247.0,2019-11-10,"(904.0, 1152.5]",34,81,-47
31247.0,2019-11-10,"(1152.5, 1401.0]",16,29,-13
31248.0,2019-11-10,"(513.26, 699.0]",9,16,-7
31248.0,2019-11-10,"(699.0, 884.0]",37,66,-29
31248.0,2019-11-10,"(884.0, 1069.0]",38,76,-38
31248.0,2019-11-10,"(1069.0, 1254.0]",10,18,-8
31249.0,2019-11-10,"(440.096, 667.0]",3,3,0
31249.0,2019-11-10,"(667.0, 893.0]",31,61,-30
31249.0,2019-11-10,"(893.0, 1119.0]",25,46,-21
31249.0,2019-11-10,"(1119.0, 1345.0]",10,17,-7
31250.0,2019-11-10,"(57.741, 373.75]",2,4,-2
31250.0,2019-11-10,"(373.75, 688.5]",3,5,-2
31250.0,2019-11-10,"(688.5, 1003.25]",4,6,-2
31250.0,2019-11-10,"(1003.25, 1318.0]",4,9,-5
31251.0,2019-11-10,"(42.677, 374.75]",3,3,0
31251.0,2019-11-10,"(374.75, 705.5]",7,15,-8
31251.0,2019-11-10,"(705.5, 1036.25]",5,17,-12
31251.0,2019-11-10,"(1036.25, 1367.0]",6,10,-4
31252.0,2019-11-10,"(702.43, 845.5]",4,6,-2
31252.0,2019-11-10,"(845.5, 988.0]",1,1,0
31252.0,2019-11-10,"(988.0, 1130.5]",1,3,-2
31252.0,2019-11-10,"(1130.5, 1273.0]",2,3,-1
31253.0,2019-11-10,"(475.175, 682.25]",1,1,0
31253.0,2019-11-10,"(682.25, 888.5]",7,7,0
31253.0,2019-11-10,"(888.5, 1094.75]",2,6,-4
31254.0,2019-11-10,"(14.89, 293.5]",1,3,-2
31254.0,2019-11-10,"(293.5, 571.0]",1,2,-1
31254.0,2019-11-10,"(571.0, 848.5]",6,16,-10
31254.0,2019-11-10,"(848.5, 1126.0]",9,18,-9
31255.0,2019-11-10,"(57.833, 350.75]",1,2,-1
31255.0,2019-11-10,"(350.75, 642.5]",1,2,-1
31255.0,2019-11-10,"(934.25, 1226.0]",2,1,1
31256.0,2019-11-10,"(506.158, 717.5]",15,22,-7
31256.0,2019-11-10,"(717.5, 928.0]",11,20,-9
31256.0,2019-11-10,"(928.0, 1138.5]",7,14,-7
31257.0,2019-11-10,"(-1.336, 334.0]",1,1,0
31257.0,2019-11-10,"(334.0, 668.0]",9,12,-3
31257.0,2019-11-10,"(668.0, 1002.0]",16,33,-17
31257.0,2019-11-10,"(1002.0, 1336.0]",19,38,-19
31258.0,2019-11-10,"(371.0, 726.0]",15,3,12
31258.0,2019-11-10,"(726.0, 1081.0]",84,32,52
31258.0,2019-11-10,"(1081.0, 1436.0]",18,185,-167
31259.0,2019-11-10,"(817.5, 865.0]",1,1,0
31260.0,2019-11-10,"(800.25, 1003.5]",3,2,1
31260.0,2019-11-10,"(1003.5, 1206.75]",7,7,0
31260.0,2019-11-10,"(1206.75, 1410.0]",3,9,-6
31261.0,2019-11-10,"(443.223, 638.25]",1,1,0
31261.0,2019-11-10,"(832.5, 1026.75]",2,2,0
31261.0,2019-11-10,"(1026.75, 1221.0]",4,3,1
31262.0,2019-11-10,"(315.5, 612.0]",4,1,3
31262.0,2019-11-10,"(612.0, 908.5]",12,5,7
31262.0,2019-11-10,"(908.5, 1205.0]",6,22,-16
31263.0,2019-11-10,"(50.616, 398.0]",1,2,-1
31263.0,2019-11-10,"(398.0, 744.0]",6,17,-11
31263.0,2019-11-10,"(744.0, 1090.0]",19,31,-12
31263.0,2019-11-10,"(1090.0, 1436.0]",6,15,-9
31264.0,2019-11-10,"(440.048, 679.0]",2,4,-2
31264.0,2019-11-10,"(679.0, 917.0]",15,25,-10
31264.0,2019-11-10,"(917.0, 1155.0]",3,6,-3
31264.0,2019-11-10,"(1155.0, 1393.0]",4,8,-4
31265.0,2019-11-10,"(28.634, 371.5]",1,1,0
31265.0,2019-11-10,"(371.5, 713.0]",9,23,-14
31265.0,2019-11-10,"(713.0, 1054.5]",19,41,-22
31265.0,2019-11-10,"(1054.5, 1396.0]",12,19,-7
31266.0,2019-11-10,"(22.607, 372.25]",2,5,-3
31266.0,2019-11-10,"(372.25, 720.5]",5,25,-20
31266.0,2019-11-10,"(720.5, 1068.75]",27,53,-26
31266.0,2019-11-10,"(1068.75, 1417.0]",17,25,-8
31267.0,2019-11-10,"(83.711, 407.25]",3,5,-2
31267.0,2019-11-10,"(407.25, 729.5]",3,7,-4
31267.0,2019-11-10,"(729.5, 1051.75]",16,31,-15
31267.0,2019-11-10,"(1051.75, 1374.0]",10,19,-9
31268.0,2019-11-10,"(0.635, 343.25]",3,9,-6
31268.0,2019-11-10,"(343.25, 684.5]",12,16,-4
31268.0,2019-11-10,"(684.5, 1025.75]",21,43,-22
31268.0,2019-11-10,"(1025.75, 1367.0]",13,23,-10
31269.0,2019-11-10,"(518.247, 707.25]",11,14,-3
31269.0,2019-11-10,"(707.25, 895.5]",12,29,-17
31269.0,2019-11-10,"(895.5, 1083.75]",13,22,-9
31269.0,2019-11-10,"(1083.75, 1272.0]",2,6,-4
31270.0,2019-11-10,"(31.71, 355.5]",1,2,-1
31270.0,2019-11-10,"(678.0, 1000.5]",8,15,-7
31270.0,2019-11-10,"(1000.5, 1323.0]",6,14,-8
31271.0,2019-11-10,"(478.13, 696.5]",8,17,-9
31271.0,2019-11-10,"(696.5, 914.0]",25,52,-27
31271.0,2019-11-10,"(914.0, 1131.5]",7,19,-12
31271.0,2019-11-10,"(1131.5, 1349.0]",5,18,-13
31272.0,2019-11-10,"(11.586, 366.5]",2,2,0
31272.0,2019-11-10,"(366.5, 720.0]",4,6,-2
31272.0,2019-11-10,"(720.0, 1073.5]",26,55,-29
31272.0,2019-11-10,"(1073.5, 1427.0]",1,3,-2
31273.0,2019-11-10,"(560.295, 737.25]",9,16,-7
31273.0,2019-11-10,"(737.25, 913.5]",3,6,-3
31273.0,2019-11-10,"(913.5, 1089.75]",1,2,-1
31273.0,2019-11-10,"(1089.75, 1266.0]",1,2,-1
31274.0,2019-11-10,"(349.5, 689.0]",1,2,-1
31274.0,2019-11-10,"(689.0, 1028.5]",16,5,11
31274.0,2019-11-10,"(1028.5, 1368.0]",5,26,-21
31275.0,2019-11-10,"(15.635, 358.25]",4,6,-2
31275.0,2019-11-10,"(358.25, 699.5]",7,16,-9
31275.0,2019-11-10,"(699.5, 1040.75]",16,29,-13
31275.0,2019-11-10,"(1040.75, 1382.0]",11,23,-12
31276.0,2019-11-10,"(15.877, 297.75]",1,3,-2
31276.0,2019-11-10,"(578.5, 859.25]",5,1,4
31276.0,2019-11-10,"(859.25, 1140.0]",3,21,-18
31277.0,2019-11-10,"(470.15, 683.5]",6,12,-6
31277.0,2019-11-10,"(683.5, 896.0]",15,37,-22
31277.0,2019-11-10,"(896.0, 1108.5]",13,19,-6
31277.0,2019-11-10,"(1108.5, 1321.0]",2,5,-3
31278.0,2019-11-10,"(42.697, 369.75]",4,4,0
31278.0,2019-11-10,"(369.75, 695.5]",7,19,-12
31278.0,2019-11-10,"(695.5, 1021.25]",16,32,-16
31278.0,2019-11-10,"(1021.25, 1347.0]",11,19,-8
31279.0,2019-11-10,"(602.393, 754.75]",6,10,-4
31279.0,2019-11-10,"(754.75, 906.5]",2,5,-3
31279.0,2019-11-10,"(906.5, 1058.25]",5,10,-5
31279.0,2019-11-10,"(1058.25, 1210.0]",2,3,-1
31280.0,2019-11-10,"(410.25, 744.5]",16,2,14
31280.0,2019-11-10,"(744.5, 1078.75]",15,28,-13
31280.0,2019-11-10,"(1078.75, 1413.0]",3,28,-25
31000.0,2019-11-11,"(998.0, 1050.5]",1,4,-3
31000.0,2019-11-11,"(1050.5, 1103.0]",2,1,1
31001.0,2019-11-11,"(720.507, 844.25]",1,4,-3
31001.0,2019-11-11,"(844.25, 967.5]",3,6,-3
31001.0,2019-11-11,"(1090.75, 1214.0]",4,2,2
31002.0,2019-11-11,"(515.222, 710.5]",4,4,0
31002.0,2019-11-11,"(710.5, 905.0]",3,5,-2
31002.0,2019-11-11,"(1099.5, 1294.0]",2,4,-2
31003.0,2019-11-11,"(518.124, 738.0]",2,2,0
31003.0,2019-11-11,"(957.0, 1176.0]",2,7,-5
31003.0,2019-11-11,"(1176.0, 1395.0]",1,1,0
31004.0,2019-11-11,"(931.5, 1023.25]",2,2,0
31004.0,2019-11-11,"(1023.25, 1115.0]",3,2,1
31005.0,2019-11-11,"(438.049, 676.75]",2,5,-3
31005.0,2019-11-11,"(676.75, 914.5]",3,4,-1
31005.0,2019-11-11,"(914.5, 1152.25]",4,8,-4
31006.0,2019-11-11,"(571.521, 691.75]",1,2,-1
31006.0,2019-11-11,"(811.5, 931.25]",2,4,-2
31006.0,2019-11-11,"(931.25, 1051.0]",1,2,-1
31007.0,2019-11-11,"(379.244, 569.0]",2,7,-5
31007.0,2019-11-11,"(569.0, 758.0]",5,8,-3
31007.0,2019-11-11,"(758.0, 947.0]",5,9,-4
31007.0,2019-11-11,"(947.0, 1136.0]",4,10,-6
31009.0,2019-11-11,"(429.381, 584.75]",2,2,0
31009.0,2019-11-11,"(894.25, 1049.0]",2,1,1
31010.0,2019-11-11,"(363.968, 623.0]",3,6,-3
31010.0,2019-11-11,"(881.0, 1139.0]",5,4,1
31010.0,2019-11-11,"(1139.0, 1397.0]",5,5,0
31011.0,2019-11-11,"(381.205, 580.75]",5,7,-2
31011.0,2019-11-11,"(580.75, 779.5]",1,1,0
31011.0,2019-11-11,"(779.5, 978.25]",2,4,-2
31012.0,2019-11-11,"(501.423, 646.25]",2,3,-1
31012.0,2019-11-11,"(790.5, 934.75]",1,1,0
31013.0,2019-11-11,"(495.31, 668.5]",2,8,-6
31013.0,2019-11-11,"(668.5, 841.0]",2,2,0
31013.0,2019-11-11,"(1013.5, 1186.0]",2,4,-2
31014.0,2019-11-11,"(323.022, 568.5]",13,19,-6
31014.0,2019-11-11,"(568.5, 813.0]",7,9,-2
31014.0,2019-11-11,"(813.0, 1057.5]",13,24,-11
31014.0,2019-11-11,"(1057.5, 1302.0]",9,22,-13
31015.0,2019-11-11,"(1.709, 325.75]",9,9,0
31015.0,2019-11-11,"(325.75, 648.5]",2,4,-2
31015.0,2019-11-11,"(648.5, 971.25]",1,4,-3
31015.0,2019-11-11,"(971.25, 1294.0]",8,11,-3
31016.0,2019-11-11,"(307.187, 511.25]",1,2,-1
31016.0,2019-11-11,"(511.25, 714.5]",4,8,-4
31016.0,2019-11-11,"(714.5, 917.75]",1,3,-2
31016.0,2019-11-11,"(917.75, 1121.0]",1,6,-5
31017.0,2019-11-11,"(473.341, 638.75]",3,5,-2
31017.0,2019-11-11,"(638.75, 803.5]",1,2,-1
31017.0,2019-11-11,"(803.5, 968.25]",2,6,-4
31017.0,2019-11-11,"(968.25, 1133.0]",2,8,-6
31018.0,2019-11-11,"(473.225, 667.75]",1,7,-6
31018.0,2019-11-11,"(667.75, 861.5]",1,4,-3
31018.0,2019-11-11,"(861.5, 1055.25]",2,3,-1
31018.0,2019-11-11,"(1055.25, 1249.0]",2,2,0
31019.0,2019-11-11,"(872.0, 1011.0]",1,1,0
31019.0,2019-11-11,"(1011.0, 1150.0]",1,2,-1
31020.0,2019-11-11,"(763.5, 979.0]",3,3,0
31020.0,2019-11-11,"(979.0, 1194.5]",1,5,-4
31021.0,2019-11-11,"(372.122, 592.5]",4,6,-2
31021.0,2019-11-11,"(592.5, 812.0]",1,3,-2
31021.0,2019-11-11,"(812.0, 1031.5]",4,9,-5
31021.0,2019-11-11,"(1031.5, 1251.0]",6,10,-4
31022.0,2019-11-11,"(854.52, 975.0]",1,3,-2
31022.0,2019-11-11,"(975.0, 1095.0]",2,5,-3
31022.0,2019-11-11,"(1215.0, 1335.0]",3,1,2
31023.0,2019-11-11,"(694.0, 1013.0]",1,1,0
31023.0,2019-11-11,"(1013.0, 1332.0]",2,2,0
31024.0,2019-11-11,"(310.989, 564.75]",2,3,-1
31024.0,2019-11-11,"(564.75, 817.5]",1,4,-3
31024.0,2019-11-11,"(817.5, 1070.25]",2,5,-3
31024.0,2019-11-11,"(1070.25, 1323.0]",6,7,-1
31025.0,2019-11-11,"(783.25, 860.5]",1,1,0
31025.0,2019-11-11,"(937.75, 1015.0]",1,2,-1
31026.0,2019-11-11,"(601.456, 738.0]",2,3,-1
31026.0,2019-11-11,"(738.0, 874.0]",2,2,0
31026.0,2019-11-11,"(874.0, 1010.0]",2,3,-1
31026.0,2019-11-11,"(1010.0, 1146.0]",2,4,-2
31027.0,2019-11-11,"(890.5, 1078.25]",1,1,0
31027.0,2019-11-11,"(1078.25, 1266.0]",2,2,0
31028.0,2019-11-11,"(1000.0, 1028.0]",1,1,0
31029.0,2019-11-11,"(642.46, 778.0]",4,8,-4
31029.0,2019-11-11,"(1048.0, 1183.0]",1,1,0
31030.0,2019-11-11,"(706.5, 942.0]",4,6,-2
31030.0,2019-11-11,"(942.0, 1177.5]",5,7,-2
31030.0,2019-11-11,"(1177.5, 1413.0]",1,6,-5
31031.0,2019-11-11,"(700.5, 902.0]",3,3,0
31031.0,2019-11-11,"(902.0, 1103.5]",3,4,-1
31031.0,2019-11-11,"(1103.5, 1305.0]",1,3,-2
31032.0,2019-11-11,"(632.0, 827.0]",1,1,0
31033.0,2019-11-11,"(919.5, 926.0]",1,1,0
31034.0,2019-11-11,"(755.75, 953.5]",2,1,1
31035.0,2019-11-11,"(586.75, 860.5]",3,3,0
31035.0,2019-11-11,"(860.5, 1134.25]",1,5,-4
31035.0,2019-11-11,"(1134.25, 1408.0]",1,4,-3
31036.0,2019-11-11,"(894.5, 1114.75]",3,3,0
31036.0,2019-11-11,"(1114.75, 1335.0]",1,6,-5
31037.0,2019-11-11,"(314.003, 564.25]",9,11,-2
31037.0,2019-11-11,"(564.25, 813.5]",6,10,-4
31037.0,2019-11-11,"(813.5, 1062.75]",4,11,-7
31037.0,2019-11-11,"(1062.75, 1312.0]",6,21,-15
31038.0,2019-11-11,"(709.605, 808.75]",1,1,0
31038.0,2019-11-11,"(907.5, 1006.25]",1,2,-1
31038.0,2019-11-11,"(1006.25, 1105.0]",1,1,0
31039.0,2019-11-11,"(548.443, 688.25]",2,2,0
31039.0,2019-11-11,"(688.25, 827.5]",1,5,-4
31039.0,2019-11-11,"(827.5, 966.75]",2,2,0
31040.0,2019-11-11,"(447.125, 666.75]",2,2,0
31040.0,2019-11-11,"(885.5, 1104.25]",2,1,1
31040.0,2019-11-11,"(1104.25, 1323.0]",1,3,-2
31041.0,2019-11-11,"(513.237, 704.75]",4,4,0
31041.0,2019-11-11,"(704.75, 895.5]",5,10,-5
31041.0,2019-11-11,"(895.5, 1086.25]",5,11,-6
31041.0,2019-11-11,"(1086.25, 1277.0]",1,2,-1
31042.0,2019-11-11,"(473.176, 680.0]",2,3,-1
31042.0,2019-11-11,"(680.0, 886.0]",1,3,-2
31042.0,2019-11-11,"(886.0, 1092.0]",6,15,-9
31042.0,2019-11-11,"(1092.0, 1298.0]",3,10,-7
31043.0,2019-11-11,"(429.314, 601.5]",3,4,-1
31043.0,2019-11-11,"(601.5, 773.0]",3,3,0
31043.0,2019-11-11,"(773.0, 944.5]",5,7,-2
31044.0,2019-11-11,"(540.373, 697.75]",3,3,0
31044.0,2019-11-11,"(697.75, 854.5]",3,4,-1
31044.0,2019-11-11,"(854.5, 1011.25]",1,1,0
31044.0,2019-11-11,"(1011.25, 1168.0]",1,2,-1
31045.0,2019-11-11,"(516.099, 742.25]",2,2,0
31045.0,2019-11-11,"(742.25, 967.5]",5,5,0
31046.0,2019-11-11,"(637.0, 783.0]",1,2,-1
31046.0,2019-11-11,"(929.0, 1075.0]",2,2,0
31047.0,2019-11-11,"(424.002, 674.5]",5,14,-9
31047.0,2019-11-11,"(674.5, 924.0]",4,9,-5
31047.0,2019-11-11,"(924.0, 1173.5]",7,17,-10
31047.0,2019-11-11,"(1173.5, 1423.0]",1,5,-4
31048.0,2019-11-11,"(508.171, 716.25]",1,3,-2
31048.0,2019-11-11,"(716.25, 923.5]",3,4,-1
31048.0,2019-11-11,"(923.5, 1130.75]",2,5,-3
31049.0,2019-11-11,"(723.5, 933.0]",1,1,0
31049.0,2019-11-11,"(933.0, 1142.5]",1,1,0
31049.0,2019-11-11,"(1142.5, 1352.0]",3,3,0
31050.0,2019-11-11,"(324.291, 502.25]",1,2,-1
31050.0,2019-11-11,"(856.75, 1034.0]",3,1,2
31051.0,2019-11-11,"(303.958, 565.5]",1,3,-2
31051.0,2019-11-11,"(565.5, 826.0]",2,6,-4
31051.0,2019-11-11,"(826.0, 1086.5]",3,5,-2
31051.0,2019-11-11,"(1086.5, 1347.0]",3,3,0
31052.0,2019-11-11,"(516.325, 685.75]",2,2,0
31052.0,2019-11-11,"(854.5, 1023.25]",2,3,-1
31052.0,2019-11-11,"(1023.25, 1192.0]",4,3,1
31053.0,2019-11-11,"(446.683, 526.25]",1,1,0
31054.0,2019-11-11,"(687.75, 917.0]",1,1,0
31055.0,2019-11-11,"(612.25, 747.5]",1,1,0
31055.0,2019-11-11,"(882.75, 1018.0]",1,1,0
31056.0,2019-11-11,"(62.743, 378.25]",1,1,0
31056.0,2019-11-11,"(1006.75, 1321.0]",1,2,-1
31057.0,2019-11-11,"(468.38, 624.0]",1,2,-1
31057.0,2019-11-11,"(934.0, 1089.0]",5,3,2
,,,,1.0,
,,,,1.0,
31059.0,2019-11-11,"(409.312, 582.0]",1,2,-1
31059.0,2019-11-11,"(926.0, 1098.0]",7,2,5
31060.0,2019-11-11,"(366.75, 681.5]",1,1,0
31060.0,2019-11-11,"(681.5, 996.25]",2,4,-2
31061.0,2019-11-11,"(599.546, 713.5]",1,1,0
31061.0,2019-11-11,"(940.5, 1054.0]",1,2,-1
31062.0,2019-11-11,"(621.546, 735.5]",4,8,-4
31062.0,2019-11-11,"(735.5, 849.0]",2,8,-6
31062.0,2019-11-11,"(849.0, 962.5]",11,17,-6
31062.0,2019-11-11,"(962.5, 1076.0]",6,12,-6
31063.0,2019-11-11,"(645.75, 765.5]",1,1,0
31063.0,2019-11-11,"(885.25, 1005.0]",1,2,-1
31064.0,2019-11-11,"(492.41, 640.5]",7,16,-9
31064.0,2019-11-11,"(640.5, 788.0]",10,20,-10
31064.0,2019-11-11,"(788.0, 935.5]",21,40,-19
31064.0,2019-11-11,"(935.5, 1083.0]",13,24,-11
31065.0,2019-11-11,"(883.0, 1140.5]",2,3,-1
31065.0,2019-11-11,"(1140.5, 1398.0]",1,3,-2
31066.0,2019-11-11,"(999.5, 1074.0]",1,1,0
31066.0,2019-11-11,"(1148.5, 1223.0]",1,1,0
31067.0,2019-11-11,"(487.373, 644.75]",1,4,-3
31067.0,2019-11-11,"(801.5, 958.25]",1,2,-1
31067.0,2019-11-11,"(958.25, 1115.0]",2,3,-1
31068.0,2019-11-11,"(537.189, 740.75]",3,5,-2
31068.0,2019-11-11,"(740.75, 943.5]",1,2,-1
31068.0,2019-11-11,"(1146.25, 1349.0]",1,1,0
31069.0,2019-11-11,"(431.143, 646.25]",1,4,-3
31069.0,2019-11-11,"(860.5, 1074.75]",2,1,1
31069.0,2019-11-11,"(1074.75, 1289.0]",5,4,1
31070.0,2019-11-11,"(491.257, 677.75]",1,3,-2
31070.0,2019-11-11,"(677.75, 863.5]",2,2,0
31070.0,2019-11-11,"(1049.25, 1235.0]",2,2,0
31071.0,2019-11-11,"(384.327, 553.25]",3,5,-2
31071.0,2019-11-11,"(553.25, 721.5]",2,8,-6
31071.0,2019-11-11,"(721.5, 889.75]",3,4,-1
31071.0,2019-11-11,"(889.75, 1058.0]",8,13,-5
,,,,1.0,
,,,,1.0,
,,,,1.0,
31073.0,2019-11-11,"(687.75, 917.0]",1,1,0
,,,,1.0,
,,,,1.0,
31075.0,2019-11-11,"(852.75, 1137.0]",3,1,2
31076.0,2019-11-11,"(417.109, 640.75]",1,1,0
31076.0,2019-11-11,"(640.75, 863.5]",2,3,-1
31076.0,2019-11-11,"(1086.25, 1309.0]",1,2,-1
31077.0,2019-11-11,"(453.158, 664.5]",5,6,-1
31077.0,2019-11-11,"(664.5, 875.0]",10,20,-10
31077.0,2019-11-11,"(875.0, 1085.5]",8,16,-8
31077.0,2019-11-11,"(1085.5, 1296.0]",3,5,-2
,,,,2.0,
31079.0,2019-11-11,"(678.75, 922.5]",2,5,-3
31079.0,2019-11-11,"(1166.25, 1410.0]",7,4,3
31080.0,2019-11-11,"(450.028, 694.0]",2,12,-10
31080.0,2019-11-11,"(694.0, 937.0]",1,2,-1
31080.0,2019-11-11,"(937.0, 1180.0]",3,5,-2
31080.0,2019-11-11,"(1180.0, 1423.0]",5,6,-1
31081.0,2019-11-11,"(516.246, 705.5]",2,4,-2
31081.0,2019-11-11,"(894.0, 1082.5]",1,1,0
31081.0,2019-11-11,"(1082.5, 1271.0]",1,3,-2
31082.0,2019-11-11,"(784.534, 901.5]",1,3,-2
31082.0,2019-11-11,"(1018.0, 1134.5]",1,1,0
31082.0,2019-11-11,"(1134.5, 1251.0]",1,1,0
31083.0,2019-11-11,"(693.556, 805.0]",1,4,-3
31083.0,2019-11-11,"(805.0, 916.0]",2,2,0
31083.0,2019-11-11,"(916.0, 1027.0]",2,2,0
31083.0,2019-11-11,"(1027.0, 1138.0]",1,1,0
31084.0,2019-11-11,"(514.534, 631.5]",1,2,-1
31085.0,2019-11-11,"(762.5, 880.75]",1,2,-1
31086.0,2019-11-11,"(98.986, 353.5]",1,1,0
31086.0,2019-11-11,"(860.5, 1114.0]",3,1,2
31087.0,2019-11-11,"(835.0, 1004.0]",4,1,3
31087.0,2019-11-11,"(1004.0, 1173.0]",3,4,-1
31088.0,2019-11-11,"(220.851, 509.25]",1,1,0
31088.0,2019-11-11,"(796.5, 1083.75]",3,2,1
31088.0,2019-11-11,"(1083.75, 1371.0]",3,4,-1
31089.0,2019-11-11,"(439.07, 672.5]",2,5,-3
31089.0,2019-11-11,"(672.5, 905.0]",5,6,-1
31089.0,2019-11-11,"(905.0, 1137.5]",5,17,-12
31089.0,2019-11-11,"(1137.5, 1370.0]",1,9,-8
31090.0,2019-11-11,"(634.597, 735.75]",2,2,0
31090.0,2019-11-11,"(735.75, 836.5]",2,5,-3
31090.0,2019-11-11,"(836.5, 937.25]",1,1,0
31090.0,2019-11-11,"(937.25, 1038.0]",1,2,-1
31091.0,2019-11-11,"(737.0, 918.0]",2,2,0
31091.0,2019-11-11,"(918.0, 1099.0]",1,1,0
31092.0,2019-11-11,"(63.68, 395.0]",1,1,0
31092.0,2019-11-11,"(725.0, 1055.0]",3,2,1
,,,,1.0,
,,,,1.0,
31094.0,2019-11-11,"(664.251, 852.25]",1,1,0
31094.0,2019-11-11,"(852.25, 1039.5]",1,2,-1
31094.0,2019-11-11,"(1039.5, 1226.75]",1,2,-1
31094.0,2019-11-11,"(1226.75, 1414.0]",1,2,-1
,,,,1.0,
,,,,1.0,
31096.0,2019-11-11,"(1094.5, 1262.0]",1,2,-1
31097.0,2019-11-11,"(465.208, 664.0]",3,4,-1
31097.0,2019-11-11,"(664.0, 862.0]",1,2,-1
31097.0,2019-11-11,"(862.0, 1060.0]",2,5,-3
31097.0,2019-11-11,"(1060.0, 1258.0]",1,4,-3
31098.0,2019-11-11,"(466.203, 666.25]",2,8,-6
31098.0,2019-11-11,"(666.25, 865.5]",2,3,-1
31098.0,2019-11-11,"(865.5, 1064.75]",4,6,-2
31098.0,2019-11-11,"(1064.75, 1264.0]",4,8,-4
31099.0,2019-11-11,"(544.199, 745.25]",2,2,0
31099.0,2019-11-11,"(945.5, 1145.75]",3,5,-2
31099.0,2019-11-11,"(1145.75, 1346.0]",1,1,0
31100.0,2019-11-11,"(392.17, 600.5]",16,17,-1
31100.0,2019-11-11,"(600.5, 808.0]",2,6,-4
31100.0,2019-11-11,"(808.0, 1015.5]",5,12,-7
31100.0,2019-11-11,"(1015.5, 1223.0]",2,15,-13
31101.0,2019-11-11,"(333.96, 595.0]",6,36,-30
31101.0,2019-11-11,"(595.0, 855.0]",21,51,-30
31101.0,2019-11-11,"(855.0, 1115.0]",54,77,-23
31101.0,2019-11-11,"(1115.0, 1375.0]",34,54,-20
31102.0,2019-11-11,"(402.042, 642.5]",2,27,-25
31102.0,2019-11-11,"(642.5, 882.0]",6,14,-8
31102.0,2019-11-11,"(882.0, 1121.5]",10,24,-14
31102.0,2019-11-11,"(1121.5, 1361.0]",10,14,-4
31103.0,2019-11-11,"(70.731, 389.25]",2,5,-3
31103.0,2019-11-11,"(389.25, 706.5]",1,34,-33
31103.0,2019-11-11,"(706.5, 1023.75]",6,35,-29
31103.0,2019-11-11,"(1023.75, 1341.0]",13,29,-16
31104.0,2019-11-11,"(394.978, 651.5]",3,6,-3
31104.0,2019-11-11,"(651.5, 907.0]",14,30,-16
31104.0,2019-11-11,"(907.0, 1162.5]",23,38,-15
31104.0,2019-11-11,"(1162.5, 1418.0]",10,19,-9
31105.0,2019-11-11,"(442.187, 646.25]",1,8,-7
31105.0,2019-11-11,"(849.5, 1052.75]",1,2,-1
31105.0,2019-11-11,"(1052.75, 1256.0]",4,6,-2
31106.0,2019-11-11,"(366.25, 658.5]",1,1,0
31106.0,2019-11-11,"(658.5, 950.75]",4,6,-2
31106.0,2019-11-11,"(950.75, 1243.0]",2,7,-5
31107.0,2019-11-11,"(294.923, 565.25]",1,16,-15
31107.0,2019-11-11,"(565.25, 834.5]",8,20,-12
31107.0,2019-11-11,"(834.5, 1103.75]",14,23,-9
31107.0,2019-11-11,"(1103.75, 1373.0]",7,12,-5
31108.0,2019-11-11,"(454.104, 679.0]",4,24,-20
31108.0,2019-11-11,"(679.0, 903.0]",17,30,-13
31108.0,2019-11-11,"(903.0, 1127.0]",34,57,-23
31108.0,2019-11-11,"(1127.0, 1351.0]",15,18,-3
31109.0,2019-11-11,"(-0.436, 360.0]",1,8,-7
31109.0,2019-11-11,"(360.0, 719.0]",5,10,-5
31109.0,2019-11-11,"(719.0, 1078.0]",22,34,-12
31109.0,2019-11-11,"(1078.0, 1437.0]",18,36,-18
31110.0,2019-11-11,"(32.776, 340.0]",3,5,-2
31110.0,2019-11-11,"(340.0, 646.0]",12,36,-24
31110.0,2019-11-11,"(646.0, 952.0]",18,36,-18
31110.0,2019-11-11,"(952.0, 1258.0]",22,44,-22
31111.0,2019-11-11,"(25.662, 361.5]",1,5,-4
31111.0,2019-11-11,"(361.5, 696.0]",5,13,-8
31111.0,2019-11-11,"(696.0, 1030.5]",10,18,-8
31111.0,2019-11-11,"(1030.5, 1365.0]",18,27,-9
31112.0,2019-11-11,"(529.396, 681.0]",2,4,-2
31112.0,2019-11-11,"(681.0, 832.0]",1,2,-1
31112.0,2019-11-11,"(832.0, 983.0]",1,2,-1
31112.0,2019-11-11,"(983.0, 1134.0]",1,3,-2
31113.0,2019-11-11,"(6.58, 363.0]",1,2,-1
31113.0,2019-11-11,"(363.0, 718.0]",1,14,-13
31113.0,2019-11-11,"(718.0, 1073.0]",10,23,-13
31113.0,2019-11-11,"(1073.0, 1428.0]",11,20,-9
31114.0,2019-11-11,"(22.654, 360.5]",2,2,0
31114.0,2019-11-11,"(360.5, 697.0]",3,28,-25
31114.0,2019-11-11,"(697.0, 1033.5]",10,25,-15
31114.0,2019-11-11,"(1033.5, 1370.0]",35,47,-12
31115.0,2019-11-11,"(182.865, 467.75]",1,4,-3
31115.0,2019-11-11,"(467.75, 751.5]",4,21,-17
31115.0,2019-11-11,"(751.5, 1035.25]",3,10,-7
31115.0,2019-11-11,"(1035.25, 1319.0]",16,30,-14
31116.0,2019-11-11,"(131.711, 455.25]",4,9,-5
31116.0,2019-11-11,"(455.25, 777.5]",10,38,-28
31116.0,2019-11-11,"(777.5, 1099.75]",24,43,-19
31116.0,2019-11-11,"(1099.75, 1422.0]",15,19,-4
31117.0,2019-11-11,"(319.927, 589.25]",5,16,-11
31117.0,2019-11-11,"(589.25, 857.5]",2,10,-8
31117.0,2019-11-11,"(857.5, 1125.75]",3,13,-10
31117.0,2019-11-11,"(1125.75, 1394.0]",10,17,-7
31118.0,2019-11-11,"(26.696, 354.0]",1,1,0
31118.0,2019-11-11,"(354.0, 680.0]",1,4,-3
31118.0,2019-11-11,"(680.0, 1006.0]",8,14,-6
31118.0,2019-11-11,"(1006.0, 1332.0]",21,29,-8
31119.0,2019-11-11,"(344.921, 615.75]",4,20,-16
31119.0,2019-11-11,"(615.75, 885.5]",6,11,-5
31119.0,2019-11-11,"(885.5, 1155.25]",17,24,-7
31119.0,2019-11-11,"(1155.25, 1425.0]",7,16,-9
31120.0,2019-11-11,"(50.648, 390.0]",4,6,-2
31120.0,2019-11-11,"(390.0, 728.0]",1,6,-5
31120.0,2019-11-11,"(728.0, 1066.0]",10,19,-9
31120.0,2019-11-11,"(1066.0, 1404.0]",10,18,-8
31121.0,2019-11-11,"(397.039, 638.25]",8,15,-7
31121.0,2019-11-11,"(638.25, 878.5]",10,19,-9
31121.0,2019-11-11,"(878.5, 1118.75]",8,17,-9
31121.0,2019-11-11,"(1118.75, 1359.0]",5,10,-5
31122.0,2019-11-11,"(317.097, 543.75]",1,5,-4
31122.0,2019-11-11,"(543.75, 769.5]",7,18,-11
31122.0,2019-11-11,"(769.5, 995.25]",3,11,-8
31122.0,2019-11-11,"(995.25, 1221.0]",8,15,-7
31123.0,2019-11-11,"(376.003, 626.25]",2,15,-13
31123.0,2019-11-11,"(626.25, 875.5]",2,4,-2
31123.0,2019-11-11,"(875.5, 1124.75]",3,8,-5
31123.0,2019-11-11,"(1124.75, 1374.0]",2,6,-4
31124.0,2019-11-11,"(303.884, 584.0]",8,28,-20
31124.0,2019-11-11,"(584.0, 863.0]",17,54,-37
31124.0,2019-11-11,"(863.0, 1142.0]",27,74,-47
31124.0,2019-11-11,"(1142.0, 1421.0]",16,39,-23
31125.0,2019-11-11,"(277.888, 557.0]",8,28,-20
31125.0,2019-11-11,"(557.0, 835.0]",7,14,-7
31125.0,2019-11-11,"(835.0, 1113.0]",28,42,-14
31125.0,2019-11-11,"(1113.0, 1391.0]",13,20,-7
31126.0,2019-11-11,"(20.655, 358.25]",1,4,-3
31126.0,2019-11-11,"(358.25, 694.5]",3,24,-21
31126.0,2019-11-11,"(694.5, 1030.75]",15,36,-21
31126.0,2019-11-11,"(1030.75, 1367.0]",26,37,-11
31127.0,2019-11-11,"(459.067, 693.25]",6,11,-5
31127.0,2019-11-11,"(693.25, 926.5]",8,18,-10
31127.0,2019-11-11,"(926.5, 1159.75]",10,28,-18
31127.0,2019-11-11,"(1159.75, 1393.0]",5,14,-9
31128.0,2019-11-11,"(7.598, 359.5]",1,3,-2
31128.0,2019-11-11,"(359.5, 710.0]",32,46,-14
31128.0,2019-11-11,"(710.0, 1060.5]",21,41,-20
31128.0,2019-11-11,"(1060.5, 1411.0]",9,24,-15
31129.0,2019-11-11,"(334.001, 584.75]",6,7,-1
31129.0,2019-11-11,"(584.75, 834.5]",8,15,-7
31129.0,2019-11-11,"(834.5, 1084.25]",20,45,-25
31129.0,2019-11-11,"(1084.25, 1334.0]",3,9,-6
31130.0,2019-11-11,"(40.692, 369.0]",1,1,0
31130.0,2019-11-11,"(369.0, 696.0]",5,23,-18
31130.0,2019-11-11,"(696.0, 1023.0]",8,14,-6
31130.0,2019-11-11,"(1023.0, 1350.0]",9,18,-9
31131.0,2019-11-11,"(441.008, 690.0]",1,13,-12
31131.0,2019-11-11,"(690.0, 938.0]",1,4,-3
31131.0,2019-11-11,"(938.0, 1186.0]",4,8,-4
31131.0,2019-11-11,"(1186.0, 1434.0]",3,4,-1
31200.0,2019-11-11,"(344.984, 600.0]",23,32,-9
31200.0,2019-11-11,"(600.0, 854.0]",27,46,-19
31200.0,2019-11-11,"(854.0, 1108.0]",31,59,-28
31200.0,2019-11-11,"(1108.0, 1362.0]",10,33,-23
31201.0,2019-11-11,"(39.605, 389.75]",2,3,-1
31201.0,2019-11-11,"(389.75, 738.5]",20,47,-27
31201.0,2019-11-11,"(738.5, 1087.25]",60,105,-45
31201.0,2019-11-11,"(1087.25, 1436.0]",28,56,-28
31202.0,2019-11-11,"(216.812, 515.0]",5,11,-6
31202.0,2019-11-11,"(515.0, 812.0]",20,33,-13
31202.0,2019-11-11,"(812.0, 1109.0]",33,58,-25
31202.0,2019-11-11,"(1109.0, 1406.0]",12,28,-16
31203.0,2019-11-11,"(18.586, 373.5]",1,5,-4
31203.0,2019-11-11,"(373.5, 727.0]",10,37,-27
31203.0,2019-11-11,"(727.0, 1080.5]",51,75,-24
31203.0,2019-11-11,"(1080.5, 1434.0]",25,47,-22
31204.0,2019-11-11,"(403.1, 629.0]",10,12,-2
31204.0,2019-11-11,"(629.0, 854.0]",12,24,-12
31204.0,2019-11-11,"(854.0, 1079.0]",6,11,-5
31204.0,2019-11-11,"(1079.0, 1304.0]",3,10,-7
31205.0,2019-11-11,"(359.25, 703.5]",38,1,37
31205.0,2019-11-11,"(703.5, 1047.75]",33,45,-12
31205.0,2019-11-11,"(1047.75, 1392.0]",7,54,-47
31206.0,2019-11-11,"(503.447, 642.25]",2,2,0
31206.0,2019-11-11,"(642.25, 780.5]",3,3,0
31206.0,2019-11-11,"(918.75, 1057.0]",2,1,1
31207.0,2019-11-11,"(520.091, 748.25]",3,8,-5
31207.0,2019-11-11,"(748.25, 975.5]",2,4,-2
31207.0,2019-11-11,"(975.5, 1202.75]",1,2,-1
31207.0,2019-11-11,"(1202.75, 1430.0]",1,1,0
31208.0,2019-11-11,"(592.353, 754.75]",3,7,-4
31208.0,2019-11-11,"(754.75, 916.5]",5,7,-2
31208.0,2019-11-11,"(916.5, 1078.25]",3,3,0
31208.0,2019-11-11,"(1078.25, 1240.0]",4,4,0
31209.0,2019-11-11,"(512.116, 734.0]",4,8,-4
31209.0,2019-11-11,"(734.0, 955.0]",4,9,-5
31209.0,2019-11-11,"(955.0, 1176.0]",6,9,-3
31209.0,2019-11-11,"(1176.0, 1397.0]",3,3,0
31211.0,2019-11-11,"(465.11, 688.5]",10,11,-1
31211.0,2019-11-11,"(688.5, 911.0]",8,13,-5
31211.0,2019-11-11,"(911.0, 1133.5]",6,12,-6
31211.0,2019-11-11,"(1133.5, 1356.0]",1,7,-6
31212.0,2019-11-11,"(316.986, 571.5]",20,26,-6
31212.0,2019-11-11,"(571.5, 825.0]",19,32,-13
31212.0,2019-11-11,"(825.0, 1078.5]",14,26,-12
31212.0,2019-11-11,"(1078.5, 1332.0]",12,23,-11
31213.0,2019-11-11,"(284.887, 564.25]",22,24,-2
31213.0,2019-11-11,"(564.25, 842.5]",16,34,-18
31213.0,2019-11-11,"(842.5, 1120.75]",13,29,-16
31213.0,2019-11-11,"(1120.75, 1399.0]",6,18,-12
31214.0,2019-11-11,"(114.726, 434.5]",2,8,-6
31214.0,2019-11-11,"(434.5, 753.0]",11,33,-22
31214.0,2019-11-11,"(753.0, 1071.5]",41,67,-26
31214.0,2019-11-11,"(1071.5, 1390.0]",23,36,-13
31215.0,2019-11-11,"(404.205, 603.75]",23,28,-5
31215.0,2019-11-11,"(603.75, 802.5]",13,18,-5
31215.0,2019-11-11,"(802.5, 1001.25]",24,40,-16
31215.0,2019-11-11,"(1001.25, 1200.0]",6,15,-9
31216.0,2019-11-11,"(313.958, 575.5]",20,21,-1
31216.0,2019-11-11,"(575.5, 836.0]",8,14,-6
31216.0,2019-11-11,"(836.0, 1096.5]",9,24,-15
31216.0,2019-11-11,"(1096.5, 1357.0]",2,21,-19
31217.0,2019-11-11,"(568.223, 763.25]",3,5,-2
31217.0,2019-11-11,"(957.5, 1151.75]",8,9,-1
31218.0,2019-11-11,"(583.408, 732.0]",1,2,-1
31218.0,2019-11-11,"(732.0, 880.0]",2,4,-2
31218.0,2019-11-11,"(880.0, 1028.0]",2,4,-2
31218.0,2019-11-11,"(1028.0, 1176.0]",3,8,-5
31219.0,2019-11-11,"(540.412, 688.0]",4,7,-3
31219.0,2019-11-11,"(688.0, 835.0]",10,17,-7
31219.0,2019-11-11,"(835.0, 982.0]",15,23,-8
31219.0,2019-11-11,"(982.0, 1129.0]",3,9,-6
31220.0,2019-11-11,"(506.423, 651.25]",3,3,0
31220.0,2019-11-11,"(939.75, 1084.0]",1,2,-1
31221.0,2019-11-11,"(63.723, 384.25]",2,2,0
31221.0,2019-11-11,"(384.25, 703.5]",25,28,-3
31221.0,2019-11-11,"(703.5, 1022.75]",15,30,-15
31221.0,2019-11-11,"(1022.75, 1342.0]",8,28,-20
31222.0,2019-11-11,"(326.037, 567.75]",12,14,-2
31222.0,2019-11-11,"(567.75, 808.5]",7,7,0
31222.0,2019-11-11,"(808.5, 1049.25]",11,23,-12
31222.0,2019-11-11,"(1049.25, 1290.0]",4,12,-8
31223.0,2019-11-11,"(392.25, 740.5]",9,1,8
31223.0,2019-11-11,"(740.5, 1088.75]",11,30,-19
31223.0,2019-11-11,"(1088.75, 1437.0]",12,23,-11
31224.0,2019-11-11,"(505.335, 672.25]",7,10,-3
31224.0,2019-11-11,"(672.25, 838.5]",8,17,-9
31224.0,2019-11-11,"(838.5, 1004.75]",7,14,-7
31224.0,2019-11-11,"(1004.75, 1171.0]",4,14,-10
31225.0,2019-11-11,"(434.05, 672.5]",7,8,-1
31225.0,2019-11-11,"(672.5, 910.0]",6,15,-9
31225.0,2019-11-11,"(910.0, 1147.5]",15,25,-10
31225.0,2019-11-11,"(1147.5, 1385.0]",5,9,-4
31226.0,2019-11-11,"(268.978, 525.5]",4,7,-3
31226.0,2019-11-11,"(525.5, 781.0]",4,8,-4
31226.0,2019-11-11,"(781.0, 1036.5]",5,17,-12
31226.0,2019-11-11,"(1036.5, 1292.0]",8,13,-5
31227.0,2019-11-11,"(7.872, 291.0]",1,1,0
31227.0,2019-11-11,"(291.0, 573.0]",42,45,-3
31227.0,2019-11-11,"(573.0, 855.0]",22,28,-6
31227.0,2019-11-11,"(855.0, 1137.0]",3,13,-10
31228.0,2019-11-11,"(49.639, 391.25]",3,6,-3
31228.0,2019-11-11,"(391.25, 731.5]",20,34,-14
31228.0,2019-11-11,"(731.5, 1071.75]",34,58,-24
31228.0,2019-11-11,"(1071.75, 1412.0]",22,41,-19
31229.0,2019-11-11,"(17.606, 367.5]",2,8,-6
31229.0,2019-11-11,"(367.5, 716.0]",21,53,-32
31229.0,2019-11-11,"(716.0, 1064.5]",30,62,-32
31229.0,2019-11-11,"(1064.5, 1413.0]",38,62,-24
31230.0,2019-11-11,"(431.226, 625.5]",26,29,-3
31230.0,2019-11-11,"(625.5, 819.0]",11,12,-1
31230.0,2019-11-11,"(819.0, 1012.5]",23,36,-13
31230.0,2019-11-11,"(1012.5, 1206.0]",8,36,-28
31231.0,2019-11-11,"(4.684, 335.0]",3,3,0
31231.0,2019-11-11,"(335.0, 664.0]",9,9,0
31231.0,2019-11-11,"(664.0, 993.0]",13,15,-2
31231.0,2019-11-11,"(993.0, 1322.0]",2,5,-3
31232.0,2019-11-11,"(40.682, 371.5]",3,5,-2
31232.0,2019-11-11,"(371.5, 701.0]",17,24,-7
31232.0,2019-11-11,"(701.0, 1030.5]",22,40,-18
31232.0,2019-11-11,"(1030.5, 1360.0]",22,44,-22
31233.0,2019-11-11,"(382.75, 705.5]",25,1,24
31233.0,2019-11-11,"(705.5, 1028.25]",13,29,-16
31233.0,2019-11-11,"(1028.25, 1351.0]",4,26,-22
31234.0,2019-11-11,"(351.985, 606.75]",12,22,-10
31234.0,2019-11-11,"(606.75, 860.5]",10,23,-13
31234.0,2019-11-11,"(860.5, 1114.25]",14,28,-14
31234.0,2019-11-11,"(1114.25, 1368.0]",8,18,-10
31235.0,2019-11-11,"(517.347, 681.25]",9,16,-7
31235.0,2019-11-11,"(681.25, 844.5]",6,8,-2
31235.0,2019-11-11,"(844.5, 1007.75]",2,6,-4
31235.0,2019-11-11,"(1007.75, 1171.0]",4,6,-2
31236.0,2019-11-11,"(355.026, 599.5]",15,22,-7
31236.0,2019-11-11,"(599.5, 843.0]",6,17,-11
31236.0,2019-11-11,"(843.0, 1086.5]",9,21,-12
31236.0,2019-11-11,"(1086.5, 1330.0]",6,22,-16
31237.0,2019-11-11,"(36.687, 366.25]",2,2,0
31237.0,2019-11-11,"(366.25, 694.5]",6,13,-7
31237.0,2019-11-11,"(694.5, 1022.75]",17,32,-15
31237.0,2019-11-11,"(1022.75, 1351.0]",17,31,-14
31238.0,2019-11-11,"(48.636, 391.0]",2,3,-1
31238.0,2019-11-11,"(391.0, 732.0]",11,16,-5
31238.0,2019-11-11,"(732.0, 1073.0]",9,27,-18
31238.0,2019-11-11,"(1073.0, 1414.0]",1,13,-12
31239.0,2019-11-11,"(316.998, 568.5]",12,15,-3
31239.0,2019-11-11,"(568.5, 819.0]",11,15,-4
31239.0,2019-11-11,"(819.0, 1069.5]",13,25,-12
31239.0,2019-11-11,"(1069.5, 1320.0]",2,18,-16
31240.0,2019-11-11,"(441.245, 630.75]",1,2,-1
31240.0,2019-11-11,"(630.75, 819.5]",7,17,-10
31240.0,2019-11-11,"(819.5, 1008.25]",17,35,-18
31240.0,2019-11-11,"(1008.25, 1197.0]",5,13,-8
31241.0,2019-11-11,"(8.599, 360.25]",3,5,-2
31241.0,2019-11-11,"(360.25, 710.5]",14,35,-21
31241.0,2019-11-11,"(710.5, 1060.75]",22,52,-30
31241.0,2019-11-11,"(1060.75, 1411.0]",22,40,-18
31242.0,2019-11-11,"(286.25, 567.5]",22,1,21
31242.0,2019-11-11,"(567.5, 848.75]",13,22,-9
31242.0,2019-11-11,"(848.75, 1130.0]",8,18,-10
31243.0,2019-11-11,"(35.789, 339.75]",2,4,-2
31243.0,2019-11-11,"(339.75, 642.5]",3,4,-1
31243.0,2019-11-11,"(642.5, 945.25]",13,19,-6
31243.0,2019-11-11,"(945.25, 1248.0]",9,17,-8
31244.0,2019-11-11,"(544.5, 777.0]",4,4,0
31244.0,2019-11-11,"(777.0, 1009.5]",8,9,-1
31244.0,2019-11-11,"(1009.5, 1242.0]",12,18,-6
31245.0,2019-11-11,"(385.002, 635.5]",10,21,-11
31245.0,2019-11-11,"(635.5, 885.0]",16,31,-15
31245.0,2019-11-11,"(885.0, 1134.5]",11,23,-12
31245.0,2019-11-11,"(1134.5, 1384.0]",9,15,-6
31246.0,2019-11-11,"(348.943, 614.25]",12,17,-5
31246.0,2019-11-11,"(614.25, 878.5]",16,26,-10
31246.0,2019-11-11,"(878.5, 1142.75]",20,43,-23
31246.0,2019-11-11,"(1142.75, 1407.0]",5,12,-7
31247.0,2019-11-11,"(15.764, 326.0]",2,2,0
31247.0,2019-11-11,"(326.0, 635.0]",11,14,-3
31247.0,2019-11-11,"(635.0, 944.0]",15,34,-19
31247.0,2019-11-11,"(944.0, 1253.0]",13,35,-22
31248.0,2019-11-11,"(84.732, 403.0]",3,7,-4
31248.0,2019-11-11,"(403.0, 720.0]",23,28,-5
31248.0,2019-11-11,"(720.0, 1037.0]",34,64,-30
31248.0,2019-11-11,"(1037.0, 1354.0]",8,15,-7
31249.0,2019-11-11,"(427.277, 608.75]",7,13,-6
31249.0,2019-11-11,"(608.75, 789.5]",3,7,-4
31249.0,2019-11-11,"(789.5, 970.25]",19,37,-18
31249.0,2019-11-11,"(970.25, 1151.0]",13,28,-15
31250.0,2019-11-11,"(417.01, 665.5]",17,22,-5
31250.0,2019-11-11,"(665.5, 913.0]",5,11,-6
31250.0,2019-11-11,"(913.0, 1160.5]",4,17,-13
31250.0,2019-11-11,"(1160.5, 1408.0]",3,10,-7
31251.0,2019-11-11,"(39.612, 388.0]",3,4,-1
31251.0,2019-11-11,"(388.0, 735.0]",9,23,-14
31251.0,2019-11-11,"(735.0, 1082.0]",9,20,-11
31251.0,2019-11-11,"(1082.0, 1429.0]",10,13,-3
31252.0,2019-11-11,"(419.154, 631.5]",11,15,-4
31252.0,2019-11-11,"(631.5, 843.0]",13,16,-3
31252.0,2019-11-11,"(843.0, 1054.5]",9,18,-9
31252.0,2019-11-11,"(1054.5, 1266.0]",3,14,-11
31253.0,2019-11-11,"(413.997, 665.75]",20,21,-1
31253.0,2019-11-11,"(665.75, 916.5]",6,10,-4
31253.0,2019-11-11,"(916.5, 1167.25]",5,25,-20
31254.0,2019-11-11,"(340.972, 599.0]",15,20,-5
31254.0,2019-11-11,"(599.0, 856.0]",4,12,-8
31254.0,2019-11-11,"(856.0, 1113.0]",5,19,-14
31254.0,2019-11-11,"(1113.0, 1370.0]",6,9,-3
31255.0,2019-11-11,"(79.803, 380.25]",1,1,0
31255.0,2019-11-11,"(380.25, 679.5]",10,15,-5
31255.0,2019-11-11,"(679.5, 978.75]",3,9,-6
31255.0,2019-11-11,"(978.75, 1278.0]",6,13,-7
31256.0,2019-11-11,"(283.859, 570.25]",12,13,-1
31256.0,2019-11-11,"(570.25, 855.5]",10,17,-7
31256.0,2019-11-11,"(855.5, 1140.75]",5,21,-16
31256.0,2019-11-11,"(1140.75, 1426.0]",11,22,-11
31257.0,2019-11-11,"(69.669, 403.75]",3,4,-1
31257.0,2019-11-11,"(403.75, 736.5]",7,15,-8
31257.0,2019-11-11,"(736.5, 1069.25]",25,50,-25
31257.0,2019-11-11,"(1069.25, 1402.0]",9,32,-23
31258.0,2019-11-11,"(432.087, 661.25]",8,19,-11
31258.0,2019-11-11,"(661.25, 889.5]",41,81,-40
31258.0,2019-11-11,"(889.5, 1117.75]",38,64,-26
31258.0,2019-11-11,"(1117.75, 1346.0]",5,9,-4
31259.0,2019-11-11,"(446.25, 747.5]",2,1,1
31259.0,2019-11-11,"(747.5, 1048.75]",3,3,0
31259.0,2019-11-11,"(1048.75, 1350.0]",4,6,-2
31260.0,2019-11-11,"(467.167, 676.25]",7,11,-4
31260.0,2019-11-11,"(676.25, 884.5]",2,7,-5
31260.0,2019-11-11,"(884.5, 1092.75]",3,8,-5
31260.0,2019-11-11,"(1092.75, 1301.0]",4,6,-2
31261.0,2019-11-11,"(490.229, 683.75]",3,4,-1
31261.0,2019-11-11,"(683.75, 876.5]",6,13,-7
31261.0,2019-11-11,"(876.5, 1069.25]",5,14,-9
31261.0,2019-11-11,"(1069.25, 1262.0]",2,2,0
31262.0,2019-11-11,"(429.104, 654.0]",6,9,-3
31262.0,2019-11-11,"(654.0, 878.0]",13,19,-6
31262.0,2019-11-11,"(878.0, 1102.0]",9,14,-5
31262.0,2019-11-11,"(1102.0, 1326.0]",2,13,-11
31263.0,2019-11-11,"(358.935, 626.25]",19,25,-6
31263.0,2019-11-11,"(626.25, 892.5]",6,20,-14
31263.0,2019-11-11,"(892.5, 1158.75]",6,19,-13
31263.0,2019-11-11,"(1158.75, 1425.0]",5,11,-6
31264.0,2019-11-11,"(13.628, 358.0]",1,2,-1
31264.0,2019-11-11,"(358.0, 701.0]",9,11,-2
31264.0,2019-11-11,"(701.0, 1044.0]",13,28,-15
31264.0,2019-11-11,"(1044.0, 1387.0]",4,11,-7
31265.0,2019-11-11,"(372.0, 712.0]",9,2,7
31265.0,2019-11-11,"(712.0, 1052.0]",12,26,-14
31265.0,2019-11-11,"(1052.0, 1392.0]",21,20,1
31266.0,2019-11-11,"(55.707, 380.25]",3,10,-7
31266.0,2019-11-11,"(380.25, 703.5]",4,14,-10
31266.0,2019-11-11,"(703.5, 1026.75]",27,48,-21
31266.0,2019-11-11,"(1026.75, 1350.0]",33,56,-23
31267.0,2019-11-11,"(40.612, 389.0]",4,8,-4
31267.0,2019-11-11,"(389.0, 736.0]",24,43,-19
31267.0,2019-11-11,"(736.0, 1083.0]",21,42,-21
31267.0,2019-11-11,"(1083.0, 1430.0]",13,31,-18
31268.0,2019-11-11,"(65.641, 406.75]",1,3,-2
31268.0,2019-11-11,"(406.75, 746.5]",8,35,-27
31268.0,2019-11-11,"(746.5, 1086.25]",18,33,-15
31268.0,2019-11-11,"(1086.25, 1426.0]",4,10,-6
31269.0,2019-11-11,"(297.9, 574.0]",2,7,-5
31269.0,2019-11-11,"(574.0, 849.0]",6,9,-3
31269.0,2019-11-11,"(849.0, 1124.0]",8,24,-16
31269.0,2019-11-11,"(1124.0, 1399.0]",7,11,-4
31270.0,2019-11-11,"(338.922, 609.5]",5,7,-2
31270.0,2019-11-11,"(609.5, 879.0]",2,4,-2
31270.0,2019-11-11,"(879.0, 1148.5]",8,19,-11
31270.0,2019-11-11,"(1148.5, 1418.0]",6,15,-9
31271.0,2019-11-11,"(339.12, 560.0]",3,3,0
31271.0,2019-11-11,"(560.0, 780.0]",1,7,-6
31271.0,2019-11-11,"(780.0, 1000.0]",9,18,-9
31271.0,2019-11-11,"(1000.0, 1220.0]",8,14,-6
31272.0,2019-11-11,"(306.914, 579.5]",7,10,-3
31272.0,2019-11-11,"(579.5, 851.0]",7,17,-10
31272.0,2019-11-11,"(851.0, 1122.5]",12,27,-15
31272.0,2019-11-11,"(1122.5, 1394.0]",4,6,-2
31273.0,2019-11-11,"(625.377, 781.75]",4,8,-4
31273.0,2019-11-11,"(781.75, 937.5]",5,9,-4
31273.0,2019-11-11,"(937.5, 1093.25]",1,5,-4
31274.0,2019-11-11,"(460.038, 701.5]",12,20,-8
31274.0,2019-11-11,"(701.5, 942.0]",10,14,-4
31274.0,2019-11-11,"(942.0, 1182.5]",14,24,-10
31274.0,2019-11-11,"(1182.5, 1423.0]",1,8,-7
31275.0,2019-11-11,"(62.65, 401.5]",4,6,-2
31275.0,2019-11-11,"(401.5, 739.0]",18,36,-18
31275.0,2019-11-11,"(739.0, 1076.5]",29,51,-22
31275.0,2019-11-11,"(1076.5, 1414.0]",12,31,-19
31276.0,2019-11-11,"(408.055, 645.25]",17,20,-3
31276.0,2019-11-11,"(645.25, 881.5]",8,16,-8
31276.0,2019-11-11,"(881.5, 1117.75]",6,19,-13
31276.0,2019-11-11,"(1117.75, 1354.0]",1,9,-8
31277.0,2019-11-11,"(444.118, 665.5]",25,25,0
31277.0,2019-11-11,"(665.5, 886.0]",11,22,-11
31277.0,2019-11-11,"(886.0, 1106.5]",15,28,-13
31277.0,2019-11-11,"(1106.5, 1327.0]",5,18,-13
31278.0,2019-11-11,"(20.582, 376.5]",3,3,0
31278.0,2019-11-11,"(376.5, 731.0]",14,35,-21
31278.0,2019-11-11,"(731.0, 1085.5]",20,44,-24
31278.0,2019-11-11,"(1085.5, 1440.0]",22,33,-11
31279.0,2019-11-11,"(421.092, 649.0]",19,23,-4
31279.0,2019-11-11,"(649.0, 876.0]",7,16,-9
31279.0,2019-11-11,"(876.0, 1103.0]",9,26,-17
31279.0,2019-11-11,"(1103.0, 1330.0]",5,13,-8
31280.0,2019-11-11,"(15.765, 325.75]",1,1,0
31280.0,2019-11-11,"(325.75, 634.5]",5,21,-16
31280.0,2019-11-11,"(634.5, 943.25]",3,10,-7
31280.0,2019-11-11,"(943.25, 1252.0]",15,20,-5
,,,,2.0,
31001.0,2019-11-12,"(850.634, 942.5]",1,2,-1
31001.0,2019-11-12,"(942.5, 1034.0]",1,3,-2
31001.0,2019-11-12,"(1125.5, 1217.0]",2,2,0
31002.0,2019-11-12,"(427.355, 589.25]",3,11,-8
31002.0,2019-11-12,"(911.75, 1073.0]",4,1,3
31003.0,2019-11-12,"(461.16, 672.0]",5,9,-4
31003.0,2019-11-12,"(672.0, 882.0]",4,8,-4
31003.0,2019-11-12,"(882.0, 1092.0]",2,3,-1
31004.0,2019-11-12,"(1074.976, 1081.0]",1,1,0
31004.0,2019-11-12,"(1087.0, 1093.0]",1,1,0
31005.0,2019-11-12,"(438.227, 632.25]",2,2,0
31005.0,2019-11-12,"(825.5, 1018.75]",2,4,-2
31005.0,2019-11-12,"(1018.75, 1212.0]",3,7,-4
31006.0,2019-11-12,"(948.96, 959.0]",1,1,0
31007.0,2019-11-12,"(590.168, 799.0]",4,7,-3
31007.0,2019-11-12,"(1007.0, 1215.0]",8,1,7
31009.0,2019-11-12,"(431.138, 647.5]",5,7,-2
31009.0,2019-11-12,"(647.5, 863.0]",1,2,-1
31009.0,2019-11-12,"(1078.5, 1294.0]",1,2,-1
31010.0,2019-11-12,"(368.75, 698.5]",1,1,0
31010.0,2019-11-12,"(1028.25, 1358.0]",2,1,1
31011.0,2019-11-12,"(47.922, 318.5]",1,1,0
31011.0,2019-11-12,"(318.5, 588.0]",4,7,-3
31011.0,2019-11-12,"(588.0, 857.5]",4,7,-3
31011.0,2019-11-12,"(857.5, 1127.0]",3,8,-5
31012.0,2019-11-12,"(592.24, 783.0]",3,3,0
31012.0,2019-11-12,"(1163.0, 1353.0]",1,4,-3
31013.0,2019-11-12,"(571.147, 785.25]",1,4,-3
31013.0,2019-11-12,"(998.5, 1211.75]",3,1,2
31013.0,2019-11-12,"(1211.75, 1425.0]",1,4,-3
31014.0,2019-11-12,"(420.118, 641.5]",17,21,-4
31014.0,2019-11-12,"(641.5, 862.0]",3,3,0
31014.0,2019-11-12,"(862.0, 1082.5]",10,13,-3
31014.0,2019-11-12,"(1082.5, 1303.0]",4,8,-4
31015.0,2019-11-12,"(307.072, 540.0]",10,11,-1
31015.0,2019-11-12,"(540.0, 772.0]",1,3,-2
31015.0,2019-11-12,"(772.0, 1004.0]",2,3,-1
31015.0,2019-11-12,"(1004.0, 1236.0]",3,9,-6
31016.0,2019-11-12,"(333.25, 646.5]",2,1,1
31016.0,2019-11-12,"(646.5, 959.75]",2,4,-2
31016.0,2019-11-12,"(959.75, 1273.0]",6,3,3
31017.0,2019-11-12,"(287.25, 566.5]",2,1,1
31017.0,2019-11-12,"(566.5, 845.75]",2,4,-2
31018.0,2019-11-12,"(1031.0, 1233.0]",5,5,0
,,,,1.0,
,,,,1.0,
,,,,1.0,
31020.0,2019-11-12,"(694.75, 895.5]",1,2,-1
31020.0,2019-11-12,"(1096.25, 1297.0]",1,1,0
31021.0,2019-11-12,"(512.186, 716.5]",1,4,-3
31021.0,2019-11-12,"(920.0, 1123.5]",1,1,0
31022.0,2019-11-12,"(495.099, 721.25]",1,6,-5
31022.0,2019-11-12,"(721.25, 946.5]",2,2,0
31022.0,2019-11-12,"(946.5, 1171.75]",1,2,-1
31022.0,2019-11-12,"(1171.75, 1397.0]",3,7,-4
31023.0,2019-11-12,"(84.744, 400.0]",1,2,-1
31023.0,2019-11-12,"(400.0, 714.0]",3,5,-2
31023.0,2019-11-12,"(714.0, 1028.0]",2,3,-1
31023.0,2019-11-12,"(1028.0, 1342.0]",2,6,-4
31024.0,2019-11-12,"(447.148, 661.0]",6,9,-3
31024.0,2019-11-12,"(874.0, 1087.0]",5,8,-3
,,,,1.0,
,,,,1.0,
,,,,3.0,
31026.0,2019-11-12,"(711.5, 1045.25]",1,1,0
31027.0,2019-11-12,"(996.0, 1143.0]",2,3,-1
31028.0,2019-11-12,"(444.094, 671.5]",1,1,0
31029.0,2019-11-12,"(487.208, 686.0]",1,8,-7
31029.0,2019-11-12,"(686.0, 884.0]",1,3,-2
31029.0,2019-11-12,"(884.0, 1082.0]",2,2,0
31029.0,2019-11-12,"(1082.0, 1280.0]",5,6,-1
31030.0,2019-11-12,"(854.5, 1102.75]",4,8,-4
31030.0,2019-11-12,"(1102.75, 1351.0]",1,1,0
31031.0,2019-11-12,"(986.691, 1064.25]",1,2,-1
31031.0,2019-11-12,"(1218.75, 1296.0]",1,1,0
,,,,1.0,
,,,,1.0,
31033.0,2019-11-12,"(742.5, 990.0]",2,1,1
31034.0,2019-11-12,"(89.678, 421.5]",1,2,-1
31034.0,2019-11-12,"(421.5, 752.0]",1,2,-1
31034.0,2019-11-12,"(752.0, 1082.5]",1,1,0
31034.0,2019-11-12,"(1082.5, 1413.0]",2,3,-1
31035.0,2019-11-12,"(16.598, 368.5]",1,1,0
31035.0,2019-11-12,"(719.0, 1069.5]",3,2,1
31035.0,2019-11-12,"(1069.5, 1420.0]",4,5,-1
31036.0,2019-11-12,"(485.079, 716.25]",1,5,-4
31036.0,2019-11-12,"(716.25, 946.5]",1,1,0
31036.0,2019-11-12,"(946.5, 1176.75]",1,2,-1
31036.0,2019-11-12,"(1176.75, 1407.0]",1,3,-2
31037.0,2019-11-12,"(369.984, 625.0]",11,14,-3
31037.0,2019-11-12,"(625.0, 879.0]",4,7,-3
31037.0,2019-11-12,"(879.0, 1133.0]",3,12,-9
31037.0,2019-11-12,"(1133.0, 1387.0]",2,5,-3
31038.0,2019-11-12,"(954.25, 1120.0]",1,2,-1
31039.0,2019-11-12,"(445.124, 665.0]",2,7,-5
31039.0,2019-11-12,"(884.0, 1103.0]",4,7,-3
31039.0,2019-11-12,"(1103.0, 1322.0]",3,6,-3
31040.0,2019-11-12,"(435.107, 659.25]",3,3,0
31041.0,2019-11-12,"(530.303, 705.25]",1,1,0
31041.0,2019-11-12,"(1053.75, 1228.0]",1,3,-2
31042.0,2019-11-12,"(439.113, 661.75]",8,8,0
31042.0,2019-11-12,"(883.5, 1105.25]",1,9,-8
31042.0,2019-11-12,"(1105.25, 1327.0]",1,2,-1
31043.0,2019-11-12,"(519.307, 693.25]",2,3,-1
31043.0,2019-11-12,"(1039.75, 1213.0]",1,4,-3
31044.0,2019-11-12,"(480.337, 646.75]",3,5,-2
31044.0,2019-11-12,"(646.75, 812.5]",1,2,-1
31044.0,2019-11-12,"(978.25, 1144.0]",2,3,-1
31045.0,2019-11-12,"(522.468, 656.0]",1,2,-1
31045.0,2019-11-12,"(922.0, 1055.0]",2,3,-1
31046.0,2019-11-12,"(802.5, 1070.0]",2,1,1
31047.0,2019-11-12,"(413.169, 621.75]",7,15,-8
31047.0,2019-11-12,"(621.75, 829.5]",2,4,-2
31047.0,2019-11-12,"(829.5, 1037.25]",1,8,-7
31047.0,2019-11-12,"(1037.25, 1245.0]",3,13,-10
31048.0,2019-11-12,"(673.25, 860.5]",1,2,-1
31048.0,2019-11-12,"(1047.75, 1235.0]",1,1,0
31049.0,2019-11-12,"(1021.687, 1100.25]",1,2,-1
31049.0,2019-11-12,"(1178.5, 1256.75]",1,1,0
31049.0,2019-11-12,"(1256.75, 1335.0]",1,1,0
31050.0,2019-11-12,"(515.247, 704.25]",1,2,-1
31051.0,2019-11-12,"(303.047, 542.25]",1,7,-6
31051.0,2019-11-12,"(780.5, 1018.75]",1,3,-2
31051.0,2019-11-12,"(1018.75, 1257.0]",4,4,0
31052.0,2019-11-12,"(503.268, 687.0]",1,2,-1
31052.0,2019-11-12,"(870.0, 1053.0]",2,2,0
31052.0,2019-11-12,"(1053.0, 1236.0]",3,5,-2
,,,,2.0,
31054.0,2019-11-12,"(750.0, 1000.0]",1,1,0
31055.0,2019-11-12,"(501.406, 650.5]",1,2,-1
31055.0,2019-11-12,"(947.5, 1096.0]",2,2,0
,,,,1.0,
,,,,1.0,
,,,,1.0,
31057.0,2019-11-12,"(1329.335, 1330.0]",1,2,-1
31058.0,2019-11-12,"(755.25, 1007.0]",2,1,1
31059.0,2019-11-12,"(1124.438, 1125.0]",1,2,-1
31060.0,2019-11-12,"(852.75, 1137.0]",3,1,2
,,,,1.0,
,,,,1.0,
31062.0,2019-11-12,"(771.855, 808.25]",1,2,-1
31062.0,2019-11-12,"(880.75, 917.0]",1,1,0
,,,,2.0,
31064.0,2019-11-12,"(504.476, 636.0]",1,2,-1
31064.0,2019-11-12,"(898.0, 1029.0]",2,4,-2
31065.0,2019-11-12,"(355.099, 581.25]",1,3,-2
31065.0,2019-11-12,"(1031.75, 1257.0]",1,1,0
31066.0,2019-11-12,"(1002.75, 1172.0]",2,2,0
31067.0,2019-11-12,"(729.5, 945.0]",1,2,-1
31067.0,2019-11-12,"(945.0, 1160.5]",2,2,0
31067.0,2019-11-12,"(1160.5, 1376.0]",1,2,-1
31068.0,2019-11-12,"(679.5, 1019.25]",1,1,0
31068.0,2019-11-12,"(1019.25, 1359.0]",2,1,1
31069.0,2019-11-12,"(456.343, 621.25]",2,7,-5
31069.0,2019-11-12,"(785.5, 949.75]",2,3,-1
31069.0,2019-11-12,"(949.75, 1114.0]",5,6,-1
31070.0,2019-11-12,"(977.0, 1181.5]",2,1,1
31070.0,2019-11-12,"(1181.5, 1386.0]",1,3,-2
31071.0,2019-11-12,"(326.176, 533.0]",1,2,-1
31071.0,2019-11-12,"(533.0, 739.0]",1,2,-1
31071.0,2019-11-12,"(945.0, 1151.0]",4,7,-3
,,,,2.0,
31073.0,2019-11-12,"(261.5, 392.25]",1,1,0
31073.0,2019-11-12,"(392.25, 523.0]",2,1,1
31074.0,2019-11-12,"(1104.75, 1286.0]",1,1,0
31075.0,2019-11-12,"(478.348, 642.0]",1,3,-2
31075.0,2019-11-12,"(968.0, 1131.0]",1,1,0
31076.0,2019-11-12,"(918.0, 1060.0]",1,1,0
31077.0,2019-11-12,"(690.75, 914.5]",1,3,-2
31077.0,2019-11-12,"(914.5, 1138.25]",5,4,1
31077.0,2019-11-12,"(1138.25, 1362.0]",3,6,-3
31078.0,2019-11-12,"(493.364, 653.0]",5,5,0
31079.0,2019-11-12,"(47.639, 389.25]",1,1,0
31079.0,2019-11-12,"(389.25, 729.5]",1,9,-8
31079.0,2019-11-12,"(729.5, 1069.75]",3,3,0
31079.0,2019-11-12,"(1069.75, 1410.0]",5,7,-2
31080.0,2019-11-12,"(899.5, 1140.75]",2,8,-6
31080.0,2019-11-12,"(1140.75, 1382.0]",3,4,-1
31081.0,2019-11-12,"(489.129, 707.75]",2,2,0
31081.0,2019-11-12,"(1143.25, 1361.0]",1,1,0
,,,,2.0,
31083.0,2019-11-12,"(874.5, 1014.0]",5,2,3
31084.0,2019-11-12,"(575.495, 702.25]",3,4,-1
,,,,1.0,
,,,,1.0,
31086.0,2019-11-12,"(942.25, 1104.0]",2,2,0
31087.0,2019-11-12,"(939.75, 1253.0]",4,1,3
31088.0,2019-11-12,"(814.5, 999.0]",2,1,1
31088.0,2019-11-12,"(999.0, 1183.5]",3,2,1
31088.0,2019-11-12,"(1183.5, 1368.0]",1,3,-2
31089.0,2019-11-12,"(486.234, 678.5]",10,13,-3
31089.0,2019-11-12,"(678.5, 870.0]",1,3,-2
31089.0,2019-11-12,"(1061.5, 1253.0]",4,7,-3
31090.0,2019-11-12,"(708.75, 945.0]",1,1,0
31091.0,2019-11-12,"(927.5, 1091.0]",2,3,-1
31092.0,2019-11-12,"(731.0, 820.0]",1,1,0
31093.0,2019-11-12,"(1027.5, 1238.0]",1,2,-1
31094.0,2019-11-12,"(454.5, 606.0]",1,1,0
,,,,2.0,
31096.0,2019-11-12,"(831.55, 944.5]",1,2,-1
31096.0,2019-11-12,"(1057.0, 1169.5]",1,1,0
31096.0,2019-11-12,"(1169.5, 1282.0]",1,1,0
31097.0,2019-11-12,"(502.248, 691.0]",2,3,-1
31097.0,2019-11-12,"(879.0, 1067.0]",2,3,-1
31097.0,2019-11-12,"(1067.0, 1255.0]",1,2,-1
31098.0,2019-11-12,"(424.32, 595.0]",5,11,-6
31098.0,2019-11-12,"(595.0, 765.0]",2,2,0
31098.0,2019-11-12,"(765.0, 935.0]",1,1,0
31098.0,2019-11-12,"(935.0, 1105.0]",8,13,-5
31099.0,2019-11-12,"(1095.92, 1116.0]",1,1,0
31100.0,2019-11-12,"(394.134, 611.5]",13,15,-2
31100.0,2019-11-12,"(611.5, 828.0]",2,3,-1
31100.0,2019-11-12,"(828.0, 1044.5]",6,11,-5
31100.0,2019-11-12,"(1044.5, 1261.0]",1,15,-14
31101.0,2019-11-12,"(27.639, 369.25]",3,6,-3
31101.0,2019-11-12,"(369.25, 709.5]",13,38,-25
31101.0,2019-11-12,"(709.5, 1049.75]",15,28,-13
31101.0,2019-11-12,"(1049.75, 1390.0]",31,44,-13
31102.0,2019-11-12,"(289.87, 573.5]",2,20,-18
31102.0,2019-11-12,"(856.0, 1138.5]",6,4,2
31102.0,2019-11-12,"(1138.5, 1421.0]",6,9,-3
31103.0,2019-11-12,"(446.14, 662.0]",2,32,-30
31103.0,2019-11-12,"(662.0, 877.0]",1,8,-7
31103.0,2019-11-12,"(877.0, 1092.0]",4,16,-12
31103.0,2019-11-12,"(1092.0, 1307.0]",6,15,-9
31104.0,2019-11-12,"(346.0, 679.0]",2,2,0
31104.0,2019-11-12,"(679.0, 1012.0]",6,14,-8
31104.0,2019-11-12,"(1012.0, 1345.0]",12,10,2
31105.0,2019-11-12,"(449.084, 679.0]",1,14,-13
31105.0,2019-11-12,"(1137.0, 1366.0]",1,3,-2
31106.0,2019-11-12,"(1008.25, 1198.0]",4,7,-3
31107.0,2019-11-12,"(585.0, 829.0]",2,13,-11
31107.0,2019-11-12,"(829.0, 1073.0]",7,6,1
31107.0,2019-11-12,"(1073.0, 1317.0]",9,14,-5
31108.0,2019-11-12,"(28.601, 379.75]",1,2,-1
31108.0,2019-11-12,"(379.75, 729.5]",10,31,-21
31108.0,2019-11-12,"(729.5, 1079.25]",17,27,-10
31108.0,2019-11-12,"(1079.25, 1429.0]",14,16,-2
31109.0,2019-11-12,"(357.928, 627.0]",7,23,-16
31109.0,2019-11-12,"(627.0, 895.0]",3,8,-5
31109.0,2019-11-12,"(895.0, 1163.0]",11,19,-8
31109.0,2019-11-12,"(1163.0, 1431.0]",11,15,-4
31110.0,2019-11-12,"(2.619, 349.25]",2,3,-1
31110.0,2019-11-12,"(349.25, 694.5]",17,38,-21
31110.0,2019-11-12,"(694.5, 1039.75]",10,22,-12
31110.0,2019-11-12,"(1039.75, 1385.0]",11,25,-14
31111.0,2019-11-12,"(142.808, 442.0]",2,4,-2
31111.0,2019-11-12,"(442.0, 740.0]",9,20,-11
31111.0,2019-11-12,"(740.0, 1038.0]",2,3,-1
31111.0,2019-11-12,"(1038.0, 1336.0]",16,20,-4
31112.0,2019-11-12,"(16.426, 160.5]",1,1,0
31112.0,2019-11-12,"(304.0, 447.5]",1,2,-1
31112.0,2019-11-12,"(447.5, 591.0]",1,3,-2
31113.0,2019-11-12,"(694.25, 941.5]",1,9,-8
31113.0,2019-11-12,"(941.5, 1188.75]",11,4,7
31113.0,2019-11-12,"(1188.75, 1436.0]",7,19,-12
31114.0,2019-11-12,"(379.993, 632.75]",4,22,-18
31114.0,2019-11-12,"(632.75, 884.5]",3,11,-8
31114.0,2019-11-12,"(884.5, 1136.25]",13,19,-6
31114.0,2019-11-12,"(1136.25, 1388.0]",13,21,-8
31115.0,2019-11-12,"(-0.342, 336.5]",2,2,0
31115.0,2019-11-12,"(336.5, 672.0]",1,21,-20
31115.0,2019-11-12,"(672.0, 1007.5]",1,4,-3
31115.0,2019-11-12,"(1007.5, 1343.0]",10,14,-4
31116.0,2019-11-12,"(368.982, 624.5]",2,18,-16
31116.0,2019-11-12,"(624.5, 879.0]",6,7,-1
31116.0,2019-11-12,"(879.0, 1133.5]",18,26,-8
31116.0,2019-11-12,"(1133.5, 1388.0]",11,15,-4
31117.0,2019-11-12,"(343.927, 613.25]",3,16,-13
31117.0,2019-11-12,"(613.25, 881.5]",3,6,-3
31117.0,2019-11-12,"(881.5, 1149.75]",6,14,-8
31117.0,2019-11-12,"(1149.75, 1418.0]",7,17,-10
31118.0,2019-11-12,"(366.932, 635.0]",2,18,-16
31118.0,2019-11-12,"(635.0, 902.0]",1,2,-1
31118.0,2019-11-12,"(902.0, 1169.0]",8,12,-4
31118.0,2019-11-12,"(1169.0, 1436.0]",5,9,-4
31119.0,2019-11-12,"(18.639, 360.25]",2,3,-1
31119.0,2019-11-12,"(360.25, 700.5]",5,18,-13
31119.0,2019-11-12,"(700.5, 1040.75]",5,14,-9
31119.0,2019-11-12,"(1040.75, 1381.0]",14,21,-7
31120.0,2019-11-12,"(24.71, 348.5]",1,3,-2
31120.0,2019-11-12,"(348.5, 671.0]",2,14,-12
31120.0,2019-11-12,"(671.0, 993.5]",3,5,-2
31120.0,2019-11-12,"(993.5, 1316.0]",9,13,-4
31121.0,2019-11-12,"(334.0, 656.0]",6,1,5
31121.0,2019-11-12,"(656.0, 978.0]",1,13,-12
31121.0,2019-11-12,"(978.0, 1300.0]",9,2,7
31122.0,2019-11-12,"(448.124, 668.0]",2,16,-14
31122.0,2019-11-12,"(887.0, 1106.0]",6,1,5
31122.0,2019-11-12,"(1106.0, 1325.0]",6,8,-2
31123.0,2019-11-12,"(622.25, 876.5]",3,7,-4
31123.0,2019-11-12,"(876.5, 1130.75]",3,7,-4
31123.0,2019-11-12,"(1130.75, 1385.0]",5,5,0
31124.0,2019-11-12,"(309.999, 561.25]",17,26,-9
31124.0,2019-11-12,"(561.25, 811.5]",10,27,-17
31124.0,2019-11-12,"(811.5, 1061.75]",7,22,-15
31124.0,2019-11-12,"(1061.75, 1312.0]",12,44,-32
31125.0,2019-11-12,"(58.672, 392.0]",2,3,-1
31125.0,2019-11-12,"(392.0, 724.0]",4,22,-18
31125.0,2019-11-12,"(724.0, 1056.0]",14,25,-11
31125.0,2019-11-12,"(1056.0, 1388.0]",18,25,-7
31126.0,2019-11-12,"(6.631, 350.25]",1,3,-2
31126.0,2019-11-12,"(350.25, 692.5]",4,21,-17
31126.0,2019-11-12,"(692.5, 1034.75]",8,21,-13
31126.0,2019-11-12,"(1034.75, 1377.0]",29,43,-14
31127.0,2019-11-12,"(351.045, 590.75]",10,11,-1
31127.0,2019-11-12,"(590.75, 829.5]",7,13,-6
31127.0,2019-11-12,"(829.5, 1068.25]",15,25,-10
31127.0,2019-11-12,"(1068.25, 1307.0]",5,17,-12
31128.0,2019-11-12,"(311.874, 594.5]",21,33,-12
31128.0,2019-11-12,"(594.5, 876.0]",12,19,-7
31128.0,2019-11-12,"(876.0, 1157.5]",16,34,-18
31128.0,2019-11-12,"(1157.5, 1439.0]",4,12,-8
31129.0,2019-11-12,"(447.097, 673.75]",8,8,0
31129.0,2019-11-12,"(673.75, 899.5]",3,5,-2
31129.0,2019-11-12,"(899.5, 1125.25]",3,6,-3
31129.0,2019-11-12,"(1125.25, 1351.0]",2,6,-4
31130.0,2019-11-12,"(36.774, 344.5]",1,1,0
31130.0,2019-11-12,"(344.5, 651.0]",2,7,-5
31130.0,2019-11-12,"(651.0, 957.5]",2,5,-3
31130.0,2019-11-12,"(957.5, 1264.0]",4,9,-5
31131.0,2019-11-12,"(894.5, 1117.25]",6,6,0
31131.0,2019-11-12,"(1117.25, 1340.0]",3,2,1
31200.0,2019-11-12,"(12.68, 344.0]",1,5,-4
31200.0,2019-11-12,"(344.0, 674.0]",22,38,-16
31200.0,2019-11-12,"(674.0, 1004.0]",11,23,-12
31200.0,2019-11-12,"(1004.0, 1334.0]",22,53,-31
31201.0,2019-11-12,"(53.66, 390.0]",4,5,-1
31201.0,2019-11-12,"(390.0, 725.0]",15,41,-26
31201.0,2019-11-12,"(725.0, 1060.0]",26,37,-11
31201.0,2019-11-12,"(1060.0, 1395.0]",24,38,-14
31202.0,2019-11-12,"(358.0, 680.0]",9,2,7
31202.0,2019-11-12,"(680.0, 1002.0]",13,26,-13
31202.0,2019-11-12,"(1002.0, 1324.0]",17,21,-4
31203.0,2019-11-12,"(38.603, 389.25]",1,4,-3
31203.0,2019-11-12,"(389.25, 738.5]",10,34,-24
31203.0,2019-11-12,"(738.5, 1087.75]",20,30,-10
31203.0,2019-11-12,"(1087.75, 1437.0]",20,30,-10
31204.0,2019-11-12,"(416.011, 664.25]",7,9,-2
31204.0,2019-11-12,"(664.25, 911.5]",4,9,-5
31204.0,2019-11-12,"(911.5, 1158.75]",6,14,-8
31204.0,2019-11-12,"(1158.75, 1406.0]",6,15,-9
31205.0,2019-11-12,"(471.219, 667.25]",20,23,-3
31205.0,2019-11-12,"(667.25, 862.5]",7,9,-2
31205.0,2019-11-12,"(862.5, 1057.75]",11,19,-8
31205.0,2019-11-12,"(1057.75, 1253.0]",6,32,-26
31206.0,2019-11-12,"(412.332, 580.0]",4,4,0
31206.0,2019-11-12,"(914.0, 1081.0]",1,1,0
31207.0,2019-11-12,"(883.5, 1095.75]",3,2,1
31207.0,2019-11-12,"(1095.75, 1308.0]",2,5,-3
31208.0,2019-11-12,"(323.084, 553.0]",8,9,-1
31208.0,2019-11-12,"(553.0, 782.0]",3,3,0
31208.0,2019-11-12,"(1011.0, 1240.0]",3,10,-7
31209.0,2019-11-12,"(463.03, 706.5]",1,3,-2
31209.0,2019-11-12,"(706.5, 949.0]",1,3,-2
31209.0,2019-11-12,"(949.0, 1191.5]",2,2,0
31209.0,2019-11-12,"(1191.5, 1434.0]",1,1,0
31211.0,2019-11-12,"(493.117, 714.75]",8,11,-3
31211.0,2019-11-12,"(714.75, 935.5]",1,2,-1
31211.0,2019-11-12,"(935.5, 1156.25]",2,7,-5
31212.0,2019-11-12,"(411.014, 658.5]",26,43,-17
31212.0,2019-11-12,"(658.5, 905.0]",8,16,-8
31212.0,2019-11-12,"(905.0, 1151.5]",10,27,-17
31212.0,2019-11-12,"(1151.5, 1398.0]",4,6,-2
31213.0,2019-11-12,"(321.01, 569.5]",19,29,-10
31213.0,2019-11-12,"(569.5, 817.0]",9,14,-5
31213.0,2019-11-12,"(817.0, 1064.5]",17,24,-7
31213.0,2019-11-12,"(1064.5, 1312.0]",15,35,-20
31214.0,2019-11-12,"(16.597, 368.75]",2,5,-3
31214.0,2019-11-12,"(368.75, 719.5]",12,30,-18
31214.0,2019-11-12,"(719.5, 1070.25]",23,40,-17
31214.0,2019-11-12,"(1070.25, 1421.0]",21,33,-12
31215.0,2019-11-12,"(449.301, 624.75]",21,22,-1
31215.0,2019-11-12,"(624.75, 799.5]",3,3,0
31215.0,2019-11-12,"(799.5, 974.25]",4,6,-2
31215.0,2019-11-12,"(974.25, 1149.0]",4,11,-7
31216.0,2019-11-12,"(499.347, 663.25]",17,18,-1
31216.0,2019-11-12,"(663.25, 826.5]",5,8,-3
31216.0,2019-11-12,"(826.5, 989.75]",2,6,-4
31216.0,2019-11-12,"(989.75, 1153.0]",1,20,-19
31217.0,2019-11-12,"(403.204, 603.0]",9,10,-1
31217.0,2019-11-12,"(603.0, 802.0]",3,5,-2
31217.0,2019-11-12,"(1001.0, 1200.0]",1,4,-3
31218.0,2019-11-12,"(342.022, 587.5]",12,25,-13
31218.0,2019-11-12,"(587.5, 832.0]",3,3,0
31218.0,2019-11-12,"(832.0, 1076.5]",6,15,-9
31218.0,2019-11-12,"(1076.5, 1321.0]",3,6,-3
31219.0,2019-11-12,"(464.261, 649.75]",5,6,-1
31219.0,2019-11-12,"(649.75, 834.5]",3,4,-1
31219.0,2019-11-12,"(1019.25, 1204.0]",4,4,0
31220.0,2019-11-12,"(364.141, 579.75]",8,11,-3
31220.0,2019-11-12,"(579.75, 794.5]",2,4,-2
31220.0,2019-11-12,"(794.5, 1009.25]",1,10,-9
31221.0,2019-11-12,"(266.002, 516.5]",12,13,-1
31221.0,2019-11-12,"(516.5, 766.0]",18,24,-6
31221.0,2019-11-12,"(766.0, 1015.5]",5,13,-8
31221.0,2019-11-12,"(1015.5, 1265.0]",9,26,-17
31222.0,2019-11-12,"(472.285, 651.75]",14,15,-1
31222.0,2019-11-12,"(651.75, 830.5]",2,5,-3
31222.0,2019-11-12,"(830.5, 1009.25]",4,8,-4
31222.0,2019-11-12,"(1009.25, 1188.0]",3,21,-18
31223.0,2019-11-12,"(43.674, 376.5]",1,3,-2
31223.0,2019-11-12,"(376.5, 708.0]",14,33,-19
31223.0,2019-11-12,"(708.0, 1039.5]",8,23,-15
31223.0,2019-11-12,"(1039.5, 1371.0]",19,37,-18
31224.0,2019-11-12,"(458.227, 652.25]",12,14,-2
31224.0,2019-11-12,"(652.25, 845.5]",1,2,-1
31224.0,2019-11-12,"(845.5, 1038.75]",2,8,-6
31224.0,2019-11-12,"(1038.75, 1232.0]",2,10,-8
31225.0,2019-11-12,"(426.229, 619.75]",9,11,-2
31225.0,2019-11-12,"(619.75, 812.5]",4,11,-7
31225.0,2019-11-12,"(812.5, 1005.25]",5,9,-4
31225.0,2019-11-12,"(1005.25, 1198.0]",5,13,-8
31226.0,2019-11-12,"(449.197, 650.75]",1,5,-4
31226.0,2019-11-12,"(650.75, 851.5]",2,3,-1
31226.0,2019-11-12,"(851.5, 1052.25]",3,8,-5
31226.0,2019-11-12,"(1052.25, 1253.0]",4,9,-5
31227.0,2019-11-12,"(414.285, 593.75]",35,35,0
31227.0,2019-11-12,"(593.75, 772.5]",9,10,-1
31227.0,2019-11-12,"(772.5, 951.25]",1,3,-2
31227.0,2019-11-12,"(951.25, 1130.0]",4,14,-10
31228.0,2019-11-12,"(87.69, 416.5]",3,3,0
31228.0,2019-11-12,"(416.5, 744.0]",17,22,-5
31228.0,2019-11-12,"(744.0, 1071.5]",21,37,-16
31228.0,2019-11-12,"(1071.5, 1399.0]",13,27,-14
31229.0,2019-11-12,"(14.606, 364.5]",3,6,-3
31229.0,2019-11-12,"(364.5, 713.0]",6,19,-13
31229.0,2019-11-12,"(713.0, 1061.5]",25,38,-13
31229.0,2019-11-12,"(1061.5, 1410.0]",32,53,-21
31230.0,2019-11-12,"(14.819, 311.25]",1,1,0
31230.0,2019-11-12,"(311.25, 606.5]",38,44,-6
31230.0,2019-11-12,"(606.5, 901.75]",11,14,-3
31230.0,2019-11-12,"(901.75, 1197.0]",12,35,-23
31231.0,2019-11-12,"(457.042, 697.5]",10,12,-2
31231.0,2019-11-12,"(697.5, 937.0]",4,5,-1
31231.0,2019-11-12,"(937.0, 1176.5]",5,16,-11
31232.0,2019-11-12,"(0.64, 342.0]",2,4,-2
31232.0,2019-11-12,"(342.0, 682.0]",17,22,-5
31232.0,2019-11-12,"(682.0, 1022.0]",7,17,-10
31232.0,2019-11-12,"(1022.0, 1362.0]",10,21,-11
31233.0,2019-11-12,"(397.029, 640.75]",28,31,-3
31233.0,2019-11-12,"(640.75, 883.5]",4,9,-5
31233.0,2019-11-12,"(883.5, 1126.25]",10,30,-20
31233.0,2019-11-12,"(1126.25, 1369.0]",2,11,-9
31234.0,2019-11-12,"(386.99, 640.5]",11,26,-15
31234.0,2019-11-12,"(640.5, 893.0]",6,11,-5
31234.0,2019-11-12,"(893.0, 1145.5]",14,27,-13
31234.0,2019-11-12,"(1145.5, 1398.0]",3,9,-6
31235.0,2019-11-12,"(528.458, 664.5]",11,11,0
31235.0,2019-11-12,"(664.5, 800.0]",1,2,-1
31235.0,2019-11-12,"(800.0, 935.5]",1,2,-1
31235.0,2019-11-12,"(935.5, 1071.0]",2,7,-5
31236.0,2019-11-12,"(63.652, 402.0]",1,2,-1
31236.0,2019-11-12,"(402.0, 739.0]",14,18,-4
31236.0,2019-11-12,"(739.0, 1076.0]",15,33,-18
31236.0,2019-11-12,"(1076.0, 1413.0]",7,19,-12
31237.0,2019-11-12,"(39.758, 351.5]",1,1,0
31237.0,2019-11-12,"(351.5, 662.0]",8,18,-10
31237.0,2019-11-12,"(662.0, 972.5]",8,12,-4
31237.0,2019-11-12,"(972.5, 1283.0]",11,19,-8
31238.0,2019-11-12,"(50.633, 393.75]",1,2,-1
31238.0,2019-11-12,"(393.75, 735.5]",21,26,-5
31238.0,2019-11-12,"(735.5, 1077.25]",8,22,-14
31238.0,2019-11-12,"(1077.25, 1419.0]",7,21,-14
31239.0,2019-11-12,"(383.086, 612.5]",22,25,-3
31239.0,2019-11-12,"(612.5, 841.0]",5,6,-1
31239.0,2019-11-12,"(841.0, 1069.5]",9,23,-14
31239.0,2019-11-12,"(1069.5, 1298.0]",5,20,-15
31240.0,2019-11-12,"(802.9, 828.0]",1,2,-1
31240.0,2019-11-12,"(878.0, 903.0]",2,4,-2
31241.0,2019-11-12,"(13.588, 368.0]",2,2,0
31241.0,2019-11-12,"(368.0, 721.0]",19,43,-24
31241.0,2019-11-12,"(721.0, 1074.0]",12,27,-15
31241.0,2019-11-12,"(1074.0, 1427.0]",16,28,-12
31242.0,2019-11-12,"(283.25, 563.5]",13,1,12
31242.0,2019-11-12,"(563.5, 843.75]",10,16,-6
31242.0,2019-11-12,"(843.75, 1124.0]",7,13,-6
31243.0,2019-11-12,"(383.076, 615.0]",19,21,-2
31243.0,2019-11-12,"(615.0, 846.0]",5,6,-1
31243.0,2019-11-12,"(846.0, 1077.0]",7,24,-17
31243.0,2019-11-12,"(1077.0, 1308.0]",2,8,-6
31244.0,2019-11-12,"(344.987, 599.25]",11,19,-8
31244.0,2019-11-12,"(599.25, 852.5]",2,2,0
31244.0,2019-11-12,"(852.5, 1105.75]",4,18,-14
31244.0,2019-11-12,"(1105.75, 1359.0]",9,12,-3
31245.0,2019-11-12,"(159.731, 478.25]",4,7,-3
31245.0,2019-11-12,"(478.25, 795.5]",11,24,-13
31245.0,2019-11-12,"(795.5, 1112.75]",13,24,-11
31245.0,2019-11-12,"(1112.75, 1430.0]",9,19,-10
31246.0,2019-11-12,"(413.237, 604.75]",9,12,-3
31246.0,2019-11-12,"(604.75, 795.5]",5,7,-2
31246.0,2019-11-12,"(795.5, 986.25]",4,5,-1
31246.0,2019-11-12,"(986.25, 1177.0]",15,26,-11
31247.0,2019-11-12,"(427.338, 593.5]",7,10,-3
31247.0,2019-11-12,"(759.0, 924.5]",2,5,-3
31247.0,2019-11-12,"(924.5, 1090.0]",7,13,-6
31248.0,2019-11-12,"(356.211, 554.25]",4,7,-3
31248.0,2019-11-12,"(554.25, 751.5]",2,2,0
31248.0,2019-11-12,"(751.5, 948.75]",3,4,-1
31248.0,2019-11-12,"(948.75, 1146.0]",9,17,-8
31249.0,2019-11-12,"(9.691, 338.25]",3,3,0
31249.0,2019-11-12,"(338.25, 665.5]",7,14,-7
31249.0,2019-11-12,"(665.5, 992.75]",3,8,-5
31249.0,2019-11-12,"(992.75, 1320.0]",3,6,-3
31250.0,2019-11-12,"(466.046, 705.5]",18,20,-2
31250.0,2019-11-12,"(705.5, 944.0]",4,8,-4
31250.0,2019-11-12,"(944.0, 1182.5]",4,17,-13
31250.0,2019-11-12,"(1182.5, 1421.0]",3,5,-2
31251.0,2019-11-12,"(19.599, 371.25]",2,3,-1
31251.0,2019-11-12,"(371.25, 721.5]",21,39,-18
31251.0,2019-11-12,"(721.5, 1071.75]",12,33,-21
31251.0,2019-11-12,"(1071.75, 1422.0]",10,18,-8
31252.0,2019-11-12,"(423.146, 637.5]",18,20,-2
31252.0,2019-11-12,"(637.5, 851.0]",4,8,-4
31252.0,2019-11-12,"(851.0, 1064.5]",7,17,-10
31252.0,2019-11-12,"(1064.5, 1278.0]",3,7,-4
31253.0,2019-11-12,"(402.258, 588.5]",13,15,-2
31253.0,2019-11-12,"(588.5, 774.0]",2,7,-5
31253.0,2019-11-12,"(774.0, 959.5]",4,14,-10
31253.0,2019-11-12,"(959.5, 1145.0]",5,16,-11
31254.0,2019-11-12,"(379.75, 627.5]",18,1,17
31254.0,2019-11-12,"(627.5, 875.25]",2,20,-18
31254.0,2019-11-12,"(875.25, 1123.0]",1,6,-5
31255.0,2019-11-12,"(320.5, 603.0]",18,1,17
31255.0,2019-11-12,"(603.0, 885.5]",1,23,-22
31255.0,2019-11-12,"(885.5, 1168.0]",13,2,11
31256.0,2019-11-12,"(281.941, 547.75]",6,7,-1
31256.0,2019-11-12,"(547.75, 812.5]",5,5,0
31256.0,2019-11-12,"(812.5, 1077.25]",1,7,-6
31256.0,2019-11-12,"(1077.25, 1342.0]",3,9,-6
31257.0,2019-11-12,"(329.979, 586.25]",14,21,-7
31257.0,2019-11-12,"(586.25, 841.5]",10,16,-6
31257.0,2019-11-12,"(841.5, 1096.75]",13,32,-19
31257.0,2019-11-12,"(1096.75, 1352.0]",10,25,-15
31258.0,2019-11-12,"(675.462, 810.5]",2,3,-1
31258.0,2019-11-12,"(810.5, 945.0]",3,3,0
31258.0,2019-11-12,"(945.0, 1079.5]",1,3,-2
31258.0,2019-11-12,"(1079.5, 1214.0]",3,6,-3
31259.0,2019-11-12,"(343.75, 610.5]",7,1,6
31259.0,2019-11-12,"(610.5, 877.25]",2,7,-5
31259.0,2019-11-12,"(877.25, 1144.0]",2,4,-2
31260.0,2019-11-12,"(382.948, 647.0]",15,19,-4
31260.0,2019-11-12,"(647.0, 910.0]",3,9,-6
31260.0,2019-11-12,"(910.0, 1173.0]",2,14,-12
31261.0,2019-11-12,"(436.331, 604.25]",10,10,0
31261.0,2019-11-12,"(938.75, 1106.0]",1,2,-1
31262.0,2019-11-12,"(104.796, 407.0]",1,1,0
31262.0,2019-11-12,"(407.0, 708.0]",9,11,-2
31262.0,2019-11-12,"(708.0, 1009.0]",2,3,-1
31262.0,2019-11-12,"(1009.0, 1310.0]",3,18,-15
31263.0,2019-11-12,"(287.931, 556.25]",12,17,-5
31263.0,2019-11-12,"(556.25, 823.5]",10,18,-8
31263.0,2019-11-12,"(823.5, 1090.75]",9,28,-19
31263.0,2019-11-12,"(1090.75, 1358.0]",5,10,-5
31264.0,2019-11-12,"(339.25, 666.5]",11,2,9
31264.0,2019-11-12,"(666.5, 993.75]",15,13,2
31264.0,2019-11-12,"(993.75, 1321.0]",8,27,-19
31265.0,2019-11-12,"(378.953, 641.75]",7,22,-15
31265.0,2019-11-12,"(641.75, 903.5]",3,6,-3
31265.0,2019-11-12,"(903.5, 1165.25]",17,33,-16
31265.0,2019-11-12,"(1165.25, 1427.0]",12,16,-4
31266.0,2019-11-12,"(49.626, 394.5]",1,3,-2
31266.0,2019-11-12,"(394.5, 738.0]",4,15,-11
31266.0,2019-11-12,"(738.0, 1081.5]",9,16,-7
31266.0,2019-11-12,"(1081.5, 1425.0]",22,39,-17
31267.0,2019-11-12,"(398.96, 660.0]",27,45,-18
31267.0,2019-11-12,"(660.0, 920.0]",8,15,-7
31267.0,2019-11-12,"(920.0, 1180.0]",12,28,-16
31267.0,2019-11-12,"(1180.0, 1440.0]",14,24,-10
31268.0,2019-11-12,"(173.785, 478.75]",5,9,-4
31268.0,2019-11-12,"(478.75, 782.5]",7,26,-19
31268.0,2019-11-12,"(782.5, 1086.25]",17,24,-7
31268.0,2019-11-12,"(1086.25, 1390.0]",14,23,-9
31269.0,2019-11-12,"(461.232, 654.0]",5,11,-6
31269.0,2019-11-12,"(654.0, 846.0]",2,4,-2
31269.0,2019-11-12,"(846.0, 1038.0]",3,10,-7
31269.0,2019-11-12,"(1038.0, 1230.0]",3,7,-4
31270.0,2019-11-12,"(332.25, 653.5]",16,1,15
31270.0,2019-11-12,"(653.5, 974.75]",5,20,-15
31270.0,2019-11-12,"(974.75, 1296.0]",9,14,-5
31271.0,2019-11-12,"(453.177, 659.75]",10,13,-3
31271.0,2019-11-12,"(659.75, 865.5]",3,5,-2
31271.0,2019-11-12,"(865.5, 1071.25]",7,15,-8
31272.0,2019-11-12,"(321.927, 591.25]",13,14,-1
31272.0,2019-11-12,"(591.25, 859.5]",6,8,-2
31272.0,2019-11-12,"(859.5, 1127.75]",6,20,-14
31273.0,2019-11-12,"(540.302, 715.5]",1,3,-2
31273.0,2019-11-12,"(715.5, 890.0]",1,1,0
31273.0,2019-11-12,"(890.0, 1064.5]",3,3,0
31273.0,2019-11-12,"(1064.5, 1239.0]",1,2,-1
31274.0,2019-11-12,"(356.053, 593.75]",18,21,-3
31274.0,2019-11-12,"(593.75, 830.5]",1,3,-2
31274.0,2019-11-12,"(830.5, 1067.25]",4,14,-10
31274.0,2019-11-12,"(1067.25, 1304.0]",3,9,-6
31275.0,2019-11-12,"(66.641, 407.75]",3,3,0
31275.0,2019-11-12,"(407.75, 747.5]",16,29,-13
31275.0,2019-11-12,"(747.5, 1087.25]",20,33,-13
31275.0,2019-11-12,"(1087.25, 1427.0]",9,21,-12
31276.0,2019-11-12,"(441.23, 634.5]",17,19,-2
31276.0,2019-11-12,"(827.0, 1019.5]",3,5,-2
31276.0,2019-11-12,"(1019.5, 1212.0]",3,11,-8
31277.0,2019-11-12,"(423.172, 631.0]",20,24,-4
31277.0,2019-11-12,"(631.0, 838.0]",6,10,-4
31277.0,2019-11-12,"(838.0, 1045.0]",6,19,-13
31277.0,2019-11-12,"(1045.0, 1252.0]",6,12,-6
31278.0,2019-11-12,"(438.111, 661.25]",7,27,-20
31278.0,2019-11-12,"(661.25, 883.5]",8,14,-6
31278.0,2019-11-12,"(883.5, 1105.75]",12,24,-12
31278.0,2019-11-12,"(1105.75, 1328.0]",20,26,-6
31279.0,2019-11-12,"(312.0, 578.0]",18,1,17
31279.0,2019-11-12,"(578.0, 844.0]",7,23,-16
31279.0,2019-11-12,"(844.0, 1110.0]",11,11,0
31280.0,2019-11-12,"(9.641, 350.75]",1,2,-1
31280.0,2019-11-12,"(350.75, 690.5]",2,14,-12
31280.0,2019-11-12,"(690.5, 1030.25]",2,2,0
31280.0,2019-11-12,"(1030.25, 1370.0]",13,19,-6
31000.0,2019-11-13,"(837.0, 1012.0]",1,1,0
31000.0,2019-11-13,"(1012.0, 1187.0]",1,2,-1
31001.0,2019-11-13,"(512.258, 698.5]",1,1,0
31001.0,2019-11-13,"(884.0, 1069.5]",1,3,-2
31001.0,2019-11-13,"(1069.5, 1255.0]",1,2,-1
31002.0,2019-11-13,"(441.255, 628.25]",3,7,-4
31002.0,2019-11-13,"(814.5, 1000.75]",1,1,0
31002.0,2019-11-13,"(1000.75, 1187.0]",2,3,-1
31003.0,2019-11-13,"(382.195, 584.25]",3,5,-2
31003.0,2019-11-13,"(785.5, 986.75]",2,2,0
31003.0,2019-11-13,"(986.75, 1188.0]",2,5,-3
31004.0,2019-11-13,"(815.0, 1001.0]",1,2,-1
31004.0,2019-11-13,"(1001.0, 1187.0]",2,2,0
31005.0,2019-11-13,"(444.252, 632.0]",3,5,-2
31005.0,2019-11-13,"(1006.0, 1193.0]",2,1,1
31006.0,2019-11-13,"(371.182, 576.5]",1,2,-1
31006.0,2019-11-13,"(985.5, 1190.0]",1,2,-1
31007.0,2019-11-13,"(357.04, 598.0]",3,16,-13
31007.0,2019-11-13,"(598.0, 838.0]",2,4,-2
31007.0,2019-11-13,"(838.0, 1078.0]",12,24,-12
31007.0,2019-11-13,"(1078.0, 1318.0]",4,11,-7
31009.0,2019-11-13,"(367.366, 526.5]",3,3,0
31009.0,2019-11-13,"(526.5, 685.0]",2,2,0
31010.0,2019-11-13,"(1116.25, 1237.0]",1,1,0
31011.0,2019-11-13,"(384.052, 622.0]",5,8,-3
31011.0,2019-11-13,"(622.0, 859.0]",3,3,0
31011.0,2019-11-13,"(859.0, 1096.0]",2,6,-4
31011.0,2019-11-13,"(1096.0, 1333.0]",3,3,0
31012.0,2019-11-13,"(360.29, 538.5]",5,5,0
31012.0,2019-11-13,"(716.0, 893.5]",1,1,0
31012.0,2019-11-13,"(893.5, 1071.0]",1,5,-4
31013.0,2019-11-13,"(672.25, 909.5]",1,2,-1
31013.0,2019-11-13,"(909.5, 1146.75]",2,2,0
31013.0,2019-11-13,"(1146.75, 1384.0]",2,2,0
31014.0,2019-11-13,"(396.082, 626.5]",25,29,-4
31014.0,2019-11-13,"(626.5, 856.0]",9,10,-1
31014.0,2019-11-13,"(856.0, 1085.5]",9,15,-6
31014.0,2019-11-13,"(1085.5, 1315.0]",5,10,-5
31015.0,2019-11-13,"(309.102, 534.5]",4,5,-1
31015.0,2019-11-13,"(759.0, 983.5]",2,4,-2
31015.0,2019-11-13,"(983.5, 1208.0]",2,4,-2
31016.0,2019-11-13,"(305.955, 568.25]",6,9,-3
31016.0,2019-11-13,"(568.25, 829.5]",3,3,0
31016.0,2019-11-13,"(829.5, 1090.75]",3,4,-1
31016.0,2019-11-13,"(1090.75, 1352.0]",1,2,-1
31017.0,2019-11-13,"(514.335, 681.25]",4,7,-3
31018.0,2019-11-13,"(354.241, 544.75]",1,7,-6
31018.0,2019-11-13,"(924.25, 1114.0]",3,4,-1
31019.0,2019-11-13,"(674.0, 894.0]",1,1,0
31019.0,2019-11-13,"(894.0, 1114.0]",2,1,1
31019.0,2019-11-13,"(1114.0, 1334.0]",1,4,-3
,,,,1.0,
,,,,1.0,
31021.0,2019-11-13,"(342.037, 583.75]",1,3,-2
31021.0,2019-11-13,"(583.75, 824.5]",2,4,-2
31021.0,2019-11-13,"(1065.25, 1306.0]",2,1,1
31022.0,2019-11-13,"(457.189, 660.75]",2,6,-4
31022.0,2019-11-13,"(660.75, 863.5]",1,2,-1
31022.0,2019-11-13,"(1066.25, 1269.0]",1,2,-1
31023.0,2019-11-13,"(594.25, 838.5]",2,2,0
31023.0,2019-11-13,"(838.5, 1082.75]",2,2,0
31023.0,2019-11-13,"(1082.75, 1327.0]",2,2,0
31024.0,2019-11-13,"(410.221, 605.75]",2,6,-4
31024.0,2019-11-13,"(605.75, 800.5]",2,2,0
31024.0,2019-11-13,"(800.5, 995.25]",2,6,-4
31025.0,2019-11-13,"(999.769, 1057.75]",1,2,-1
31025.0,2019-11-13,"(1173.25, 1231.0]",1,2,-1
31026.0,2019-11-13,"(971.5, 1135.0]",1,1,0
31027.0,2019-11-13,"(681.5, 835.0]",1,2,-1
31027.0,2019-11-13,"(835.0, 988.5]",1,2,-1
31027.0,2019-11-13,"(988.5, 1142.0]",2,1,1
31028.0,2019-11-13,"(465.312, 638.0]",1,1,0
31028.0,2019-11-13,"(982.0, 1154.0]",1,2,-1
31029.0,2019-11-13,"(865.0, 1044.0]",3,6,-3
31029.0,2019-11-13,"(1044.0, 1223.0]",3,2,1
31030.0,2019-11-13,"(335.171, 543.25]",1,6,-5
31030.0,2019-11-13,"(750.5, 957.75]",1,4,-3
31030.0,2019-11-13,"(957.75, 1165.0]",5,1,4
31031.0,2019-11-13,"(540.5, 726.0]",1,1,0
31031.0,2019-11-13,"(911.5, 1097.0]",2,4,-2
31032.0,2019-11-13,"(805.5, 972.25]",1,1,0
31032.0,2019-11-13,"(972.25, 1139.0]",2,1,1
,,,,2.0,
31034.0,2019-11-13,"(737.25, 902.5]",3,1,2
31035.0,2019-11-13,"(910.25, 1078.0]",1,4,-3
31036.0,2019-11-13,"(498.386, 652.5]",1,3,-2
31036.0,2019-11-13,"(959.5, 1113.0]",2,2,0
31037.0,2019-11-13,"(356.139, 572.25]",9,13,-4
31037.0,2019-11-13,"(572.25, 787.5]",1,2,-1
31037.0,2019-11-13,"(787.5, 1002.75]",2,5,-3
31037.0,2019-11-13,"(1002.75, 1218.0]",2,14,-12
31038.0,2019-11-13,"(385.241, 575.75]",3,4,-1
31038.0,2019-11-13,"(575.75, 765.5]",1,1,0
31038.0,2019-11-13,"(955.25, 1145.0]",1,1,0
31039.0,2019-11-13,"(469.275, 651.25]",2,3,-1
31039.0,2019-11-13,"(832.5, 1013.75]",2,3,-1
31039.0,2019-11-13,"(1013.75, 1195.0]",1,3,-2
31040.0,2019-11-13,"(467.121, 687.75]",3,3,0
31040.0,2019-11-13,"(907.5, 1127.25]",1,1,0
31040.0,2019-11-13,"(1127.25, 1347.0]",2,4,-2
31041.0,2019-11-13,"(472.319, 643.25]",3,3,0
31041.0,2019-11-13,"(983.75, 1154.0]",2,2,0
31042.0,2019-11-13,"(446.12, 667.0]",9,9,0
31042.0,2019-11-13,"(667.0, 887.0]",2,3,-1
31042.0,2019-11-13,"(887.0, 1107.0]",2,7,-5
31043.0,2019-11-13,"(521.461, 656.75]",1,2,-1
31043.0,2019-11-13,"(791.5, 926.25]",2,2,0
31043.0,2019-11-13,"(926.25, 1061.0]",1,3,-2
31044.0,2019-11-13,"(480.435, 622.25]",1,2,-1
31044.0,2019-11-13,"(904.75, 1046.0]",1,1,0
31045.0,2019-11-13,"(259.5, 519.0]",1,1,0
31045.0,2019-11-13,"(778.5, 1038.0]",1,1,0
31046.0,2019-11-13,"(513.5, 572.75]",1,1,0
31046.0,2019-11-13,"(572.75, 632.0]",1,2,-1
31047.0,2019-11-13,"(349.985, 604.75]",10,16,-6
31047.0,2019-11-13,"(604.75, 858.5]",2,5,-3
31047.0,2019-11-13,"(858.5, 1112.25]",5,17,-12
31047.0,2019-11-13,"(1112.25, 1366.0]",3,10,-7
31048.0,2019-11-13,"(407.289, 585.75]",4,7,-3
31048.0,2019-11-13,"(941.25, 1119.0]",3,1,2
31049.0,2019-11-13,"(1039.805, 1088.75]",1,2,-1
31049.0,2019-11-13,"(1186.25, 1235.0]",1,1,0
,,,,2.0,
31051.0,2019-11-13,"(907.5, 1108.0]",5,4,1
31052.0,2019-11-13,"(519.273, 701.75]",3,5,-2
31052.0,2019-11-13,"(883.5, 1065.25]",1,1,0
31052.0,2019-11-13,"(1065.25, 1247.0]",4,6,-2
31053.0,2019-11-13,"(1284.0, 1359.0]",1,1,0
31054.0,2019-11-13,"(771.0, 1028.0]",1,1,0
31055.0,2019-11-13,"(925.25, 1070.0]",2,1,1
31056.0,2019-11-13,"(17.454, 154.5]",1,1,0
31057.0,2019-11-13,"(813.75, 1085.0]",1,1,0
31058.0,2019-11-13,"(757.5, 1010.0]",1,1,0
,,,,1.0,
,,,,1.0,
,,,,2.0,
,,,,1.0,
,,,,1.0,
,,,,1.0,
,,,,1.0,
31062.0,2019-11-13,"(670.5, 795.25]",1,1,0
31062.0,2019-11-13,"(795.25, 920.0]",1,2,-1
,,,,2.0,
31064.0,2019-11-13,"(442.269, 625.75]",1,3,-2
31064.0,2019-11-13,"(808.5, 991.25]",3,6,-3
31064.0,2019-11-13,"(991.25, 1174.0]",3,6,-3
31065.0,2019-11-13,"(721.5, 858.25]",1,2,-1
31065.0,2019-11-13,"(858.25, 995.0]",1,2,-1
,,,,2.0,
31067.0,2019-11-13,"(830.555, 942.25]",2,3,-1
31067.0,2019-11-13,"(1053.5, 1164.75]",1,1,0
31067.0,2019-11-13,"(1164.75, 1276.0]",2,2,0
31068.0,2019-11-13,"(958.0, 1152.0]",2,1,1
31068.0,2019-11-13,"(1152.0, 1346.0]",1,2,-1
31069.0,2019-11-13,"(435.197, 636.75]",1,7,-6
31069.0,2019-11-13,"(837.5, 1038.25]",5,3,2
31069.0,2019-11-13,"(1038.25, 1239.0]",3,5,-2
31070.0,2019-11-13,"(830.56, 941.0]",1,2,-1
31070.0,2019-11-13,"(1051.0, 1161.0]",1,1,0
31070.0,2019-11-13,"(1161.0, 1271.0]",1,1,0
31071.0,2019-11-13,"(378.044, 618.0]",2,3,-1
31071.0,2019-11-13,"(618.0, 857.0]",1,2,-1
31071.0,2019-11-13,"(857.0, 1096.0]",6,7,-1
31071.0,2019-11-13,"(1096.0, 1335.0]",2,4,-2
,,,,1.0,
,,,,1.0,
31073.0,2019-11-13,"(495.467, 629.25]",2,3,-1
31074.0,2019-11-13,"(648.299, 824.25]",1,2,-1
31074.0,2019-11-13,"(999.5, 1174.75]",2,4,-2
31074.0,2019-11-13,"(1174.75, 1350.0]",2,3,-1
31075.0,2019-11-13,"(971.5, 1115.0]",1,1,0
31076.0,2019-11-13,"(299.0, 598.0]",1,1,0
31076.0,2019-11-13,"(897.0, 1196.0]",3,1,2
31077.0,2019-11-13,"(466.112, 689.0]",1,7,-6
31077.0,2019-11-13,"(911.0, 1133.0]",4,6,-2
31077.0,2019-11-13,"(1133.0, 1355.0]",2,3,-1
31078.0,2019-11-13,"(461.358, 622.5]",3,3,0
31078.0,2019-11-13,"(943.5, 1104.0]",2,1,1
31079.0,2019-11-13,"(1135.5, 1366.0]",6,7,-1
31080.0,2019-11-13,"(383.016, 630.0]",1,14,-13
31080.0,2019-11-13,"(630.0, 876.0]",1,2,-1
31080.0,2019-11-13,"(876.0, 1122.0]",5,7,-2
31080.0,2019-11-13,"(1122.0, 1368.0]",4,4,0
31081.0,2019-11-13,"(969.812, 1017.0]",1,1,0
31081.0,2019-11-13,"(1064.0, 1111.0]",2,3,-1
,,,,1.0,
,,,,1.0,
31083.0,2019-11-13,"(820.0, 1024.5]",1,1,0
31083.0,2019-11-13,"(1024.5, 1229.0]",4,1,3
31084.0,2019-11-13,"(569.457, 705.75]",2,2,0
31084.0,2019-11-13,"(705.75, 841.5]",1,1,0
31085.0,2019-11-13,"(399.054, 636.5]",1,2,-1
31085.0,2019-11-13,"(873.0, 1109.5]",2,3,-1
31085.0,2019-11-13,"(1109.5, 1346.0]",3,3,0
31086.0,2019-11-13,"(649.25, 890.5]",1,1,0
31086.0,2019-11-13,"(1131.75, 1373.0]",1,1,0
31087.0,2019-11-13,"(925.0, 1074.0]",3,2,1
31088.0,2019-11-13,"(803.5, 1008.75]",1,1,0
31088.0,2019-11-13,"(1008.75, 1214.0]",3,2,1
31089.0,2019-11-13,"(447.087, 676.25]",5,9,-4
31089.0,2019-11-13,"(676.25, 904.5]",2,4,-2
31089.0,2019-11-13,"(904.5, 1132.75]",2,16,-14
31089.0,2019-11-13,"(1132.75, 1361.0]",3,6,-3
,,,,2.0,
31091.0,2019-11-13,"(679.0, 916.0]",1,4,-3
31091.0,2019-11-13,"(916.0, 1153.0]",3,1,2
31091.0,2019-11-13,"(1153.0, 1390.0]",2,3,-1
31092.0,2019-11-13,"(1000.0, 1042.0]",1,1,0
31093.0,2019-11-13,"(687.5, 834.75]",1,1,0
31094.0,2019-11-13,"(606.5, 655.0]",1,1,0
,,,,2.0,
31096.0,2019-11-13,"(893.5, 1106.25]",1,3,-2
31096.0,2019-11-13,"(1106.25, 1319.0]",1,1,0
31097.0,2019-11-13,"(473.334, 640.5]",4,5,-1
31098.0,2019-11-13,"(416.232, 609.0]",5,9,-4
31098.0,2019-11-13,"(609.0, 801.0]",1,2,-1
31098.0,2019-11-13,"(801.0, 993.0]",2,4,-2
31098.0,2019-11-13,"(993.0, 1185.0]",4,9,-5
31099.0,2019-11-13,"(1022.0, 1210.0]",1,3,-2
31100.0,2019-11-13,"(396.269, 579.75]",9,11,-2
31100.0,2019-11-13,"(579.75, 762.5]",5,6,-1
31100.0,2019-11-13,"(762.5, 945.25]",2,6,-4
31100.0,2019-11-13,"(945.25, 1128.0]",1,12,-11
31101.0,2019-11-13,"(2.566, 362.5]",2,4,-2
31101.0,2019-11-13,"(362.5, 721.0]",13,48,-35
31101.0,2019-11-13,"(721.0, 1079.5]",24,42,-18
31101.0,2019-11-13,"(1079.5, 1438.0]",22,31,-9
31102.0,2019-11-13,"(350.945, 615.75]",1,17,-16
31102.0,2019-11-13,"(879.5, 1143.25]",8,2,6
31102.0,2019-11-13,"(1143.25, 1407.0]",6,13,-7
31103.0,2019-11-13,"(66.665, 401.75]",1,2,-1
31103.0,2019-11-13,"(401.75, 735.5]",1,31,-30
31103.0,2019-11-13,"(735.5, 1069.25]",2,9,-7
31103.0,2019-11-13,"(1069.25, 1403.0]",9,27,-18
31104.0,2019-11-13,"(58.633, 401.75]",3,6,-3
31104.0,2019-11-13,"(401.75, 743.5]",3,15,-12
31104.0,2019-11-13,"(743.5, 1085.25]",15,26,-11
31104.0,2019-11-13,"(1085.25, 1427.0]",9,21,-12
31105.0,2019-11-13,"(1020.75, 1237.0]",5,5,0
31106.0,2019-11-13,"(425.75, 741.5]",1,1,0
31106.0,2019-11-13,"(1057.25, 1373.0]",6,10,-4
31107.0,2019-11-13,"(373.986, 628.5]",4,26,-22
31107.0,2019-11-13,"(628.5, 882.0]",2,5,-3
31107.0,2019-11-13,"(882.0, 1135.5]",7,11,-4
31107.0,2019-11-13,"(1135.5, 1389.0]",7,9,-2
31108.0,2019-11-13,"(356.75, 709.5]",7,1,6
31108.0,2019-11-13,"(709.5, 1062.25]",13,20,-7
31108.0,2019-11-13,"(1062.25, 1415.0]",20,29,-9
31109.0,2019-11-13,"(38.64, 380.0]",1,3,-2
31109.0,2019-11-13,"(380.0, 720.0]",5,19,-14
31109.0,2019-11-13,"(720.0, 1060.0]",11,18,-7
31109.0,2019-11-13,"(1060.0, 1400.0]",17,26,-9
31110.0,2019-11-13,"(314.927, 584.25]",16,39,-23
31110.0,2019-11-13,"(584.25, 852.5]",7,16,-9
31110.0,2019-11-13,"(852.5, 1120.75]",18,29,-11
31110.0,2019-11-13,"(1120.75, 1389.0]",9,19,-10
31111.0,2019-11-13,"(444.067, 678.25]",5,23,-18
31111.0,2019-11-13,"(678.25, 911.5]",1,1,0
31111.0,2019-11-13,"(911.5, 1144.75]",13,17,-4
31111.0,2019-11-13,"(1144.75, 1378.0]",7,13,-6
31112.0,2019-11-13,"(952.75, 1094.0]",3,2,1
31113.0,2019-11-13,"(241.019, 487.25]",2,13,-11
31113.0,2019-11-13,"(487.25, 732.5]",1,14,-13
31113.0,2019-11-13,"(732.5, 977.75]",1,2,-1
31113.0,2019-11-13,"(977.75, 1223.0]",22,33,-11
31114.0,2019-11-13,"(382.99, 636.5]",2,29,-27
31114.0,2019-11-13,"(636.5, 889.0]",1,3,-2
31114.0,2019-11-13,"(889.0, 1141.5]",16,23,-7
31114.0,2019-11-13,"(1141.5, 1394.0]",9,13,-4
31115.0,2019-11-13,"(346.93, 615.5]",1,15,-14
31115.0,2019-11-13,"(615.5, 883.0]",1,6,-5
31115.0,2019-11-13,"(883.0, 1150.5]",11,14,-3
31115.0,2019-11-13,"(1150.5, 1418.0]",8,10,-2
31116.0,2019-11-13,"(305.909, 579.75]",3,20,-17
31116.0,2019-11-13,"(579.75, 852.5]",7,12,-5
31116.0,2019-11-13,"(852.5, 1125.25]",21,27,-6
31116.0,2019-11-13,"(1125.25, 1398.0]",6,8,-2
31117.0,2019-11-13,"(353.019, 599.25]",3,17,-14
31117.0,2019-11-13,"(599.25, 844.5]",1,11,-10
31117.0,2019-11-13,"(844.5, 1089.75]",10,16,-6
31117.0,2019-11-13,"(1089.75, 1335.0]",4,7,-3
31118.0,2019-11-13,"(417.028, 661.0]",5,20,-15
31118.0,2019-11-13,"(904.0, 1147.0]",13,3,10
31118.0,2019-11-13,"(1147.0, 1390.0]",4,18,-14
31119.0,2019-11-13,"(300.87, 584.5]",7,24,-17
31119.0,2019-11-13,"(584.5, 867.0]",5,8,-3
31119.0,2019-11-13,"(867.0, 1149.5]",16,21,-5
31119.0,2019-11-13,"(1149.5, 1432.0]",3,6,-3
31120.0,2019-11-13,"(400.061, 635.75]",4,16,-12
31120.0,2019-11-13,"(635.75, 870.5]",1,4,-3
31120.0,2019-11-13,"(870.5, 1105.25]",10,16,-6
31120.0,2019-11-13,"(1105.25, 1340.0]",10,16,-6
31121.0,2019-11-13,"(24.717, 346.75]",1,3,-2
31121.0,2019-11-13,"(346.75, 667.5]",11,19,-8
31121.0,2019-11-13,"(667.5, 988.25]",3,5,-2
31121.0,2019-11-13,"(988.25, 1309.0]",12,20,-8
31122.0,2019-11-13,"(467.106, 691.5]",1,10,-9
31122.0,2019-11-13,"(691.5, 915.0]",1,5,-4
31122.0,2019-11-13,"(915.0, 1138.5]",7,11,-4
31122.0,2019-11-13,"(1138.5, 1362.0]",1,1,0
31123.0,2019-11-13,"(2.596, 355.0]",2,2,0
31123.0,2019-11-13,"(706.0, 1057.0]",3,12,-9
31123.0,2019-11-13,"(1057.0, 1408.0]",6,8,-2
31124.0,2019-11-13,"(20.582, 376.5]",3,4,-1
31124.0,2019-11-13,"(376.5, 731.0]",18,36,-18
31124.0,2019-11-13,"(731.0, 1085.5]",17,40,-23
31124.0,2019-11-13,"(1085.5, 1440.0]",10,43,-33
31125.0,2019-11-13,"(78.702, 404.5]",1,5,-4
31125.0,2019-11-13,"(404.5, 729.0]",3,21,-18
31125.0,2019-11-13,"(729.0, 1053.5]",11,14,-3
31125.0,2019-11-13,"(1053.5, 1378.0]",18,28,-10
31126.0,2019-11-13,"(300.97, 559.5]",6,30,-24
31126.0,2019-11-13,"(559.5, 817.0]",4,17,-13
31126.0,2019-11-13,"(817.0, 1074.5]",13,19,-6
31126.0,2019-11-13,"(1074.5, 1332.0]",2,4,-2
31127.0,2019-11-13,"(521.21, 719.5]",11,16,-5
31127.0,2019-11-13,"(719.5, 917.0]",5,10,-5
31127.0,2019-11-13,"(917.0, 1114.5]",12,22,-10
31127.0,2019-11-13,"(1114.5, 1312.0]",2,12,-10
31128.0,2019-11-13,"(0.607, 350.25]",2,5,-3
31128.0,2019-11-13,"(350.25, 698.5]",26,40,-14
31128.0,2019-11-13,"(698.5, 1046.75]",18,36,-18
31128.0,2019-11-13,"(1046.75, 1395.0]",5,18,-13
31129.0,2019-11-13,"(349.125, 568.75]",5,7,-2
31129.0,2019-11-13,"(568.75, 787.5]",4,8,-4
31129.0,2019-11-13,"(787.5, 1006.25]",5,7,-2
31129.0,2019-11-13,"(1006.25, 1225.0]",3,11,-8
31130.0,2019-11-13,"(336.033, 578.75]",1,12,-11
31130.0,2019-11-13,"(578.75, 820.5]",3,8,-5
31130.0,2019-11-13,"(820.5, 1062.25]",4,8,-4
31130.0,2019-11-13,"(1062.25, 1304.0]",8,10,-2
31131.0,2019-11-13,"(655.25, 891.5]",1,11,-10
31131.0,2019-11-13,"(1127.75, 1364.0]",3,2,1
31200.0,2019-11-13,"(112.707, 437.25]",4,7,-3
31200.0,2019-11-13,"(437.25, 760.5]",44,59,-15
31200.0,2019-11-13,"(760.5, 1083.75]",21,43,-22
31200.0,2019-11-13,"(1083.75, 1407.0]",14,34,-20
31201.0,2019-11-13,"(103.75, 417.5]",7,11,-4
31201.0,2019-11-13,"(417.5, 730.0]",18,44,-26
31201.0,2019-11-13,"(730.0, 1042.5]",27,41,-14
31201.0,2019-11-13,"(1042.5, 1355.0]",29,60,-31
31202.0,2019-11-13,"(353.927, 623.25]",4,16,-12
31202.0,2019-11-13,"(623.25, 891.5]",5,10,-5
31202.0,2019-11-13,"(891.5, 1159.75]",22,35,-13
31202.0,2019-11-13,"(1159.75, 1428.0]",3,13,-10
31203.0,2019-11-13,"(337.929, 606.75]",3,20,-17
31203.0,2019-11-13,"(606.75, 874.5]",10,21,-11
31203.0,2019-11-13,"(874.5, 1142.25]",26,44,-18
31203.0,2019-11-13,"(1142.25, 1410.0]",7,22,-15
31204.0,2019-11-13,"(319.921, 590.75]",14,22,-8
31204.0,2019-11-13,"(590.75, 860.5]",6,9,-3
31204.0,2019-11-13,"(860.5, 1130.25]",7,21,-14
31204.0,2019-11-13,"(1130.25, 1400.0]",1,7,-6
31205.0,2019-11-13,"(423.038, 664.5]",25,29,-4
31205.0,2019-11-13,"(664.5, 905.0]",11,20,-9
31205.0,2019-11-13,"(905.0, 1145.5]",13,26,-13
31205.0,2019-11-13,"(1145.5, 1386.0]",1,14,-13
31206.0,2019-11-13,"(412.255, 599.25]",8,9,-1
31206.0,2019-11-13,"(599.25, 785.5]",1,1,0
31206.0,2019-11-13,"(971.75, 1158.0]",5,3,2
31207.0,2019-11-13,"(928.0, 1143.5]",2,7,-5
31207.0,2019-11-13,"(1143.5, 1359.0]",4,5,-1
31208.0,2019-11-13,"(323.039, 564.25]",11,12,-1
31208.0,2019-11-13,"(564.25, 804.5]",1,3,-2
31208.0,2019-11-13,"(804.5, 1044.75]",2,10,-8
31208.0,2019-11-13,"(1044.75, 1285.0]",5,9,-4
31209.0,2019-11-13,"(463.069, 696.75]",1,3,-2
31209.0,2019-11-13,"(696.75, 929.5]",3,4,-1
31209.0,2019-11-13,"(929.5, 1162.25]",4,8,-4
31209.0,2019-11-13,"(1162.25, 1395.0]",3,4,-1
31211.0,2019-11-13,"(396.156, 608.0]",5,6,-1
31211.0,2019-11-13,"(819.0, 1030.0]",4,3,1
31211.0,2019-11-13,"(1030.0, 1241.0]",5,5,0
31212.0,2019-11-13,"(349.957, 611.75]",27,38,-11
31212.0,2019-11-13,"(611.75, 872.5]",5,14,-9
31212.0,2019-11-13,"(872.5, 1133.25]",14,34,-20
31212.0,2019-11-13,"(1133.25, 1394.0]",10,21,-11
31213.0,2019-11-13,"(275.891, 554.25]",23,31,-8
31213.0,2019-11-13,"(554.25, 831.5]",11,16,-5
31213.0,2019-11-13,"(831.5, 1108.75]",18,36,-18
31213.0,2019-11-13,"(1108.75, 1386.0]",4,10,-6
31214.0,2019-11-13,"(15.585, 370.75]",2,4,-2
31214.0,2019-11-13,"(370.75, 724.5]",11,35,-24
31214.0,2019-11-13,"(724.5, 1078.25]",15,31,-16
31214.0,2019-11-13,"(1078.25, 1432.0]",29,43,-14
31215.0,2019-11-13,"(403.055, 640.25]",25,26,-1
31215.0,2019-11-13,"(640.25, 876.5]",5,8,-3
31215.0,2019-11-13,"(876.5, 1112.75]",7,18,-11
31215.0,2019-11-13,"(1112.75, 1349.0]",3,6,-3
31216.0,2019-11-13,"(458.087, 687.25]",21,21,0
31216.0,2019-11-13,"(687.25, 915.5]",3,7,-4
31216.0,2019-11-13,"(915.5, 1143.75]",4,25,-21
31217.0,2019-11-13,"(325.207, 524.25]",13,13,0
31217.0,2019-11-13,"(524.25, 722.5]",3,4,-1
31217.0,2019-11-13,"(722.5, 920.75]",1,2,-1
31217.0,2019-11-13,"(920.75, 1119.0]",2,10,-8
31218.0,2019-11-13,"(343.198, 544.5]",11,21,-10
31218.0,2019-11-13,"(544.5, 745.0]",2,4,-2
31218.0,2019-11-13,"(745.0, 945.5]",6,7,-1
31218.0,2019-11-13,"(945.5, 1146.0]",11,21,-10
31219.0,2019-11-13,"(433.337, 599.75]",14,15,-1
31219.0,2019-11-13,"(599.75, 765.5]",2,3,-1
31219.0,2019-11-13,"(765.5, 931.25]",3,4,-1
31220.0,2019-11-13,"(318.258, 504.5]",15,18,-3
31220.0,2019-11-13,"(504.5, 690.0]",4,7,-3
31220.0,2019-11-13,"(690.0, 875.5]",2,3,-1
31221.0,2019-11-13,"(455.1, 681.0]",21,23,-2
31221.0,2019-11-13,"(681.0, 906.0]",11,16,-5
31221.0,2019-11-13,"(906.0, 1131.0]",9,31,-22
31221.0,2019-11-13,"(1131.0, 1356.0]",2,4,-2
31222.0,2019-11-13,"(481.3, 657.0]",19,20,-1
31222.0,2019-11-13,"(657.0, 832.0]",2,5,-3
31222.0,2019-11-13,"(832.0, 1007.0]",2,7,-5
31222.0,2019-11-13,"(1007.0, 1182.0]",1,16,-15
31223.0,2019-11-13,"(49.614, 397.5]",2,4,-2
31223.0,2019-11-13,"(397.5, 744.0]",14,36,-22
31223.0,2019-11-13,"(744.0, 1090.5]",12,25,-13
31223.0,2019-11-13,"(1090.5, 1437.0]",4,15,-11
31224.0,2019-11-13,"(431.083, 661.25]",19,20,-1
31224.0,2019-11-13,"(661.25, 890.5]",5,7,-2
31224.0,2019-11-13,"(890.5, 1119.75]",5,13,-8
31224.0,2019-11-13,"(1119.75, 1349.0]",1,2,-1
31225.0,2019-11-13,"(429.125, 648.75]",9,14,-5
31225.0,2019-11-13,"(648.75, 867.5]",1,6,-5
31225.0,2019-11-13,"(867.5, 1086.25]",4,6,-2
31225.0,2019-11-13,"(1086.25, 1305.0]",6,10,-4
31226.0,2019-11-13,"(267.967, 527.25]",6,9,-3
31226.0,2019-11-13,"(527.25, 785.5]",2,5,-3
31226.0,2019-11-13,"(785.5, 1043.75]",2,7,-5
31226.0,2019-11-13,"(1043.75, 1302.0]",4,8,-4
31227.0,2019-11-13,"(441.176, 648.0]",31,32,-1
31227.0,2019-11-13,"(648.0, 854.0]",7,11,-4
31227.0,2019-11-13,"(854.0, 1060.0]",5,12,-7
31227.0,2019-11-13,"(1060.0, 1266.0]",3,15,-12
31228.0,2019-11-13,"(44.612, 393.0]",3,4,-1
31228.0,2019-11-13,"(393.0, 740.0]",20,29,-9
31228.0,2019-11-13,"(740.0, 1087.0]",20,37,-17
31228.0,2019-11-13,"(1087.0, 1434.0]",12,26,-14
31229.0,2019-11-13,"(116.743, 432.25]",12,22,-10
31229.0,2019-11-13,"(432.25, 746.5]",6,33,-27
31229.0,2019-11-13,"(746.5, 1060.75]",20,45,-25
31229.0,2019-11-13,"(1060.75, 1375.0]",26,38,-12
31230.0,2019-11-13,"(409.037, 650.75]",47,54,-7
31230.0,2019-11-13,"(650.75, 891.5]",6,11,-5
31230.0,2019-11-13,"(891.5, 1132.25]",13,35,-22
31231.0,2019-11-13,"(331.195, 533.25]",8,9,-1
31231.0,2019-11-13,"(533.25, 734.5]",5,7,-2
31231.0,2019-11-13,"(734.5, 935.75]",6,13,-7
31231.0,2019-11-13,"(935.75, 1137.0]",5,17,-12
31232.0,2019-11-13,"(7.643, 348.25]",2,5,-3
31232.0,2019-11-13,"(348.25, 687.5]",4,5,-1
31232.0,2019-11-13,"(687.5, 1026.75]",4,9,-5
31232.0,2019-11-13,"(1026.75, 1366.0]",11,24,-13
31233.0,2019-11-13,"(2.565, 362.75]",1,1,0
31233.0,2019-11-13,"(362.75, 721.5]",32,35,-3
31233.0,2019-11-13,"(721.5, 1080.25]",28,45,-17
31233.0,2019-11-13,"(1080.25, 1439.0]",6,21,-15
31234.0,2019-11-13,"(381.023, 626.25]",16,31,-15
31234.0,2019-11-13,"(626.25, 870.5]",9,20,-11
31234.0,2019-11-13,"(870.5, 1114.75]",8,16,-8
31234.0,2019-11-13,"(1114.75, 1359.0]",8,17,-9
31235.0,2019-11-13,"(495.241, 685.75]",4,4,0
31235.0,2019-11-13,"(685.75, 875.5]",3,3,0
31235.0,2019-11-13,"(875.5, 1065.25]",3,6,-3
31236.0,2019-11-13,"(333.5, 664.0]",20,1,19
31236.0,2019-11-13,"(664.0, 994.5]",8,24,-16
31236.0,2019-11-13,"(994.5, 1325.0]",9,23,-14
31237.0,2019-11-13,"(46.654, 384.5]",1,1,0
31237.0,2019-11-13,"(384.5, 721.0]",8,18,-10
31237.0,2019-11-13,"(721.0, 1057.5]",19,31,-12
31237.0,2019-11-13,"(1057.5, 1394.0]",13,25,-12
31238.0,2019-11-13,"(56.893, 334.75]",1,1,0
31238.0,2019-11-13,"(334.75, 611.5]",19,25,-6
31238.0,2019-11-13,"(611.5, 888.25]",4,10,-6
31238.0,2019-11-13,"(888.25, 1165.0]",10,29,-19
31239.0,2019-11-13,"(334.974, 592.5]",23,26,-3
31239.0,2019-11-13,"(592.5, 849.0]",12,16,-4
31239.0,2019-11-13,"(849.0, 1105.5]",11,26,-15
31239.0,2019-11-13,"(1105.5, 1362.0]",2,20,-18
31240.0,2019-11-13,"(609.0, 801.0]",2,1,1
31240.0,2019-11-13,"(993.0, 1185.0]",7,4,3
31241.0,2019-11-13,"(10.58, 367.0]",2,4,-2
31241.0,2019-11-13,"(367.0, 722.0]",28,59,-31
31241.0,2019-11-13,"(722.0, 1077.0]",9,28,-19
31241.0,2019-11-13,"(1077.0, 1432.0]",17,37,-20
31242.0,2019-11-13,"(362.055, 599.25]",28,30,-2
31242.0,2019-11-13,"(599.25, 835.5]",5,13,-8
31242.0,2019-11-13,"(835.5, 1071.75]",5,20,-15
31242.0,2019-11-13,"(1071.75, 1308.0]",1,15,-14
31243.0,2019-11-13,"(377.019, 623.25]",28,32,-4
31243.0,2019-11-13,"(623.25, 868.5]",7,12,-5
31243.0,2019-11-13,"(868.5, 1113.75]",11,32,-21
31243.0,2019-11-13,"(1113.75, 1359.0]",2,10,-8
31244.0,2019-11-13,"(419.062, 654.5]",14,25,-11
31244.0,2019-11-13,"(654.5, 889.0]",6,10,-4
31244.0,2019-11-13,"(889.0, 1123.5]",6,21,-15
31244.0,2019-11-13,"(1123.5, 1358.0]",6,7,-1
31245.0,2019-11-13,"(374.945, 639.75]",8,21,-13
31245.0,2019-11-13,"(639.75, 903.5]",3,8,-5
31245.0,2019-11-13,"(903.5, 1167.25]",12,27,-15
31245.0,2019-11-13,"(1167.25, 1431.0]",5,8,-3
31246.0,2019-11-13,"(396.086, 625.5]",10,13,-3
31246.0,2019-11-13,"(625.5, 854.0]",9,13,-4
31246.0,2019-11-13,"(854.0, 1082.5]",9,21,-12
31246.0,2019-11-13,"(1082.5, 1311.0]",7,14,-7
31247.0,2019-11-13,"(437.352, 600.0]",6,10,-4
31247.0,2019-11-13,"(600.0, 762.0]",5,6,-1
31247.0,2019-11-13,"(762.0, 924.0]",3,11,-8
31247.0,2019-11-13,"(924.0, 1086.0]",8,14,-6
31248.0,2019-11-13,"(354.229, 547.75]",5,10,-5
31248.0,2019-11-13,"(547.75, 740.5]",5,11,-6
31248.0,2019-11-13,"(740.5, 933.25]",3,5,-2
31248.0,2019-11-13,"(933.25, 1126.0]",5,11,-6
31249.0,2019-11-13,"(554.394, 706.5]",4,7,-3
31249.0,2019-11-13,"(706.5, 858.0]",2,4,-2
31249.0,2019-11-13,"(858.0, 1009.5]",2,4,-2
31249.0,2019-11-13,"(1009.5, 1161.0]",2,4,-2
31250.0,2019-11-13,"(321.25, 640.5]",15,1,14
31250.0,2019-11-13,"(640.5, 959.75]",10,17,-7
31250.0,2019-11-13,"(959.75, 1279.0]",3,15,-12
31251.0,2019-11-13,"(395.25, 699.5]",16,1,15
31251.0,2019-11-13,"(699.5, 1003.75]",7,29,-22
31251.0,2019-11-13,"(1003.75, 1308.0]",13,12,1
31252.0,2019-11-13,"(430.185, 634.75]",19,20,-1
31252.0,2019-11-13,"(634.75, 838.5]",4,6,-2
31252.0,2019-11-13,"(838.5, 1042.25]",5,17,-12
31252.0,2019-11-13,"(1042.25, 1246.0]",2,5,-3
31253.0,2019-11-13,"(378.216, 575.0]",15,16,-1
31253.0,2019-11-13,"(575.0, 771.0]",6,9,-3
31253.0,2019-11-13,"(771.0, 967.0]",7,9,-2
31253.0,2019-11-13,"(967.0, 1163.0]",4,26,-22
31254.0,2019-11-13,"(412.163, 622.25]",14,16,-2
31254.0,2019-11-13,"(622.25, 831.5]",5,12,-7
31254.0,2019-11-13,"(831.5, 1040.75]",8,17,-9
31254.0,2019-11-13,"(1040.75, 1250.0]",5,18,-13
31255.0,2019-11-13,"(352.0, 659.0]",18,1,17
31255.0,2019-11-13,"(659.0, 966.0]",6,24,-18
31255.0,2019-11-13,"(966.0, 1273.0]",6,9,-3
31256.0,2019-11-13,"(280.953, 543.75]",7,9,-2
31256.0,2019-11-13,"(543.75, 805.5]",6,9,-3
31256.0,2019-11-13,"(805.5, 1067.25]",9,20,-11
31256.0,2019-11-13,"(1067.25, 1329.0]",4,12,-8
31257.0,2019-11-13,"(321.937, 588.75]",19,31,-12
31257.0,2019-11-13,"(588.75, 854.5]",14,19,-5
31257.0,2019-11-13,"(854.5, 1120.25]",16,36,-20
31257.0,2019-11-13,"(1120.25, 1386.0]",5,15,-10
31258.0,2019-11-13,"(321.153, 533.75]",10,20,-10
31258.0,2019-11-13,"(533.75, 745.5]",6,13,-7
31258.0,2019-11-13,"(745.5, 957.25]",3,6,-3
31258.0,2019-11-13,"(957.25, 1169.0]",3,3,0
31259.0,2019-11-13,"(449.1, 675.0]",8,8,0
31259.0,2019-11-13,"(675.0, 900.0]",2,4,-2
31259.0,2019-11-13,"(900.0, 1125.0]",2,13,-11
31259.0,2019-11-13,"(1125.0, 1350.0]",1,5,-4
31260.0,2019-11-13,"(365.942, 631.5]",13,16,-3
31260.0,2019-11-13,"(631.5, 896.0]",4,8,-4
31260.0,2019-11-13,"(896.0, 1160.5]",5,18,-13
31260.0,2019-11-13,"(1160.5, 1425.0]",2,2,0
31261.0,2019-11-13,"(383.335, 550.25]",10,11,-1
31261.0,2019-11-13,"(550.25, 716.5]",1,2,-1
31261.0,2019-11-13,"(716.5, 882.75]",2,2,0
31262.0,2019-11-13,"(446.034, 688.5]",8,12,-4
31262.0,2019-11-13,"(688.5, 930.0]",2,2,0
31262.0,2019-11-13,"(930.0, 1171.5]",6,11,-5
31262.0,2019-11-13,"(1171.5, 1413.0]",3,11,-8
31263.0,2019-11-13,"(103.746, 418.5]",3,5,-2
31263.0,2019-11-13,"(418.5, 732.0]",21,30,-9
31263.0,2019-11-13,"(732.0, 1045.5]",9,27,-18
31263.0,2019-11-13,"(1045.5, 1359.0]",4,7,-3
31264.0,2019-11-13,"(460.226, 654.5]",12,14,-2
31264.0,2019-11-13,"(654.5, 848.0]",7,11,-4
31264.0,2019-11-13,"(848.0, 1041.5]",5,16,-11
31264.0,2019-11-13,"(1041.5, 1235.0]",1,7,-6
31265.0,2019-11-13,"(326.93, 595.5]",14,37,-23
31265.0,2019-11-13,"(595.5, 863.0]",6,9,-3
31265.0,2019-11-13,"(863.0, 1130.5]",15,30,-15
31265.0,2019-11-13,"(1130.5, 1398.0]",10,24,-14
31266.0,2019-11-13,"(376.25, 724.5]",6,3,3
31266.0,2019-11-13,"(724.5, 1072.75]",11,23,-12
31266.0,2019-11-13,"(1072.75, 1421.0]",17,24,-7
31267.0,2019-11-13,"(4.647, 344.25]",1,1,0
31267.0,2019-11-13,"(344.25, 682.5]",21,41,-20
31267.0,2019-11-13,"(682.5, 1020.75]",12,28,-16
31267.0,2019-11-13,"(1020.75, 1359.0]",19,36,-17
31268.0,2019-11-13,"(202.769, 511.75]",14,27,-13
31268.0,2019-11-13,"(511.75, 819.5]",8,23,-15
31268.0,2019-11-13,"(819.5, 1127.25]",19,30,-11
31268.0,2019-11-13,"(1127.25, 1435.0]",13,21,-8
31269.0,2019-11-13,"(385.147, 599.25]",8,11,-3
31269.0,2019-11-13,"(599.25, 812.5]",3,6,-3
31269.0,2019-11-13,"(1025.75, 1239.0]",6,4,2
31270.0,2019-11-13,"(375.942, 641.5]",16,23,-7
31270.0,2019-11-13,"(641.5, 906.0]",4,9,-5
31270.0,2019-11-13,"(906.0, 1170.5]",9,24,-15
31270.0,2019-11-13,"(1170.5, 1435.0]",1,7,-6
31271.0,2019-11-13,"(323.162, 533.5]",6,11,-5
31271.0,2019-11-13,"(533.5, 743.0]",12,18,-6
31271.0,2019-11-13,"(743.0, 952.5]",4,14,-10
31271.0,2019-11-13,"(952.5, 1162.0]",2,10,-8
31272.0,2019-11-13,"(297.966, 557.5]",24,26,-2
31272.0,2019-11-13,"(557.5, 816.0]",5,6,-1
31272.0,2019-11-13,"(816.0, 1074.5]",6,18,-12
31272.0,2019-11-13,"(1074.5, 1333.0]",2,9,-7
31273.0,2019-11-13,"(539.436, 681.0]",1,2,-1
31273.0,2019-11-13,"(681.0, 822.0]",2,4,-2
31273.0,2019-11-13,"(963.0, 1104.0]",2,2,0
31274.0,2019-11-13,"(338.5, 651.0]",9,1,8
31274.0,2019-11-13,"(651.0, 963.5]",5,14,-9
31274.0,2019-11-13,"(963.5, 1276.0]",2,5,-3
31275.0,2019-11-13,"(58.71, 382.5]",4,7,-3
31275.0,2019-11-13,"(382.5, 705.0]",23,39,-16
31275.0,2019-11-13,"(705.0, 1027.5]",20,35,-15
31275.0,2019-11-13,"(1027.5, 1350.0]",16,42,-26
31276.0,2019-11-13,"(424.339, 590.25]",17,19,-2
31276.0,2019-11-13,"(590.25, 755.5]",2,3,-1
31276.0,2019-11-13,"(755.5, 920.75]",3,8,-5
31276.0,2019-11-13,"(920.75, 1086.0]",3,20,-17
31277.0,2019-11-13,"(319.178, 525.5]",29,34,-5
31277.0,2019-11-13,"(525.5, 731.0]",18,27,-9
31277.0,2019-11-13,"(731.0, 936.5]",9,16,-7
31277.0,2019-11-13,"(936.5, 1142.0]",2,17,-15
31278.0,2019-11-13,"(36.613, 384.75]",1,2,-1
31278.0,2019-11-13,"(384.75, 731.5]",9,33,-24
31278.0,2019-11-13,"(731.5, 1078.25]",9,18,-9
31278.0,2019-11-13,"(1078.25, 1425.0]",18,23,-5
31279.0,2019-11-13,"(391.139, 607.25]",21,24,-3
31279.0,2019-11-13,"(607.25, 822.5]",12,22,-10
31279.0,2019-11-13,"(822.5, 1037.75]",8,18,-10
31279.0,2019-11-13,"(1037.75, 1253.0]",3,24,-21
31280.0,2019-11-13,"(343.955, 606.25]",3,12,-9
31280.0,2019-11-13,"(606.25, 867.5]",2,5,-3
31280.0,2019-11-13,"(867.5, 1128.75]",10,11,-1
31280.0,2019-11-13,"(1128.75, 1390.0]",5,7,-2
31000.0,2019-11-14,"(895.5, 1093.75]",1,2,-1
,,,,1.0,
,,,,1.0,
31002.0,2019-11-14,"(440.219, 636.25]",5,8,-3
31002.0,2019-11-14,"(636.25, 831.5]",1,2,-1
31002.0,2019-11-14,"(831.5, 1026.75]",1,3,-2
31002.0,2019-11-14,"(1026.75, 1222.0]",3,6,-3
31003.0,2019-11-14,"(435.317, 606.75]",2,7,-5
31003.0,2019-11-14,"(606.75, 777.5]",2,4,-2
31003.0,2019-11-14,"(777.5, 948.25]",1,2,-1
31003.0,2019-11-14,"(948.25, 1119.0]",2,3,-1
31004.0,2019-11-14,"(796.5, 949.25]",1,2,-1
31004.0,2019-11-14,"(949.25, 1102.0]",1,1,0
31005.0,2019-11-14,"(492.304, 667.0]",3,4,-1
31005.0,2019-11-14,"(841.0, 1015.0]",1,2,-1
31005.0,2019-11-14,"(1015.0, 1189.0]",1,6,-5
31006.0,2019-11-14,"(957.771, 1015.25]",3,4,-1
31006.0,2019-11-14,"(1015.25, 1072.5]",2,2,0
31006.0,2019-11-14,"(1129.75, 1187.0]",1,1,0
31007.0,2019-11-14,"(362.139, 578.25]",4,13,-9
31007.0,2019-11-14,"(578.25, 793.5]",1,4,-3
31007.0,2019-11-14,"(793.5, 1008.75]",6,10,-4
31007.0,2019-11-14,"(1008.75, 1224.0]",4,14,-10
31009.0,2019-11-14,"(427.37, 585.5]",6,6,0
31010.0,2019-11-14,"(1198.5, 1350.0]",1,1,0
31011.0,2019-11-14,"(323.252, 511.0]",5,7,-2
31011.0,2019-11-14,"(511.0, 698.0]",5,7,-2
31011.0,2019-11-14,"(698.0, 885.0]",1,2,-1
31012.0,2019-11-14,"(366.239, 557.25]",2,2,0
31012.0,2019-11-14,"(557.25, 747.5]",1,1,0
31013.0,2019-11-14,"(431.309, 604.75]",1,2,-1
31013.0,2019-11-14,"(777.5, 950.25]",1,1,0
31013.0,2019-11-14,"(950.25, 1123.0]",3,1,2
31014.0,2019-11-14,"(317.896, 595.0]",19,25,-6
31014.0,2019-11-14,"(595.0, 871.0]",9,12,-3
31014.0,2019-11-14,"(871.0, 1147.0]",9,15,-6
31014.0,2019-11-14,"(1147.0, 1423.0]",1,2,-1
31015.0,2019-11-14,"(304.94, 571.0]",8,9,-1
31015.0,2019-11-14,"(836.0, 1101.0]",4,1,3
31015.0,2019-11-14,"(1101.0, 1366.0]",1,5,-4
31016.0,2019-11-14,"(457.169, 665.75]",4,8,-4
31016.0,2019-11-14,"(665.75, 873.5]",4,7,-3
31016.0,2019-11-14,"(873.5, 1081.25]",1,5,-4
31016.0,2019-11-14,"(1081.25, 1289.0]",5,10,-5
31017.0,2019-11-14,"(476.213, 673.75]",6,12,-6
31017.0,2019-11-14,"(673.75, 870.5]",1,2,-1
31017.0,2019-11-14,"(870.5, 1067.25]",1,4,-3
31018.0,2019-11-14,"(387.266, 571.5]",2,8,-6
31018.0,2019-11-14,"(938.5, 1122.0]",2,1,1
,,,,1.0,
,,,,1.0,
,,,,1.0,
31020.0,2019-11-14,"(801.5, 963.75]",1,1,0
31020.0,2019-11-14,"(963.75, 1126.0]",1,1,0
31021.0,2019-11-14,"(880.5, 1082.25]",2,3,-1
31022.0,2019-11-14,"(407.078, 638.5]",3,9,-6
31022.0,2019-11-14,"(638.5, 869.0]",2,8,-6
31022.0,2019-11-14,"(1099.5, 1330.0]",2,2,0
31023.0,2019-11-14,"(690.25, 884.5]",1,3,-2
31023.0,2019-11-14,"(1078.75, 1273.0]",1,1,0
31024.0,2019-11-14,"(464.175, 671.25]",5,9,-4
31024.0,2019-11-14,"(671.25, 877.5]",1,1,0
31024.0,2019-11-14,"(877.5, 1083.75]",4,6,-2
31024.0,2019-11-14,"(1083.75, 1290.0]",2,10,-8
31025.0,2019-11-14,"(1085.95, 1098.5]",1,1,0
31026.0,2019-11-14,"(374.051, 612.25]",1,2,-1
31026.0,2019-11-14,"(612.25, 849.5]",1,2,-1
31026.0,2019-11-14,"(1086.75, 1324.0]",3,1,2
31027.0,2019-11-14,"(562.223, 757.25]",1,2,-1
31027.0,2019-11-14,"(757.25, 951.5]",2,3,-1
31027.0,2019-11-14,"(951.5, 1145.75]",1,2,-1
31027.0,2019-11-14,"(1145.75, 1340.0]",1,2,-1
31028.0,2019-11-14,"(995.5, 1149.0]",2,1,1
31029.0,2019-11-14,"(331.04, 572.0]",1,5,-4
31029.0,2019-11-14,"(812.0, 1052.0]",3,3,0
31029.0,2019-11-14,"(1052.0, 1292.0]",5,4,1
31030.0,2019-11-14,"(810.0, 992.5]",2,6,-4
31030.0,2019-11-14,"(992.5, 1175.0]",4,3,1
31031.0,2019-11-14,"(500.225, 694.75]",1,3,-2
31031.0,2019-11-14,"(888.5, 1082.25]",1,3,-2
31031.0,2019-11-14,"(1082.25, 1276.0]",2,2,0
31032.0,2019-11-14,"(898.0, 1039.0]",1,1,0
31033.0,2019-11-14,"(748.5, 998.0]",1,1,0
31034.0,2019-11-14,"(380.043, 620.25]",2,5,-3
31034.0,2019-11-14,"(1098.75, 1338.0]",3,3,0
31035.0,2019-11-14,"(426.011, 674.25]",3,6,-3
31035.0,2019-11-14,"(921.5, 1168.75]",3,3,0
31035.0,2019-11-14,"(1168.75, 1416.0]",3,3,0
31036.0,2019-11-14,"(498.393, 650.75]",1,4,-3
31036.0,2019-11-14,"(954.25, 1106.0]",3,3,0
31037.0,2019-11-14,"(421.207, 620.25]",16,20,-4
31037.0,2019-11-14,"(620.25, 818.5]",3,3,0
31037.0,2019-11-14,"(818.5, 1016.75]",3,9,-6
31037.0,2019-11-14,"(1016.75, 1215.0]",3,16,-13
31038.0,2019-11-14,"(445.371, 603.25]",1,2,-1
31038.0,2019-11-14,"(917.75, 1075.0]",1,1,0
31039.0,2019-11-14,"(454.12, 675.0]",2,6,-4
31039.0,2019-11-14,"(675.0, 895.0]",3,4,-1
31039.0,2019-11-14,"(1115.0, 1335.0]",3,5,-2
31040.0,2019-11-14,"(475.189, 678.75]",2,2,0
31041.0,2019-11-14,"(520.419, 666.25]",3,3,0
31041.0,2019-11-14,"(956.75, 1102.0]",1,2,-1
31042.0,2019-11-14,"(448.143, 663.25]",9,9,0
31042.0,2019-11-14,"(877.5, 1091.75]",2,6,-4
31042.0,2019-11-14,"(1091.75, 1306.0]",1,1,0
31043.0,2019-11-14,"(427.233, 619.75]",1,2,-1
31043.0,2019-11-14,"(1003.25, 1195.0]",2,1,1
31044.0,2019-11-14,"(977.827, 1021.25]",1,1,0
31044.0,2019-11-14,"(1107.75, 1151.0]",1,1,0
31045.0,2019-11-14,"(511.398, 662.5]",3,3,0
31045.0,2019-11-14,"(662.5, 813.0]",1,2,-1
31045.0,2019-11-14,"(963.5, 1114.0]",1,3,-2
31046.0,2019-11-14,"(394.256, 581.0]",1,3,-2
31046.0,2019-11-14,"(953.0, 1139.0]",1,2,-1
31047.0,2019-11-14,"(360.933, 628.75]",11,21,-10
31047.0,2019-11-14,"(628.75, 895.5]",3,4,-1
31047.0,2019-11-14,"(895.5, 1162.25]",11,24,-13
31047.0,2019-11-14,"(1162.25, 1429.0]",1,6,-5
31048.0,2019-11-14,"(510.267, 694.25]",2,4,-2
31048.0,2019-11-14,"(877.5, 1060.75]",1,1,0
31048.0,2019-11-14,"(1060.75, 1244.0]",2,1,1
31049.0,2019-11-14,"(544.29, 722.5]",1,1,0
31049.0,2019-11-14,"(900.0, 1077.5]",1,2,-1
,,,,1.0,
,,,,2.0,
,,,,1.0,
31051.0,2019-11-14,"(523.25, 744.5]",1,3,-2
31051.0,2019-11-14,"(744.5, 965.75]",1,2,-1
31051.0,2019-11-14,"(965.75, 1187.0]",3,3,0
31052.0,2019-11-14,"(511.281, 691.75]",2,2,0
31052.0,2019-11-14,"(1051.25, 1231.0]",1,1,0
,,,,1.0,
,,,,1.0,
,,,,2.0,
31054.0,2019-11-14,"(1003.786, 1057.5]",1,1,0
31054.0,2019-11-14,"(1111.0, 1164.5]",1,1,0
31055.0,2019-11-14,"(827.0, 939.0]",1,1,0
,,,,1.0,
,,,,1.0,
31057.0,2019-11-14,"(1062.75, 1089.0]",1,1,0
,,,,2.0,
31059.0,2019-11-14,"(711.25, 723.0]",1,1,0
31060.0,2019-11-14,"(734.713, 806.75]",1,1,0
31060.0,2019-11-14,"(950.25, 1022.0]",2,1,1
31061.0,2019-11-14,"(764.25, 1019.0]",1,1,0
31062.0,2019-11-14,"(762.75, 1017.0]",1,1,0
31063.0,2019-11-14,"(714.0, 952.0]",1,1,0
31064.0,2019-11-14,"(509.342, 674.5]",1,2,-1
31064.0,2019-11-14,"(839.0, 1003.5]",4,1,3
31064.0,2019-11-14,"(1003.5, 1168.0]",3,5,-2
31065.0,2019-11-14,"(729.0, 849.0]",1,1,0
31065.0,2019-11-14,"(849.0, 969.0]",1,1,0
,,,,2.0,
31067.0,2019-11-14,"(899.5, 1083.75]",1,2,-1
31067.0,2019-11-14,"(1083.75, 1268.0]",3,2,1
31068.0,2019-11-14,"(666.75, 889.0]",1,1,0
31069.0,2019-11-14,"(433.105, 657.75]",3,9,-6
31069.0,2019-11-14,"(657.75, 881.5]",1,3,-2
31069.0,2019-11-14,"(881.5, 1105.25]",3,4,-1
31069.0,2019-11-14,"(1105.25, 1329.0]",4,4,0
31070.0,2019-11-14,"(1091.75, 1255.0]",2,1,1
31071.0,2019-11-14,"(317.023, 562.25]",3,6,-3
31071.0,2019-11-14,"(806.5, 1050.75]",4,5,-1
31071.0,2019-11-14,"(1050.75, 1295.0]",3,5,-2
,,,,1.0,
,,,,1.0,
31073.0,2019-11-14,"(487.391, 640.25]",3,5,-2
31073.0,2019-11-14,"(944.75, 1097.0]",2,3,-1
31074.0,2019-11-14,"(1020.5, 1188.0]",4,1,3
31075.0,2019-11-14,"(969.25, 1115.0]",1,1,0
31076.0,2019-11-14,"(1038.0, 1061.0]",2,1,1
31076.0,2019-11-14,"(1084.0, 1107.0]",1,2,-1
31077.0,2019-11-14,"(892.0, 1113.0]",1,3,-2
31077.0,2019-11-14,"(1113.0, 1334.0]",2,1,1
31078.0,2019-11-14,"(474.309, 647.75]",3,4,-1
31079.0,2019-11-14,"(27.833, 320.75]",1,1,0
31079.0,2019-11-14,"(320.75, 612.5]",1,8,-7
31079.0,2019-11-14,"(904.25, 1196.0]",3,3,0
31080.0,2019-11-14,"(342.926, 612.5]",2,12,-10
31080.0,2019-11-14,"(612.5, 881.0]",1,3,-2
31080.0,2019-11-14,"(881.0, 1149.5]",6,10,-4
31080.0,2019-11-14,"(1149.5, 1418.0]",3,3,0
31081.0,2019-11-14,"(486.362, 646.5]",2,2,0
31081.0,2019-11-14,"(646.5, 806.0]",1,1,0
31081.0,2019-11-14,"(806.0, 965.5]",1,2,-1
31082.0,2019-11-14,"(713.0, 722.0]",1,1,0
31083.0,2019-11-14,"(865.0, 1046.0]",5,1,4
31083.0,2019-11-14,"(1046.0, 1227.0]",2,2,0
31084.0,2019-11-14,"(523.346, 687.5]",4,5,-1
31084.0,2019-11-14,"(687.5, 851.0]",2,4,-2
31085.0,2019-11-14,"(399.253, 586.75]",1,4,-3
31085.0,2019-11-14,"(960.25, 1147.0]",1,1,0
31086.0,2019-11-14,"(869.25, 1159.0]",2,1,1
31087.0,2019-11-14,"(945.75, 1105.0]",2,1,1
31088.0,2019-11-14,"(752.75, 955.5]",1,2,-1
31088.0,2019-11-14,"(955.5, 1158.25]",4,2,2
31088.0,2019-11-14,"(1158.25, 1361.0]",1,4,-3
31089.0,2019-11-14,"(382.115, 604.25]",11,14,-3
31089.0,2019-11-14,"(604.25, 825.5]",2,3,-1
31089.0,2019-11-14,"(825.5, 1046.75]",2,10,-8
31089.0,2019-11-14,"(1046.75, 1268.0]",3,13,-10
31090.0,2019-11-14,"(509.528, 628.0]",1,1,0
31090.0,2019-11-14,"(864.0, 982.0]",1,2,-1
31091.0,2019-11-14,"(934.5, 1165.25]",3,3,0
31091.0,2019-11-14,"(1165.25, 1396.0]",1,3,-2
31092.0,2019-11-14,"(942.75, 1081.0]",1,1,0
31093.0,2019-11-14,"(901.5, 1093.0]",1,2,-1
31094.0,2019-11-14,"(489.0, 652.0]",1,1,0
,,,,1.0,
,,,,1.0,
31096.0,2019-11-14,"(927.5, 1129.25]",1,1,0
31096.0,2019-11-14,"(1129.25, 1331.0]",3,2,1
31097.0,2019-11-14,"(495.08, 726.0]",3,4,-1
31097.0,2019-11-14,"(956.0, 1186.0]",2,6,-4
31097.0,2019-11-14,"(1186.0, 1416.0]",2,3,-1
31098.0,2019-11-14,"(408.113, 630.75]",5,10,-5
31098.0,2019-11-14,"(630.75, 852.5]",2,3,-1
31098.0,2019-11-14,"(852.5, 1074.25]",4,5,-1
31099.0,2019-11-14,"(935.5, 1177.25]",1,1,0
31099.0,2019-11-14,"(1177.25, 1419.0]",1,3,-2
31100.0,2019-11-14,"(431.287, 610.25]",10,10,0
31100.0,2019-11-14,"(610.25, 788.5]",3,5,-2
31100.0,2019-11-14,"(788.5, 966.75]",1,2,-1
31101.0,2019-11-14,"(71.661, 407.75]",2,4,-2
31101.0,2019-11-14,"(407.75, 742.5]",12,44,-32
31101.0,2019-11-14,"(742.5, 1077.25]",22,32,-10
31101.0,2019-11-14,"(1077.25, 1412.0]",31,51,-20
31102.0,2019-11-14,"(319.951, 583.25]",2,18,-16
31102.0,2019-11-14,"(845.5, 1107.75]",5,3,2
31102.0,2019-11-14,"(1107.75, 1370.0]",8,16,-8
31103.0,2019-11-14,"(56.678, 388.5]",1,2,-1
31103.0,2019-11-14,"(388.5, 719.0]",2,27,-25
31103.0,2019-11-14,"(719.0, 1049.5]",2,9,-7
31103.0,2019-11-14,"(1049.5, 1380.0]",12,22,-10
31104.0,2019-11-14,"(17.581, 373.75]",1,4,-3
31104.0,2019-11-14,"(373.75, 728.5]",5,18,-13
31104.0,2019-11-14,"(728.5, 1083.25]",14,28,-14
31104.0,2019-11-14,"(1083.25, 1438.0]",12,24,-12
31105.0,2019-11-14,"(370.952, 634.0]",3,20,-17
31105.0,2019-11-14,"(896.0, 1158.0]",2,6,-4
31106.0,2019-11-14,"(795.0, 967.5]",1,7,-6
31106.0,2019-11-14,"(967.5, 1140.0]",2,2,0
31107.0,2019-11-14,"(350.015, 597.25]",4,26,-22
31107.0,2019-11-14,"(843.5, 1089.75]",12,1,11
31107.0,2019-11-14,"(1089.75, 1336.0]",12,21,-9
31108.0,2019-11-14,"(43.641, 384.75]",2,4,-2
31108.0,2019-11-14,"(384.75, 724.5]",7,23,-16
31108.0,2019-11-14,"(724.5, 1064.25]",18,33,-15
31108.0,2019-11-14,"(1064.25, 1404.0]",18,27,-9
31109.0,2019-11-14,"(20.629, 364.75]",1,2,-1
31109.0,2019-11-14,"(364.75, 707.5]",5,21,-16
31109.0,2019-11-14,"(707.5, 1050.25]",13,21,-8
31109.0,2019-11-14,"(1050.25, 1393.0]",15,22,-7
31110.0,2019-11-14,"(310.904, 586.0]",13,35,-22
31110.0,2019-11-14,"(586.0, 860.0]",11,20,-9
31110.0,2019-11-14,"(860.0, 1134.0]",17,33,-16
31110.0,2019-11-14,"(1134.0, 1408.0]",12,20,-8
31111.0,2019-11-14,"(154.778, 461.5]",3,4,-1
31111.0,2019-11-14,"(461.5, 767.0]",6,24,-18
31111.0,2019-11-14,"(767.0, 1072.5]",8,11,-3
31111.0,2019-11-14,"(1072.5, 1378.0]",10,16,-6
31112.0,2019-11-14,"(129.021, 374.75]",2,3,-1
31112.0,2019-11-14,"(619.5, 864.25]",3,3,0
31112.0,2019-11-14,"(864.25, 1109.0]",3,3,0
31113.0,2019-11-14,"(315.893, 593.75]",1,20,-19
31113.0,2019-11-14,"(593.75, 870.5]",2,9,-7
31113.0,2019-11-14,"(870.5, 1147.25]",8,13,-5
31113.0,2019-11-14,"(1147.25, 1424.0]",4,10,-6
31114.0,2019-11-14,"(340.909, 614.75]",2,22,-20
31114.0,2019-11-14,"(614.75, 887.5]",3,10,-7
31114.0,2019-11-14,"(887.5, 1160.25]",16,25,-9
31114.0,2019-11-14,"(1160.25, 1433.0]",12,21,-9
31115.0,2019-11-14,"(245.824, 541.0]",1,19,-18
31115.0,2019-11-14,"(541.0, 835.0]",2,5,-3
31115.0,2019-11-14,"(835.0, 1129.0]",8,13,-5
31115.0,2019-11-14,"(1129.0, 1423.0]",7,15,-8
31116.0,2019-11-14,"(75.664, 411.0]",2,2,0
31116.0,2019-11-14,"(411.0, 745.0]",2,21,-19
31116.0,2019-11-14,"(745.0, 1079.0]",18,31,-13
31116.0,2019-11-14,"(1079.0, 1413.0]",14,21,-7
31117.0,2019-11-14,"(331.937, 598.75]",1,17,-16
31117.0,2019-11-14,"(598.75, 864.5]",1,1,0
31117.0,2019-11-14,"(864.5, 1130.25]",10,18,-8
31117.0,2019-11-14,"(1130.25, 1396.0]",5,12,-7
31118.0,2019-11-14,"(421.091, 649.25]",3,16,-13
31118.0,2019-11-14,"(649.25, 876.5]",1,3,-2
31118.0,2019-11-14,"(876.5, 1103.75]",9,11,-2
31118.0,2019-11-14,"(1103.75, 1331.0]",11,14,-3
31119.0,2019-11-14,"(314.931, 583.25]",8,27,-19
31119.0,2019-11-14,"(583.25, 850.5]",4,8,-4
31119.0,2019-11-14,"(850.5, 1117.75]",18,25,-7
31119.0,2019-11-14,"(1117.75, 1385.0]",9,19,-10
31120.0,2019-11-14,"(345.945, 610.75]",3,16,-13
31120.0,2019-11-14,"(874.5, 1138.25]",7,2,5
31120.0,2019-11-14,"(1138.25, 1402.0]",9,11,-2
31121.0,2019-11-14,"(119.738, 436.5]",2,6,-4
31121.0,2019-11-14,"(436.5, 752.0]",7,13,-6
31121.0,2019-11-14,"(752.0, 1067.5]",7,15,-8
31121.0,2019-11-14,"(1067.5, 1383.0]",7,13,-6
31122.0,2019-11-14,"(482.088, 711.0]",1,15,-14
31122.0,2019-11-14,"(711.0, 939.0]",2,4,-2
31122.0,2019-11-14,"(939.0, 1167.0]",8,9,-1
31122.0,2019-11-14,"(1167.0, 1395.0]",8,15,-7
31123.0,2019-11-14,"(849.0, 1052.5]",4,15,-11
31123.0,2019-11-14,"(1052.5, 1256.0]",5,6,-1
31124.0,2019-11-14,"(34.596, 387.0]",2,2,0
31124.0,2019-11-14,"(387.0, 738.0]",21,47,-26
31124.0,2019-11-14,"(738.0, 1089.0]",14,41,-27
31124.0,2019-11-14,"(1089.0, 1440.0]",18,51,-33
31125.0,2019-11-14,"(150.74, 467.0]",4,11,-7
31125.0,2019-11-14,"(467.0, 782.0]",3,19,-16
31125.0,2019-11-14,"(782.0, 1097.0]",16,27,-11
31125.0,2019-11-14,"(1097.0, 1412.0]",20,23,-3
31126.0,2019-11-14,"(385.963, 646.25]",3,25,-22
31126.0,2019-11-14,"(646.25, 905.5]",2,4,-2
31126.0,2019-11-14,"(905.5, 1164.75]",15,21,-6
31126.0,2019-11-14,"(1164.75, 1424.0]",5,9,-4
31127.0,2019-11-14,"(475.138, 691.5]",13,18,-5
31127.0,2019-11-14,"(691.5, 907.0]",6,11,-5
31127.0,2019-11-14,"(907.0, 1122.5]",10,19,-9
31127.0,2019-11-14,"(1122.5, 1338.0]",4,17,-13
31128.0,2019-11-14,"(362.5, 720.0]",25,1,24
31128.0,2019-11-14,"(720.0, 1077.5]",21,40,-19
31128.0,2019-11-14,"(1077.5, 1435.0]",6,40,-34
31129.0,2019-11-14,"(307.906, 582.5]",6,9,-3
31129.0,2019-11-14,"(582.5, 856.0]",4,9,-5
31129.0,2019-11-14,"(1129.5, 1403.0]",3,11,-8
31130.0,2019-11-14,"(377.972, 636.0]",2,13,-11
31130.0,2019-11-14,"(636.0, 893.0]",3,13,-10
31130.0,2019-11-14,"(893.0, 1150.0]",5,10,-5
31130.0,2019-11-14,"(1150.0, 1407.0]",7,10,-3
31131.0,2019-11-14,"(654.5, 902.0]",1,14,-13
31131.0,2019-11-14,"(902.0, 1149.5]",2,2,0
31131.0,2019-11-14,"(1149.5, 1397.0]",9,5,4
31200.0,2019-11-14,"(141.71, 465.5]",5,14,-9
31200.0,2019-11-14,"(465.5, 788.0]",37,59,-22
31200.0,2019-11-14,"(788.0, 1110.5]",27,54,-27
31200.0,2019-11-14,"(1110.5, 1433.0]",23,48,-25
31201.0,2019-11-14,"(288.861, 574.75]",18,38,-20
31201.0,2019-11-14,"(574.75, 859.5]",16,26,-10
31201.0,2019-11-14,"(859.5, 1144.25]",40,65,-25
31201.0,2019-11-14,"(1144.25, 1429.0]",22,47,-25
31202.0,2019-11-14,"(337.93, 606.5]",12,25,-13
31202.0,2019-11-14,"(606.5, 874.0]",7,12,-5
31202.0,2019-11-14,"(874.0, 1141.5]",26,42,-16
31202.0,2019-11-14,"(1141.5, 1409.0]",16,27,-11
31203.0,2019-11-14,"(294.876, 577.0]",4,13,-9
31203.0,2019-11-14,"(577.0, 858.0]",7,15,-8
31203.0,2019-11-14,"(858.0, 1139.0]",21,27,-6
31203.0,2019-11-14,"(1139.0, 1420.0]",16,29,-13
31204.0,2019-11-14,"(426.001, 676.75]",13,18,-5
31204.0,2019-11-14,"(676.75, 926.5]",10,15,-5
31204.0,2019-11-14,"(926.5, 1176.25]",6,20,-14
31204.0,2019-11-14,"(1176.25, 1426.0]",6,10,-4
31205.0,2019-11-14,"(419.03, 662.5]",26,30,-4
31205.0,2019-11-14,"(662.5, 905.0]",21,29,-8
31205.0,2019-11-14,"(905.0, 1147.5]",11,25,-14
31205.0,2019-11-14,"(1147.5, 1390.0]",6,22,-16
31206.0,2019-11-14,"(449.351, 612.25]",9,10,-1
31206.0,2019-11-14,"(936.75, 1099.0]",2,2,0
31207.0,2019-11-14,"(572.25, 787.5]",1,8,-7
31207.0,2019-11-14,"(1002.75, 1218.0]",2,1,1
31208.0,2019-11-14,"(361.007, 610.25]",12,14,-2
31208.0,2019-11-14,"(610.25, 858.5]",1,2,-1
31208.0,2019-11-14,"(858.5, 1106.75]",1,15,-14
31208.0,2019-11-14,"(1106.75, 1355.0]",3,6,-3
31209.0,2019-11-14,"(484.124, 704.0]",2,4,-2
31209.0,2019-11-14,"(704.0, 923.0]",2,5,-3
31209.0,2019-11-14,"(923.0, 1142.0]",4,4,0
31209.0,2019-11-14,"(1142.0, 1361.0]",3,6,-3
31211.0,2019-11-14,"(393.06, 629.0]",11,13,-2
31211.0,2019-11-14,"(864.0, 1099.0]",5,2,3
31211.0,2019-11-14,"(1099.0, 1334.0]",2,7,-5
31212.0,2019-11-14,"(63.655, 401.25]",4,8,-4
31212.0,2019-11-14,"(401.25, 737.5]",40,58,-18
31212.0,2019-11-14,"(737.5, 1073.75]",17,35,-18
31212.0,2019-11-14,"(1073.75, 1410.0]",13,30,-17
31213.0,2019-11-14,"(332.025, 576.75]",31,46,-15
31213.0,2019-11-14,"(576.75, 820.5]",9,21,-12
31213.0,2019-11-14,"(820.5, 1064.25]",10,19,-9
31213.0,2019-11-14,"(1064.25, 1308.0]",14,34,-20
31214.0,2019-11-14,"(374.983, 630.25]",6,28,-22
31214.0,2019-11-14,"(630.25, 884.5]",7,13,-6
31214.0,2019-11-14,"(884.5, 1138.75]",22,35,-13
31214.0,2019-11-14,"(1138.75, 1393.0]",14,20,-6
31215.0,2019-11-14,"(403.04, 644.0]",30,33,-3
31215.0,2019-11-14,"(644.0, 884.0]",3,5,-2
31215.0,2019-11-14,"(884.0, 1124.0]",6,9,-3
31215.0,2019-11-14,"(1124.0, 1364.0]",3,10,-7
31216.0,2019-11-14,"(440.204, 640.0]",22,23,-1
31216.0,2019-11-14,"(640.0, 839.0]",6,14,-8
31216.0,2019-11-14,"(839.0, 1038.0]",2,9,-7
31216.0,2019-11-14,"(1038.0, 1237.0]",8,24,-16
31217.0,2019-11-14,"(323.174, 530.5]",10,10,0
31217.0,2019-11-14,"(530.5, 737.0]",3,4,-1
31217.0,2019-11-14,"(943.5, 1150.0]",3,1,2
31218.0,2019-11-14,"(330.004, 580.0]",19,33,-14
31218.0,2019-11-14,"(580.0, 829.0]",3,7,-4
31218.0,2019-11-14,"(829.0, 1078.0]",12,21,-9
31218.0,2019-11-14,"(1078.0, 1327.0]",1,8,-7
31219.0,2019-11-14,"(371.231, 564.25]",14,14,0
31219.0,2019-11-14,"(564.25, 756.5]",3,4,-1
31219.0,2019-11-14,"(756.5, 948.75]",2,7,-5
31219.0,2019-11-14,"(948.75, 1141.0]",4,14,-10
31220.0,2019-11-14,"(329.245, 518.75]",16,18,-2
31220.0,2019-11-14,"(707.5, 896.25]",1,3,-2
31220.0,2019-11-14,"(896.25, 1085.0]",1,16,-15
31221.0,2019-11-14,"(4.586, 359.5]",3,4,-1
31221.0,2019-11-14,"(359.5, 713.0]",33,35,-2
31221.0,2019-11-14,"(713.0, 1066.5]",16,34,-18
31221.0,2019-11-14,"(1066.5, 1420.0]",3,22,-19
31222.0,2019-11-14,"(395.35, 558.5]",16,16,0
31222.0,2019-11-14,"(558.5, 721.0]",4,6,-2
31222.0,2019-11-14,"(721.0, 883.5]",2,2,0
31222.0,2019-11-14,"(883.5, 1046.0]",4,15,-11
31223.0,2019-11-14,"(43.623, 389.25]",1,3,-2
31223.0,2019-11-14,"(389.25, 733.5]",23,53,-30
31223.0,2019-11-14,"(733.5, 1077.75]",16,35,-19
31223.0,2019-11-14,"(1077.75, 1422.0]",10,21,-11
31224.0,2019-11-14,"(420.073, 652.75]",13,15,-2
31224.0,2019-11-14,"(652.75, 884.5]",1,8,-7
31224.0,2019-11-14,"(884.5, 1116.25]",3,11,-8
31224.0,2019-11-14,"(1116.25, 1348.0]",1,10,-9
31225.0,2019-11-14,"(388.166, 597.5]",9,16,-7
31225.0,2019-11-14,"(597.5, 806.0]",1,5,-4
31225.0,2019-11-14,"(806.0, 1014.5]",2,6,-4
31225.0,2019-11-14,"(1014.5, 1223.0]",6,9,-3
31226.0,2019-11-14,"(348.991, 602.25]",4,9,-5
31226.0,2019-11-14,"(854.5, 1106.75]",2,6,-4
31226.0,2019-11-14,"(1106.75, 1359.0]",2,5,-3
31227.0,2019-11-14,"(429.087, 658.25]",49,56,-7
31227.0,2019-11-14,"(658.25, 886.5]",5,8,-3
31227.0,2019-11-14,"(886.5, 1114.75]",3,14,-11
31227.0,2019-11-14,"(1114.75, 1343.0]",2,16,-14
31228.0,2019-11-14,"(320.933, 588.75]",21,28,-7
31228.0,2019-11-14,"(588.75, 855.5]",6,10,-4
31228.0,2019-11-14,"(855.5, 1122.25]",27,51,-24
31228.0,2019-11-14,"(1122.25, 1389.0]",8,25,-17
31229.0,2019-11-14,"(348.932, 617.0]",12,46,-34
31229.0,2019-11-14,"(617.0, 884.0]",8,26,-18
31229.0,2019-11-14,"(884.0, 1151.0]",37,63,-26
31229.0,2019-11-14,"(1151.0, 1418.0]",17,24,-7
31230.0,2019-11-14,"(404.012, 652.0]",39,51,-12
31230.0,2019-11-14,"(652.0, 899.0]",11,12,-1
31230.0,2019-11-14,"(899.0, 1146.0]",8,29,-21
31230.0,2019-11-14,"(1146.0, 1393.0]",4,9,-5
31231.0,2019-11-14,"(326.909, 600.75]",15,18,-3
31231.0,2019-11-14,"(600.75, 873.5]",6,15,-9
31231.0,2019-11-14,"(873.5, 1146.25]",9,19,-10
31231.0,2019-11-14,"(1146.25, 1419.0]",1,3,-2
31232.0,2019-11-14,"(339.978, 596.5]",10,14,-4
31232.0,2019-11-14,"(596.5, 852.0]",8,10,-2
31232.0,2019-11-14,"(852.0, 1107.5]",17,24,-7
31232.0,2019-11-14,"(1107.5, 1363.0]",4,17,-13
31233.0,2019-11-14,"(12.611, 361.25]",2,3,-1
31233.0,2019-11-14,"(361.25, 708.5]",33,38,-5
31233.0,2019-11-14,"(708.5, 1055.75]",17,32,-15
31233.0,2019-11-14,"(1055.75, 1403.0]",9,27,-18
31234.0,2019-11-14,"(404.985, 659.75]",20,39,-19
31234.0,2019-11-14,"(659.75, 913.5]",10,19,-9
31234.0,2019-11-14,"(913.5, 1167.25]",15,27,-12
31234.0,2019-11-14,"(1167.25, 1421.0]",10,15,-5
31235.0,2019-11-14,"(493.195, 695.25]",7,7,0
31235.0,2019-11-14,"(896.5, 1097.75]",2,3,-1
31235.0,2019-11-14,"(1097.75, 1299.0]",1,3,-2
31236.0,2019-11-14,"(406.136, 623.0]",11,13,-2
31236.0,2019-11-14,"(623.0, 839.0]",7,11,-4
31236.0,2019-11-14,"(839.0, 1055.0]",8,24,-16
31236.0,2019-11-14,"(1055.0, 1271.0]",7,18,-11
31237.0,2019-11-14,"(371.021, 616.75]",3,11,-8
31237.0,2019-11-14,"(616.75, 861.5]",10,20,-10
31237.0,2019-11-14,"(861.5, 1106.25]",13,20,-7
31237.0,2019-11-14,"(1106.25, 1351.0]",12,21,-9
31238.0,2019-11-14,"(50.777, 357.75]",1,1,0
31238.0,2019-11-14,"(357.75, 663.5]",24,30,-6
31238.0,2019-11-14,"(663.5, 969.25]",8,16,-8
31238.0,2019-11-14,"(969.25, 1275.0]",9,32,-23
31239.0,2019-11-14,"(337.008, 586.0]",18,19,-1
31239.0,2019-11-14,"(586.0, 834.0]",12,18,-6
31239.0,2019-11-14,"(834.0, 1082.0]",7,24,-17
31239.0,2019-11-14,"(1082.0, 1330.0]",2,5,-3
,,,,1.0,
,,,,3.0,
31241.0,2019-11-14,"(22.596, 375.0]",1,4,-3
31241.0,2019-11-14,"(375.0, 726.0]",24,54,-30
31241.0,2019-11-14,"(726.0, 1077.0]",10,30,-20
31241.0,2019-11-14,"(1077.0, 1428.0]",19,32,-13
31242.0,2019-11-14,"(380.237, 571.75]",19,23,-4
31242.0,2019-11-14,"(571.75, 762.5]",5,7,-2
31242.0,2019-11-14,"(762.5, 953.25]",7,11,-4
31242.0,2019-11-14,"(953.25, 1144.0]",1,23,-22
31243.0,2019-11-14,"(349.982, 605.5]",33,39,-6
31243.0,2019-11-14,"(605.5, 860.0]",2,2,0
31243.0,2019-11-14,"(860.0, 1114.5]",11,46,-35
31243.0,2019-11-14,"(1114.5, 1369.0]",2,12,-10
31244.0,2019-11-14,"(352.954, 615.5]",15,23,-8
31244.0,2019-11-14,"(615.5, 877.0]",4,14,-10
31244.0,2019-11-14,"(877.0, 1138.5]",9,20,-11
31244.0,2019-11-14,"(1138.5, 1400.0]",7,11,-4
31245.0,2019-11-14,"(290.893, 568.75]",8,23,-15
31245.0,2019-11-14,"(568.75, 845.5]",5,8,-3
31245.0,2019-11-14,"(845.5, 1122.25]",13,27,-14
31245.0,2019-11-14,"(1122.25, 1399.0]",4,7,-3
31246.0,2019-11-14,"(396.072, 629.0]",13,20,-7
31246.0,2019-11-14,"(629.0, 861.0]",5,7,-2
31246.0,2019-11-14,"(861.0, 1093.0]",14,28,-14
31246.0,2019-11-14,"(1093.0, 1325.0]",12,25,-13
31247.0,2019-11-14,"(312.067, 546.25]",5,7,-2
31247.0,2019-11-14,"(546.25, 779.5]",6,8,-2
31247.0,2019-11-14,"(779.5, 1012.75]",6,10,-4
31247.0,2019-11-14,"(1012.75, 1246.0]",9,19,-10
31248.0,2019-11-14,"(355.059, 591.25]",8,14,-6
31248.0,2019-11-14,"(591.25, 826.5]",2,7,-5
31248.0,2019-11-14,"(826.5, 1061.75]",14,26,-12
31248.0,2019-11-14,"(1061.75, 1297.0]",6,12,-6
31249.0,2019-11-14,"(377.208, 576.0]",9,18,-9
31249.0,2019-11-14,"(576.0, 774.0]",8,14,-6
31249.0,2019-11-14,"(774.0, 972.0]",4,8,-4
31249.0,2019-11-14,"(972.0, 1170.0]",6,13,-7
31250.0,2019-11-14,"(413.993, 666.75]",18,24,-6
31250.0,2019-11-14,"(666.75, 918.5]",10,16,-6
31250.0,2019-11-14,"(918.5, 1170.25]",3,18,-15
31250.0,2019-11-14,"(1170.25, 1422.0]",1,5,-4
31251.0,2019-11-14,"(93.655, 431.25]",3,6,-3
31251.0,2019-11-14,"(431.25, 767.5]",20,39,-19
31251.0,2019-11-14,"(767.5, 1103.75]",14,31,-17
31251.0,2019-11-14,"(1103.75, 1440.0]",6,11,-5
31252.0,2019-11-14,"(437.275, 619.25]",22,23,-1
31252.0,2019-11-14,"(619.25, 800.5]",3,5,-2
31252.0,2019-11-14,"(800.5, 981.75]",4,7,-3
31252.0,2019-11-14,"(981.75, 1163.0]",2,20,-18
31253.0,2019-11-14,"(410.214, 607.5]",20,22,-2
31253.0,2019-11-14,"(607.5, 804.0]",2,4,-2
31253.0,2019-11-14,"(804.0, 1000.5]",3,9,-6
31253.0,2019-11-14,"(1000.5, 1197.0]",3,17,-14
31254.0,2019-11-14,"(409.113, 631.75]",17,18,-1
31254.0,2019-11-14,"(631.75, 853.5]",4,7,-3
31254.0,2019-11-14,"(853.5, 1075.25]",2,16,-14
31254.0,2019-11-14,"(1075.25, 1297.0]",1,6,-5
31255.0,2019-11-14,"(357.082, 587.5]",19,31,-12
31255.0,2019-11-14,"(587.5, 817.0]",4,8,-4
31255.0,2019-11-14,"(817.0, 1046.5]",6,16,-10
31255.0,2019-11-14,"(1046.5, 1276.0]",9,15,-6
31256.0,2019-11-14,"(283.89, 562.5]",8,9,-1
31256.0,2019-11-14,"(562.5, 840.0]",4,4,0
31256.0,2019-11-14,"(840.0, 1117.5]",7,15,-8
31256.0,2019-11-14,"(1117.5, 1395.0]",4,17,-13
31257.0,2019-11-14,"(11.643, 352.25]",1,2,-1
31257.0,2019-11-14,"(352.25, 691.5]",22,40,-18
31257.0,2019-11-14,"(691.5, 1030.75]",18,33,-15
31257.0,2019-11-14,"(1030.75, 1370.0]",12,37,-25
31258.0,2019-11-14,"(538.36, 699.0]",3,6,-3
31258.0,2019-11-14,"(699.0, 859.0]",1,1,0
31258.0,2019-11-14,"(859.0, 1019.0]",3,5,-2
31258.0,2019-11-14,"(1019.0, 1179.0]",3,3,0
31259.0,2019-11-14,"(452.274, 634.5]",12,12,0
31259.0,2019-11-14,"(816.0, 997.5]",1,3,-2
31259.0,2019-11-14,"(997.5, 1179.0]",1,12,-11
31260.0,2019-11-14,"(350.049, 588.75]",19,29,-10
31260.0,2019-11-14,"(588.75, 826.5]",3,5,-2
31260.0,2019-11-14,"(826.5, 1064.25]",1,11,-10
31260.0,2019-11-14,"(1064.25, 1302.0]",6,10,-4
31261.0,2019-11-14,"(428.11, 651.5]",15,15,0
31261.0,2019-11-14,"(651.5, 874.0]",2,5,-3
31261.0,2019-11-14,"(874.0, 1096.5]",1,6,-5
31261.0,2019-11-14,"(1096.5, 1319.0]",2,10,-8
31262.0,2019-11-14,"(267.991, 521.25]",4,5,-1
31262.0,2019-11-14,"(521.25, 773.5]",6,9,-3
31262.0,2019-11-14,"(773.5, 1025.75]",2,4,-2
31262.0,2019-11-14,"(1025.75, 1278.0]",3,12,-9
31263.0,2019-11-14,"(61.646, 401.5]",2,2,0
31263.0,2019-11-14,"(401.5, 740.0]",19,33,-14
31263.0,2019-11-14,"(740.0, 1078.5]",12,28,-16
31263.0,2019-11-14,"(1078.5, 1417.0]",4,7,-3
31264.0,2019-11-14,"(58.67, 392.5]",1,1,0
31264.0,2019-11-14,"(392.5, 725.0]",16,20,-4
31264.0,2019-11-14,"(725.0, 1057.5]",8,18,-10
31264.0,2019-11-14,"(1057.5, 1390.0]",4,11,-7
31265.0,2019-11-14,"(383.955, 646.25]",16,32,-16
31265.0,2019-11-14,"(646.25, 907.5]",7,9,-2
31265.0,2019-11-14,"(907.5, 1168.75]",19,31,-12
31265.0,2019-11-14,"(1168.75, 1430.0]",10,21,-11
31266.0,2019-11-14,"(31.655, 369.25]",1,1,0
31266.0,2019-11-14,"(369.25, 705.5]",7,24,-17
31266.0,2019-11-14,"(705.5, 1041.75]",16,35,-19
31266.0,2019-11-14,"(1041.75, 1378.0]",29,43,-14
31267.0,2019-11-14,"(4.655, 342.25]",1,3,-2
31267.0,2019-11-14,"(342.25, 678.5]",25,45,-20
31267.0,2019-11-14,"(678.5, 1014.75]",12,29,-17
31267.0,2019-11-14,"(1014.75, 1351.0]",19,46,-27
31268.0,2019-11-14,"(22.607, 372.25]",4,6,-2
31268.0,2019-11-14,"(372.25, 720.5]",17,54,-37
31268.0,2019-11-14,"(720.5, 1068.75]",11,23,-12
31268.0,2019-11-14,"(1068.75, 1417.0]",24,40,-16
31269.0,2019-11-14,"(389.054, 626.5]",10,14,-4
31269.0,2019-11-14,"(626.5, 863.0]",4,8,-4
31269.0,2019-11-14,"(863.0, 1099.5]",7,16,-9
31269.0,2019-11-14,"(1099.5, 1336.0]",4,15,-11
31270.0,2019-11-14,"(320.985, 575.75]",15,21,-6
31270.0,2019-11-14,"(575.75, 829.5]",4,7,-3
31270.0,2019-11-14,"(829.5, 1083.25]",5,13,-8
31270.0,2019-11-14,"(1083.25, 1337.0]",8,15,-7
31271.0,2019-11-14,"(382.75, 707.5]",15,1,14
31271.0,2019-11-14,"(707.5, 1032.25]",8,20,-12
31271.0,2019-11-14,"(1032.25, 1357.0]",5,14,-9
31272.0,2019-11-14,"(314.074, 546.5]",22,23,-1
31272.0,2019-11-14,"(546.5, 778.0]",7,8,-1
31272.0,2019-11-14,"(778.0, 1009.5]",4,16,-12
31272.0,2019-11-14,"(1009.5, 1241.0]",3,12,-9
31273.0,2019-11-14,"(667.75, 815.5]",1,3,-2
31273.0,2019-11-14,"(815.5, 963.25]",2,3,-1
31273.0,2019-11-14,"(963.25, 1111.0]",3,2,1
31274.0,2019-11-14,"(394.033, 636.75]",14,17,-3
31274.0,2019-11-14,"(636.75, 878.5]",3,5,-2
31274.0,2019-11-14,"(878.5, 1120.25]",11,20,-9
31274.0,2019-11-14,"(1120.25, 1362.0]",2,8,-6
31275.0,2019-11-14,"(313.883, 594.25]",25,40,-15
31275.0,2019-11-14,"(594.25, 873.5]",8,12,-4
31275.0,2019-11-14,"(873.5, 1152.75]",14,31,-17
31275.0,2019-11-14,"(1152.75, 1432.0]",9,20,-11
31276.0,2019-11-14,"(444.04, 685.0]",26,29,-3
31276.0,2019-11-14,"(685.0, 925.0]",2,4,-2
31276.0,2019-11-14,"(925.0, 1165.0]",5,23,-18
31276.0,2019-11-14,"(1165.0, 1405.0]",2,12,-10
31277.0,2019-11-14,"(291.929, 560.75]",27,33,-6
31277.0,2019-11-14,"(560.75, 828.5]",21,25,-4
31277.0,2019-11-14,"(828.5, 1096.25]",11,39,-28
31277.0,2019-11-14,"(1096.25, 1364.0]",6,15,-9
31278.0,2019-11-14,"(17.637, 359.75]",1,2,-1
31278.0,2019-11-14,"(359.75, 700.5]",3,22,-19
31278.0,2019-11-14,"(700.5, 1041.25]",8,16,-8
31278.0,2019-11-14,"(1041.25, 1382.0]",26,37,-11
31279.0,2019-11-14,"(408.141, 623.75]",30,33,-3
31279.0,2019-11-14,"(623.75, 838.5]",3,5,-2
31279.0,2019-11-14,"(838.5, 1053.25]",10,25,-15
31279.0,2019-11-14,"(1053.25, 1268.0]",2,17,-15
31280.0,2019-11-14,"(343.915, 616.25]",7,27,-20
31280.0,2019-11-14,"(616.25, 887.5]",3,7,-4
31280.0,2019-11-14,"(887.5, 1158.75]",10,12,-2
31280.0,2019-11-14,"(1158.75, 1430.0]",7,11,-4
31000.0,2019-11-15,"(760.5, 893.75]",1,1,0
31001.0,2019-11-15,"(914.25, 1219.0]",1,1,0
31002.0,2019-11-15,"(441.356, 603.0]",2,8,-6
31002.0,2019-11-15,"(603.0, 764.0]",3,3,0
31002.0,2019-11-15,"(764.0, 925.0]",1,2,-1
31002.0,2019-11-15,"(925.0, 1086.0]",5,7,-2
31003.0,2019-11-15,"(351.264, 536.0]",2,4,-2
31003.0,2019-11-15,"(536.0, 720.0]",2,2,0
31003.0,2019-11-15,"(720.0, 904.0]",2,2,0
31004.0,2019-11-15,"(951.75, 1104.0]",3,5,-2
31005.0,2019-11-15,"(495.287, 674.25]",4,4,0
31005.0,2019-11-15,"(1030.75, 1209.0]",5,1,4
31006.0,2019-11-15,"(871.75, 1035.0]",3,1,2
31007.0,2019-11-15,"(363.955, 626.25]",7,22,-15
31007.0,2019-11-15,"(626.25, 887.5]",2,3,-1
31007.0,2019-11-15,"(887.5, 1148.75]",10,22,-12
31007.0,2019-11-15,"(1148.75, 1410.0]",4,6,-2
31009.0,2019-11-15,"(368.232, 561.0]",4,5,-1
31009.0,2019-11-15,"(753.0, 945.0]",1,3,-2
31009.0,2019-11-15,"(945.0, 1137.0]",1,5,-4
31010.0,2019-11-15,"(396.035, 638.25]",2,4,-2
31010.0,2019-11-15,"(638.25, 879.5]",1,3,-2
31010.0,2019-11-15,"(1120.75, 1362.0]",5,8,-3
31011.0,2019-11-15,"(416.06, 652.0]",5,6,-1
31011.0,2019-11-15,"(1122.0, 1357.0]",1,4,-3
31012.0,2019-11-15,"(375.292, 553.0]",4,4,0
31012.0,2019-11-15,"(553.0, 730.0]",1,2,-1
31013.0,2019-11-15,"(508.103, 733.25]",1,3,-2
31013.0,2019-11-15,"(733.25, 957.5]",3,4,-1
31013.0,2019-11-15,"(957.5, 1181.75]",1,1,0
31013.0,2019-11-15,"(1181.75, 1406.0]",1,4,-3
31014.0,2019-11-15,"(323.942, 589.5]",22,26,-4
31014.0,2019-11-15,"(589.5, 854.0]",2,6,-4
31014.0,2019-11-15,"(854.0, 1118.5]",12,20,-8
31014.0,2019-11-15,"(1118.5, 1383.0]",7,10,-3
31015.0,2019-11-15,"(306.085, 535.75]",8,10,-2
31015.0,2019-11-15,"(535.75, 764.5]",1,2,-1
31015.0,2019-11-15,"(764.5, 993.25]",3,4,-1
31015.0,2019-11-15,"(993.25, 1222.0]",7,8,-1
31016.0,2019-11-15,"(396.993, 649.75]",7,11,-4
31016.0,2019-11-15,"(649.75, 901.5]",3,3,0
31016.0,2019-11-15,"(901.5, 1153.25]",2,10,-8
31016.0,2019-11-15,"(1153.25, 1405.0]",1,1,0
31017.0,2019-11-15,"(513.128, 732.0]",4,7,-3
31017.0,2019-11-15,"(732.0, 950.0]",1,2,-1
31017.0,2019-11-15,"(950.0, 1168.0]",1,5,-4
31018.0,2019-11-15,"(962.75, 1155.0]",1,4,-3
31019.0,2019-11-15,"(689.75, 921.5]",3,4,-1
31019.0,2019-11-15,"(921.5, 1153.25]",4,5,-1
31020.0,2019-11-15,"(313.0, 602.0]",2,1,1
31020.0,2019-11-15,"(891.0, 1180.0]",4,3,1
31021.0,2019-11-15,"(16.847, 306.25]",1,2,-1
31021.0,2019-11-15,"(882.75, 1171.0]",2,4,-2
31022.0,2019-11-15,"(471.231, 664.25]",3,8,-5
31022.0,2019-11-15,"(664.25, 856.5]",2,4,-2
31022.0,2019-11-15,"(856.5, 1048.75]",3,8,-5
31022.0,2019-11-15,"(1048.75, 1241.0]",4,8,-4
31023.0,2019-11-15,"(393.258, 579.5]",1,2,-1
31023.0,2019-11-15,"(765.0, 950.5]",1,1,0
31023.0,2019-11-15,"(950.5, 1136.0]",3,1,2
31024.0,2019-11-15,"(431.05, 669.5]",10,14,-4
31024.0,2019-11-15,"(907.0, 1144.5]",4,4,0
31025.0,2019-11-15,"(415.17, 623.5]",1,3,-2
31025.0,2019-11-15,"(623.5, 831.0]",1,3,-2
31025.0,2019-11-15,"(1038.5, 1246.0]",2,3,-1
31026.0,2019-11-15,"(331.5, 592.0]",2,1,1
31026.0,2019-11-15,"(592.0, 852.5]",2,5,-3
31026.0,2019-11-15,"(852.5, 1113.0]",1,3,-2
31027.0,2019-11-15,"(525.399, 676.25]",1,4,-3
31027.0,2019-11-15,"(976.75, 1127.0]",2,4,-2
31028.0,2019-11-15,"(475.151, 688.25]",2,2,0
31028.0,2019-11-15,"(900.5, 1112.75]",1,1,0
31029.0,2019-11-15,"(661.0, 890.0]",1,5,-4
31029.0,2019-11-15,"(890.0, 1119.0]",1,1,0
31029.0,2019-11-15,"(1119.0, 1348.0]",3,2,1
31030.0,2019-11-15,"(25.632, 369.0]",2,2,0
31030.0,2019-11-15,"(369.0, 711.0]",1,12,-11
31030.0,2019-11-15,"(711.0, 1053.0]",3,5,-2
31030.0,2019-11-15,"(1053.0, 1395.0]",7,11,-4
31031.0,2019-11-15,"(984.75, 1136.0]",3,5,-2
31032.0,2019-11-15,"(1050.75, 1250.0]",3,3,0
31033.0,2019-11-15,"(728.879, 759.25]",1,1,0
31034.0,2019-11-15,"(21.786, 326.5]",1,1,0
31034.0,2019-11-15,"(326.5, 630.0]",4,8,-4
31034.0,2019-11-15,"(933.5, 1237.0]",2,1,1
31035.0,2019-11-15,"(556.75, 785.5]",1,3,-2
31035.0,2019-11-15,"(785.5, 1014.25]",1,1,0
31035.0,2019-11-15,"(1014.25, 1243.0]",2,2,0
31036.0,2019-11-15,"(424.031, 667.25]",1,4,-3
31036.0,2019-11-15,"(667.25, 909.5]",1,1,0
31036.0,2019-11-15,"(909.5, 1151.75]",4,4,0
31036.0,2019-11-15,"(1151.75, 1394.0]",1,1,0
31037.0,2019-11-15,"(408.032, 651.0]",13,15,-2
31037.0,2019-11-15,"(651.0, 893.0]",1,5,-4
31037.0,2019-11-15,"(893.0, 1135.0]",3,13,-10
31037.0,2019-11-15,"(1135.0, 1377.0]",3,6,-3
31038.0,2019-11-15,"(369.5, 657.0]",1,1,0
31038.0,2019-11-15,"(657.0, 944.5]",1,3,-2
31038.0,2019-11-15,"(944.5, 1232.0]",1,3,-2
31039.0,2019-11-15,"(458.072, 691.0]",4,7,-3
31039.0,2019-11-15,"(691.0, 923.0]",4,6,-2
31039.0,2019-11-15,"(923.0, 1155.0]",1,9,-8
31039.0,2019-11-15,"(1155.0, 1387.0]",1,4,-3
31040.0,2019-11-15,"(457.197, 658.75]",2,2,0
31040.0,2019-11-15,"(859.5, 1060.25]",3,4,-1
31041.0,2019-11-15,"(518.214, 715.5]",3,3,0
31042.0,2019-11-15,"(433.185, 637.75]",9,11,-2
31042.0,2019-11-15,"(637.75, 841.5]",1,3,-2
31042.0,2019-11-15,"(841.5, 1045.25]",3,9,-6
31042.0,2019-11-15,"(1045.25, 1249.0]",1,7,-6
31043.0,2019-11-15,"(535.283, 715.25]",1,2,-1
31043.0,2019-11-15,"(715.25, 894.5]",1,3,-2
31043.0,2019-11-15,"(894.5, 1073.75]",1,2,-1
31043.0,2019-11-15,"(1073.75, 1253.0]",2,4,-2
31044.0,2019-11-15,"(752.534, 869.5]",3,4,-1
31044.0,2019-11-15,"(869.5, 986.0]",1,3,-2
31044.0,2019-11-15,"(1102.5, 1219.0]",3,3,0
31045.0,2019-11-15,"(438.444, 578.0]",3,4,-1
31045.0,2019-11-15,"(578.0, 717.0]",1,1,0
31046.0,2019-11-15,"(-0.121, 281.25]",1,1,0
31046.0,2019-11-15,"(281.25, 561.5]",1,4,-3
31046.0,2019-11-15,"(841.75, 1122.0]",1,3,-2
31047.0,2019-11-15,"(356.974, 614.5]",9,18,-9
31047.0,2019-11-15,"(614.5, 871.0]",2,3,-1
31047.0,2019-11-15,"(871.0, 1127.5]",7,20,-13
31047.0,2019-11-15,"(1127.5, 1384.0]",2,6,-4
31048.0,2019-11-15,"(402.016, 649.0]",3,4,-1
31048.0,2019-11-15,"(895.0, 1141.0]",6,3,3
31049.0,2019-11-15,"(530.334, 697.5]",2,4,-2
31049.0,2019-11-15,"(1030.5, 1197.0]",1,1,0
31050.0,2019-11-15,"(338.803, 388.25]",1,1,0
31051.0,2019-11-15,"(638.0, 805.5]",1,1,0
31051.0,2019-11-15,"(805.5, 973.0]",2,3,-1
31052.0,2019-11-15,"(509.357, 670.75]",4,6,-2
31052.0,2019-11-15,"(992.25, 1153.0]",4,2,2
,,,,1.0,
,,,,2.0,
31054.0,2019-11-15,"(756.0, 1008.0]",1,1,0
31055.0,2019-11-15,"(656.25, 875.0]",2,1,1
31056.0,2019-11-15,"(92.682, 423.5]",1,1,0
31056.0,2019-11-15,"(753.0, 1082.5]",2,2,0
31056.0,2019-11-15,"(1082.5, 1412.0]",1,2,-1
31057.0,2019-11-15,"(504.101, 729.75]",1,2,-1
31057.0,2019-11-15,"(729.75, 954.5]",1,1,0
31057.0,2019-11-15,"(1179.25, 1404.0]",1,2,-1
31058.0,2019-11-15,"(566.0, 849.0]",1,1,0
31058.0,2019-11-15,"(849.0, 1132.0]",2,1,1
31059.0,2019-11-15,"(373.096, 600.0]",1,3,-2
31059.0,2019-11-15,"(826.0, 1052.0]",1,3,-2
31059.0,2019-11-15,"(1052.0, 1278.0]",2,2,0
31060.0,2019-11-15,"(378.75, 676.5]",1,1,0
31060.0,2019-11-15,"(676.5, 974.25]",1,1,0
31060.0,2019-11-15,"(974.25, 1272.0]",2,3,-1
31061.0,2019-11-15,"(613.752, 676.0]",1,1,0
31062.0,2019-11-15,"(847.5, 935.0]",1,2,-1
31062.0,2019-11-15,"(935.0, 1022.5]",6,2,4
31062.0,2019-11-15,"(1022.5, 1110.0]",2,11,-9
,,,,2.0,
31064.0,2019-11-15,"(492.33, 660.5]",5,11,-6
31064.0,2019-11-15,"(660.5, 828.0]",3,6,-3
31064.0,2019-11-15,"(828.0, 995.5]",3,8,-5
31064.0,2019-11-15,"(995.5, 1163.0]",4,8,-4
31065.0,2019-11-15,"(753.5, 909.75]",1,1,0
31065.0,2019-11-15,"(909.75, 1066.0]",2,1,1
31066.0,2019-11-15,"(819.0, 979.5]",3,1,2
31066.0,2019-11-15,"(979.5, 1140.0]",1,3,-2
31067.0,2019-11-15,"(370.122, 590.5]",1,3,-2
31067.0,2019-11-15,"(590.5, 810.0]",2,3,-1
31067.0,2019-11-15,"(810.0, 1029.5]",1,1,0
31067.0,2019-11-15,"(1029.5, 1249.0]",3,4,-1
31068.0,2019-11-15,"(794.734, 861.5]",1,2,-1
31068.0,2019-11-15,"(928.0, 994.5]",1,1,0
31069.0,2019-11-15,"(416.034, 658.5]",3,8,-5
31069.0,2019-11-15,"(658.5, 900.0]",1,2,-1
31069.0,2019-11-15,"(1141.5, 1383.0]",2,1,1
31070.0,2019-11-15,"(639.5, 845.0]",1,4,-3
31070.0,2019-11-15,"(845.0, 1050.5]",2,1,1
31070.0,2019-11-15,"(1050.5, 1256.0]",2,4,-2
31071.0,2019-11-15,"(418.201, 618.75]",2,6,-4
31071.0,2019-11-15,"(618.75, 818.5]",1,1,0
31071.0,2019-11-15,"(818.5, 1018.25]",3,7,-4
31071.0,2019-11-15,"(1018.25, 1218.0]",3,6,-3
,,,,1.0,
,,,,1.0,
31073.0,2019-11-15,"(478.222, 673.5]",2,3,-1
31073.0,2019-11-15,"(868.0, 1062.5]",1,1,0
31073.0,2019-11-15,"(1062.5, 1257.0]",1,1,0
31074.0,2019-11-15,"(621.25, 878.5]",1,3,-2
31074.0,2019-11-15,"(878.5, 1135.75]",4,4,0
31074.0,2019-11-15,"(1135.75, 1393.0]",1,5,-4
31075.0,2019-11-15,"(976.75, 1120.0]",2,1,1
31076.0,2019-11-15,"(257.25, 514.5]",1,1,0
31076.0,2019-11-15,"(771.75, 1029.0]",1,1,0
31077.0,2019-11-15,"(722.25, 905.5]",3,3,0
31077.0,2019-11-15,"(905.5, 1088.75]",2,3,-1
31077.0,2019-11-15,"(1088.75, 1272.0]",2,2,0
31078.0,2019-11-15,"(476.254, 663.5]",1,1,0
31078.0,2019-11-15,"(663.5, 850.0]",1,2,-1
31079.0,2019-11-15,"(3.646, 343.5]",2,2,0
31079.0,2019-11-15,"(682.0, 1020.5]",3,5,-2
31079.0,2019-11-15,"(1020.5, 1359.0]",5,7,-2
31080.0,2019-11-15,"(638.0, 875.0]",2,7,-5
31080.0,2019-11-15,"(875.0, 1112.0]",4,4,0
31080.0,2019-11-15,"(1112.0, 1349.0]",4,10,-6
31081.0,2019-11-15,"(365.227, 559.25]",2,3,-1
31081.0,2019-11-15,"(559.25, 752.5]",1,2,-1
31081.0,2019-11-15,"(945.75, 1139.0]",1,4,-3
31082.0,2019-11-15,"(689.343, 854.25]",1,2,-1
31082.0,2019-11-15,"(854.25, 1018.5]",1,1,0
31082.0,2019-11-15,"(1018.5, 1182.75]",2,2,0
31083.0,2019-11-15,"(427.096, 654.0]",1,4,-3
31083.0,2019-11-15,"(880.0, 1106.0]",4,6,-2
31083.0,2019-11-15,"(1106.0, 1332.0]",1,1,0
31084.0,2019-11-15,"(573.337, 739.75]",3,3,0
31084.0,2019-11-15,"(739.75, 905.5]",1,2,-1
31084.0,2019-11-15,"(1071.25, 1237.0]",2,1,1
31085.0,2019-11-15,"(383.546, 497.5]",1,4,-3
31085.0,2019-11-15,"(724.5, 838.0]",1,2,-1
31086.0,2019-11-15,"(744.0, 910.5]",2,3,-1
31086.0,2019-11-15,"(910.5, 1077.0]",5,2,3
31087.0,2019-11-15,"(973.912, 996.0]",1,1,0
31087.0,2019-11-15,"(1040.0, 1062.0]",1,1,0
31088.0,2019-11-15,"(611.5, 834.0]",1,5,-4
31088.0,2019-11-15,"(834.0, 1056.5]",3,2,1
31088.0,2019-11-15,"(1056.5, 1279.0]",2,4,-2
31089.0,2019-11-15,"(409.75, 721.5]",8,2,6
31089.0,2019-11-15,"(721.5, 1033.25]",1,11,-10
31089.0,2019-11-15,"(1033.25, 1345.0]",6,8,-2
31090.0,2019-11-15,"(727.999, 728.25]",1,1,0
31091.0,2019-11-15,"(989.25, 1183.0]",5,4,1
31092.0,2019-11-15,"(562.0, 604.5]",1,2,-1
,,,,1.0,
,,,,1.0,
,,,,2.0,
,,,,1.0,
31094.0,2019-11-15,"(985.749, 1048.75]",1,2,-1
31094.0,2019-11-15,"(1174.25, 1237.0]",1,1,0
,,,,1.0,
,,,,1.0,
31096.0,2019-11-15,"(958.25, 1115.0]",1,1,0
31097.0,2019-11-15,"(537.176, 744.0]",2,2,0
31097.0,2019-11-15,"(950.0, 1156.0]",1,2,-1
31097.0,2019-11-15,"(1156.0, 1362.0]",1,2,-1
31098.0,2019-11-15,"(414.172, 622.0]",5,10,-5
31098.0,2019-11-15,"(829.0, 1036.0]",6,1,5
31098.0,2019-11-15,"(1036.0, 1243.0]",3,9,-6
31099.0,2019-11-15,"(513.75, 685.0]",1,1,0
31100.0,2019-11-15,"(397.985, 652.75]",8,9,-1
31100.0,2019-11-15,"(652.75, 906.5]",5,7,-2
31100.0,2019-11-15,"(906.5, 1160.25]",4,15,-11
31100.0,2019-11-15,"(1160.25, 1414.0]",1,5,-4
31101.0,2019-11-15,"(227.813, 525.75]",6,28,-22
31101.0,2019-11-15,"(525.75, 822.5]",9,26,-17
31101.0,2019-11-15,"(822.5, 1119.25]",38,58,-20
31101.0,2019-11-15,"(1119.25, 1416.0]",19,35,-16
31102.0,2019-11-15,"(221.846, 511.5]",1,8,-7
31102.0,2019-11-15,"(800.0, 1088.5]",7,15,-8
31102.0,2019-11-15,"(1088.5, 1377.0]",8,21,-13
31103.0,2019-11-15,"(336.999, 588.25]",1,27,-26
31103.0,2019-11-15,"(588.25, 838.5]",6,26,-20
31103.0,2019-11-15,"(838.5, 1088.75]",9,25,-16
31103.0,2019-11-15,"(1088.75, 1339.0]",7,17,-10
31104.0,2019-11-15,"(156.767, 466.25]",3,12,-9
31104.0,2019-11-15,"(466.25, 774.5]",7,26,-19
31104.0,2019-11-15,"(774.5, 1082.75]",16,30,-14
31104.0,2019-11-15,"(1082.75, 1391.0]",21,35,-14
31105.0,2019-11-15,"(870.5, 1125.75]",1,6,-5
31105.0,2019-11-15,"(1125.75, 1381.0]",2,9,-7
31106.0,2019-11-15,"(350.0, 664.0]",1,1,0
31106.0,2019-11-15,"(664.0, 978.0]",3,10,-7
31106.0,2019-11-15,"(978.0, 1292.0]",6,6,0
31107.0,2019-11-15,"(2.568, 362.0]",2,3,-1
31107.0,2019-11-15,"(362.0, 720.0]",6,28,-22
31107.0,2019-11-15,"(720.0, 1078.0]",15,34,-19
31107.0,2019-11-15,"(1078.0, 1436.0]",12,21,-9
31108.0,2019-11-15,"(0.669, 334.75]",2,2,0
31108.0,2019-11-15,"(334.75, 667.5]",7,28,-21
31108.0,2019-11-15,"(667.5, 1000.25]",18,37,-19
31108.0,2019-11-15,"(1000.25, 1333.0]",32,43,-11
31109.0,2019-11-15,"(344.927, 614.25]",5,16,-11
31109.0,2019-11-15,"(614.25, 882.5]",10,23,-13
31109.0,2019-11-15,"(882.5, 1150.75]",11,19,-8
31109.0,2019-11-15,"(1150.75, 1419.0]",14,23,-9
31110.0,2019-11-15,"(87.687, 417.25]",5,10,-5
31110.0,2019-11-15,"(417.25, 745.5]",17,42,-25
31110.0,2019-11-15,"(745.5, 1073.75]",12,24,-12
31110.0,2019-11-15,"(1073.75, 1402.0]",7,17,-10
31111.0,2019-11-15,"(37.668, 372.0]",2,4,-2
31111.0,2019-11-15,"(372.0, 705.0]",13,28,-15
31111.0,2019-11-15,"(705.0, 1038.0]",9,14,-5
31111.0,2019-11-15,"(1038.0, 1371.0]",21,37,-16
31112.0,2019-11-15,"(311.931, 580.25]",1,4,-3
31112.0,2019-11-15,"(580.25, 847.5]",2,3,-1
31112.0,2019-11-15,"(847.5, 1114.75]",4,7,-3
31113.0,2019-11-15,"(313.96, 575.0]",2,16,-14
31113.0,2019-11-15,"(575.0, 835.0]",2,8,-6
31113.0,2019-11-15,"(835.0, 1095.0]",6,15,-9
31113.0,2019-11-15,"(1095.0, 1355.0]",5,13,-8
31114.0,2019-11-15,"(421.03, 664.5]",1,21,-20
31114.0,2019-11-15,"(664.5, 907.0]",8,19,-11
31114.0,2019-11-15,"(907.0, 1149.5]",18,28,-10
31114.0,2019-11-15,"(1149.5, 1392.0]",7,16,-9
31115.0,2019-11-15,"(123.705, 448.75]",1,5,-4
31115.0,2019-11-15,"(448.75, 772.5]",1,12,-11
31115.0,2019-11-15,"(772.5, 1096.25]",13,27,-14
31115.0,2019-11-15,"(1096.25, 1420.0]",10,18,-8
31116.0,2019-11-15,"(388.966, 648.5]",3,18,-15
31116.0,2019-11-15,"(648.5, 907.0]",5,9,-4
31116.0,2019-11-15,"(907.0, 1165.5]",20,26,-6
31116.0,2019-11-15,"(1165.5, 1424.0]",3,10,-7
31117.0,2019-11-15,"(356.975, 614.25]",2,11,-9
31117.0,2019-11-15,"(870.5, 1126.75]",9,4,5
31117.0,2019-11-15,"(1126.75, 1383.0]",6,19,-13
31118.0,2019-11-15,"(444.183, 649.25]",2,19,-17
31118.0,2019-11-15,"(649.25, 853.5]",1,5,-4
31118.0,2019-11-15,"(853.5, 1057.75]",5,11,-6
31118.0,2019-11-15,"(1057.75, 1262.0]",14,16,-2
31119.0,2019-11-15,"(11.625, 356.75]",1,4,-3
31119.0,2019-11-15,"(356.75, 700.5]",4,15,-11
31119.0,2019-11-15,"(700.5, 1044.25]",14,26,-12
31119.0,2019-11-15,"(1044.25, 1388.0]",10,22,-12
31120.0,2019-11-15,"(81.671, 415.25]",3,5,-2
31120.0,2019-11-15,"(415.25, 747.5]",4,15,-11
31120.0,2019-11-15,"(747.5, 1079.75]",5,12,-7
31120.0,2019-11-15,"(1079.75, 1412.0]",9,10,-1
31121.0,2019-11-15,"(0.617, 347.75]",3,5,-2
31121.0,2019-11-15,"(347.75, 693.5]",15,22,-7
31121.0,2019-11-15,"(693.5, 1039.25]",5,15,-10
31121.0,2019-11-15,"(1039.25, 1385.0]",12,26,-14
31122.0,2019-11-15,"(47.615, 395.25]",1,1,0
31122.0,2019-11-15,"(395.25, 741.5]",1,17,-16
31122.0,2019-11-15,"(741.5, 1087.75]",9,24,-15
31122.0,2019-11-15,"(1087.75, 1434.0]",3,12,-9
31123.0,2019-11-15,"(308.051, 546.25]",1,19,-18
31123.0,2019-11-15,"(546.25, 783.5]",1,2,-1
31123.0,2019-11-15,"(783.5, 1020.75]",1,2,-1
31123.0,2019-11-15,"(1020.75, 1258.0]",4,8,-4
31124.0,2019-11-15,"(22.593, 375.75]",3,4,-1
31124.0,2019-11-15,"(375.75, 727.5]",13,33,-20
31124.0,2019-11-15,"(727.5, 1079.25]",16,54,-38
31124.0,2019-11-15,"(1079.25, 1431.0]",19,42,-23
31125.0,2019-11-15,"(2.577, 359.75]",1,2,-1
31125.0,2019-11-15,"(359.75, 715.5]",8,30,-22
31125.0,2019-11-15,"(715.5, 1071.25]",23,33,-10
31125.0,2019-11-15,"(1071.25, 1427.0]",14,23,-9
31126.0,2019-11-15,"(382.948, 647.0]",7,32,-25
31126.0,2019-11-15,"(647.0, 910.0]",4,7,-3
31126.0,2019-11-15,"(910.0, 1173.0]",15,21,-6
31126.0,2019-11-15,"(1173.0, 1436.0]",7,17,-10
31127.0,2019-11-15,"(319.0, 619.0]",10,1,9
31127.0,2019-11-15,"(619.0, 919.0]",12,14,-2
31127.0,2019-11-15,"(919.0, 1219.0]",16,28,-12
31128.0,2019-11-15,"(8.609, 357.75]",2,3,-1
31128.0,2019-11-15,"(357.75, 705.5]",27,38,-11
31128.0,2019-11-15,"(705.5, 1053.25]",16,33,-17
31128.0,2019-11-15,"(1053.25, 1401.0]",10,23,-13
31129.0,2019-11-15,"(478.108, 702.0]",10,13,-3
31129.0,2019-11-15,"(702.0, 925.0]",18,32,-14
31129.0,2019-11-15,"(925.0, 1148.0]",10,14,-4
31130.0,2019-11-15,"(368.934, 636.5]",3,13,-10
31130.0,2019-11-15,"(636.5, 903.0]",3,5,-2
31130.0,2019-11-15,"(903.0, 1169.5]",11,16,-5
31130.0,2019-11-15,"(1169.5, 1436.0]",3,6,-3
31131.0,2019-11-15,"(370.065, 604.75]",1,19,-18
31131.0,2019-11-15,"(838.5, 1072.25]",7,1,6
31131.0,2019-11-15,"(1072.25, 1306.0]",6,15,-9
31200.0,2019-11-15,"(44.656, 382.0]",1,2,-1
31200.0,2019-11-15,"(382.0, 718.0]",50,64,-14
31200.0,2019-11-15,"(718.0, 1054.0]",20,46,-26
31200.0,2019-11-15,"(1054.0, 1390.0]",22,41,-19
31201.0,2019-11-15,"(53.633, 396.75]",4,4,0
31201.0,2019-11-15,"(396.75, 738.5]",28,64,-36
31201.0,2019-11-15,"(738.5, 1080.25]",31,51,-20
31201.0,2019-11-15,"(1080.25, 1422.0]",40,67,-27
31202.0,2019-11-15,"(73.642, 414.5]",1,5,-4
31202.0,2019-11-15,"(414.5, 754.0]",8,19,-11
31202.0,2019-11-15,"(754.0, 1093.5]",28,43,-15
31202.0,2019-11-15,"(1093.5, 1433.0]",9,19,-10
31203.0,2019-11-15,"(377.5, 717.0]",11,6,5
31203.0,2019-11-15,"(717.0, 1056.5]",22,30,-8
31203.0,2019-11-15,"(1056.5, 1396.0]",31,38,-7
31204.0,2019-11-15,"(365.75, 718.5]",14,1,13
31204.0,2019-11-15,"(718.5, 1071.25]",9,23,-14
31204.0,2019-11-15,"(1071.25, 1424.0]",4,25,-21
31205.0,2019-11-15,"(456.025, 700.75]",27,36,-9
31205.0,2019-11-15,"(700.75, 944.5]",18,29,-11
31205.0,2019-11-15,"(944.5, 1188.25]",13,36,-23
31205.0,2019-11-15,"(1188.25, 1432.0]",3,12,-9
31206.0,2019-11-15,"(473.142, 688.5]",6,6,0
31206.0,2019-11-15,"(688.5, 903.0]",2,3,-1
31206.0,2019-11-15,"(903.0, 1117.5]",1,5,-4
31206.0,2019-11-15,"(1117.5, 1332.0]",2,4,-2
31207.0,2019-11-15,"(575.75, 789.5]",2,6,-4
31207.0,2019-11-15,"(789.5, 1003.25]",1,3,-2
31208.0,2019-11-15,"(20.666, 355.5]",3,4,-1
31208.0,2019-11-15,"(355.5, 689.0]",7,12,-5
31208.0,2019-11-15,"(689.0, 1022.5]",5,8,-3
31208.0,2019-11-15,"(1022.5, 1356.0]",5,10,-5
31209.0,2019-11-15,"(687.5, 885.0]",1,2,-1
31209.0,2019-11-15,"(1082.5, 1280.0]",2,2,0
31211.0,2019-11-15,"(429.046, 668.5]",10,12,-2
31211.0,2019-11-15,"(668.5, 907.0]",6,10,-4
31211.0,2019-11-15,"(907.0, 1145.5]",7,12,-5
31211.0,2019-11-15,"(1145.5, 1384.0]",3,7,-4
31212.0,2019-11-15,"(388.5, 720.0]",27,2,25
31212.0,2019-11-15,"(720.0, 1051.5]",6,37,-31
31212.0,2019-11-15,"(1051.5, 1383.0]",5,13,-8
31213.0,2019-11-15,"(292.871, 576.25]",34,46,-12
31213.0,2019-11-15,"(576.25, 858.5]",12,27,-15
31213.0,2019-11-15,"(858.5, 1140.75]",16,28,-12
31213.0,2019-11-15,"(1140.75, 1423.0]",2,6,-4
31214.0,2019-11-15,"(13.622, 359.5]",3,5,-2
31214.0,2019-11-15,"(359.5, 704.0]",11,32,-21
31214.0,2019-11-15,"(704.0, 1048.5]",23,41,-18
31214.0,2019-11-15,"(1048.5, 1393.0]",23,37,-14
31215.0,2019-11-15,"(297.859, 584.25]",18,21,-3
31215.0,2019-11-15,"(584.25, 869.5]",12,16,-4
31215.0,2019-11-15,"(869.5, 1154.75]",15,25,-10
31215.0,2019-11-15,"(1154.75, 1440.0]",4,10,-6
31216.0,2019-11-15,"(276.01, 524.5]",8,11,-3
31216.0,2019-11-15,"(524.5, 772.0]",19,26,-7
31216.0,2019-11-15,"(772.0, 1019.5]",4,11,-7
31216.0,2019-11-15,"(1019.5, 1267.0]",5,25,-20
31217.0,2019-11-15,"(389.959, 651.25]",11,14,-3
31217.0,2019-11-15,"(651.25, 911.5]",2,10,-8
31217.0,2019-11-15,"(1171.75, 1432.0]",3,6,-3
31218.0,2019-11-15,"(378.077, 609.75]",12,23,-11
31218.0,2019-11-15,"(609.75, 840.5]",7,8,-1
31218.0,2019-11-15,"(840.5, 1071.25]",4,8,-4
31218.0,2019-11-15,"(1071.25, 1302.0]",2,6,-4
31219.0,2019-11-15,"(374.29, 552.5]",6,6,0
31219.0,2019-11-15,"(552.5, 730.0]",5,7,-2
31219.0,2019-11-15,"(730.0, 907.5]",7,11,-4
31219.0,2019-11-15,"(907.5, 1085.0]",4,14,-10
31220.0,2019-11-15,"(303.977, 560.75]",18,21,-3
31220.0,2019-11-15,"(816.5, 1072.25]",4,20,-16
31220.0,2019-11-15,"(1072.25, 1328.0]",1,4,-3
31221.0,2019-11-15,"(120.688, 450.0]",3,4,-1
31221.0,2019-11-15,"(450.0, 778.0]",28,39,-11
31221.0,2019-11-15,"(778.0, 1106.0]",17,43,-26
31221.0,2019-11-15,"(1106.0, 1434.0]",8,11,-3
31222.0,2019-11-15,"(380.084, 610.0]",22,25,-3
31222.0,2019-11-15,"(610.0, 839.0]",2,6,-4
31222.0,2019-11-15,"(839.0, 1068.0]",10,22,-12
31222.0,2019-11-15,"(1068.0, 1297.0]",1,14,-13
31223.0,2019-11-15,"(18.588, 373.0]",2,4,-2
31223.0,2019-11-15,"(373.0, 726.0]",11,22,-11
31223.0,2019-11-15,"(726.0, 1079.0]",13,22,-9
31223.0,2019-11-15,"(1079.0, 1432.0]",12,21,-9
31224.0,2019-11-15,"(337.75, 660.5]",18,1,17
31224.0,2019-11-15,"(660.5, 983.25]",6,20,-14
31224.0,2019-11-15,"(983.25, 1306.0]",3,19,-16
31225.0,2019-11-15,"(21.771, 330.25]",1,1,0
31225.0,2019-11-15,"(330.25, 637.5]",11,17,-6
31225.0,2019-11-15,"(637.5, 944.75]",9,15,-6
31225.0,2019-11-15,"(944.75, 1252.0]",10,22,-12
31226.0,2019-11-15,"(339.0, 676.0]",4,1,3
31226.0,2019-11-15,"(676.0, 1013.0]",7,9,-2
31226.0,2019-11-15,"(1013.0, 1350.0]",7,17,-10
31227.0,2019-11-15,"(377.75, 696.5]",51,1,50
31227.0,2019-11-15,"(696.5, 1015.25]",14,53,-39
31227.0,2019-11-15,"(1015.25, 1334.0]",4,26,-22
31228.0,2019-11-15,"(7.571, 366.25]",1,2,-1
31228.0,2019-11-15,"(366.25, 723.5]",22,32,-10
31228.0,2019-11-15,"(723.5, 1080.75]",33,67,-34
31228.0,2019-11-15,"(1080.75, 1438.0]",25,38,-13
31229.0,2019-11-15,"(24.589, 378.75]",2,4,-2
31229.0,2019-11-15,"(378.75, 731.5]",26,78,-52
31229.0,2019-11-15,"(731.5, 1084.25]",37,65,-28
31229.0,2019-11-15,"(1084.25, 1437.0]",29,44,-15
31230.0,2019-11-15,"(91.713, 414.75]",4,7,-3
31230.0,2019-11-15,"(414.75, 736.5]",44,55,-11
31230.0,2019-11-15,"(736.5, 1058.25]",19,37,-18
31230.0,2019-11-15,"(1058.25, 1380.0]",7,23,-16
31231.0,2019-11-15,"(324.911, 598.25]",9,12,-3
31231.0,2019-11-15,"(598.25, 870.5]",14,28,-14
31231.0,2019-11-15,"(870.5, 1142.75]",10,21,-11
31231.0,2019-11-15,"(1142.75, 1415.0]",2,5,-3
31232.0,2019-11-15,"(279.856, 567.0]",9,14,-5
31232.0,2019-11-15,"(567.0, 853.0]",12,16,-4
31232.0,2019-11-15,"(853.0, 1139.0]",25,38,-13
31232.0,2019-11-15,"(1139.0, 1425.0]",3,7,-4
31233.0,2019-11-15,"(1.565, 361.75]",1,2,-1
31233.0,2019-11-15,"(361.75, 720.5]",33,38,-5
31233.0,2019-11-15,"(720.5, 1079.25]",15,34,-19
31233.0,2019-11-15,"(1079.25, 1438.0]",7,15,-8
31234.0,2019-11-15,"(319.914, 592.5]",14,30,-16
31234.0,2019-11-15,"(592.5, 864.0]",13,24,-11
31234.0,2019-11-15,"(864.0, 1135.5]",20,32,-12
31234.0,2019-11-15,"(1135.5, 1407.0]",3,8,-5
31235.0,2019-11-15,"(501.155, 713.25]",5,6,-1
31235.0,2019-11-15,"(713.25, 924.5]",1,2,-1
31235.0,2019-11-15,"(924.5, 1135.75]",6,13,-7
31235.0,2019-11-15,"(1135.75, 1347.0]",6,12,-6
31236.0,2019-11-15,"(454.027, 698.25]",18,24,-6
31236.0,2019-11-15,"(698.25, 941.5]",12,22,-10
31236.0,2019-11-15,"(941.5, 1184.75]",8,25,-17
31236.0,2019-11-15,"(1184.75, 1428.0]",2,5,-3
31237.0,2019-11-15,"(328.947, 593.25]",4,14,-10
31237.0,2019-11-15,"(593.25, 856.5]",15,25,-10
31237.0,2019-11-15,"(856.5, 1119.75]",8,18,-10
31237.0,2019-11-15,"(1119.75, 1383.0]",8,16,-8
31238.0,2019-11-15,"(52.622, 398.5]",2,5,-3
31238.0,2019-11-15,"(398.5, 743.0]",22,30,-8
31238.0,2019-11-15,"(743.0, 1087.5]",13,32,-19
31238.0,2019-11-15,"(1087.5, 1432.0]",4,16,-12
31239.0,2019-11-15,"(373.209, 571.75]",21,22,-1
31239.0,2019-11-15,"(571.75, 769.5]",13,15,-2
31239.0,2019-11-15,"(769.5, 967.25]",7,12,-5
31239.0,2019-11-15,"(967.25, 1165.0]",4,29,-25
31240.0,2019-11-15,"(679.565, 788.75]",7,14,-7
31240.0,2019-11-15,"(788.75, 897.5]",8,19,-11
31240.0,2019-11-15,"(897.5, 1006.25]",7,11,-4
31240.0,2019-11-15,"(1006.25, 1115.0]",3,5,-2
31241.0,2019-11-15,"(62.672, 396.0]",2,3,-1
31241.0,2019-11-15,"(396.0, 728.0]",24,47,-23
31241.0,2019-11-15,"(728.0, 1060.0]",10,29,-19
31241.0,2019-11-15,"(1060.0, 1392.0]",18,36,-18
31242.0,2019-11-15,"(326.101, 551.75]",20,21,-1
31242.0,2019-11-15,"(551.75, 776.5]",11,18,-7
31242.0,2019-11-15,"(776.5, 1001.25]",7,16,-9
31242.0,2019-11-15,"(1001.25, 1226.0]",4,27,-23
31243.0,2019-11-15,"(374.099, 600.25]",22,25,-3
31243.0,2019-11-15,"(600.25, 825.5]",11,14,-3
31243.0,2019-11-15,"(825.5, 1050.75]",8,24,-16
31243.0,2019-11-15,"(1050.75, 1276.0]",5,16,-11
31244.0,2019-11-15,"(428.019, 674.25]",7,16,-9
31244.0,2019-11-15,"(674.25, 919.5]",6,12,-6
31244.0,2019-11-15,"(919.5, 1164.75]",4,8,-4
31244.0,2019-11-15,"(1164.75, 1410.0]",4,7,-3
31245.0,2019-11-15,"(377.016, 624.0]",13,28,-15
31245.0,2019-11-15,"(624.0, 870.0]",6,11,-5
31245.0,2019-11-15,"(870.0, 1116.0]",13,25,-12
31245.0,2019-11-15,"(1116.0, 1362.0]",5,14,-9
31246.0,2019-11-15,"(485.1, 711.0]",15,22,-7
31246.0,2019-11-15,"(711.0, 936.0]",4,13,-9
31246.0,2019-11-15,"(936.0, 1161.0]",20,34,-14
31246.0,2019-11-15,"(1161.0, 1386.0]",6,9,-3
31247.0,2019-11-15,"(435.265, 619.75]",8,11,-3
31247.0,2019-11-15,"(619.75, 803.5]",15,25,-10
31247.0,2019-11-15,"(803.5, 987.25]",9,22,-13
31247.0,2019-11-15,"(987.25, 1171.0]",15,39,-24
31248.0,2019-11-15,"(350.022, 595.5]",6,14,-8
31248.0,2019-11-15,"(595.5, 840.0]",8,14,-6
31248.0,2019-11-15,"(840.0, 1084.5]",23,40,-17
31248.0,2019-11-15,"(1084.5, 1329.0]",13,23,-10
31249.0,2019-11-15,"(478.383, 633.25]",7,14,-7
31249.0,2019-11-15,"(633.25, 787.5]",5,10,-5
31249.0,2019-11-15,"(787.5, 941.75]",5,11,-6
31249.0,2019-11-15,"(941.75, 1096.0]",4,8,-4
31250.0,2019-11-15,"(407.241, 597.75]",20,23,-3
31250.0,2019-11-15,"(597.75, 787.5]",4,7,-3
31250.0,2019-11-15,"(787.5, 977.25]",6,20,-14
31250.0,2019-11-15,"(977.25, 1167.0]",4,18,-14
31251.0,2019-11-15,"(363.929, 632.75]",17,35,-18
31251.0,2019-11-15,"(632.75, 900.5]",8,14,-6
31251.0,2019-11-15,"(900.5, 1168.25]",10,21,-11
31251.0,2019-11-15,"(1168.25, 1436.0]",6,9,-3
31252.0,2019-11-15,"(442.308, 616.0]",22,26,-4
31252.0,2019-11-15,"(616.0, 789.0]",7,10,-3
31253.0,2019-11-15,"(408.992, 662.0]",20,27,-7
31253.0,2019-11-15,"(662.0, 914.0]",11,16,-5
31253.0,2019-11-15,"(914.0, 1166.0]",3,21,-18
31253.0,2019-11-15,"(1166.0, 1418.0]",1,4,-3
31254.0,2019-11-15,"(454.15, 667.5]",18,21,-3
31254.0,2019-11-15,"(667.5, 880.0]",8,9,-1
31254.0,2019-11-15,"(880.0, 1092.5]",3,21,-18
31254.0,2019-11-15,"(1092.5, 1305.0]",4,9,-5
31255.0,2019-11-15,"(404.991, 658.25]",15,25,-10
31255.0,2019-11-15,"(658.25, 910.5]",10,18,-8
31255.0,2019-11-15,"(910.5, 1162.75]",10,19,-9
31255.0,2019-11-15,"(1162.75, 1415.0]",3,4,-1
31256.0,2019-11-15,"(281.849, 570.75]",7,7,0
31256.0,2019-11-15,"(570.75, 858.5]",6,10,-4
31256.0,2019-11-15,"(858.5, 1146.25]",9,21,-12
31256.0,2019-11-15,"(1146.25, 1434.0]",5,12,-7
31257.0,2019-11-15,"(326.902, 602.5]",17,26,-9
31257.0,2019-11-15,"(602.5, 877.0]",16,25,-9
31257.0,2019-11-15,"(877.0, 1151.5]",20,49,-29
31257.0,2019-11-15,"(1151.5, 1426.0]",8,21,-13
31258.0,2019-11-15,"(17.795, 320.25]",1,1,0
31258.0,2019-11-15,"(320.25, 621.5]",2,2,0
31258.0,2019-11-15,"(922.75, 1224.0]",19,52,-33
31259.0,2019-11-15,"(451.15, 664.5]",12,13,-1
31259.0,2019-11-15,"(664.5, 877.0]",1,2,-1
31259.0,2019-11-15,"(877.0, 1089.5]",2,7,-5
31260.0,2019-11-15,"(330.0, 644.0]",15,1,14
31260.0,2019-11-15,"(644.0, 958.0]",3,23,-20
31260.0,2019-11-15,"(958.0, 1272.0]",7,6,1
31261.0,2019-11-15,"(419.337, 585.75]",16,17,-1
31261.0,2019-11-15,"(917.25, 1083.0]",1,3,-2
31262.0,2019-11-15,"(414.208, 613.0]",8,10,-2
31262.0,2019-11-15,"(613.0, 811.0]",1,4,-3
31262.0,2019-11-15,"(811.0, 1009.0]",5,11,-6
31262.0,2019-11-15,"(1009.0, 1207.0]",3,9,-6
31263.0,2019-11-15,"(134.7, 461.0]",1,2,-1
31263.0,2019-11-15,"(461.0, 786.0]",29,42,-13
31263.0,2019-11-15,"(786.0, 1111.0]",13,39,-26
31263.0,2019-11-15,"(1111.0, 1436.0]",6,16,-10
31264.0,2019-11-15,"(417.02, 663.0]",22,29,-7
31264.0,2019-11-15,"(663.0, 908.0]",7,13,-6
31264.0,2019-11-15,"(908.0, 1153.0]",10,21,-11
31264.0,2019-11-15,"(1153.0, 1398.0]",1,7,-6
31265.0,2019-11-15,"(280.842, 571.5]",13,33,-20
31265.0,2019-11-15,"(571.5, 861.0]",13,25,-12
31265.0,2019-11-15,"(861.0, 1150.5]",19,34,-15
31265.0,2019-11-15,"(1150.5, 1440.0]",11,16,-5
31266.0,2019-11-15,"(23.586, 378.5]",1,4,-3
31266.0,2019-11-15,"(378.5, 732.0]",8,32,-24
31266.0,2019-11-15,"(732.0, 1085.5]",20,39,-19
31266.0,2019-11-15,"(1085.5, 1439.0]",18,31,-13
31267.0,2019-11-15,"(448.092, 676.0]",21,37,-16
31267.0,2019-11-15,"(676.0, 903.0]",13,36,-23
31267.0,2019-11-15,"(903.0, 1130.0]",19,33,-14
31267.0,2019-11-15,"(1130.0, 1357.0]",8,13,-5
31268.0,2019-11-15,"(18.596, 371.0]",1,2,-1
31268.0,2019-11-15,"(371.0, 722.0]",15,44,-29
31268.0,2019-11-15,"(722.0, 1073.0]",21,34,-13
31268.0,2019-11-15,"(1073.0, 1424.0]",19,27,-8
31269.0,2019-11-15,"(391.038, 632.5]",10,20,-10
31269.0,2019-11-15,"(632.5, 873.0]",8,14,-6
31269.0,2019-11-15,"(873.0, 1113.5]",9,22,-13
31269.0,2019-11-15,"(1113.5, 1354.0]",2,7,-5
31270.0,2019-11-15,"(329.91, 603.5]",15,19,-4
31270.0,2019-11-15,"(603.5, 876.0]",9,16,-7
31270.0,2019-11-15,"(876.0, 1148.5]",20,38,-18
31271.0,2019-11-15,"(379.167, 588.25]",15,19,-4
31271.0,2019-11-15,"(588.25, 796.5]",8,19,-11
31271.0,2019-11-15,"(796.5, 1004.75]",8,17,-9
31271.0,2019-11-15,"(1004.75, 1213.0]",4,15,-11
31272.0,2019-11-15,"(6.71, 330.5]",1,2,-1
31272.0,2019-11-15,"(330.5, 653.0]",26,29,-3
31272.0,2019-11-15,"(653.0, 975.5]",22,38,-16
31272.0,2019-11-15,"(975.5, 1298.0]",5,19,-14
31273.0,2019-11-15,"(658.0, 807.0]",2,3,-1
31273.0,2019-11-15,"(807.0, 956.0]",6,8,-2
31273.0,2019-11-15,"(956.0, 1105.0]",3,9,-6
31274.0,2019-11-15,"(344.5, 661.0]",14,1,13
31274.0,2019-11-15,"(661.0, 977.5]",12,19,-7
31274.0,2019-11-15,"(977.5, 1294.0]",4,19,-15
31275.0,2019-11-15,"(364.75, 711.5]",20,2,18
31275.0,2019-11-15,"(711.5, 1058.25]",26,32,-6
31275.0,2019-11-15,"(1058.25, 1405.0]",14,57,-43
31276.0,2019-11-15,"(387.75, 710.5]",26,1,25
31276.0,2019-11-15,"(710.5, 1033.25]",7,30,-23
31276.0,2019-11-15,"(1033.25, 1356.0]",4,24,-20
31277.0,2019-11-15,"(172.981, 428.75]",3,4,-1
31277.0,2019-11-15,"(428.75, 683.5]",33,40,-7
31277.0,2019-11-15,"(683.5, 938.25]",17,25,-8
31277.0,2019-11-15,"(938.25, 1193.0]",7,33,-26
31278.0,2019-11-15,"(55.661, 391.75]",1,2,-1
31278.0,2019-11-15,"(391.75, 726.5]",12,36,-24
31278.0,2019-11-15,"(726.5, 1061.25]",17,29,-12
31278.0,2019-11-15,"(1061.25, 1396.0]",21,38,-17
31279.0,2019-11-15,"(442.064, 677.0]",22,23,-1
31279.0,2019-11-15,"(677.0, 911.0]",5,15,-10
31279.0,2019-11-15,"(911.0, 1145.0]",6,29,-23
31279.0,2019-11-15,"(1145.0, 1379.0]",2,2,0
31280.0,2019-11-15,"(40.613, 388.75]",3,4,-1
31280.0,2019-11-15,"(388.75, 735.5]",6,28,-22
31280.0,2019-11-15,"(735.5, 1082.25]",12,20,-8
31280.0,2019-11-15,"(1082.25, 1429.0]",10,24,-14
31000.0,2019-11-16,"(476.067, 710.25]",1,3,-2
31000.0,2019-11-16,"(710.25, 943.5]",1,3,-2
31000.0,2019-11-16,"(943.5, 1176.75]",2,2,0
31000.0,2019-11-16,"(1176.75, 1410.0]",5,9,-4
31001.0,2019-11-16,"(537.382, 692.5]",1,2,-1
31001.0,2019-11-16,"(847.0, 1001.5]",6,3,3
31001.0,2019-11-16,"(1001.5, 1156.0]",1,8,-7
31002.0,2019-11-16,"(787.75, 848.5]",5,1,4
31002.0,2019-11-16,"(909.25, 970.0]",3,7,-4
31003.0,2019-11-16,"(423.439, 564.25]",2,3,-1
31003.0,2019-11-16,"(564.25, 704.5]",2,2,0
31003.0,2019-11-16,"(844.75, 985.0]",1,2,-1
31004.0,2019-11-16,"(809.826, 853.5]",1,1,0
31004.0,2019-11-16,"(940.5, 984.0]",1,1,0
31005.0,2019-11-16,"(607.606, 706.5]",1,5,-4
31005.0,2019-11-16,"(706.5, 805.0]",3,4,-1
31005.0,2019-11-16,"(805.0, 903.5]",2,3,-1
31005.0,2019-11-16,"(903.5, 1002.0]",1,3,-2
31006.0,2019-11-16,"(101.839, 393.25]",1,1,0
31006.0,2019-11-16,"(683.5, 973.75]",3,1,2
31006.0,2019-11-16,"(973.75, 1264.0]",4,6,-2
31007.0,2019-11-16,"(575.153, 787.75]",1,3,-2
31007.0,2019-11-16,"(787.75, 999.5]",8,10,-2
31007.0,2019-11-16,"(999.5, 1211.25]",1,3,-2
31007.0,2019-11-16,"(1211.25, 1423.0]",1,2,-1
31009.0,2019-11-16,"(805.5, 911.0]",1,1,0
31010.0,2019-11-16,"(466.256, 653.0]",3,8,-5
31010.0,2019-11-16,"(653.0, 839.0]",4,8,-4
31010.0,2019-11-16,"(839.0, 1025.0]",1,3,-2
31011.0,2019-11-16,"(426.698, 502.5]",1,1,0
31011.0,2019-11-16,"(653.5, 729.0]",4,1,3
,,,,2.0,
31013.0,2019-11-16,"(669.75, 921.5]",1,4,-3
31013.0,2019-11-16,"(921.5, 1173.25]",3,4,-1
31013.0,2019-11-16,"(1173.25, 1425.0]",2,5,-3
31014.0,2019-11-16,"(129.013, 376.75]",1,1,0
31014.0,2019-11-16,"(376.75, 623.5]",5,7,-2
31014.0,2019-11-16,"(623.5, 870.25]",9,12,-3
31014.0,2019-11-16,"(870.25, 1117.0]",6,7,-1
31015.0,2019-11-16,"(158.026, 402.5]",2,2,0
31015.0,2019-11-16,"(402.5, 646.0]",5,8,-3
31015.0,2019-11-16,"(646.0, 889.5]",3,4,-1
31015.0,2019-11-16,"(889.5, 1133.0]",2,3,-1
31016.0,2019-11-16,"(999.63, 1092.5]",1,2,-1
31016.0,2019-11-16,"(1277.5, 1370.0]",2,1,1
31017.0,2019-11-16,"(991.5, 1167.75]",1,1,0
31018.0,2019-11-16,"(39.976, 297.0]",1,1,0
31018.0,2019-11-16,"(809.0, 1065.0]",1,6,-5
31019.0,2019-11-16,"(774.408, 923.0]",1,3,-2
31019.0,2019-11-16,"(1071.0, 1219.0]",1,1,0
31020.0,2019-11-16,"(7.336, 174.0]",1,1,0
31020.0,2019-11-16,"(506.0, 672.0]",1,2,-1
31021.0,2019-11-16,"(358.5, 698.0]",1,2,-1
31021.0,2019-11-16,"(698.0, 1037.5]",3,2,1
31021.0,2019-11-16,"(1037.5, 1377.0]",2,7,-5
31022.0,2019-11-16,"(361.5, 720.0]",2,2,0
31022.0,2019-11-16,"(720.0, 1078.5]",6,4,2
31023.0,2019-11-16,"(619.0, 904.0]",1,2,-1
31023.0,2019-11-16,"(904.0, 1189.0]",3,1,2
31024.0,2019-11-16,"(519.386, 673.5]",1,3,-2
31024.0,2019-11-16,"(827.0, 980.5]",3,1,2
31024.0,2019-11-16,"(980.5, 1134.0]",2,4,-2
31025.0,2019-11-16,"(734.722, 804.5]",1,2,-1
31025.0,2019-11-16,"(943.5, 1013.0]",1,4,-3
31026.0,2019-11-16,"(685.75, 823.5]",1,1,0
31026.0,2019-11-16,"(823.5, 961.25]",1,2,-1
31027.0,2019-11-16,"(604.424, 749.0]",2,4,-2
31027.0,2019-11-16,"(749.0, 893.0]",3,3,0
31028.0,2019-11-16,"(525.313, 697.75]",1,3,-2
31028.0,2019-11-16,"(869.5, 1041.25]",1,4,-3
31029.0,2019-11-16,"(910.5, 1101.75]",1,5,-4
31029.0,2019-11-16,"(1101.75, 1293.0]",1,2,-1
31030.0,2019-11-16,"(802.0, 940.0]",3,1,2
31030.0,2019-11-16,"(940.0, 1078.0]",1,5,-4
31030.0,2019-11-16,"(1078.0, 1216.0]",1,1,0
31031.0,2019-11-16,"(22.677, 354.75]",1,1,0
31031.0,2019-11-16,"(1016.25, 1347.0]",2,2,0
31032.0,2019-11-16,"(720.358, 881.5]",1,3,-2
31032.0,2019-11-16,"(881.5, 1042.0]",1,2,-1
31032.0,2019-11-16,"(1042.0, 1202.5]",1,1,0
31032.0,2019-11-16,"(1202.5, 1363.0]",1,1,0
31033.0,2019-11-16,"(551.627, 645.25]",1,1,0
31033.0,2019-11-16,"(831.75, 925.0]",1,1,0
31034.0,2019-11-16,"(92.091, 320.25]",1,1,0
31034.0,2019-11-16,"(774.75, 1002.0]",1,5,-4
31035.0,2019-11-16,"(1010.5, 1072.0]",1,2,-1
,,,,1.0,
,,,,1.0,
31037.0,2019-11-16,"(416.122, 636.5]",2,2,0
31037.0,2019-11-16,"(636.5, 856.0]",1,5,-4
31037.0,2019-11-16,"(856.0, 1075.5]",2,7,-5
31037.0,2019-11-16,"(1075.5, 1295.0]",5,7,-2
31038.0,2019-11-16,"(535.41, 683.5]",2,3,-1
31038.0,2019-11-16,"(683.5, 831.0]",1,1,0
31039.0,2019-11-16,"(622.0, 875.0]",2,1,1
31039.0,2019-11-16,"(875.0, 1128.0]",1,3,-2
31040.0,2019-11-16,"(779.0, 860.0]",1,1,0
31041.0,2019-11-16,"(609.75, 813.0]",9,1,8
31042.0,2019-11-16,"(482.369, 640.75]",4,7,-3
31042.0,2019-11-16,"(640.75, 798.5]",1,2,-1
31042.0,2019-11-16,"(798.5, 956.25]",3,3,0
31042.0,2019-11-16,"(956.25, 1114.0]",1,1,0
31043.0,2019-11-16,"(645.535, 762.25]",1,2,-1
31044.0,2019-11-16,"(806.42, 952.0]",2,4,-2
31045.0,2019-11-16,"(667.859, 703.25]",1,1,0
31045.0,2019-11-16,"(773.75, 809.0]",1,1,0
31046.0,2019-11-16,"(489.75, 653.0]",1,1,0
31047.0,2019-11-16,"(498.326, 667.5]",1,1,0
31047.0,2019-11-16,"(836.0, 1004.5]",1,2,-1
31047.0,2019-11-16,"(1004.5, 1173.0]",2,2,0
31048.0,2019-11-16,"(702.75, 759.0]",1,1,0
31049.0,2019-11-16,"(713.75, 775.5]",1,1,0
31049.0,2019-11-16,"(775.5, 837.25]",1,1,0
31049.0,2019-11-16,"(837.25, 899.0]",1,1,0
31050.0,2019-11-16,"(662.25, 883.0]",1,1,0
31051.0,2019-11-16,"(822.5, 966.75]",2,2,0
31051.0,2019-11-16,"(966.75, 1111.0]",3,1,2
31052.0,2019-11-16,"(921.796, 973.0]",2,2,0
31052.0,2019-11-16,"(973.0, 1024.0]",1,1,0
31053.0,2019-11-16,"(498.491, 626.25]",1,1,0
31053.0,2019-11-16,"(753.5, 880.75]",4,3,1
31054.0,2019-11-16,"(634.5, 846.0]",1,1,0
31055.0,2019-11-16,"(1014.5, 1030.0]",1,1,0
31056.0,2019-11-16,"(605.75, 702.5]",1,1,0
31057.0,2019-11-16,"(589.628, 683.0]",1,1,0
31057.0,2019-11-16,"(869.0, 962.0]",3,1,2
31058.0,2019-11-16,"(540.75, 721.0]",3,1,2
31059.0,2019-11-16,"(510.57, 618.5]",3,4,-1
31059.0,2019-11-16,"(833.5, 941.0]",1,1,0
31060.0,2019-11-16,"(516.59, 619.5]",1,1,0
31060.0,2019-11-16,"(722.0, 824.5]",1,1,0
31060.0,2019-11-16,"(824.5, 927.0]",2,1,1
31061.0,2019-11-16,"(547.5, 730.0]",1,1,0
31062.0,2019-11-16,"(517.517, 638.75]",4,4,0
31062.0,2019-11-16,"(638.75, 759.5]",4,6,-2
31062.0,2019-11-16,"(759.5, 880.25]",4,11,-7
31062.0,2019-11-16,"(880.25, 1001.0]",6,9,-3
31063.0,2019-11-16,"(921.0, 1047.0]",1,1,0
31064.0,2019-11-16,"(595.613, 692.75]",3,6,-3
31064.0,2019-11-16,"(692.75, 789.5]",2,4,-2
31064.0,2019-11-16,"(789.5, 886.25]",3,7,-4
31064.0,2019-11-16,"(886.25, 983.0]",8,16,-8
31065.0,2019-11-16,"(486.596, 588.0]",1,1,0
31065.0,2019-11-16,"(689.0, 790.0]",1,2,-1
31065.0,2019-11-16,"(790.0, 891.0]",3,3,0
31066.0,2019-11-16,"(802.997, 803.75]",1,1,0
31066.0,2019-11-16,"(803.75, 804.5]",1,2,-1
31066.0,2019-11-16,"(804.5, 805.25]",1,2,-1
,,,,1.0,
,,,,4.0,
31068.0,2019-11-16,"(681.0, 908.0]",2,1,1
31069.0,2019-11-16,"(653.5, 896.0]",1,3,-2
31069.0,2019-11-16,"(896.0, 1138.5]",1,1,0
31069.0,2019-11-16,"(1138.5, 1381.0]",1,1,0
31070.0,2019-11-16,"(597.484, 727.0]",1,3,-2
31070.0,2019-11-16,"(727.0, 856.0]",3,4,-1
31071.0,2019-11-16,"(420.167, 629.25]",1,2,-1
31071.0,2019-11-16,"(629.25, 837.5]",5,11,-6
31071.0,2019-11-16,"(837.5, 1045.75]",3,8,-5
31071.0,2019-11-16,"(1045.75, 1254.0]",1,5,-4
,,,,2.0,
31073.0,2019-11-16,"(51.0, 68.0]",2,1,1
31074.0,2019-11-16,"(462.75, 617.0]",1,1,0
,,,,2.0,
,,,,1.0,
,,,,2.0,
31077.0,2019-11-16,"(484.137, 700.75]",3,3,0
31077.0,2019-11-16,"(700.75, 916.5]",8,16,-8
31077.0,2019-11-16,"(916.5, 1132.25]",3,7,-4
31077.0,2019-11-16,"(1132.25, 1348.0]",1,1,0
,,,,1.0,
,,,,1.0,
31079.0,2019-11-16,"(106.76, 418.0]",1,1,0
31079.0,2019-11-16,"(728.0, 1038.0]",4,3,1
31079.0,2019-11-16,"(1038.0, 1348.0]",3,7,-4
31080.0,2019-11-16,"(92.097, 318.75]",1,1,0
31080.0,2019-11-16,"(544.5, 770.25]",1,4,-3
31080.0,2019-11-16,"(770.25, 996.0]",4,7,-3
31081.0,2019-11-16,"(1096.664, 1181.0]",1,1,0
31082.0,2019-11-16,"(139.28, 320.0]",1,1,0
31082.0,2019-11-16,"(680.0, 860.0]",1,2,-1
31083.0,2019-11-16,"(750.0, 1000.0]",1,1,0
31084.0,2019-11-16,"(481.434, 623.5]",1,1,0
31084.0,2019-11-16,"(765.0, 906.5]",1,1,0
31084.0,2019-11-16,"(906.5, 1048.0]",1,1,0
31085.0,2019-11-16,"(571.0, 668.0]",1,1,0
31085.0,2019-11-16,"(765.0, 862.0]",1,2,-1
31086.0,2019-11-16,"(636.536, 753.0]",1,2,-1
31086.0,2019-11-16,"(753.0, 869.0]",3,3,0
31087.0,2019-11-16,"(536.782, 591.5]",1,2,-1
31087.0,2019-11-16,"(700.5, 755.0]",2,2,0
31088.0,2019-11-16,"(874.5, 1048.75]",2,1,1
31088.0,2019-11-16,"(1048.75, 1223.0]",1,2,-1
31089.0,2019-11-16,"(481.339, 647.25]",4,5,-1
31089.0,2019-11-16,"(647.25, 812.5]",1,4,-3
31089.0,2019-11-16,"(812.5, 977.75]",2,7,-5
31089.0,2019-11-16,"(977.75, 1143.0]",1,8,-7
31090.0,2019-11-16,"(681.909, 704.75]",1,1,0
31090.0,2019-11-16,"(727.5, 750.25]",1,1,0
31091.0,2019-11-16,"(617.598, 718.5]",1,2,-1
31091.0,2019-11-16,"(718.5, 819.0]",1,2,-1
31091.0,2019-11-16,"(919.5, 1020.0]",2,3,-1
31092.0,2019-11-16,"(650.263, 835.25]",2,5,-3
31092.0,2019-11-16,"(835.25, 1019.5]",1,1,0
31092.0,2019-11-16,"(1203.75, 1388.0]",1,1,0
31093.0,2019-11-16,"(1167.25, 1358.0]",1,2,-1
31094.0,2019-11-16,"(1257.75, 1381.0]",1,1,0
,,,,2.0,
31096.0,2019-11-16,"(568.495, 695.25]",2,4,-2
31096.0,2019-11-16,"(947.75, 1074.0]",1,1,0
31097.0,2019-11-16,"(563.457, 699.75]",1,2,-1
31097.0,2019-11-16,"(835.5, 971.25]",1,1,0
31098.0,2019-11-16,"(554.751, 617.25]",1,2,-1
31098.0,2019-11-16,"(617.25, 679.5]",1,2,-1
31099.0,2019-11-16,"(650.675, 651.0]",1,2,-1
31100.0,2019-11-16,"(547.461, 682.75]",2,2,0
31100.0,2019-11-16,"(682.75, 817.5]",2,3,-1
31100.0,2019-11-16,"(817.5, 952.25]",1,2,-1
31100.0,2019-11-16,"(952.25, 1087.0]",2,3,-1
31101.0,2019-11-16,"(25.604, 376.0]",2,7,-5
31101.0,2019-11-16,"(376.0, 725.0]",36,56,-20
31101.0,2019-11-16,"(725.0, 1074.0]",41,77,-36
31101.0,2019-11-16,"(1074.0, 1423.0]",22,31,-9
31102.0,2019-11-16,"(36.658, 373.5]",7,8,-1
31102.0,2019-11-16,"(373.5, 709.0]",1,15,-14
31102.0,2019-11-16,"(709.0, 1044.5]",13,33,-20
31102.0,2019-11-16,"(1044.5, 1380.0]",6,8,-2
31103.0,2019-11-16,"(43.628, 388.0]",2,3,-1
31103.0,2019-11-16,"(388.0, 731.0]",4,17,-13
31103.0,2019-11-16,"(731.0, 1074.0]",6,32,-26
31103.0,2019-11-16,"(1074.0, 1417.0]",4,26,-22
31104.0,2019-11-16,"(376.0, 726.0]",11,7,4
31104.0,2019-11-16,"(726.0, 1076.0]",20,24,-4
31104.0,2019-11-16,"(1076.0, 1426.0]",17,39,-22
31105.0,2019-11-16,"(346.189, 549.75]",1,4,-3
31105.0,2019-11-16,"(549.75, 752.5]",1,7,-6
31105.0,2019-11-16,"(752.5, 955.25]",8,18,-10
31105.0,2019-11-16,"(955.25, 1158.0]",2,7,-5
31106.0,2019-11-16,"(663.25, 861.5]",4,5,-1
31106.0,2019-11-16,"(861.5, 1059.75]",1,8,-7
31106.0,2019-11-16,"(1059.75, 1258.0]",2,2,0
31107.0,2019-11-16,"(50.626, 395.5]",3,6,-3
31107.0,2019-11-16,"(395.5, 739.0]",11,26,-15
31107.0,2019-11-16,"(739.0, 1082.5]",12,30,-18
31107.0,2019-11-16,"(1082.5, 1426.0]",8,14,-6
31108.0,2019-11-16,"(493.155, 705.25]",3,14,-11
31108.0,2019-11-16,"(705.25, 916.5]",9,28,-19
31108.0,2019-11-16,"(916.5, 1127.75]",19,32,-13
31108.0,2019-11-16,"(1127.75, 1339.0]",9,11,-2
31109.0,2019-11-16,"(6.586, 361.5]",2,6,-4
31109.0,2019-11-16,"(361.5, 715.0]",8,16,-8
31109.0,2019-11-16,"(715.0, 1068.5]",15,31,-16
31109.0,2019-11-16,"(1068.5, 1422.0]",11,20,-9
31110.0,2019-11-16,"(24.77, 333.5]",1,2,-1
31110.0,2019-11-16,"(333.5, 641.0]",8,13,-5
31110.0,2019-11-16,"(641.0, 948.5]",15,26,-11
31110.0,2019-11-16,"(948.5, 1256.0]",6,21,-15
31111.0,2019-11-16,"(24.609, 373.75]",2,3,-1
31111.0,2019-11-16,"(373.75, 721.5]",7,14,-7
31111.0,2019-11-16,"(721.5, 1069.25]",14,24,-10
31111.0,2019-11-16,"(1069.25, 1417.0]",12,22,-10
31112.0,2019-11-16,"(552.563, 662.25]",1,4,-3
31112.0,2019-11-16,"(662.25, 771.5]",5,7,-2
31112.0,2019-11-16,"(771.5, 880.75]",3,8,-5
31112.0,2019-11-16,"(880.75, 990.0]",9,12,-3
31113.0,2019-11-16,"(3.577, 360.75]",3,4,-1
31113.0,2019-11-16,"(360.75, 716.5]",5,11,-6
31113.0,2019-11-16,"(716.5, 1072.25]",10,26,-16
31113.0,2019-11-16,"(1072.25, 1428.0]",8,15,-7
31114.0,2019-11-16,"(346.75, 684.5]",8,4,4
31114.0,2019-11-16,"(684.5, 1022.25]",20,16,4
31114.0,2019-11-16,"(1022.25, 1360.0]",18,41,-23
31115.0,2019-11-16,"(82.66, 419.0]",1,3,-2
31115.0,2019-11-16,"(419.0, 754.0]",6,22,-16
31115.0,2019-11-16,"(754.0, 1089.0]",6,12,-6
31115.0,2019-11-16,"(1089.0, 1424.0]",3,7,-4
31116.0,2019-11-16,"(19.617, 366.75]",3,5,-2
31116.0,2019-11-16,"(366.75, 712.5]",6,14,-8
31116.0,2019-11-16,"(712.5, 1058.25]",21,33,-12
31116.0,2019-11-16,"(1058.25, 1404.0]",8,19,-11
31117.0,2019-11-16,"(396.0, 722.0]",8,1,7
31117.0,2019-11-16,"(722.0, 1048.0]",7,23,-16
31117.0,2019-11-16,"(1048.0, 1374.0]",7,17,-10
31118.0,2019-11-16,"(550.137, 766.75]",3,13,-10
31118.0,2019-11-16,"(766.75, 982.5]",9,15,-6
31118.0,2019-11-16,"(982.5, 1198.25]",9,13,-4
31118.0,2019-11-16,"(1198.25, 1414.0]",1,2,-1
31119.0,2019-11-16,"(33.644, 374.0]",2,2,0
31119.0,2019-11-16,"(374.0, 713.0]",9,23,-14
31119.0,2019-11-16,"(713.0, 1052.0]",10,23,-13
31119.0,2019-11-16,"(1052.0, 1391.0]",4,8,-4
31120.0,2019-11-16,"(376.0, 717.0]",2,2,0
31120.0,2019-11-16,"(717.0, 1058.0]",5,11,-6
31120.0,2019-11-16,"(1058.0, 1399.0]",12,9,3
31121.0,2019-11-16,"(32.598, 384.5]",4,5,-1
31121.0,2019-11-16,"(384.5, 735.0]",6,17,-11
31121.0,2019-11-16,"(735.0, 1085.5]",10,21,-11
31121.0,2019-11-16,"(1085.5, 1436.0]",4,7,-3
31122.0,2019-11-16,"(414.0, 743.0]",6,1,5
31122.0,2019-11-16,"(743.0, 1072.0]",8,13,-5
31122.0,2019-11-16,"(1072.0, 1401.0]",1,25,-24
31123.0,2019-11-16,"(435.016, 682.0]",3,7,-4
31123.0,2019-11-16,"(682.0, 928.0]",1,12,-11
31123.0,2019-11-16,"(928.0, 1174.0]",3,6,-3
31123.0,2019-11-16,"(1174.0, 1420.0]",5,9,-4
31124.0,2019-11-16,"(30.609, 379.75]",2,6,-4
31124.0,2019-11-16,"(379.75, 727.5]",14,41,-27
31124.0,2019-11-16,"(727.5, 1075.25]",30,73,-43
31124.0,2019-11-16,"(1075.25, 1423.0]",12,35,-23
31125.0,2019-11-16,"(134.699, 461.25]",5,9,-4
31125.0,2019-11-16,"(461.25, 786.5]",12,29,-17
31125.0,2019-11-16,"(786.5, 1111.75]",17,31,-14
31125.0,2019-11-16,"(1111.75, 1437.0]",6,15,-9
31126.0,2019-11-16,"(17.593, 370.75]",4,6,-2
31126.0,2019-11-16,"(370.75, 722.5]",1,11,-10
31126.0,2019-11-16,"(722.5, 1074.25]",11,19,-8
31126.0,2019-11-16,"(1074.25, 1426.0]",10,20,-10
31127.0,2019-11-16,"(352.75, 660.5]",4,3,1
31127.0,2019-11-16,"(660.5, 968.25]",4,5,-1
31127.0,2019-11-16,"(968.25, 1276.0]",4,13,-9
31128.0,2019-11-16,"(1.632, 345.0]",2,5,-3
31128.0,2019-11-16,"(345.0, 687.0]",13,21,-8
31128.0,2019-11-16,"(687.0, 1029.0]",20,33,-13
31128.0,2019-11-16,"(1029.0, 1371.0]",4,13,-9
31129.0,2019-11-16,"(679.296, 856.0]",10,15,-5
31129.0,2019-11-16,"(856.0, 1032.0]",8,14,-6
31129.0,2019-11-16,"(1032.0, 1208.0]",11,15,-4
31129.0,2019-11-16,"(1208.0, 1384.0]",2,3,-1
31130.0,2019-11-16,"(27.754, 340.5]",1,1,0
31130.0,2019-11-16,"(340.5, 652.0]",2,8,-6
31130.0,2019-11-16,"(652.0, 963.5]",7,14,-7
31130.0,2019-11-16,"(963.5, 1275.0]",4,6,-2
31131.0,2019-11-16,"(109.681, 440.75]",1,1,0
31131.0,2019-11-16,"(770.5, 1100.25]",3,7,-4
31131.0,2019-11-16,"(1100.25, 1430.0]",1,4,-3
31200.0,2019-11-16,"(28.599, 380.25]",2,4,-2
31200.0,2019-11-16,"(380.25, 730.5]",14,22,-8
31200.0,2019-11-16,"(730.5, 1080.75]",26,47,-21
31200.0,2019-11-16,"(1080.75, 1431.0]",8,20,-12
31201.0,2019-11-16,"(13.594, 366.5]",1,8,-7
31201.0,2019-11-16,"(366.5, 718.0]",23,44,-21
31201.0,2019-11-16,"(718.0, 1069.5]",51,100,-49
31201.0,2019-11-16,"(1069.5, 1421.0]",12,23,-11
31202.0,2019-11-16,"(60.714, 383.5]",1,6,-5
31202.0,2019-11-16,"(383.5, 705.0]",9,16,-7
31202.0,2019-11-16,"(705.0, 1026.5]",29,51,-22
31202.0,2019-11-16,"(1026.5, 1348.0]",15,29,-14
31203.0,2019-11-16,"(2.607, 352.25]",1,6,-5
31203.0,2019-11-16,"(352.25, 700.5]",6,15,-9
31203.0,2019-11-16,"(700.5, 1048.75]",38,63,-25
31203.0,2019-11-16,"(1048.75, 1397.0]",9,22,-13
31204.0,2019-11-16,"(0.595, 353.25]",3,3,0
31204.0,2019-11-16,"(353.25, 704.5]",2,7,-5
31204.0,2019-11-16,"(704.5, 1055.75]",5,11,-6
31204.0,2019-11-16,"(1055.75, 1407.0]",2,6,-4
31205.0,2019-11-16,"(7.573, 365.75]",6,8,-2
31205.0,2019-11-16,"(365.75, 722.5]",6,7,-1
31205.0,2019-11-16,"(722.5, 1079.25]",8,15,-7
31205.0,2019-11-16,"(1079.25, 1436.0]",2,10,-8
,,,,2.0,
,,,,1.0,
,,,,1.0,
31207.0,2019-11-16,"(692.5, 823.0]",5,4,1
31207.0,2019-11-16,"(823.0, 953.5]",2,6,-4
31208.0,2019-11-16,"(493.077, 724.75]",1,3,-2
31208.0,2019-11-16,"(724.75, 955.5]",3,4,-1
31208.0,2019-11-16,"(955.5, 1186.25]",2,2,0
31208.0,2019-11-16,"(1186.25, 1417.0]",1,2,-1
31209.0,2019-11-16,"(15.941, 281.75]",2,2,0
31209.0,2019-11-16,"(281.75, 546.5]",1,1,0
31209.0,2019-11-16,"(546.5, 811.25]",4,8,-4
31209.0,2019-11-16,"(811.25, 1076.0]",6,12,-6
31211.0,2019-11-16,"(70.709, 394.75]",1,2,-1
31211.0,2019-11-16,"(717.5, 1040.25]",5,11,-6
31211.0,2019-11-16,"(1040.25, 1363.0]",6,8,-2
31212.0,2019-11-16,"(45.68, 377.0]",1,1,0
31212.0,2019-11-16,"(377.0, 707.0]",6,12,-6
31212.0,2019-11-16,"(707.0, 1037.0]",10,24,-14
31212.0,2019-11-16,"(1037.0, 1367.0]",9,14,-5
31213.0,2019-11-16,"(345.75, 681.5]",8,1,7
31213.0,2019-11-16,"(681.5, 1017.25]",16,10,6
31213.0,2019-11-16,"(1017.25, 1353.0]",4,23,-19
31214.0,2019-11-16,"(1.565, 361.75]",5,7,-2
31214.0,2019-11-16,"(361.75, 720.5]",16,25,-9
31214.0,2019-11-16,"(720.5, 1079.25]",22,46,-24
31214.0,2019-11-16,"(1079.25, 1438.0]",7,12,-5
31215.0,2019-11-16,"(478.069, 711.75]",4,4,0
31215.0,2019-11-16,"(711.75, 944.5]",11,15,-4
31215.0,2019-11-16,"(944.5, 1177.25]",10,16,-6
31216.0,2019-11-16,"(474.353, 636.75]",6,6,0
31216.0,2019-11-16,"(636.75, 798.5]",2,4,-2
31216.0,2019-11-16,"(798.5, 960.25]",4,6,-2
31216.0,2019-11-16,"(960.25, 1122.0]",3,7,-4
31217.0,2019-11-16,"(549.431, 692.25]",1,3,-2
31217.0,2019-11-16,"(834.5, 976.75]",6,7,-1
31217.0,2019-11-16,"(976.75, 1119.0]",1,3,-2
31218.0,2019-11-16,"(672.0, 801.0]",2,1,1
31218.0,2019-11-16,"(801.0, 930.0]",7,7,0
31218.0,2019-11-16,"(930.0, 1059.0]",2,9,-7
31219.0,2019-11-16,"(663.619, 759.25]",6,7,-1
31219.0,2019-11-16,"(759.25, 854.5]",5,7,-2
31219.0,2019-11-16,"(854.5, 949.75]",6,9,-3
31219.0,2019-11-16,"(949.75, 1045.0]",8,11,-3
31220.0,2019-11-16,"(99.069, 332.75]",1,1,0
31221.0,2019-11-16,"(111.743, 427.25]",3,4,-1
31221.0,2019-11-16,"(427.25, 741.5]",8,12,-4
31221.0,2019-11-16,"(741.5, 1055.75]",7,19,-12
31221.0,2019-11-16,"(1055.75, 1370.0]",6,10,-4
31222.0,2019-11-16,"(425.0, 692.0]",7,1,6
31222.0,2019-11-16,"(692.0, 959.0]",12,7,5
31222.0,2019-11-16,"(959.0, 1226.0]",1,18,-17
31223.0,2019-11-16,"(6.607, 356.25]",3,8,-5
31223.0,2019-11-16,"(356.25, 704.5]",8,18,-10
31223.0,2019-11-16,"(704.5, 1052.75]",22,36,-14
31223.0,2019-11-16,"(1052.75, 1401.0]",8,16,-8
31224.0,2019-11-16,"(547.278, 728.5]",3,7,-4
31224.0,2019-11-16,"(728.5, 909.0]",4,4,0
31224.0,2019-11-16,"(909.0, 1089.5]",2,4,-2
31225.0,2019-11-16,"(-0.375, 344.75]",1,1,0
31225.0,2019-11-16,"(344.75, 688.5]",6,6,0
31225.0,2019-11-16,"(688.5, 1032.25]",14,25,-11
31225.0,2019-11-16,"(1032.25, 1376.0]",5,12,-7
31226.0,2019-11-16,"(423.25, 611.5]",4,6,-2
31226.0,2019-11-16,"(611.5, 799.0]",3,8,-5
31226.0,2019-11-16,"(799.0, 986.5]",2,5,-3
31226.0,2019-11-16,"(986.5, 1174.0]",3,5,-2
31227.0,2019-11-16,"(523.221, 718.75]",4,7,-3
31227.0,2019-11-16,"(718.75, 913.5]",6,10,-4
31227.0,2019-11-16,"(913.5, 1108.25]",8,9,-1
31227.0,2019-11-16,"(1108.25, 1303.0]",5,7,-2
31228.0,2019-11-16,"(341.75, 672.5]",8,2,6
31228.0,2019-11-16,"(672.5, 1003.25]",30,12,18
31228.0,2019-11-16,"(1003.25, 1334.0]",17,41,-24
31229.0,2019-11-16,"(11.596, 364.0]",5,6,-1
31229.0,2019-11-16,"(364.0, 715.0]",27,60,-33
31229.0,2019-11-16,"(715.0, 1066.0]",35,72,-37
31229.0,2019-11-16,"(1066.0, 1417.0]",17,30,-13
31230.0,2019-11-16,"(320.75, 639.5]",6,3,3
31230.0,2019-11-16,"(639.5, 958.25]",14,7,7
31230.0,2019-11-16,"(958.25, 1277.0]",10,29,-19
31231.0,2019-11-16,"(679.0, 862.0]",3,5,-2
31231.0,2019-11-16,"(862.0, 1045.0]",10,5,5
31231.0,2019-11-16,"(1045.0, 1228.0]",2,11,-9
31232.0,2019-11-16,"(337.913, 610.75]",3,4,-1
31232.0,2019-11-16,"(610.75, 882.5]",19,25,-6
31232.0,2019-11-16,"(882.5, 1154.25]",19,29,-10
31232.0,2019-11-16,"(1154.25, 1426.0]",6,10,-4
31233.0,2019-11-16,"(441.064, 676.0]",3,6,-3
31233.0,2019-11-16,"(676.0, 910.0]",5,10,-5
31233.0,2019-11-16,"(910.0, 1144.0]",5,9,-4
31233.0,2019-11-16,"(1144.0, 1378.0]",2,6,-4
31234.0,2019-11-16,"(357.25, 713.5]",7,2,5
31234.0,2019-11-16,"(713.5, 1069.75]",13,14,-1
31234.0,2019-11-16,"(1069.75, 1426.0]",4,25,-21
31235.0,2019-11-16,"(438.189, 641.75]",1,1,0
31235.0,2019-11-16,"(844.5, 1047.25]",8,3,5
31235.0,2019-11-16,"(1047.25, 1250.0]",6,8,-2
31236.0,2019-11-16,"(397.25, 715.5]",6,1,5
31236.0,2019-11-16,"(715.5, 1033.75]",16,7,9
31237.0,2019-11-16,"(10.72, 332.0]",2,2,0
31237.0,2019-11-16,"(332.0, 652.0]",3,10,-7
31237.0,2019-11-16,"(652.0, 972.0]",16,30,-14
31237.0,2019-11-16,"(972.0, 1292.0]",9,18,-9
31238.0,2019-11-16,"(57.877, 339.75]",1,3,-2
31238.0,2019-11-16,"(339.75, 620.5]",2,5,-3
31238.0,2019-11-16,"(620.5, 901.25]",3,8,-5
31238.0,2019-11-16,"(901.25, 1182.0]",5,5,0
31239.0,2019-11-16,"(526.107, 750.25]",9,11,-2
31239.0,2019-11-16,"(750.25, 973.5]",5,10,-5
31239.0,2019-11-16,"(973.5, 1196.75]",8,14,-6
31239.0,2019-11-16,"(1196.75, 1420.0]",4,10,-6
31240.0,2019-11-16,"(637.396, 789.0]",4,7,-3
31240.0,2019-11-16,"(789.0, 940.0]",17,32,-15
31240.0,2019-11-16,"(940.0, 1091.0]",2,4,-2
31240.0,2019-11-16,"(1091.0, 1242.0]",2,4,-2
31241.0,2019-11-16,"(89.71, 413.5]",2,9,-7
31241.0,2019-11-16,"(413.5, 736.0]",7,18,-11
31241.0,2019-11-16,"(736.0, 1058.5]",14,25,-11
31241.0,2019-11-16,"(1058.5, 1381.0]",9,15,-6
31242.0,2019-11-16,"(571.514, 693.5]",3,3,0
31242.0,2019-11-16,"(693.5, 815.0]",2,5,-3
31242.0,2019-11-16,"(815.0, 936.5]",1,1,0
31242.0,2019-11-16,"(936.5, 1058.0]",1,4,-3
31243.0,2019-11-16,"(78.642, 419.5]",1,1,0
31243.0,2019-11-16,"(419.5, 759.0]",6,16,-10
31243.0,2019-11-16,"(759.0, 1098.5]",10,16,-6
31243.0,2019-11-16,"(1098.5, 1438.0]",7,12,-5
31244.0,2019-11-16,"(705.0, 1038.5]",7,2,5
31244.0,2019-11-16,"(1038.5, 1372.0]",6,2,4
31245.0,2019-11-16,"(20.628, 365.0]",1,4,-3
31245.0,2019-11-16,"(365.0, 708.0]",7,10,-3
31245.0,2019-11-16,"(708.0, 1051.0]",9,22,-13
31245.0,2019-11-16,"(1051.0, 1394.0]",13,27,-14
31246.0,2019-11-16,"(20.853, 308.75]",1,3,-2
31246.0,2019-11-16,"(308.75, 595.5]",6,9,-3
31246.0,2019-11-16,"(595.5, 882.25]",13,22,-9
31246.0,2019-11-16,"(882.25, 1169.0]",18,39,-21
31247.0,2019-11-16,"(549.264, 734.0]",16,30,-14
31247.0,2019-11-16,"(734.0, 918.0]",23,41,-18
31247.0,2019-11-16,"(918.0, 1102.0]",11,35,-24
31248.0,2019-11-16,"(536.476, 668.0]",4,5,-1
31248.0,2019-11-16,"(668.0, 799.0]",13,20,-7
31248.0,2019-11-16,"(799.0, 930.0]",8,24,-16
31248.0,2019-11-16,"(930.0, 1061.0]",17,27,-10
31249.0,2019-11-16,"(478.501, 603.75]",3,4,-1
31249.0,2019-11-16,"(728.5, 853.25]",17,35,-18
31249.0,2019-11-16,"(853.25, 978.0]",13,22,-9
31250.0,2019-11-16,"(507.75, 744.5]",2,1,1
31250.0,2019-11-16,"(744.5, 981.25]",2,2,0
31250.0,2019-11-16,"(981.25, 1218.0]",3,4,-1
31251.0,2019-11-16,"(12.58, 369.0]",1,3,-2
31251.0,2019-11-16,"(369.0, 724.0]",4,9,-5
31251.0,2019-11-16,"(724.0, 1079.0]",8,14,-6
31251.0,2019-11-16,"(1079.0, 1434.0]",12,17,-5
31252.0,2019-11-16,"(513.172, 721.0]",3,5,-2
31252.0,2019-11-16,"(721.0, 928.0]",1,3,-2
31252.0,2019-11-16,"(928.0, 1135.0]",1,2,-1
31253.0,2019-11-16,"(473.202, 673.5]",3,4,-1
31253.0,2019-11-16,"(673.5, 873.0]",2,5,-3
31253.0,2019-11-16,"(873.0, 1072.5]",2,5,-3
31253.0,2019-11-16,"(1072.5, 1272.0]",1,5,-4
31254.0,2019-11-16,"(1.59, 355.5]",1,1,0
31254.0,2019-11-16,"(355.5, 708.0]",5,6,-1
31254.0,2019-11-16,"(708.0, 1060.5]",5,14,-9
31254.0,2019-11-16,"(1060.5, 1413.0]",2,4,-2
31255.0,2019-11-16,"(425.267, 609.25]",2,2,0
31255.0,2019-11-16,"(792.5, 975.75]",2,2,0
31255.0,2019-11-16,"(975.75, 1159.0]",2,4,-2
31256.0,2019-11-16,"(625.342, 790.5]",7,8,-1
31256.0,2019-11-16,"(790.5, 955.0]",5,9,-4
31256.0,2019-11-16,"(955.0, 1119.5]",1,2,-1
31256.0,2019-11-16,"(1119.5, 1284.0]",2,6,-4
31257.0,2019-11-16,"(503.111, 726.25]",10,16,-6
31257.0,2019-11-16,"(726.25, 948.5]",4,9,-5
31257.0,2019-11-16,"(948.5, 1170.75]",6,13,-7
31257.0,2019-11-16,"(1170.75, 1393.0]",2,6,-4
31258.0,2019-11-16,"(605.57, 713.5]",9,25,-16
31258.0,2019-11-16,"(713.5, 821.0]",37,64,-27
31258.0,2019-11-16,"(821.0, 928.5]",9,26,-17
31258.0,2019-11-16,"(928.5, 1036.0]",2,7,-5
,,,,2.0,
31260.0,2019-11-16,"(501.231, 694.25]",2,5,-3
31260.0,2019-11-16,"(694.25, 886.5]",2,4,-2
31260.0,2019-11-16,"(886.5, 1078.75]",1,2,-1
31260.0,2019-11-16,"(1078.75, 1271.0]",1,1,0
31261.0,2019-11-16,"(936.5, 1090.75]",1,4,-3
31261.0,2019-11-16,"(1090.75, 1245.0]",4,2,2
31262.0,2019-11-16,"(625.203, 825.25]",7,10,-3
31262.0,2019-11-16,"(825.25, 1024.5]",12,21,-9
31262.0,2019-11-16,"(1024.5, 1223.75]",6,8,-2
31263.0,2019-11-16,"(2.591, 356.25]",2,2,0
31263.0,2019-11-16,"(356.25, 708.5]",7,12,-5
31263.0,2019-11-16,"(708.5, 1060.75]",15,23,-8
31263.0,2019-11-16,"(1060.75, 1413.0]",6,12,-6
31264.0,2019-11-16,"(494.101, 719.75]",6,6,0
31264.0,2019-11-16,"(719.75, 944.5]",3,7,-4
31264.0,2019-11-16,"(944.5, 1169.25]",3,3,0
31265.0,2019-11-16,"(18.62, 365.0]",5,11,-6
31265.0,2019-11-16,"(365.0, 710.0]",5,14,-9
31265.0,2019-11-16,"(710.0, 1055.0]",9,22,-13
31265.0,2019-11-16,"(1055.0, 1400.0]",8,16,-8
31266.0,2019-11-16,"(44.635, 387.25]",4,4,0
31266.0,2019-11-16,"(387.25, 728.5]",5,22,-17
31266.0,2019-11-16,"(728.5, 1069.75]",16,38,-22
31266.0,2019-11-16,"(1069.75, 1411.0]",14,25,-11
31267.0,2019-11-16,"(416.25, 749.5]",13,3,10
31267.0,2019-11-16,"(749.5, 1082.75]",7,18,-11
31267.0,2019-11-16,"(1082.75, 1416.0]",9,15,-6
31268.0,2019-11-16,"(46.62, 393.0]",3,7,-4
31268.0,2019-11-16,"(393.0, 738.0]",15,29,-14
31268.0,2019-11-16,"(738.0, 1083.0]",20,27,-7
31268.0,2019-11-16,"(1083.0, 1428.0]",15,28,-13
31269.0,2019-11-16,"(590.363, 750.25]",7,9,-2
31269.0,2019-11-16,"(750.25, 909.5]",6,13,-7
31269.0,2019-11-16,"(909.5, 1068.75]",6,13,-7
31270.0,2019-11-16,"(508.355, 670.25]",10,13,-3
31270.0,2019-11-16,"(670.25, 831.5]",3,6,-3
31270.0,2019-11-16,"(831.5, 992.75]",6,11,-5
31270.0,2019-11-16,"(992.75, 1154.0]",5,10,-5
31271.0,2019-11-16,"(10.662, 346.5]",1,1,0
31271.0,2019-11-16,"(681.0, 1015.5]",25,45,-20
31271.0,2019-11-16,"(1015.5, 1350.0]",1,3,-2
31272.0,2019-11-16,"(597.279, 778.25]",10,13,-3
31272.0,2019-11-16,"(778.25, 958.5]",12,19,-7
31272.0,2019-11-16,"(958.5, 1138.75]",3,9,-6
31272.0,2019-11-16,"(1138.75, 1319.0]",1,1,0
31273.0,2019-11-16,"(460.635, 552.25]",4,4,0
31273.0,2019-11-16,"(734.75, 826.0]",1,3,-2
31274.0,2019-11-16,"(417.242, 607.5]",1,3,-2
31274.0,2019-11-16,"(607.5, 797.0]",4,13,-9
31274.0,2019-11-16,"(797.0, 986.5]",6,10,-4
31274.0,2019-11-16,"(986.5, 1176.0]",1,5,-4
31275.0,2019-11-16,"(368.959, 630.25]",2,7,-5
31275.0,2019-11-16,"(630.25, 890.5]",9,20,-11
31275.0,2019-11-16,"(890.5, 1150.75]",10,18,-8
31275.0,2019-11-16,"(1150.75, 1411.0]",4,7,-3
31276.0,2019-11-16,"(471.048, 710.0]",5,7,-2
31276.0,2019-11-16,"(710.0, 948.0]",3,8,-5
31276.0,2019-11-16,"(948.0, 1186.0]",3,5,-2
31276.0,2019-11-16,"(1186.0, 1424.0]",1,1,0
31277.0,2019-11-16,"(323.062, 558.5]",2,3,-1
31277.0,2019-11-16,"(558.5, 793.0]",12,17,-5
31277.0,2019-11-16,"(793.0, 1027.5]",10,15,-5
31277.0,2019-11-16,"(1027.5, 1262.0]",6,12,-6
31278.0,2019-11-16,"(9.628, 354.0]",4,5,-1
31278.0,2019-11-16,"(354.0, 697.0]",12,23,-11
31278.0,2019-11-16,"(697.0, 1040.0]",23,45,-22
31278.0,2019-11-16,"(1040.0, 1383.0]",14,22,-8
31279.0,2019-11-16,"(568.385, 722.75]",1,1,0
31279.0,2019-11-16,"(876.5, 1030.25]",1,3,-2
31279.0,2019-11-16,"(1030.25, 1184.0]",2,2,0
31280.0,2019-11-16,"(2.566, 362.5]",4,8,-4
31280.0,2019-11-16,"(362.5, 721.0]",16,28,-12
31280.0,2019-11-16,"(721.0, 1079.5]",14,29,-15
31280.0,2019-11-16,"(1079.5, 1438.0]",9,20,-11
31000.0,2019-11-17,"(1063.0, 1093.0]",1,1,0
31001.0,2019-11-17,"(76.784, 382.0]",2,2,0
31001.0,2019-11-17,"(990.0, 1294.0]",2,7,-5
31002.0,2019-11-17,"(878.5, 958.25]",1,2,-1
31002.0,2019-11-17,"(958.25, 1038.0]",2,1,1
31003.0,2019-11-17,"(684.5, 740.0]",1,2,-1
31003.0,2019-11-17,"(795.5, 851.0]",1,1,0
31004.0,2019-11-17,"(875.0, 1001.0]",1,1,0
31005.0,2019-11-17,"(830.25, 890.0]",2,1,1
31006.0,2019-11-17,"(607.306, 781.5]",3,5,-2
31006.0,2019-11-17,"(781.5, 955.0]",2,4,-2
31006.0,2019-11-17,"(955.0, 1128.5]",1,2,-1
31006.0,2019-11-17,"(1128.5, 1302.0]",1,1,0
31007.0,2019-11-17,"(999.0, 1162.0]",1,3,-2
31007.0,2019-11-17,"(1162.0, 1325.0]",4,1,3
31009.0,2019-11-17,"(833.754, 895.5]",1,1,0
31009.0,2019-11-17,"(1018.5, 1080.0]",2,4,-2
31010.0,2019-11-17,"(707.495, 834.25]",3,4,-1
31010.0,2019-11-17,"(834.25, 960.5]",1,2,-1
31010.0,2019-11-17,"(960.5, 1086.75]",1,1,0
31010.0,2019-11-17,"(1086.75, 1213.0]",1,3,-2
31011.0,2019-11-17,"(452.436, 594.0]",1,2,-1
31011.0,2019-11-17,"(594.0, 735.0]",1,1,0
31011.0,2019-11-17,"(876.0, 1017.0]",1,2,-1
,,,,2.0,
31013.0,2019-11-17,"(834.25, 1088.0]",4,2,2
31014.0,2019-11-17,"(88.884, 369.0]",2,3,-1
31014.0,2019-11-17,"(369.0, 648.0]",1,5,-4
31014.0,2019-11-17,"(648.0, 927.0]",14,16,-2
31014.0,2019-11-17,"(927.0, 1206.0]",6,7,-1
31015.0,2019-11-17,"(342.042, 582.5]",3,3,0
31015.0,2019-11-17,"(582.5, 822.0]",3,7,-4
31015.0,2019-11-17,"(822.0, 1061.5]",5,9,-4
31015.0,2019-11-17,"(1061.5, 1301.0]",1,3,-2
,,,,1.0,
,,,,1.0,
,,,,2.0,
31018.0,2019-11-17,"(546.479, 677.25]",1,6,-5
31018.0,2019-11-17,"(677.25, 807.5]",2,2,0
31018.0,2019-11-17,"(937.75, 1068.0]",1,4,-3
31019.0,2019-11-17,"(761.5, 838.25]",1,1,0
31020.0,2019-11-17,"(871.0, 1151.0]",1,1,0
31021.0,2019-11-17,"(600.0, 856.0]",3,1,2
31021.0,2019-11-17,"(856.0, 1112.0]",1,5,-4
31022.0,2019-11-17,"(566.226, 760.5]",2,3,-1
31022.0,2019-11-17,"(760.5, 954.0]",1,3,-2
31022.0,2019-11-17,"(954.0, 1147.5]",1,4,-3
31023.0,2019-11-17,"(703.0, 1024.0]",2,2,0
31023.0,2019-11-17,"(1024.0, 1345.0]",1,4,-3
31024.0,2019-11-17,"(441.249, 629.75]",1,4,-3
31024.0,2019-11-17,"(629.75, 817.5]",1,1,0
31024.0,2019-11-17,"(817.5, 1005.25]",1,1,0
31024.0,2019-11-17,"(1005.25, 1193.0]",1,3,-2
31025.0,2019-11-17,"(719.824, 764.0]",1,1,0
31026.0,2019-11-17,"(842.917, 863.75]",1,2,-1
31026.0,2019-11-17,"(905.25, 926.0]",1,1,0
31027.0,2019-11-17,"(1106.0, 1267.0]",1,1,0
,,,,1.0,
,,,,1.0,
31029.0,2019-11-17,"(2.112, 225.0]",1,1,0
31029.0,2019-11-17,"(447.0, 669.0]",1,2,-1
31029.0,2019-11-17,"(669.0, 891.0]",1,5,-4
31030.0,2019-11-17,"(33.113, 255.75]",1,1,0
31030.0,2019-11-17,"(699.25, 921.0]",2,1,1
31031.0,2019-11-17,"(678.563, 788.25]",1,4,-3
31031.0,2019-11-17,"(1006.75, 1116.0]",2,2,0
31032.0,2019-11-17,"(829.0, 948.0]",1,1,0
31033.0,2019-11-17,"(978.75, 983.0]",1,1,0
31034.0,2019-11-17,"(96.72, 418.0]",1,1,0
31034.0,2019-11-17,"(418.0, 738.0]",1,1,0
31034.0,2019-11-17,"(738.0, 1058.0]",3,8,-5
31034.0,2019-11-17,"(1058.0, 1378.0]",4,4,0
31035.0,2019-11-17,"(351.973, 609.75]",1,2,-1
31035.0,2019-11-17,"(866.5, 1123.25]",1,2,-1
31035.0,2019-11-17,"(1123.25, 1380.0]",1,2,-1
31036.0,2019-11-17,"(718.25, 900.5]",1,1,0
31036.0,2019-11-17,"(1082.75, 1265.0]",2,2,0
31037.0,2019-11-17,"(543.162, 753.5]",2,3,-1
31037.0,2019-11-17,"(753.5, 963.0]",3,4,-1
31037.0,2019-11-17,"(963.0, 1172.5]",3,6,-3
31038.0,2019-11-17,"(1171.75, 1245.0]",1,1,0
31039.0,2019-11-17,"(921.25, 1065.0]",1,1,0
,,,,1.0,
,,,,2.0,
,,,,2.0,
31041.0,2019-11-17,"(617.712, 690.0]",5,7,-2
31041.0,2019-11-17,"(690.0, 762.0]",1,2,-1
31041.0,2019-11-17,"(834.0, 906.0]",1,1,0
31042.0,2019-11-17,"(786.75, 1037.0]",1,1,0
31043.0,2019-11-17,"(495.605, 594.75]",2,3,-1
31044.0,2019-11-17,"(587.5, 881.25]",2,1,1
31044.0,2019-11-17,"(881.25, 1175.0]",3,2,1
31045.0,2019-11-17,"(1221.0, 1373.0]",1,1,0
,,,,2.0,
31047.0,2019-11-17,"(45.942, 311.5]",1,1,0
31047.0,2019-11-17,"(576.0, 840.5]",3,3,0
31048.0,2019-11-17,"(952.832, 995.0]",1,1,0
31049.0,2019-11-17,"(65.884, 346.0]",2,2,0
31049.0,2019-11-17,"(346.0, 625.0]",1,2,-1
31049.0,2019-11-17,"(904.0, 1183.0]",1,1,0
31050.0,2019-11-17,"(327.75, 655.5]",1,1,0
31050.0,2019-11-17,"(655.5, 983.25]",2,1,1
31050.0,2019-11-17,"(983.25, 1311.0]",1,2,-1
31051.0,2019-11-17,"(377.28, 558.0]",1,1,0
31051.0,2019-11-17,"(558.0, 738.0]",1,1,0
31051.0,2019-11-17,"(918.0, 1098.0]",1,2,-1
31052.0,2019-11-17,"(1036.75, 1043.0]",1,1,0
31053.0,2019-11-17,"(906.0, 939.0]",2,1,1
,,,,2.0,
,,,,2.0,
,,,,1.0,
,,,,1.0,
31057.0,2019-11-17,"(728.846, 767.5]",1,2,-1
31057.0,2019-11-17,"(844.5, 883.0]",1,2,-1
,,,,2.0,
31059.0,2019-11-17,"(733.25, 823.5]",3,2,1
31059.0,2019-11-17,"(823.5, 913.75]",1,4,-3
31059.0,2019-11-17,"(913.75, 1004.0]",1,2,-1
31060.0,2019-11-17,"(663.69, 741.5]",2,2,0
31060.0,2019-11-17,"(819.0, 896.5]",1,2,-1
31061.0,2019-11-17,"(444.75, 593.0]",1,1,0
31062.0,2019-11-17,"(648.721, 718.75]",2,6,-4
31062.0,2019-11-17,"(718.75, 788.5]",5,9,-4
31062.0,2019-11-17,"(788.5, 858.25]",2,2,0
31063.0,2019-11-17,"(651.999, 652.25]",2,2,0
31064.0,2019-11-17,"(597.642, 687.5]",4,6,-2
31064.0,2019-11-17,"(687.5, 777.0]",4,6,-2
31064.0,2019-11-17,"(777.0, 866.5]",3,6,-3
31064.0,2019-11-17,"(866.5, 956.0]",3,6,-3
,,,,1.0,
,,,,1.0,
,,,,2.0,
31067.0,2019-11-17,"(676.591, 779.25]",1,2,-1
31067.0,2019-11-17,"(983.75, 1086.0]",1,1,0
31068.0,2019-11-17,"(1022.25, 1363.0]",1,1,0
31069.0,2019-11-17,"(940.0, 1044.5]",1,2,-1
31069.0,2019-11-17,"(1044.5, 1149.0]",1,2,-1
31070.0,2019-11-17,"(668.365, 827.75]",1,2,-1
31070.0,2019-11-17,"(986.5, 1145.25]",1,2,-1
31070.0,2019-11-17,"(1145.25, 1304.0]",1,1,0
31071.0,2019-11-17,"(447.285, 626.75]",2,5,-3
31071.0,2019-11-17,"(626.75, 805.5]",2,2,0
31071.0,2019-11-17,"(805.5, 984.25]",1,1,0
31071.0,2019-11-17,"(984.25, 1163.0]",1,6,-5
,,,,2.0,
31073.0,2019-11-17,"(752.684, 832.0]",3,6,-3
31073.0,2019-11-17,"(832.0, 911.0]",1,1,0
31074.0,2019-11-17,"(821.769, 879.75]",1,1,0
,,,,1.0,
,,,,1.0,
31076.0,2019-11-17,"(698.883, 728.25]",1,1,0
31077.0,2019-11-17,"(616.277, 797.75]",3,11,-8
31077.0,2019-11-17,"(797.75, 978.5]",4,4,0
31077.0,2019-11-17,"(978.5, 1159.25]",2,5,-3
31077.0,2019-11-17,"(1159.25, 1340.0]",1,1,0
,,,,2.0,
31079.0,2019-11-17,"(595.249, 783.75]",2,3,-1
31079.0,2019-11-17,"(783.75, 971.5]",1,2,-1
31079.0,2019-11-17,"(971.5, 1159.25]",1,1,0
31079.0,2019-11-17,"(1159.25, 1347.0]",1,1,0
31080.0,2019-11-17,"(10.612, 359.0]",1,1,0
31080.0,2019-11-17,"(359.0, 706.0]",2,2,0
31080.0,2019-11-17,"(706.0, 1053.0]",1,3,-2
31080.0,2019-11-17,"(1053.0, 1400.0]",1,2,-1
,,,,1.0,
,,,,2.0,
,,,,2.0,
31082.0,2019-11-17,"(564.75, 753.0]",1,1,0
,,,,2.0,
31084.0,2019-11-17,"(898.0, 974.0]",1,1,0
31085.0,2019-11-17,"(486.0, 729.0]",1,1,0
31085.0,2019-11-17,"(729.0, 972.0]",4,1,3
31086.0,2019-11-17,"(750.5, 777.0]",1,1,0
31087.0,2019-11-17,"(991.5, 1050.0]",1,1,0
31088.0,2019-11-17,"(1193.5, 1223.0]",1,2,-1
31089.0,2019-11-17,"(660.398, 811.5]",2,9,-7
31089.0,2019-11-17,"(811.5, 962.0]",2,3,-1
31089.0,2019-11-17,"(962.0, 1112.5]",1,2,-1
31089.0,2019-11-17,"(1112.5, 1263.0]",2,3,-1
31090.0,2019-11-17,"(915.898, 941.5]",1,1,0
31091.0,2019-11-17,"(1312.75, 1331.0]",1,1,0
31092.0,2019-11-17,"(730.75, 974.0]",1,1,0
,,,,1.0,
,,,,1.0,
,,,,1.0,
,,,,2.0,
31095.0,2019-11-17,"(786.0, 1048.0]",1,1,0
31096.0,2019-11-17,"(828.75, 975.5]",1,1,0
31097.0,2019-11-17,"(899.733, 966.75]",1,3,-2
31098.0,2019-11-17,"(659.25, 879.0]",2,1,1
,,,,2.0,
31100.0,2019-11-17,"(476.292, 654.0]",1,1,0
31100.0,2019-11-17,"(831.0, 1008.0]",1,2,-1
31100.0,2019-11-17,"(1008.0, 1185.0]",4,1,3
31101.0,2019-11-17,"(347.0, 666.0]",14,4,10
31101.0,2019-11-17,"(666.0, 985.0]",36,35,1
31101.0,2019-11-17,"(985.0, 1304.0]",21,53,-32
31102.0,2019-11-17,"(6.788, 311.0]",3,7,-4
31102.0,2019-11-17,"(614.0, 917.0]",9,2,7
31102.0,2019-11-17,"(917.0, 1220.0]",7,29,-22
31103.0,2019-11-17,"(78.709, 402.75]",2,5,-3
31103.0,2019-11-17,"(402.75, 725.5]",5,16,-11
31103.0,2019-11-17,"(725.5, 1048.25]",10,36,-26
31103.0,2019-11-17,"(1048.25, 1371.0]",11,21,-10
31104.0,2019-11-17,"(368.75, 721.5]",12,8,4
31104.0,2019-11-17,"(721.5, 1074.25]",10,20,-10
31104.0,2019-11-17,"(1074.25, 1427.0]",7,19,-12
31105.0,2019-11-17,"(707.575, 814.25]",2,7,-5
31105.0,2019-11-17,"(920.5, 1026.75]",1,2,-1
31105.0,2019-11-17,"(1026.75, 1133.0]",3,4,-1
31106.0,2019-11-17,"(1052.75, 1228.0]",1,1,0
31107.0,2019-11-17,"(14.654, 352.5]",2,3,-1
31107.0,2019-11-17,"(352.5, 689.0]",2,6,-4
31107.0,2019-11-17,"(689.0, 1025.5]",18,38,-20
31107.0,2019-11-17,"(1025.5, 1362.0]",11,19,-8
31108.0,2019-11-17,"(47.632, 391.0]",3,3,0
31108.0,2019-11-17,"(391.0, 733.0]",4,12,-8
31108.0,2019-11-17,"(733.0, 1075.0]",14,31,-17
31108.0,2019-11-17,"(1075.0, 1417.0]",9,10,-1
31109.0,2019-11-17,"(32.647, 372.25]",3,6,-3
31109.0,2019-11-17,"(372.25, 710.5]",8,15,-7
31109.0,2019-11-17,"(710.5, 1048.75]",10,15,-5
31109.0,2019-11-17,"(1048.75, 1387.0]",8,20,-12
31110.0,2019-11-17,"(50.657, 387.75]",1,2,-1
31110.0,2019-11-17,"(387.75, 723.5]",13,28,-15
31110.0,2019-11-17,"(723.5, 1059.25]",16,36,-20
31110.0,2019-11-17,"(1059.25, 1395.0]",11,17,-6
31111.0,2019-11-17,"(11.624, 357.0]",3,9,-6
31111.0,2019-11-17,"(357.0, 701.0]",7,10,-3
31111.0,2019-11-17,"(701.0, 1045.0]",9,17,-8
31111.0,2019-11-17,"(1045.0, 1389.0]",7,14,-7
31112.0,2019-11-17,"(438.0, 584.0]",1,1,0
31113.0,2019-11-17,"(423.068, 657.0]",4,15,-11
31113.0,2019-11-17,"(657.0, 890.0]",4,13,-9
31113.0,2019-11-17,"(890.0, 1123.0]",4,17,-13
31113.0,2019-11-17,"(1123.0, 1356.0]",3,7,-4
31114.0,2019-11-17,"(8.639, 350.25]",4,14,-10
31114.0,2019-11-17,"(350.25, 690.5]",1,5,-4
31114.0,2019-11-17,"(690.5, 1030.75]",13,28,-15
31114.0,2019-11-17,"(1030.75, 1371.0]",8,16,-8
31115.0,2019-11-17,"(90.793, 393.75]",2,2,0
31115.0,2019-11-17,"(393.75, 695.5]",4,11,-7
31115.0,2019-11-17,"(695.5, 997.25]",8,15,-7
31115.0,2019-11-17,"(997.25, 1299.0]",7,13,-6
31116.0,2019-11-17,"(417.047, 656.25]",6,16,-10
31116.0,2019-11-17,"(656.25, 894.5]",7,15,-8
31116.0,2019-11-17,"(894.5, 1132.75]",6,14,-8
31116.0,2019-11-17,"(1132.75, 1371.0]",8,12,-4
31117.0,2019-11-17,"(359.75, 717.5]",6,1,5
31117.0,2019-11-17,"(717.5, 1075.25]",7,11,-4
31117.0,2019-11-17,"(1075.25, 1433.0]",6,18,-12
31118.0,2019-11-17,"(455.0, 767.0]",4,1,3
31118.0,2019-11-17,"(767.0, 1079.0]",12,10,2
31118.0,2019-11-17,"(1079.0, 1391.0]",8,28,-20
31119.0,2019-11-17,"(416.243, 606.25]",3,7,-4
31119.0,2019-11-17,"(606.25, 795.5]",6,8,-2
31119.0,2019-11-17,"(795.5, 984.75]",5,11,-6
31119.0,2019-11-17,"(984.75, 1174.0]",9,17,-8
31120.0,2019-11-17,"(141.765, 451.75]",3,3,0
31120.0,2019-11-17,"(451.75, 760.5]",2,11,-9
31120.0,2019-11-17,"(760.5, 1069.25]",6,12,-6
31120.0,2019-11-17,"(1069.25, 1378.0]",5,9,-4
31121.0,2019-11-17,"(14.654, 352.5]",1,3,-2
31121.0,2019-11-17,"(352.5, 689.0]",8,15,-7
31121.0,2019-11-17,"(689.0, 1025.5]",8,15,-7
31121.0,2019-11-17,"(1025.5, 1362.0]",6,13,-7
31122.0,2019-11-17,"(21.661, 357.75]",2,3,-1
31122.0,2019-11-17,"(357.75, 692.5]",3,5,-2
31122.0,2019-11-17,"(692.5, 1027.25]",3,7,-4
31123.0,2019-11-17,"(43.61, 392.5]",1,2,-1
31123.0,2019-11-17,"(392.5, 740.0]",1,4,-3
31123.0,2019-11-17,"(740.0, 1087.5]",2,6,-4
31123.0,2019-11-17,"(1087.5, 1435.0]",2,4,-2
31124.0,2019-11-17,"(22.632, 366.0]",1,3,-2
31124.0,2019-11-17,"(366.0, 708.0]",11,26,-15
31124.0,2019-11-17,"(708.0, 1050.0]",23,60,-37
31124.0,2019-11-17,"(1050.0, 1392.0]",9,30,-21
31125.0,2019-11-17,"(39.608, 389.0]",1,5,-4
31125.0,2019-11-17,"(389.0, 737.0]",6,14,-8
31125.0,2019-11-17,"(737.0, 1085.0]",24,41,-17
31125.0,2019-11-17,"(1085.0, 1433.0]",11,16,-5
31126.0,2019-11-17,"(20.724, 341.0]",1,8,-7
31126.0,2019-11-17,"(341.0, 660.0]",1,13,-12
31126.0,2019-11-17,"(660.0, 979.0]",8,16,-8
31126.0,2019-11-17,"(979.0, 1298.0]",11,18,-7
31127.0,2019-11-17,"(425.006, 674.5]",7,10,-3
31127.0,2019-11-17,"(674.5, 923.0]",4,8,-4
31127.0,2019-11-17,"(923.0, 1171.5]",7,15,-8
31127.0,2019-11-17,"(1171.5, 1420.0]",5,9,-4
31128.0,2019-11-17,"(22.599, 374.25]",1,4,-3
31128.0,2019-11-17,"(374.25, 724.5]",12,27,-15
31128.0,2019-11-17,"(724.5, 1074.75]",15,26,-11
31128.0,2019-11-17,"(1074.75, 1425.0]",1,4,-3
31129.0,2019-11-17,"(587.427, 731.25]",4,7,-3
31129.0,2019-11-17,"(731.25, 874.5]",6,11,-5
31129.0,2019-11-17,"(874.5, 1017.75]",5,5,0
31129.0,2019-11-17,"(1017.75, 1161.0]",5,8,-3
31130.0,2019-11-17,"(327.75, 619.5]",1,1,0
31130.0,2019-11-17,"(619.5, 911.25]",7,5,2
31130.0,2019-11-17,"(911.25, 1203.0]",9,14,-5
31131.0,2019-11-17,"(393.0, 671.0]",2,1,1
31131.0,2019-11-17,"(671.0, 949.0]",3,5,-2
31131.0,2019-11-17,"(949.0, 1227.0]",6,12,-6
31200.0,2019-11-17,"(-1.351, 337.75]",2,5,-3
31200.0,2019-11-17,"(337.75, 675.5]",48,67,-19
31200.0,2019-11-17,"(675.5, 1013.25]",41,79,-38
31200.0,2019-11-17,"(1013.25, 1351.0]",9,29,-20
31201.0,2019-11-17,"(6.675, 339.25]",3,8,-5
31201.0,2019-11-17,"(339.25, 670.5]",16,31,-15
31201.0,2019-11-17,"(670.5, 1001.75]",42,82,-40
31201.0,2019-11-17,"(1001.75, 1333.0]",25,43,-18
31202.0,2019-11-17,"(56.701, 382.75]",1,5,-4
31202.0,2019-11-17,"(382.75, 707.5]",8,15,-7
31202.0,2019-11-17,"(707.5, 1032.25]",18,37,-19
31202.0,2019-11-17,"(1032.25, 1357.0]",11,27,-16
31203.0,2019-11-17,"(16.642, 357.5]",3,5,-2
31203.0,2019-11-17,"(357.5, 697.0]",11,20,-9
31203.0,2019-11-17,"(697.0, 1036.5]",18,37,-19
31203.0,2019-11-17,"(1036.5, 1376.0]",28,43,-15
31204.0,2019-11-17,"(116.799, 418.25]",2,3,-1
31204.0,2019-11-17,"(418.25, 718.5]",3,8,-5
31204.0,2019-11-17,"(718.5, 1018.75]",5,12,-7
31204.0,2019-11-17,"(1018.75, 1319.0]",3,5,-2
31205.0,2019-11-17,"(27.603, 378.25]",2,2,0
31205.0,2019-11-17,"(378.25, 727.5]",10,12,-2
31205.0,2019-11-17,"(727.5, 1076.75]",9,17,-8
31205.0,2019-11-17,"(1076.75, 1426.0]",2,13,-11
31206.0,2019-11-17,"(633.0, 844.0]",1,1,0
31207.0,2019-11-17,"(591.279, 772.25]",2,7,-5
31207.0,2019-11-17,"(772.25, 952.5]",1,6,-5
31207.0,2019-11-17,"(1132.75, 1313.0]",1,1,0
31208.0,2019-11-17,"(488.228, 682.0]",3,4,-1
31208.0,2019-11-17,"(682.0, 875.0]",2,2,0
31208.0,2019-11-17,"(875.0, 1068.0]",3,3,0
31208.0,2019-11-17,"(1068.0, 1261.0]",2,2,0
31209.0,2019-11-17,"(533.625, 627.75]",1,2,-1
31209.0,2019-11-17,"(721.5, 815.25]",3,4,-1
31209.0,2019-11-17,"(815.25, 909.0]",2,5,-3
31211.0,2019-11-17,"(552.285, 731.75]",2,4,-2
31211.0,2019-11-17,"(731.75, 910.5]",5,7,-2
31211.0,2019-11-17,"(910.5, 1089.25]",1,3,-2
31211.0,2019-11-17,"(1089.25, 1268.0]",3,6,-3
31212.0,2019-11-17,"(62.731, 381.25]",2,4,-2
31212.0,2019-11-17,"(381.25, 698.5]",6,18,-12
31212.0,2019-11-17,"(698.5, 1015.75]",7,15,-8
31212.0,2019-11-17,"(1015.75, 1333.0]",7,17,-10
31213.0,2019-11-17,"(105.684, 436.0]",1,4,-3
31213.0,2019-11-17,"(436.0, 765.0]",9,15,-6
31213.0,2019-11-17,"(765.0, 1094.0]",5,15,-10
31213.0,2019-11-17,"(1094.0, 1423.0]",3,9,-6
31214.0,2019-11-17,"(425.5, 731.0]",9,2,7
31214.0,2019-11-17,"(731.0, 1036.5]",21,21,0
31214.0,2019-11-17,"(1036.5, 1342.0]",19,48,-29
31215.0,2019-11-17,"(478.366, 637.5]",3,4,-1
31215.0,2019-11-17,"(637.5, 796.0]",2,2,0
31215.0,2019-11-17,"(796.0, 954.5]",2,4,-2
31215.0,2019-11-17,"(954.5, 1113.0]",9,15,-6
31216.0,2019-11-17,"(285.75, 520.5]",1,1,0
31216.0,2019-11-17,"(520.5, 755.25]",6,1,5
31216.0,2019-11-17,"(755.25, 990.0]",6,9,-3
31217.0,2019-11-17,"(883.5, 1168.0]",3,1,2
31218.0,2019-11-17,"(594.322, 764.5]",3,4,-1
31218.0,2019-11-17,"(934.0, 1103.5]",6,2,4
31219.0,2019-11-17,"(575.5, 786.25]",8,2,6
31219.0,2019-11-17,"(786.25, 997.0]",16,9,7
31220.0,2019-11-17,"(829.5, 1106.0]",3,1,2
31221.0,2019-11-17,"(343.0, 657.0]",6,4,2
31221.0,2019-11-17,"(657.0, 971.0]",6,7,-1
31221.0,2019-11-17,"(971.0, 1285.0]",10,9,1
31222.0,2019-11-17,"(673.475, 805.25]",1,2,-1
31222.0,2019-11-17,"(805.25, 936.5]",3,5,-2
31222.0,2019-11-17,"(936.5, 1067.75]",1,2,-1
31222.0,2019-11-17,"(1067.75, 1199.0]",2,6,-4
31223.0,2019-11-17,"(1.604, 352.0]",3,7,-4
31223.0,2019-11-17,"(352.0, 701.0]",4,9,-5
31223.0,2019-11-17,"(701.0, 1050.0]",1,18,-17
31223.0,2019-11-17,"(1050.0, 1399.0]",7,12,-5
31224.0,2019-11-17,"(627.0, 928.5]",5,1,4
31224.0,2019-11-17,"(928.5, 1230.0]",2,1,1
31225.0,2019-11-17,"(431.101, 656.75]",5,8,-3
31225.0,2019-11-17,"(656.75, 881.5]",5,10,-5
31225.0,2019-11-17,"(881.5, 1106.25]",16,16,0
31226.0,2019-11-17,"(633.362, 793.5]",4,6,-2
31226.0,2019-11-17,"(793.5, 953.0]",3,5,-2
31226.0,2019-11-17,"(953.0, 1112.5]",4,5,-1
31226.0,2019-11-17,"(1112.5, 1272.0]",2,3,-1
31227.0,2019-11-17,"(126.977, 383.75]",1,2,-1
31227.0,2019-11-17,"(383.75, 639.5]",3,4,-1
31227.0,2019-11-17,"(639.5, 895.25]",4,12,-8
31227.0,2019-11-17,"(895.25, 1151.0]",5,6,-1
31228.0,2019-11-17,"(369.75, 702.5]",6,3,3
31228.0,2019-11-17,"(702.5, 1035.25]",26,10,16
31228.0,2019-11-17,"(1035.25, 1368.0]",9,38,-29
31229.0,2019-11-17,"(33.605, 383.75]",4,6,-2
31229.0,2019-11-17,"(383.75, 732.5]",20,51,-31
31229.0,2019-11-17,"(732.5, 1081.25]",28,54,-26
31229.0,2019-11-17,"(1081.25, 1430.0]",21,36,-15
31230.0,2019-11-17,"(433.073, 665.75]",3,5,-2
31230.0,2019-11-17,"(665.75, 897.5]",8,11,-3
31230.0,2019-11-17,"(897.5, 1129.25]",9,17,-8
31230.0,2019-11-17,"(1129.25, 1361.0]",2,9,-7
31231.0,2019-11-17,"(665.611, 763.25]",1,3,-2
31231.0,2019-11-17,"(763.25, 860.5]",3,3,0
31232.0,2019-11-17,"(6.617, 353.75]",1,2,-1
31232.0,2019-11-17,"(353.75, 699.5]",5,9,-4
31232.0,2019-11-17,"(699.5, 1045.25]",13,18,-5
31232.0,2019-11-17,"(1045.25, 1391.0]",5,7,-2
31233.0,2019-11-17,"(474.082, 704.5]",9,15,-6
31233.0,2019-11-17,"(704.5, 934.0]",13,17,-4
31233.0,2019-11-17,"(934.0, 1163.5]",3,6,-3
31233.0,2019-11-17,"(1163.5, 1393.0]",1,4,-3
31234.0,2019-11-17,"(46.655, 384.25]",2,3,-1
31234.0,2019-11-17,"(384.25, 720.5]",10,23,-13
31234.0,2019-11-17,"(720.5, 1056.75]",10,21,-11
31234.0,2019-11-17,"(1056.75, 1393.0]",9,14,-5
31235.0,2019-11-17,"(744.547, 858.25]",1,2,-1
31235.0,2019-11-17,"(858.25, 971.5]",3,7,-4
31236.0,2019-11-17,"(378.0, 720.0]",7,1,6
31236.0,2019-11-17,"(720.0, 1062.0]",9,10,-1
31236.0,2019-11-17,"(1062.0, 1404.0]",2,18,-16
31237.0,2019-11-17,"(48.799, 350.25]",1,2,-1
31237.0,2019-11-17,"(350.25, 650.5]",8,21,-13
31237.0,2019-11-17,"(650.5, 950.75]",12,27,-15
31237.0,2019-11-17,"(950.75, 1251.0]",6,13,-7
31238.0,2019-11-17,"(76.73, 395.5]",1,1,0
31238.0,2019-11-17,"(395.5, 713.0]",3,8,-5
31238.0,2019-11-17,"(713.0, 1030.5]",5,9,-4
31238.0,2019-11-17,"(1030.5, 1348.0]",1,5,-4
31239.0,2019-11-17,"(344.5, 666.0]",4,2,2
31239.0,2019-11-17,"(666.0, 987.5]",9,4,5
31239.0,2019-11-17,"(987.5, 1309.0]",7,13,-6
31240.0,2019-11-17,"(486.481, 616.75]",4,4,0
31240.0,2019-11-17,"(616.75, 746.5]",2,4,-2
31240.0,2019-11-17,"(876.25, 1006.0]",6,4,2
31241.0,2019-11-17,"(225.806, 525.5]",1,2,-1
31241.0,2019-11-17,"(525.5, 824.0]",1,8,-7
31241.0,2019-11-17,"(824.0, 1122.5]",9,17,-8
31241.0,2019-11-17,"(1122.5, 1421.0]",12,17,-5
31242.0,2019-11-17,"(563.434, 705.5]",5,7,-2
31242.0,2019-11-17,"(705.5, 847.0]",6,8,-2
31242.0,2019-11-17,"(847.0, 988.5]",4,10,-6
31243.0,2019-11-17,"(441.2, 642.0]",2,2,0
31243.0,2019-11-17,"(842.0, 1042.0]",3,6,-3
31243.0,2019-11-17,"(1042.0, 1242.0]",1,5,-4
31244.0,2019-11-17,"(5.659, 342.25]",1,1,0
31244.0,2019-11-17,"(677.5, 1012.75]",4,11,-7
31244.0,2019-11-17,"(1012.75, 1348.0]",5,7,-2
31245.0,2019-11-17,"(8.625, 353.75]",1,3,-2
31245.0,2019-11-17,"(353.75, 697.5]",4,6,-2
31245.0,2019-11-17,"(697.5, 1041.25]",13,20,-7
31245.0,2019-11-17,"(1041.25, 1385.0]",5,11,-6
31246.0,2019-11-17,"(60.781, 366.75]",1,2,-1
31246.0,2019-11-17,"(366.75, 671.5]",9,17,-8
31246.0,2019-11-17,"(671.5, 976.25]",22,30,-8
31246.0,2019-11-17,"(976.25, 1281.0]",7,14,-7
31247.0,2019-11-17,"(48.893, 326.75]",3,3,0
31247.0,2019-11-17,"(326.75, 603.5]",3,3,0
31247.0,2019-11-17,"(603.5, 880.25]",28,44,-16
31247.0,2019-11-17,"(880.25, 1157.0]",5,11,-6
31248.0,2019-11-17,"(453.167, 662.25]",5,9,-4
31248.0,2019-11-17,"(662.25, 870.5]",15,26,-11
31248.0,2019-11-17,"(870.5, 1078.75]",14,22,-8
31248.0,2019-11-17,"(1078.75, 1287.0]",6,8,-2
31249.0,2019-11-17,"(647.5, 789.0]",4,3,1
31249.0,2019-11-17,"(789.0, 930.5]",6,9,-3
31249.0,2019-11-17,"(930.5, 1072.0]",4,12,-8
31250.0,2019-11-17,"(121.963, 382.25]",3,3,0
31250.0,2019-11-17,"(382.25, 641.5]",1,1,0
31250.0,2019-11-17,"(641.5, 900.75]",1,5,-4
31250.0,2019-11-17,"(900.75, 1160.0]",2,7,-5
31251.0,2019-11-17,"(56.817, 353.75]",1,2,-1
31251.0,2019-11-17,"(353.75, 649.5]",2,6,-4
31251.0,2019-11-17,"(649.5, 945.25]",9,22,-13
31251.0,2019-11-17,"(945.25, 1241.0]",3,7,-4
31252.0,2019-11-17,"(660.473, 792.75]",2,2,0
31252.0,2019-11-17,"(792.75, 924.5]",3,3,0
31252.0,2019-11-17,"(1056.25, 1188.0]",2,2,0
31253.0,2019-11-17,"(722.685, 801.75]",2,3,-1
31253.0,2019-11-17,"(801.75, 880.5]",1,2,-1
31253.0,2019-11-17,"(880.5, 959.25]",1,1,0
31253.0,2019-11-17,"(959.25, 1038.0]",1,2,-1
31254.0,2019-11-17,"(2.713, 325.75]",1,4,-3
31254.0,2019-11-17,"(647.5, 969.25]",2,2,0
31254.0,2019-11-17,"(969.25, 1291.0]",9,2,7
31255.0,2019-11-17,"(441.228, 635.0]",1,3,-2
31255.0,2019-11-17,"(828.0, 1021.0]",5,2,3
31255.0,2019-11-17,"(1021.0, 1214.0]",1,7,-6
31256.0,2019-11-17,"(500.114, 722.5]",5,5,0
31256.0,2019-11-17,"(722.5, 944.0]",12,15,-3
31256.0,2019-11-17,"(944.0, 1165.5]",5,13,-8
31256.0,2019-11-17,"(1165.5, 1387.0]",3,5,-2
31257.0,2019-11-17,"(481.044, 721.0]",9,11,-2
31257.0,2019-11-17,"(721.0, 960.0]",8,12,-4
31257.0,2019-11-17,"(960.0, 1199.0]",10,19,-9
31257.0,2019-11-17,"(1199.0, 1438.0]",1,7,-6
31258.0,2019-11-17,"(548.287, 727.25]",5,20,-15
31258.0,2019-11-17,"(727.25, 905.5]",16,30,-14
31258.0,2019-11-17,"(905.5, 1083.75]",5,10,-5
31258.0,2019-11-17,"(1083.75, 1262.0]",1,4,-3
31259.0,2019-11-17,"(786.0, 833.0]",3,3,0
31259.0,2019-11-17,"(880.0, 927.0]",1,3,-2
31260.0,2019-11-17,"(100.68, 432.0]",2,2,0
31260.0,2019-11-17,"(762.0, 1092.0]",2,3,-1
31260.0,2019-11-17,"(1092.0, 1422.0]",2,3,-1
31261.0,2019-11-17,"(51.071, 284.25]",1,2,-1
31261.0,2019-11-17,"(516.5, 748.75]",1,3,-2
31261.0,2019-11-17,"(748.75, 981.0]",2,6,-4
31262.0,2019-11-17,"(512.0, 756.0]",4,1,3
31262.0,2019-11-17,"(756.0, 1000.0]",6,4,2
31262.0,2019-11-17,"(1000.0, 1244.0]",8,9,-1
31263.0,2019-11-17,"(31.763, 342.25]",1,2,-1
31263.0,2019-11-17,"(342.25, 651.5]",7,11,-4
31263.0,2019-11-17,"(651.5, 960.75]",6,14,-8
31263.0,2019-11-17,"(960.75, 1270.0]",8,17,-9
31264.0,2019-11-17,"(615.225, 809.75]",9,16,-7
31264.0,2019-11-17,"(809.75, 1003.5]",7,9,-2
31264.0,2019-11-17,"(1003.5, 1197.25]",2,6,-4
31264.0,2019-11-17,"(1197.25, 1391.0]",1,2,-1
31265.0,2019-11-17,"(418.022, 663.5]",5,9,-4
31265.0,2019-11-17,"(663.5, 908.0]",7,16,-9
31265.0,2019-11-17,"(908.0, 1152.5]",10,11,-1
31265.0,2019-11-17,"(1152.5, 1397.0]",6,13,-7
31266.0,2019-11-17,"(29.598, 381.5]",7,7,0
31266.0,2019-11-17,"(381.5, 732.0]",11,33,-22
31266.0,2019-11-17,"(732.0, 1082.5]",21,41,-20
31266.0,2019-11-17,"(1082.5, 1433.0]",8,17,-9
31267.0,2019-11-17,"(156.778, 463.5]",1,2,-1
31267.0,2019-11-17,"(463.5, 769.0]",6,17,-11
31267.0,2019-11-17,"(769.0, 1074.5]",11,14,-3
31267.0,2019-11-17,"(1074.5, 1380.0]",1,8,-7
31268.0,2019-11-17,"(13.645, 353.75]",3,6,-3
31268.0,2019-11-17,"(353.75, 692.5]",10,17,-7
31268.0,2019-11-17,"(692.5, 1031.25]",11,21,-10
31268.0,2019-11-17,"(1031.25, 1370.0]",9,16,-7
31269.0,2019-11-17,"(570.383, 725.25]",7,14,-7
31269.0,2019-11-17,"(725.25, 879.5]",5,11,-6
31269.0,2019-11-17,"(879.5, 1033.75]",3,5,-2
31269.0,2019-11-17,"(1033.75, 1188.0]",2,8,-6
31270.0,2019-11-17,"(54.894, 332.5]",1,1,0
31270.0,2019-11-17,"(332.5, 609.0]",1,3,-2
31270.0,2019-11-17,"(609.0, 885.5]",7,11,-4
31270.0,2019-11-17,"(885.5, 1162.0]",4,9,-5
31271.0,2019-11-17,"(163.196, 365.0]",3,5,-2
31271.0,2019-11-17,"(767.0, 968.0]",6,1,5
31272.0,2019-11-17,"(217.816, 515.0]",1,2,-1
31272.0,2019-11-17,"(515.0, 811.0]",4,7,-3
31272.0,2019-11-17,"(811.0, 1107.0]",9,16,-7
31272.0,2019-11-17,"(1107.0, 1403.0]",1,3,-2
31273.0,2019-11-17,"(447.314, 619.5]",3,5,-2
31273.0,2019-11-17,"(619.5, 791.0]",8,17,-9
31273.0,2019-11-17,"(791.0, 962.5]",2,2,0
31273.0,2019-11-17,"(962.5, 1134.0]",1,1,0
31274.0,2019-11-17,"(504.135, 721.25]",3,4,-1
31274.0,2019-11-17,"(721.25, 937.5]",7,8,-1
31274.0,2019-11-17,"(937.5, 1153.75]",4,9,-5
31274.0,2019-11-17,"(1153.75, 1370.0]",1,2,-1
31275.0,2019-11-17,"(15.63, 359.5]",2,3,-1
31275.0,2019-11-17,"(359.5, 702.0]",7,17,-10
31275.0,2019-11-17,"(702.0, 1044.5]",6,15,-9
31275.0,2019-11-17,"(1044.5, 1387.0]",12,19,-7
31276.0,2019-11-17,"(567.147, 781.25]",3,3,0
31276.0,2019-11-17,"(781.25, 994.5]",1,1,0
31276.0,2019-11-17,"(994.5, 1207.75]",1,2,-1
31277.0,2019-11-17,"(163.89, 442.5]",1,3,-2
31277.0,2019-11-17,"(442.5, 720.0]",4,6,-2
31277.0,2019-11-17,"(720.0, 997.5]",3,7,-4
31277.0,2019-11-17,"(997.5, 1275.0]",8,19,-11
31278.0,2019-11-17,"(11.689, 340.75]",4,5,-1
31278.0,2019-11-17,"(340.75, 668.5]",5,16,-11
31278.0,2019-11-17,"(668.5, 996.25]",9,24,-15
31278.0,2019-11-17,"(996.25, 1324.0]",13,20,-7
31279.0,2019-11-17,"(658.433, 800.75]",1,1,0
31279.0,2019-11-17,"(942.5, 1084.25]",1,1,0
31280.0,2019-11-17,"(35.709, 359.75]",2,5,-3
31280.0,2019-11-17,"(359.75, 682.5]",6,16,-10
31280.0,2019-11-17,"(682.5, 1005.25]",10,19,-9
31280.0,2019-11-17,"(1005.25, 1328.0]",10,16,-6
31000.0,2019-11-18,"(786.25, 884.0]",1,1,0
31001.0,2019-11-18,"(1050.5, 1202.0]",1,1,0
31002.0,2019-11-18,"(383.325, 552.75]",3,6,-3
31002.0,2019-11-18,"(552.75, 721.5]",2,3,-1
31002.0,2019-11-18,"(721.5, 890.25]",2,3,-1
31002.0,2019-11-18,"(890.25, 1059.0]",1,2,-1
31003.0,2019-11-18,"(433.257, 619.75]",3,6,-3
31003.0,2019-11-18,"(619.75, 805.5]",2,3,-1
31003.0,2019-11-18,"(805.5, 991.25]",4,5,-1
31003.0,2019-11-18,"(991.25, 1177.0]",3,6,-3
31004.0,2019-11-18,"(551.469, 684.75]",1,2,-1
31004.0,2019-11-18,"(950.25, 1083.0]",2,4,-2
31005.0,2019-11-18,"(435.058, 671.5]",3,4,-1
31005.0,2019-11-18,"(907.0, 1142.5]",5,1,4
31006.0,2019-11-18,"(581.5, 776.0]",2,1,1
31006.0,2019-11-18,"(776.0, 970.5]",2,2,0
31006.0,2019-11-18,"(970.5, 1165.0]",2,2,0
31007.0,2019-11-18,"(324.12, 545.0]",4,15,-11
31007.0,2019-11-18,"(545.0, 765.0]",6,12,-6
31007.0,2019-11-18,"(765.0, 985.0]",3,5,-2
31007.0,2019-11-18,"(985.0, 1205.0]",11,26,-15
31009.0,2019-11-18,"(436.316, 608.0]",5,5,0
31009.0,2019-11-18,"(950.0, 1121.0]",1,5,-4
31010.0,2019-11-18,"(297.75, 581.5]",1,1,0
31010.0,2019-11-18,"(865.25, 1149.0]",1,1,0
31011.0,2019-11-18,"(163.039, 404.25]",2,2,0
31011.0,2019-11-18,"(404.25, 644.5]",5,6,-1
31011.0,2019-11-18,"(644.5, 884.75]",1,2,-1
31011.0,2019-11-18,"(884.75, 1125.0]",4,12,-8
31012.0,2019-11-18,"(387.242, 577.5]",4,4,0
31012.0,2019-11-18,"(767.0, 956.5]",1,1,0
31013.0,2019-11-18,"(967.5, 1144.0]",4,2,2
31014.0,2019-11-18,"(323.108, 547.0]",14,20,-6
31014.0,2019-11-18,"(547.0, 770.0]",7,9,-2
31014.0,2019-11-18,"(770.0, 993.0]",4,5,-1
31014.0,2019-11-18,"(993.0, 1216.0]",12,23,-11
31015.0,2019-11-18,"(49.719, 371.25]",2,3,-1
31015.0,2019-11-18,"(371.25, 691.5]",10,12,-2
31015.0,2019-11-18,"(691.5, 1011.75]",3,14,-11
31015.0,2019-11-18,"(1011.75, 1332.0]",4,9,-5
31016.0,2019-11-18,"(445.286, 624.5]",3,7,-4
31016.0,2019-11-18,"(624.5, 803.0]",2,2,0
31016.0,2019-11-18,"(803.0, 981.5]",3,4,-1
31016.0,2019-11-18,"(981.5, 1160.0]",2,7,-5
31017.0,2019-11-18,"(475.229, 668.75]",5,6,-1
31017.0,2019-11-18,"(1054.25, 1247.0]",3,1,2
31018.0,2019-11-18,"(582.75, 781.5]",1,6,-5
31018.0,2019-11-18,"(980.25, 1179.0]",1,1,0
31019.0,2019-11-18,"(729.553, 841.75]",1,2,-1
31020.0,2019-11-18,"(1345.955, 1357.25]",1,1,0
31021.0,2019-11-18,"(319.172, 527.0]",2,5,-3
31021.0,2019-11-18,"(734.0, 941.0]",1,3,-2
31021.0,2019-11-18,"(941.0, 1148.0]",1,2,-1
31022.0,2019-11-18,"(686.5, 910.0]",1,3,-2
31022.0,2019-11-18,"(910.0, 1133.5]",3,2,1
31022.0,2019-11-18,"(1133.5, 1357.0]",1,6,-5
31023.0,2019-11-18,"(833.601, 933.75]",1,1,0
31023.0,2019-11-18,"(1033.5, 1133.25]",2,2,0
31024.0,2019-11-18,"(462.139, 678.25]",2,4,-2
31024.0,2019-11-18,"(678.25, 893.5]",2,2,0
31024.0,2019-11-18,"(893.5, 1108.75]",5,12,-7
31024.0,2019-11-18,"(1108.75, 1324.0]",2,4,-2
31025.0,2019-11-18,"(527.445, 666.75]",2,2,0
31025.0,2019-11-18,"(666.75, 805.5]",1,3,-2
31025.0,2019-11-18,"(805.5, 944.25]",1,2,-1
31025.0,2019-11-18,"(944.25, 1083.0]",2,2,0
31026.0,2019-11-18,"(939.0, 1142.0]",2,1,1
31026.0,2019-11-18,"(1142.0, 1345.0]",1,1,0
31027.0,2019-11-18,"(493.243, 683.25]",1,2,-1
31027.0,2019-11-18,"(1061.75, 1251.0]",3,1,2
31028.0,2019-11-18,"(449.107, 673.25]",1,1,0
31028.0,2019-11-18,"(896.5, 1119.75]",1,2,-1
31029.0,2019-11-18,"(898.0, 1121.0]",3,7,-4
31029.0,2019-11-18,"(1121.0, 1344.0]",2,4,-2
31030.0,2019-11-18,"(311.919, 583.25]",2,12,-10
31030.0,2019-11-18,"(853.5, 1123.75]",3,5,-2
31030.0,2019-11-18,"(1123.75, 1394.0]",2,3,-1
,,,,1.0,
,,,,2.0,
31032.0,2019-11-18,"(1052.5, 1206.0]",1,1,0
,,,,2.0,
31034.0,2019-11-18,"(515.432, 658.0]",1,3,-2
31034.0,2019-11-18,"(658.0, 800.0]",1,1,0
31034.0,2019-11-18,"(942.0, 1084.0]",1,1,0
31035.0,2019-11-18,"(328.905, 603.75]",2,7,-5
31035.0,2019-11-18,"(603.75, 877.5]",1,3,-2
31035.0,2019-11-18,"(877.5, 1151.25]",6,7,-1
31035.0,2019-11-18,"(1151.25, 1425.0]",1,1,0
31036.0,2019-11-18,"(361.202, 561.5]",1,3,-2
31036.0,2019-11-18,"(960.5, 1160.0]",7,3,4
31037.0,2019-11-18,"(365.212, 563.0]",10,14,-4
31037.0,2019-11-18,"(563.0, 760.0]",3,3,0
31037.0,2019-11-18,"(760.0, 957.0]",3,9,-6
31037.0,2019-11-18,"(957.0, 1154.0]",2,17,-15
31038.0,2019-11-18,"(586.747, 650.25]",1,1,0
31038.0,2019-11-18,"(776.75, 840.0]",1,1,0
31039.0,2019-11-18,"(457.035, 699.25]",1,6,-5
31039.0,2019-11-18,"(699.25, 940.5]",2,4,-2
31039.0,2019-11-18,"(940.5, 1181.75]",7,12,-5
31039.0,2019-11-18,"(1181.75, 1423.0]",1,2,-1
31040.0,2019-11-18,"(442.12, 663.0]",3,3,0
31040.0,2019-11-18,"(663.0, 883.0]",1,2,-1
31041.0,2019-11-18,"(499.289, 677.75]",2,2,0
31041.0,2019-11-18,"(855.5, 1033.25]",1,1,0
31041.0,2019-11-18,"(1033.25, 1211.0]",1,3,-2
31042.0,2019-11-18,"(443.354, 605.5]",10,12,-2
31043.0,2019-11-18,"(417.219, 613.25]",1,2,-1
31043.0,2019-11-18,"(1003.75, 1199.0]",5,2,3
31044.0,2019-11-18,"(401.25, 535.0]",1,1,0
31045.0,2019-11-18,"(399.0, 532.0]",2,1,1
31046.0,2019-11-18,"(393.357, 554.75]",1,3,-2
31046.0,2019-11-18,"(876.25, 1037.0]",1,1,0
31047.0,2019-11-18,"(338.11, 561.5]",15,24,-9
31047.0,2019-11-18,"(561.5, 784.0]",4,6,-2
31047.0,2019-11-18,"(784.0, 1006.5]",2,8,-6
31047.0,2019-11-18,"(1006.5, 1229.0]",7,22,-15
31048.0,2019-11-18,"(408.249, 596.75]",6,8,-2
31048.0,2019-11-18,"(972.25, 1160.0]",4,1,3
31049.0,2019-11-18,"(539.486, 668.5]",2,3,-1
31049.0,2019-11-18,"(925.5, 1054.0]",1,1,0
31050.0,2019-11-18,"(343.827, 387.25]",1,1,0
31051.0,2019-11-18,"(301.193, 503.75]",1,3,-2
31051.0,2019-11-18,"(907.25, 1109.0]",4,3,1
31052.0,2019-11-18,"(533.411, 681.25]",3,5,-2
31052.0,2019-11-18,"(681.25, 828.5]",1,2,-1
31052.0,2019-11-18,"(828.5, 975.75]",1,1,0
31052.0,2019-11-18,"(975.75, 1123.0]",1,5,-4
31053.0,2019-11-18,"(927.5, 1072.0]",2,2,0
31054.0,2019-11-18,"(756.0, 1008.0]",1,1,0
31055.0,2019-11-18,"(974.0, 1132.0]",1,1,0
31056.0,2019-11-18,"(16.041, 256.75]",1,1,0
31056.0,2019-11-18,"(736.25, 976.0]",1,1,0
31057.0,2019-11-18,"(855.75, 1141.0]",2,1,1
31058.0,2019-11-18,"(920.75, 1062.0]",1,2,-1
31059.0,2019-11-18,"(571.75, 732.5]",1,1,0
31059.0,2019-11-18,"(893.25, 1054.0]",1,1,0
31060.0,2019-11-18,"(842.0, 1121.0]",1,1,0
,,,,2.0,
31062.0,2019-11-18,"(781.609, 782.0]",1,2,-1
,,,,2.0,
31064.0,2019-11-18,"(507.327, 676.25]",1,4,-3
31064.0,2019-11-18,"(676.25, 844.5]",1,2,-1
31064.0,2019-11-18,"(844.5, 1012.75]",1,2,-1
31064.0,2019-11-18,"(1012.75, 1181.0]",2,3,-1
,,,,1.0,
,,,,1.0,
,,,,1.0,
,,,,2.0,
31066.0,2019-11-18,"(480.75, 497.5]",1,1,0
31067.0,2019-11-18,"(410.213, 607.75]",1,4,-3
31067.0,2019-11-18,"(607.75, 804.5]",1,1,0
31067.0,2019-11-18,"(1001.25, 1198.0]",2,4,-2
31068.0,2019-11-18,"(539.328, 708.0]",1,2,-1
31068.0,2019-11-18,"(1044.0, 1212.0]",2,2,0
31069.0,2019-11-18,"(391.128, 610.0]",3,9,-6
31069.0,2019-11-18,"(610.0, 828.0]",1,1,0
31069.0,2019-11-18,"(828.0, 1046.0]",3,6,-3
31069.0,2019-11-18,"(1046.0, 1264.0]",2,3,-1
31070.0,2019-11-18,"(612.264, 797.0]",1,2,-1
31070.0,2019-11-18,"(797.0, 981.0]",1,2,-1
31070.0,2019-11-18,"(981.0, 1165.0]",2,4,-2
31070.0,2019-11-18,"(1165.0, 1349.0]",1,1,0
31071.0,2019-11-18,"(413.238, 604.5]",2,3,-1
31071.0,2019-11-18,"(604.5, 795.0]",2,2,0
31071.0,2019-11-18,"(985.5, 1176.0]",6,3,3
,,,,1.0,
,,,,1.0,
31073.0,2019-11-18,"(496.431, 639.25]",2,3,-1
31073.0,2019-11-18,"(923.75, 1066.0]",2,2,0
31074.0,2019-11-18,"(515.276, 697.0]",1,2,-1
31074.0,2019-11-18,"(878.0, 1059.0]",2,1,1
31074.0,2019-11-18,"(1059.0, 1240.0]",3,3,0
31075.0,2019-11-18,"(841.25, 941.0]",2,1,1
31076.0,2019-11-18,"(418.205, 617.75]",1,1,0
31076.0,2019-11-18,"(1015.25, 1214.0]",3,1,2
31077.0,2019-11-18,"(318.0, 588.0]",1,1,0
31077.0,2019-11-18,"(588.0, 858.0]",5,5,0
31077.0,2019-11-18,"(858.0, 1128.0]",6,14,-8
31078.0,2019-11-18,"(472.324, 642.0]",4,5,-1
31078.0,2019-11-18,"(980.0, 1149.0]",2,7,-5
31079.0,2019-11-18,"(626.5, 851.0]",1,9,-8
31079.0,2019-11-18,"(851.0, 1075.5]",1,2,-1
31079.0,2019-11-18,"(1075.5, 1300.0]",4,2,2
31080.0,2019-11-18,"(396.13, 614.5]",2,12,-10
31080.0,2019-11-18,"(832.0, 1049.5]",1,3,-2
31080.0,2019-11-18,"(1049.5, 1267.0]",5,6,-1
31081.0,2019-11-18,"(492.363, 652.25]",1,1,0
31081.0,2019-11-18,"(811.5, 970.75]",1,1,0
31081.0,2019-11-18,"(970.75, 1130.0]",1,2,-1
31082.0,2019-11-18,"(1086.75, 1103.0]",1,1,0
31083.0,2019-11-18,"(850.0, 1041.5]",2,1,1
31083.0,2019-11-18,"(1041.5, 1233.0]",2,2,0
31084.0,2019-11-18,"(559.449, 697.75]",6,7,-1
31084.0,2019-11-18,"(697.75, 835.5]",2,2,0
31085.0,2019-11-18,"(395.212, 593.0]",1,6,-5
31085.0,2019-11-18,"(987.0, 1184.0]",3,3,0
31086.0,2019-11-18,"(722.5, 872.25]",2,1,1
31086.0,2019-11-18,"(872.25, 1022.0]",1,3,-2
31087.0,2019-11-18,"(940.0, 1101.0]",4,1,3
31088.0,2019-11-18,"(806.5, 1012.25]",3,3,0
31088.0,2019-11-18,"(1012.25, 1218.0]",3,4,-1
31089.0,2019-11-18,"(407.113, 629.75]",7,13,-6
31089.0,2019-11-18,"(851.5, 1073.25]",1,9,-8
31090.0,2019-11-18,"(633.5, 781.0]",1,1,0
31090.0,2019-11-18,"(928.5, 1076.0]",4,1,3
31091.0,2019-11-18,"(877.5, 1129.25]",2,3,-1
31091.0,2019-11-18,"(1129.25, 1381.0]",4,3,1
31092.0,2019-11-18,"(818.452, 956.0]",1,2,-1
31092.0,2019-11-18,"(1230.0, 1367.0]",1,1,0
,,,,1.0,
,,,,2.0,
,,,,1.0,
,,,,2.0,
31095.0,2019-11-18,"(970.0, 1008.0]",1,1,0
31096.0,2019-11-18,"(969.25, 1126.0]",2,3,-1
31097.0,2019-11-18,"(522.405, 671.75]",3,3,0
31097.0,2019-11-18,"(969.25, 1118.0]",1,4,-3
31098.0,2019-11-18,"(409.296, 586.0]",5,14,-9
31098.0,2019-11-18,"(586.0, 762.0]",1,2,-1
31098.0,2019-11-18,"(938.0, 1114.0]",9,1,8
31099.0,2019-11-18,"(657.5, 832.75]",1,2,-1
31099.0,2019-11-18,"(832.75, 1008.0]",2,1,1
31100.0,2019-11-18,"(400.281, 580.75]",11,12,-1
31100.0,2019-11-18,"(580.75, 760.5]",2,3,-1
31100.0,2019-11-18,"(760.5, 940.25]",4,10,-6
31100.0,2019-11-18,"(940.25, 1120.0]",2,16,-14
31101.0,2019-11-18,"(366.25, 697.5]",14,3,11
31101.0,2019-11-18,"(697.5, 1028.75]",23,44,-21
31101.0,2019-11-18,"(1028.75, 1360.0]",32,45,-13
31102.0,2019-11-18,"(240.857, 527.75]",1,16,-15
31102.0,2019-11-18,"(527.75, 813.5]",2,6,-4
31102.0,2019-11-18,"(813.5, 1099.25]",3,3,0
31102.0,2019-11-18,"(1099.25, 1385.0]",11,19,-8
31103.0,2019-11-18,"(308.903, 584.25]",1,35,-34
31103.0,2019-11-18,"(584.25, 858.5]",2,19,-17
31103.0,2019-11-18,"(858.5, 1132.75]",7,22,-15
31103.0,2019-11-18,"(1132.75, 1407.0]",3,11,-8
31104.0,2019-11-18,"(353.0, 705.0]",4,3,1
31104.0,2019-11-18,"(705.0, 1057.0]",12,19,-7
31104.0,2019-11-18,"(1057.0, 1409.0]",9,19,-10
31105.0,2019-11-18,"(358.15, 571.5]",1,7,-6
31105.0,2019-11-18,"(996.5, 1209.0]",5,3,2
31106.0,2019-11-18,"(372.115, 594.25]",2,16,-14
31106.0,2019-11-18,"(815.5, 1036.75]",1,1,0
31106.0,2019-11-18,"(1036.75, 1258.0]",3,1,2
31107.0,2019-11-18,"(18.809, 317.75]",1,2,-1
31107.0,2019-11-18,"(317.75, 615.5]",1,14,-13
31107.0,2019-11-18,"(615.5, 913.25]",5,11,-6
31107.0,2019-11-18,"(913.25, 1211.0]",19,31,-12
31108.0,2019-11-18,"(394.048, 633.0]",7,30,-23
31108.0,2019-11-18,"(633.0, 871.0]",12,24,-12
31108.0,2019-11-18,"(871.0, 1109.0]",17,36,-19
31108.0,2019-11-18,"(1109.0, 1347.0]",14,18,-4
31109.0,2019-11-18,"(317.06, 553.0]",7,15,-8
31109.0,2019-11-18,"(553.0, 788.0]",1,9,-8
31109.0,2019-11-18,"(788.0, 1023.0]",4,8,-4
31109.0,2019-11-18,"(1023.0, 1258.0]",18,24,-6
31110.0,2019-11-18,"(316.929, 585.75]",14,42,-28
31110.0,2019-11-18,"(585.75, 853.5]",10,25,-15
31110.0,2019-11-18,"(853.5, 1121.25]",25,48,-23
31110.0,2019-11-18,"(1121.25, 1389.0]",9,22,-13
31111.0,2019-11-18,"(361.17, 569.5]",7,15,-8
31111.0,2019-11-18,"(569.5, 777.0]",2,7,-5
31111.0,2019-11-18,"(777.0, 984.5]",3,4,-1
31111.0,2019-11-18,"(984.5, 1192.0]",11,19,-8
31112.0,2019-11-18,"(438.347, 602.25]",1,10,-9
31112.0,2019-11-18,"(765.5, 928.75]",1,1,0
31112.0,2019-11-18,"(928.75, 1092.0]",4,6,-2
31113.0,2019-11-18,"(575.0, 832.0]",1,14,-13
31113.0,2019-11-18,"(832.0, 1089.0]",5,4,1
31113.0,2019-11-18,"(1089.0, 1346.0]",5,10,-5
31114.0,2019-11-18,"(40.714, 363.5]",1,1,0
31114.0,2019-11-18,"(363.5, 685.0]",1,22,-21
31114.0,2019-11-18,"(685.0, 1006.5]",10,17,-7
31114.0,2019-11-18,"(1006.5, 1328.0]",26,35,-9
31115.0,2019-11-18,"(100.808, 400.0]",1,4,-3
31115.0,2019-11-18,"(400.0, 698.0]",1,13,-12
31115.0,2019-11-18,"(698.0, 996.0]",3,6,-3
31115.0,2019-11-18,"(996.0, 1294.0]",15,24,-9
31116.0,2019-11-18,"(346.983, 602.25]",6,18,-12
31116.0,2019-11-18,"(602.25, 856.5]",6,10,-4
31116.0,2019-11-18,"(856.5, 1110.75]",19,22,-3
31116.0,2019-11-18,"(1110.75, 1365.0]",7,11,-4
31117.0,2019-11-18,"(112.765, 422.75]",5,10,-5
31117.0,2019-11-18,"(422.75, 731.5]",3,20,-17
31117.0,2019-11-18,"(731.5, 1040.25]",5,14,-9
31117.0,2019-11-18,"(1040.25, 1349.0]",17,28,-11
31118.0,2019-11-18,"(444.273, 626.75]",2,15,-13
31118.0,2019-11-18,"(626.75, 808.5]",1,3,-2
31118.0,2019-11-18,"(808.5, 990.25]",3,3,0
31118.0,2019-11-18,"(990.25, 1172.0]",18,23,-5
31119.0,2019-11-18,"(4.713, 327.75]",2,2,0
31119.0,2019-11-18,"(327.75, 649.5]",4,13,-9
31119.0,2019-11-18,"(649.5, 971.25]",4,8,-4
31119.0,2019-11-18,"(971.25, 1293.0]",22,35,-13
31120.0,2019-11-18,"(408.163, 618.25]",4,15,-11
31120.0,2019-11-18,"(618.25, 827.5]",4,7,-3
31120.0,2019-11-18,"(827.5, 1036.75]",4,8,-4
31120.0,2019-11-18,"(1036.75, 1246.0]",17,21,-4
31121.0,2019-11-18,"(341.02, 587.0]",16,21,-5
31121.0,2019-11-18,"(587.0, 832.0]",1,6,-5
31121.0,2019-11-18,"(832.0, 1077.0]",4,15,-11
31121.0,2019-11-18,"(1077.0, 1322.0]",2,5,-3
31122.0,2019-11-18,"(406.976, 664.0]",1,5,-4
31122.0,2019-11-18,"(664.0, 920.0]",2,3,-1
31122.0,2019-11-18,"(920.0, 1176.0]",9,14,-5
31122.0,2019-11-18,"(1176.0, 1432.0]",5,9,-4
31123.0,2019-11-18,"(399.133, 616.75]",1,10,-9
31123.0,2019-11-18,"(833.5, 1050.25]",1,1,0
31123.0,2019-11-18,"(1050.25, 1267.0]",10,13,-3
31124.0,2019-11-18,"(374.993, 627.75]",14,52,-38
31124.0,2019-11-18,"(627.75, 879.5]",9,35,-26
31124.0,2019-11-18,"(879.5, 1131.25]",14,50,-36
31124.0,2019-11-18,"(1131.25, 1383.0]",13,27,-14
31125.0,2019-11-18,"(355.033, 597.75]",7,28,-21
31125.0,2019-11-18,"(597.75, 839.5]",5,7,-2
31125.0,2019-11-18,"(839.5, 1081.25]",22,29,-7
31125.0,2019-11-18,"(1081.25, 1323.0]",12,18,-6
31126.0,2019-11-18,"(32.727, 352.25]",1,1,0
31126.0,2019-11-18,"(352.25, 670.5]",4,21,-17
31126.0,2019-11-18,"(670.5, 988.75]",3,5,-2
31126.0,2019-11-18,"(988.75, 1307.0]",25,32,-7
31127.0,2019-11-18,"(11.596, 364.0]",1,2,-1
31127.0,2019-11-18,"(364.0, 715.0]",14,22,-8
31127.0,2019-11-18,"(715.0, 1066.0]",24,44,-20
31127.0,2019-11-18,"(1066.0, 1417.0]",10,25,-15
31128.0,2019-11-18,"(13.714, 336.5]",3,4,-1
31128.0,2019-11-18,"(336.5, 658.0]",20,31,-11
31128.0,2019-11-18,"(658.0, 979.5]",26,40,-14
31128.0,2019-11-18,"(979.5, 1301.0]",19,37,-18
31129.0,2019-11-18,"(292.25, 568.5]",7,6,1
31129.0,2019-11-18,"(568.5, 844.75]",9,9,0
31129.0,2019-11-18,"(844.75, 1121.0]",1,13,-12
31130.0,2019-11-18,"(618.5, 842.0]",1,10,-9
31130.0,2019-11-18,"(842.0, 1065.5]",3,4,-1
31130.0,2019-11-18,"(1065.5, 1289.0]",6,6,0
31131.0,2019-11-18,"(402.196, 604.0]",1,11,-10
31131.0,2019-11-18,"(1006.0, 1207.0]",6,3,3
31200.0,2019-11-18,"(330.0, 581.0]",24,32,-8
31200.0,2019-11-18,"(581.0, 831.0]",11,23,-12
31200.0,2019-11-18,"(831.0, 1081.0]",14,32,-18
31200.0,2019-11-18,"(1081.0, 1331.0]",15,31,-16
31201.0,2019-11-18,"(296.966, 556.5]",17,47,-30
31201.0,2019-11-18,"(556.5, 815.0]",18,27,-9
31201.0,2019-11-18,"(815.0, 1073.5]",28,38,-10
31201.0,2019-11-18,"(1073.5, 1332.0]",25,49,-24
31202.0,2019-11-18,"(352.01, 600.5]",9,25,-16
31202.0,2019-11-18,"(600.5, 848.0]",5,10,-5
31202.0,2019-11-18,"(848.0, 1095.5]",22,31,-9
31202.0,2019-11-18,"(1095.5, 1343.0]",7,15,-8
31203.0,2019-11-18,"(64.707, 389.25]",1,3,-2
31203.0,2019-11-18,"(389.25, 712.5]",9,32,-23
31203.0,2019-11-18,"(712.5, 1035.75]",19,34,-15
31203.0,2019-11-18,"(1035.75, 1359.0]",18,25,-7
31204.0,2019-11-18,"(14.69, 343.5]",1,1,0
31204.0,2019-11-18,"(343.5, 671.0]",10,12,-2
31204.0,2019-11-18,"(671.0, 998.5]",9,23,-14
31204.0,2019-11-18,"(998.5, 1326.0]",6,20,-14
31205.0,2019-11-18,"(347.059, 583.25]",20,26,-6
31205.0,2019-11-18,"(583.25, 818.5]",18,27,-9
31205.0,2019-11-18,"(818.5, 1053.75]",18,28,-10
31205.0,2019-11-18,"(1053.75, 1289.0]",6,22,-16
31206.0,2019-11-18,"(469.319, 640.25]",6,6,0
31206.0,2019-11-18,"(640.25, 810.5]",1,2,-1
31206.0,2019-11-18,"(980.75, 1151.0]",3,1,2
31207.0,2019-11-18,"(525.172, 733.0]",2,5,-3
31207.0,2019-11-18,"(733.0, 940.0]",1,2,-1
31207.0,2019-11-18,"(940.0, 1147.0]",3,5,-2
31207.0,2019-11-18,"(1147.0, 1354.0]",1,1,0
31208.0,2019-11-18,"(50.855, 338.25]",2,3,-1
31208.0,2019-11-18,"(338.25, 624.5]",11,11,0
31208.0,2019-11-18,"(624.5, 910.75]",1,4,-3
31208.0,2019-11-18,"(910.75, 1197.0]",5,19,-14
31209.0,2019-11-18,"(486.372, 644.0]",1,4,-3
31209.0,2019-11-18,"(644.0, 801.0]",3,4,-1
31209.0,2019-11-18,"(958.0, 1115.0]",7,1,6
31211.0,2019-11-18,"(399.086, 628.5]",8,12,-4
31211.0,2019-11-18,"(628.5, 857.0]",2,4,-2
31211.0,2019-11-18,"(857.0, 1085.5]",6,9,-3
31211.0,2019-11-18,"(1085.5, 1314.0]",1,5,-4
31212.0,2019-11-18,"(348.924, 619.0]",32,46,-14
31212.0,2019-11-18,"(619.0, 888.0]",9,14,-5
31212.0,2019-11-18,"(888.0, 1157.0]",17,38,-21
31212.0,2019-11-18,"(1157.0, 1426.0]",4,11,-7
31213.0,2019-11-18,"(390.163, 600.25]",35,50,-15
31213.0,2019-11-18,"(600.25, 809.5]",9,18,-9
31213.0,2019-11-18,"(809.5, 1018.75]",8,15,-7
31213.0,2019-11-18,"(1018.75, 1228.0]",12,46,-34
31214.0,2019-11-18,"(124.728, 444.0]",4,7,-3
31214.0,2019-11-18,"(444.0, 762.0]",14,43,-29
31214.0,2019-11-18,"(762.0, 1080.0]",14,25,-11
31214.0,2019-11-18,"(1080.0, 1398.0]",27,37,-10
31215.0,2019-11-18,"(483.23, 676.5]",26,26,0
31215.0,2019-11-18,"(676.5, 869.0]",1,5,-4
31215.0,2019-11-18,"(869.0, 1061.5]",6,8,-2
31215.0,2019-11-18,"(1061.5, 1254.0]",4,11,-7
31216.0,2019-11-18,"(467.251, 655.25]",20,20,0
31216.0,2019-11-18,"(655.25, 842.5]",6,9,-3
31216.0,2019-11-18,"(842.5, 1029.75]",3,6,-3
31216.0,2019-11-18,"(1029.75, 1217.0]",3,27,-24
31217.0,2019-11-18,"(322.255, 509.25]",13,13,0
31217.0,2019-11-18,"(509.25, 695.5]",5,6,-1
31217.0,2019-11-18,"(695.5, 881.75]",5,8,-3
31217.0,2019-11-18,"(881.75, 1068.0]",1,14,-13
31218.0,2019-11-18,"(358.23, 551.5]",14,32,-18
31218.0,2019-11-18,"(551.5, 744.0]",1,3,-2
31218.0,2019-11-18,"(744.0, 936.5]",5,7,-2
31218.0,2019-11-18,"(936.5, 1129.0]",11,17,-6
31219.0,2019-11-18,"(382.166, 591.5]",13,15,-2
31219.0,2019-11-18,"(591.5, 800.0]",14,16,-2
31219.0,2019-11-18,"(800.0, 1008.5]",5,10,-5
31219.0,2019-11-18,"(1008.5, 1217.0]",1,9,-8
31220.0,2019-11-18,"(303.275, 485.25]",11,14,-3
31220.0,2019-11-18,"(666.5, 847.75]",1,2,-1
31220.0,2019-11-18,"(847.75, 1029.0]",3,21,-18
31221.0,2019-11-18,"(325.25, 617.5]",26,1,25
31221.0,2019-11-18,"(617.5, 909.75]",21,31,-10
31221.0,2019-11-18,"(909.75, 1202.0]",9,25,-16
31222.0,2019-11-18,"(388.224, 583.0]",13,13,0
31222.0,2019-11-18,"(583.0, 777.0]",2,4,-2
31222.0,2019-11-18,"(777.0, 971.0]",2,8,-6
31222.0,2019-11-18,"(971.0, 1165.0]",2,19,-17
31223.0,2019-11-18,"(23.615, 371.25]",3,5,-2
31223.0,2019-11-18,"(371.25, 717.5]",9,34,-25
31223.0,2019-11-18,"(717.5, 1063.75]",9,33,-24
31223.0,2019-11-18,"(1063.75, 1410.0]",8,18,-10
31224.0,2019-11-18,"(420.203, 620.25]",19,23,-4
31224.0,2019-11-18,"(620.25, 819.5]",3,4,-1
31224.0,2019-11-18,"(819.5, 1018.75]",4,9,-5
31224.0,2019-11-18,"(1018.75, 1218.0]",2,16,-14
31225.0,2019-11-18,"(39.736, 357.0]",1,1,0
31225.0,2019-11-18,"(357.0, 673.0]",13,20,-7
31225.0,2019-11-18,"(673.0, 989.0]",7,15,-8
31225.0,2019-11-18,"(989.0, 1305.0]",9,19,-10
31226.0,2019-11-18,"(273.115, 495.25]",3,6,-3
31226.0,2019-11-18,"(495.25, 716.5]",4,8,-4
31226.0,2019-11-18,"(716.5, 937.75]",2,3,-1
31226.0,2019-11-18,"(937.75, 1159.0]",7,18,-11
31227.0,2019-11-18,"(414.122, 634.5]",45,47,-2
31227.0,2019-11-18,"(634.5, 854.0]",13,24,-11
31227.0,2019-11-18,"(854.0, 1073.5]",2,19,-17
31227.0,2019-11-18,"(1073.5, 1293.0]",7,13,-6
31228.0,2019-11-18,"(261.913, 534.75]",18,22,-4
31228.0,2019-11-18,"(534.75, 806.5]",11,25,-14
31228.0,2019-11-18,"(806.5, 1078.25]",19,33,-14
31228.0,2019-11-18,"(1078.25, 1350.0]",19,36,-17
31229.0,2019-11-18,"(302.887, 582.25]",10,37,-27
31229.0,2019-11-18,"(582.25, 860.5]",13,36,-23
31229.0,2019-11-18,"(860.5, 1138.75]",36,55,-19
31229.0,2019-11-18,"(1138.75, 1417.0]",8,18,-10
31230.0,2019-11-18,"(388.171, 596.25]",42,49,-7
31230.0,2019-11-18,"(596.25, 803.5]",11,16,-5
31230.0,2019-11-18,"(803.5, 1010.75]",11,18,-7
31230.0,2019-11-18,"(1010.75, 1218.0]",11,44,-33
31231.0,2019-11-18,"(393.253, 580.75]",14,17,-3
31231.0,2019-11-18,"(580.75, 767.5]",2,3,-1
31231.0,2019-11-18,"(767.5, 954.25]",8,14,-6
31231.0,2019-11-18,"(954.25, 1141.0]",6,14,-8
31232.0,2019-11-18,"(56.764, 367.0]",1,3,-2
31232.0,2019-11-18,"(367.0, 676.0]",21,29,-8
31232.0,2019-11-18,"(676.0, 985.0]",6,9,-3
31232.0,2019-11-18,"(985.0, 1294.0]",13,19,-6
31233.0,2019-11-18,"(118.814, 416.5]",1,2,-1
31233.0,2019-11-18,"(416.5, 713.0]",38,45,-7
31233.0,2019-11-18,"(713.0, 1009.5]",20,27,-7
31233.0,2019-11-18,"(1009.5, 1306.0]",8,15,-7
31234.0,2019-11-18,"(292.94, 559.0]",9,24,-15
31234.0,2019-11-18,"(559.0, 824.0]",12,23,-11
31234.0,2019-11-18,"(824.0, 1089.0]",11,23,-12
31234.0,2019-11-18,"(1089.0, 1354.0]",9,15,-6
31235.0,2019-11-18,"(514.44, 655.0]",13,13,0
31235.0,2019-11-18,"(655.0, 795.0]",2,2,0
31235.0,2019-11-18,"(795.0, 935.0]",2,2,0
31235.0,2019-11-18,"(935.0, 1075.0]",1,3,-2
31236.0,2019-11-18,"(462.215, 659.25]",20,27,-7
31236.0,2019-11-18,"(659.25, 855.5]",9,16,-7
31236.0,2019-11-18,"(855.5, 1051.75]",5,21,-16
31236.0,2019-11-18,"(1051.75, 1248.0]",5,15,-10
31237.0,2019-11-18,"(2.605, 352.75]",1,1,0
31237.0,2019-11-18,"(352.75, 701.5]",7,12,-5
31237.0,2019-11-18,"(701.5, 1050.25]",16,28,-12
31237.0,2019-11-18,"(1050.25, 1399.0]",8,20,-12
31238.0,2019-11-18,"(49.904, 325.0]",1,1,0
31238.0,2019-11-18,"(325.0, 599.0]",17,25,-8
31238.0,2019-11-18,"(599.0, 873.0]",6,14,-8
31238.0,2019-11-18,"(873.0, 1147.0]",7,25,-18
31239.0,2019-11-18,"(386.054, 623.5]",16,17,-1
31239.0,2019-11-18,"(623.5, 860.0]",2,5,-3
31239.0,2019-11-18,"(860.0, 1096.5]",8,30,-22
31239.0,2019-11-18,"(1096.5, 1333.0]",6,17,-11
31240.0,2019-11-18,"(929.5, 982.0]",1,1,0
31240.0,2019-11-18,"(1034.5, 1087.0]",1,2,-1
31241.0,2019-11-18,"(292.967, 552.25]",16,36,-20
31241.0,2019-11-18,"(552.25, 810.5]",23,35,-12
31241.0,2019-11-18,"(810.5, 1068.75]",5,23,-18
31241.0,2019-11-18,"(1068.75, 1327.0]",16,30,-14
31242.0,2019-11-18,"(330.75, 643.5]",34,1,33
31242.0,2019-11-18,"(643.5, 956.25]",12,39,-27
31242.0,2019-11-18,"(956.25, 1269.0]",3,27,-24
31243.0,2019-11-18,"(383.136, 600.0]",26,30,-4
31243.0,2019-11-18,"(600.0, 816.0]",4,8,-4
31243.0,2019-11-18,"(816.0, 1032.0]",12,35,-23
31243.0,2019-11-18,"(1032.0, 1248.0]",6,19,-13
31244.0,2019-11-18,"(348.005, 597.75]",16,27,-11
31244.0,2019-11-18,"(597.75, 846.5]",2,7,-5
31244.0,2019-11-18,"(846.5, 1095.25]",6,26,-20
31244.0,2019-11-18,"(1095.25, 1344.0]",6,9,-3
31245.0,2019-11-18,"(397.133, 614.75]",9,24,-15
31245.0,2019-11-18,"(614.75, 831.5]",2,7,-5
31245.0,2019-11-18,"(831.5, 1048.25]",13,23,-10
31245.0,2019-11-18,"(1048.25, 1265.0]",12,21,-9
31246.0,2019-11-18,"(392.032, 635.0]",14,22,-8
31246.0,2019-11-18,"(635.0, 877.0]",6,11,-5
31246.0,2019-11-18,"(877.0, 1119.0]",11,32,-21
31246.0,2019-11-18,"(1119.0, 1361.0]",12,18,-6
31247.0,2019-11-18,"(425.222, 620.5]",12,17,-5
31247.0,2019-11-18,"(620.5, 815.0]",1,1,0
31247.0,2019-11-18,"(815.0, 1009.5]",9,14,-5
31247.0,2019-11-18,"(1009.5, 1204.0]",1,9,-8
31248.0,2019-11-18,"(351.176, 558.0]",4,7,-3
31248.0,2019-11-18,"(558.0, 764.0]",4,6,-2
31248.0,2019-11-18,"(764.0, 970.0]",22,38,-16
31248.0,2019-11-18,"(970.0, 1176.0]",11,21,-10
31249.0,2019-11-18,"(414.362, 574.5]",3,5,-2
31249.0,2019-11-18,"(893.5, 1053.0]",5,1,4
31250.0,2019-11-18,"(410.177, 616.75]",17,20,-3
31250.0,2019-11-18,"(616.75, 822.5]",2,4,-2
31250.0,2019-11-18,"(822.5, 1028.25]",5,9,-4
31250.0,2019-11-18,"(1028.25, 1234.0]",2,18,-16
31251.0,2019-11-18,"(366.019, 612.25]",22,42,-20
31251.0,2019-11-18,"(612.25, 857.5]",8,10,-2
31251.0,2019-11-18,"(857.5, 1102.75]",11,25,-14
31251.0,2019-11-18,"(1102.75, 1348.0]",8,18,-10
31252.0,2019-11-18,"(391.27, 574.5]",15,16,-1
31252.0,2019-11-18,"(574.5, 757.0]",3,4,-1
31252.0,2019-11-18,"(757.0, 939.5]",4,9,-5
31252.0,2019-11-18,"(939.5, 1122.0]",1,15,-14
31253.0,2019-11-18,"(376.187, 580.25]",20,24,-4
31253.0,2019-11-18,"(580.25, 783.5]",6,9,-3
31253.0,2019-11-18,"(783.5, 986.75]",2,6,-4
31253.0,2019-11-18,"(986.75, 1190.0]",2,17,-15
31254.0,2019-11-18,"(403.19, 606.5]",15,16,-1
31254.0,2019-11-18,"(809.0, 1011.5]",1,1,0
31254.0,2019-11-18,"(1011.5, 1214.0]",1,7,-6
31255.0,2019-11-18,"(326.25, 650.5]",16,1,15
31255.0,2019-11-18,"(650.5, 974.75]",6,28,-22
31255.0,2019-11-18,"(974.75, 1299.0]",10,12,-2
31256.0,2019-11-18,"(230.964, 491.0]",5,6,-1
31256.0,2019-11-18,"(491.0, 750.0]",8,8,0
31256.0,2019-11-18,"(750.0, 1009.0]",1,4,-3
31256.0,2019-11-18,"(1009.0, 1268.0]",8,20,-12
31257.0,2019-11-18,"(324.084, 554.0]",10,16,-6
31257.0,2019-11-18,"(554.0, 783.0]",9,16,-7
31257.0,2019-11-18,"(783.0, 1012.0]",11,24,-13
31257.0,2019-11-18,"(1012.0, 1241.0]",12,26,-14
31258.0,2019-11-18,"(494.301, 669.75]",6,9,-3
31258.0,2019-11-18,"(669.75, 844.5]",7,15,-8
31258.0,2019-11-18,"(844.5, 1019.25]",5,11,-6
31258.0,2019-11-18,"(1019.25, 1194.0]",7,11,-4
31259.0,2019-11-18,"(398.079, 629.25]",10,10,0
31259.0,2019-11-18,"(629.25, 859.5]",1,2,-1
31259.0,2019-11-18,"(859.5, 1089.75]",5,9,-4
31259.0,2019-11-18,"(1089.75, 1320.0]",1,3,-2
31260.0,2019-11-18,"(382.106, 606.5]",15,17,-2
31260.0,2019-11-18,"(606.5, 830.0]",2,5,-3
31260.0,2019-11-18,"(830.0, 1053.5]",5,18,-13
31260.0,2019-11-18,"(1053.5, 1277.0]",8,18,-10
31261.0,2019-11-18,"(438.326, 607.5]",14,14,0
31261.0,2019-11-18,"(776.0, 944.5]",1,2,-1
31261.0,2019-11-18,"(944.5, 1113.0]",2,2,0
31262.0,2019-11-18,"(246.864, 532.0]",7,8,-1
31262.0,2019-11-18,"(532.0, 816.0]",7,11,-4
31262.0,2019-11-18,"(816.0, 1100.0]",8,19,-11
31262.0,2019-11-18,"(1100.0, 1384.0]",4,11,-7
31263.0,2019-11-18,"(362.143, 577.25]",20,30,-10
31263.0,2019-11-18,"(577.25, 791.5]",6,17,-11
31263.0,2019-11-18,"(791.5, 1005.75]",3,9,-6
31263.0,2019-11-18,"(1005.75, 1220.0]",5,15,-10
31264.0,2019-11-18,"(392.171, 600.25]",14,19,-5
31264.0,2019-11-18,"(600.25, 807.5]",3,7,-4
31264.0,2019-11-18,"(807.5, 1014.75]",4,10,-6
31264.0,2019-11-18,"(1014.75, 1222.0]",5,14,-9
31265.0,2019-11-18,"(307.012, 555.0]",12,29,-17
31265.0,2019-11-18,"(555.0, 802.0]",7,12,-5
31265.0,2019-11-18,"(802.0, 1049.0]",13,24,-11
31265.0,2019-11-18,"(1049.0, 1296.0]",18,37,-19
31266.0,2019-11-18,"(48.684, 379.0]",1,3,-2
31266.0,2019-11-18,"(379.0, 708.0]",8,27,-19
31266.0,2019-11-18,"(708.0, 1037.0]",11,22,-11
31266.0,2019-11-18,"(1037.0, 1366.0]",23,47,-24
31267.0,2019-11-18,"(414.019, 660.25]",21,36,-15
31267.0,2019-11-18,"(660.25, 905.5]",14,24,-10
31267.0,2019-11-18,"(905.5, 1150.75]",16,37,-21
31267.0,2019-11-18,"(1150.75, 1396.0]",3,6,-3
31268.0,2019-11-18,"(334.922, 605.5]",11,40,-29
31268.0,2019-11-18,"(605.5, 875.0]",3,8,-5
31268.0,2019-11-18,"(875.0, 1144.5]",25,32,-7
31268.0,2019-11-18,"(1144.5, 1414.0]",12,14,-2
31269.0,2019-11-18,"(378.243, 568.25]",8,14,-6
31269.0,2019-11-18,"(568.25, 757.5]",5,9,-4
31269.0,2019-11-18,"(757.5, 946.75]",5,9,-4
31269.0,2019-11-18,"(946.75, 1136.0]",11,24,-13
31270.0,2019-11-18,"(371.147, 585.25]",14,19,-5
31270.0,2019-11-18,"(585.25, 798.5]",3,10,-7
31270.0,2019-11-18,"(798.5, 1011.75]",12,23,-11
31270.0,2019-11-18,"(1011.75, 1225.0]",9,21,-12
31271.0,2019-11-18,"(383.234, 575.5]",12,15,-3
31271.0,2019-11-18,"(767.0, 958.5]",3,1,2
31271.0,2019-11-18,"(958.5, 1150.0]",1,15,-14
31272.0,2019-11-18,"(2.718, 324.5]",1,2,-1
31272.0,2019-11-18,"(324.5, 645.0]",24,26,-2
31272.0,2019-11-18,"(645.0, 965.5]",8,14,-6
31272.0,2019-11-18,"(965.5, 1286.0]",4,24,-20
31273.0,2019-11-18,"(487.164, 697.0]",2,6,-4
31273.0,2019-11-18,"(697.0, 906.0]",3,4,-1
31273.0,2019-11-18,"(906.0, 1115.0]",3,4,-1
31273.0,2019-11-18,"(1115.0, 1324.0]",1,2,-1
31274.0,2019-11-18,"(398.32, 569.0]",17,22,-5
31274.0,2019-11-18,"(569.0, 739.0]",5,5,0
31274.0,2019-11-18,"(739.0, 909.0]",1,2,-1
31274.0,2019-11-18,"(909.0, 1079.0]",3,13,-10
31275.0,2019-11-18,"(313.997, 565.75]",19,32,-13
31275.0,2019-11-18,"(565.75, 816.5]",10,16,-6
31275.0,2019-11-18,"(816.5, 1067.25]",14,28,-14
31275.0,2019-11-18,"(1067.25, 1318.0]",6,17,-11
31276.0,2019-11-18,"(401.006, 650.5]",16,20,-4
31276.0,2019-11-18,"(650.5, 899.0]",8,13,-5
31276.0,2019-11-18,"(899.0, 1147.5]",2,22,-20
31276.0,2019-11-18,"(1147.5, 1396.0]",1,7,-6
31277.0,2019-11-18,"(417.285, 596.75]",25,29,-4
31277.0,2019-11-18,"(596.75, 775.5]",23,40,-17
31277.0,2019-11-18,"(775.5, 954.25]",4,10,-6
31277.0,2019-11-18,"(954.25, 1133.0]",6,21,-15
31278.0,2019-11-18,"(296.967, 556.25]",9,26,-17
31278.0,2019-11-18,"(556.25, 814.5]",4,6,-2
31278.0,2019-11-18,"(814.5, 1072.75]",8,16,-8
31278.0,2019-11-18,"(1072.75, 1331.0]",18,28,-10
31279.0,2019-11-18,"(436.333, 603.75]",20,23,-3
31279.0,2019-11-18,"(770.5, 937.25]",7,1,6
31279.0,2019-11-18,"(937.25, 1104.0]",8,13,-5
31280.0,2019-11-18,"(354.016, 601.0]",6,27,-21
31280.0,2019-11-18,"(601.0, 847.0]",2,7,-5
31280.0,2019-11-18,"(847.0, 1093.0]",9,13,-4
31280.0,2019-11-18,"(1093.0, 1339.0]",14,21,-7
31000.0,2019-11-19,"(576.437, 717.75]",1,2,-1
31000.0,2019-11-19,"(999.25, 1140.0]",1,1,0
31001.0,2019-11-19,"(548.115, 770.25]",1,2,-1
31001.0,2019-11-19,"(770.25, 991.5]",1,3,-2
31001.0,2019-11-19,"(991.5, 1212.75]",2,7,-5
31002.0,2019-11-19,"(688.5, 811.0]",2,2,0
31002.0,2019-11-19,"(933.5, 1056.0]",1,4,-3
31003.0,2019-11-19,"(378.018, 624.5]",6,9,-3
31003.0,2019-11-19,"(624.5, 870.0]",1,3,-2
31003.0,2019-11-19,"(870.0, 1115.5]",4,7,-3
31003.0,2019-11-19,"(1115.5, 1361.0]",1,3,-2
31004.0,2019-11-19,"(1015.0, 1131.0]",3,1,2
31004.0,2019-11-19,"(1247.0, 1363.0]",1,5,-4
31005.0,2019-11-19,"(439.35, 602.5]",4,5,-1
31005.0,2019-11-19,"(765.0, 927.5]",3,1,2
31005.0,2019-11-19,"(927.5, 1090.0]",5,5,0
31006.0,2019-11-19,"(774.5, 968.75]",1,1,0
31006.0,2019-11-19,"(968.75, 1163.0]",4,2,2
31007.0,2019-11-19,"(399.072, 632.0]",7,22,-15
31007.0,2019-11-19,"(632.0, 864.0]",3,8,-5
31007.0,2019-11-19,"(864.0, 1096.0]",13,24,-11
31007.0,2019-11-19,"(1096.0, 1328.0]",3,11,-8
31009.0,2019-11-19,"(429.36, 590.0]",2,3,-1
31009.0,2019-11-19,"(910.0, 1070.0]",1,3,-2
31010.0,2019-11-19,"(906.0, 1133.0]",2,2,0
31010.0,2019-11-19,"(1133.0, 1360.0]",1,2,-1
31011.0,2019-11-19,"(333.079, 564.25]",10,14,-4
31011.0,2019-11-19,"(564.25, 794.5]",5,7,-2
31011.0,2019-11-19,"(794.5, 1024.75]",3,6,-3
31011.0,2019-11-19,"(1024.75, 1255.0]",2,7,-5
31012.0,2019-11-19,"(383.052, 621.0]",6,7,-1
31012.0,2019-11-19,"(621.0, 858.0]",2,2,0
31012.0,2019-11-19,"(1095.0, 1332.0]",1,6,-5
31013.0,2019-11-19,"(750.5, 940.0]",2,1,1
31013.0,2019-11-19,"(940.0, 1129.5]",2,3,-1
31013.0,2019-11-19,"(1129.5, 1319.0]",2,5,-3
31014.0,2019-11-19,"(393.079, 624.25]",22,30,-8
31014.0,2019-11-19,"(624.25, 854.5]",7,11,-4
31014.0,2019-11-19,"(854.5, 1084.75]",11,20,-9
31014.0,2019-11-19,"(1084.75, 1315.0]",9,14,-5
31015.0,2019-11-19,"(304.962, 565.5]",12,14,-2
31015.0,2019-11-19,"(565.5, 825.0]",6,11,-5
31015.0,2019-11-19,"(825.0, 1084.5]",4,10,-6
31015.0,2019-11-19,"(1084.5, 1344.0]",3,6,-3
31016.0,2019-11-19,"(457.189, 660.75]",5,16,-11
31016.0,2019-11-19,"(660.75, 863.5]",3,3,0
31016.0,2019-11-19,"(863.5, 1066.25]",2,6,-4
31016.0,2019-11-19,"(1066.25, 1269.0]",3,4,-1
31017.0,2019-11-19,"(449.112, 672.0]",5,9,-4
31018.0,2019-11-19,"(390.04, 631.0]",1,3,-2
31018.0,2019-11-19,"(871.0, 1111.0]",3,5,-2
31018.0,2019-11-19,"(1111.0, 1351.0]",5,7,-2
31019.0,2019-11-19,"(894.5, 1115.75]",1,1,0
31019.0,2019-11-19,"(1115.75, 1337.0]",2,4,-2
31020.0,2019-11-19,"(390.155, 602.25]",1,2,-1
31021.0,2019-11-19,"(373.202, 573.5]",1,5,-4
31021.0,2019-11-19,"(773.0, 972.5]",1,2,-1
31021.0,2019-11-19,"(972.5, 1172.0]",1,3,-2
31022.0,2019-11-19,"(495.103, 720.25]",6,12,-6
31022.0,2019-11-19,"(720.25, 944.5]",3,7,-4
31022.0,2019-11-19,"(944.5, 1168.75]",1,6,-5
31023.0,2019-11-19,"(463.129, 681.75]",2,2,0
31024.0,2019-11-19,"(304.007, 553.25]",4,7,-3
31024.0,2019-11-19,"(553.25, 801.5]",4,8,-4
31024.0,2019-11-19,"(801.5, 1049.75]",4,9,-5
31024.0,2019-11-19,"(1049.75, 1298.0]",7,16,-9
31025.0,2019-11-19,"(581.31, 754.5]",1,2,-1
31025.0,2019-11-19,"(927.0, 1099.5]",2,5,-3
31025.0,2019-11-19,"(1099.5, 1272.0]",1,2,-1
31026.0,2019-11-19,"(807.5, 1007.25]",1,2,-1
,,,,1.0,
,,,,3.0,
,,,,2.0,
31028.0,2019-11-19,"(781.25, 893.5]",1,2,-1
31028.0,2019-11-19,"(1005.75, 1118.0]",1,1,0
31029.0,2019-11-19,"(491.101, 716.75]",1,7,-6
31029.0,2019-11-19,"(716.75, 941.5]",4,4,0
31029.0,2019-11-19,"(941.5, 1166.25]",3,5,-2
31029.0,2019-11-19,"(1166.25, 1391.0]",3,4,-1
31030.0,2019-11-19,"(904.5, 1134.25]",5,6,-1
31030.0,2019-11-19,"(1134.25, 1364.0]",2,3,-1
31031.0,2019-11-19,"(697.25, 895.5]",1,4,-3
31031.0,2019-11-19,"(895.5, 1093.75]",1,2,-1
31031.0,2019-11-19,"(1093.75, 1292.0]",1,2,-1
31032.0,2019-11-19,"(791.0, 949.0]",1,2,-1
31032.0,2019-11-19,"(949.0, 1107.0]",2,1,1
,,,,2.0,
31034.0,2019-11-19,"(449.352, 612.0]",4,7,-3
31035.0,2019-11-19,"(463.095, 690.25]",2,6,-4
31035.0,2019-11-19,"(690.25, 916.5]",4,7,-3
31035.0,2019-11-19,"(916.5, 1142.75]",3,7,-4
31035.0,2019-11-19,"(1142.75, 1369.0]",1,3,-2
31036.0,2019-11-19,"(604.0, 803.0]",1,2,-1
31036.0,2019-11-19,"(803.0, 1002.0]",2,2,0
31036.0,2019-11-19,"(1002.0, 1201.0]",5,4,1
31037.0,2019-11-19,"(408.129, 626.75]",11,14,-3
31037.0,2019-11-19,"(626.75, 844.5]",4,7,-3
31037.0,2019-11-19,"(844.5, 1062.25]",4,9,-5
31037.0,2019-11-19,"(1062.25, 1280.0]",4,19,-15
31038.0,2019-11-19,"(455.173, 662.75]",2,5,-3
31038.0,2019-11-19,"(662.75, 869.5]",1,3,-2
31038.0,2019-11-19,"(869.5, 1076.25]",2,4,-2
31038.0,2019-11-19,"(1076.25, 1283.0]",2,3,-1
31039.0,2019-11-19,"(454.321, 624.75]",4,8,-4
31039.0,2019-11-19,"(794.5, 964.25]",3,4,-1
31039.0,2019-11-19,"(964.25, 1134.0]",5,5,0
31040.0,2019-11-19,"(457.411, 605.25]",1,2,-1
31040.0,2019-11-19,"(752.5, 899.75]",1,1,0
31041.0,2019-11-19,"(536.582, 641.5]",1,1,0
31042.0,2019-11-19,"(440.131, 658.25]",14,15,-1
31042.0,2019-11-19,"(875.5, 1092.75]",2,12,-10
31042.0,2019-11-19,"(1092.75, 1310.0]",1,4,-3
31043.0,2019-11-19,"(400.139, 616.25]",1,3,-2
31043.0,2019-11-19,"(831.5, 1046.75]",1,1,0
31043.0,2019-11-19,"(1046.75, 1262.0]",4,2,2
31044.0,2019-11-19,"(734.485, 863.75]",2,3,-1
31044.0,2019-11-19,"(863.75, 992.5]",1,1,0
31044.0,2019-11-19,"(992.5, 1121.25]",4,4,0
31044.0,2019-11-19,"(1121.25, 1250.0]",2,6,-4
31045.0,2019-11-19,"(508.42, 654.0]",1,2,-1
31045.0,2019-11-19,"(944.0, 1089.0]",2,1,1
31046.0,2019-11-19,"(394.361, 554.75]",1,4,-3
31046.0,2019-11-19,"(714.5, 874.25]",1,2,-1
31046.0,2019-11-19,"(874.25, 1034.0]",1,1,0
31047.0,2019-11-19,"(353.097, 579.75]",15,23,-8
31047.0,2019-11-19,"(579.75, 805.5]",2,4,-2
31047.0,2019-11-19,"(805.5, 1031.25]",2,10,-8
31047.0,2019-11-19,"(1031.25, 1257.0]",8,21,-13
31048.0,2019-11-19,"(526.348, 690.0]",1,3,-2
31048.0,2019-11-19,"(1016.0, 1179.0]",1,2,-1
31049.0,2019-11-19,"(308.237, 499.75]",1,1,0
31049.0,2019-11-19,"(690.5, 881.25]",1,1,0
31049.0,2019-11-19,"(881.25, 1072.0]",2,2,0
31050.0,2019-11-19,"(941.25, 1083.0]",1,1,0
31051.0,2019-11-19,"(302.113, 524.75]",1,4,-3
31051.0,2019-11-19,"(524.75, 746.5]",1,4,-3
31051.0,2019-11-19,"(968.25, 1190.0]",8,9,-1
31052.0,2019-11-19,"(236.004, 486.0]",2,4,-2
31052.0,2019-11-19,"(486.0, 735.0]",1,2,-1
31052.0,2019-11-19,"(984.0, 1233.0]",2,1,1
31053.0,2019-11-19,"(950.25, 1120.0]",2,3,-1
,,,,1.0,
,,,,1.0,
31055.0,2019-11-19,"(495.367, 654.25]",2,6,-4
31055.0,2019-11-19,"(970.75, 1129.0]",2,3,-1
31056.0,2019-11-19,"(115.025, 359.75]",1,1,0
31056.0,2019-11-19,"(847.25, 1091.0]",2,2,0
,,,,2.0,
31058.0,2019-11-19,"(549.0, 732.0]",1,1,0
31059.0,2019-11-19,"(946.5, 1124.0]",3,1,2
31060.0,2019-11-19,"(412.0, 720.0]",1,1,0
31060.0,2019-11-19,"(720.0, 1028.0]",4,2,2
31060.0,2019-11-19,"(1028.0, 1336.0]",2,4,-2
31061.0,2019-11-19,"(749.25, 999.0]",1,1,0
31062.0,2019-11-19,"(675.431, 818.25]",1,3,-2
31062.0,2019-11-19,"(818.25, 960.5]",2,5,-3
31062.0,2019-11-19,"(960.5, 1102.75]",1,2,-1
31062.0,2019-11-19,"(1102.75, 1245.0]",2,4,-2
31063.0,2019-11-19,"(926.907, 950.25]",1,1,0
31064.0,2019-11-19,"(450.264, 635.0]",3,6,-3
31064.0,2019-11-19,"(819.0, 1003.0]",1,1,0
31064.0,2019-11-19,"(1003.0, 1187.0]",7,15,-8
31065.0,2019-11-19,"(619.5, 869.0]",2,1,1
31065.0,2019-11-19,"(869.0, 1118.5]",1,4,-3
,,,,1.0,
,,,,2.0,
,,,,1.0,
31067.0,2019-11-19,"(425.048, 664.0]",1,3,-2
31067.0,2019-11-19,"(902.0, 1140.0]",3,5,-2
31067.0,2019-11-19,"(1140.0, 1378.0]",1,1,0
31068.0,2019-11-19,"(592.244, 782.0]",1,3,-2
31068.0,2019-11-19,"(971.0, 1160.0]",2,2,0
31068.0,2019-11-19,"(1160.0, 1349.0]",2,2,0
31069.0,2019-11-19,"(399.151, 612.25]",2,8,-6
31069.0,2019-11-19,"(612.25, 824.5]",1,2,-1
31069.0,2019-11-19,"(824.5, 1036.75]",2,4,-2
31069.0,2019-11-19,"(1036.75, 1249.0]",6,7,-1
31070.0,2019-11-19,"(935.5, 1168.75]",2,2,0
31070.0,2019-11-19,"(1168.75, 1402.0]",3,2,1
31071.0,2019-11-19,"(326.963, 587.25]",3,8,-5
31071.0,2019-11-19,"(587.25, 846.5]",4,6,-2
31071.0,2019-11-19,"(846.5, 1105.75]",4,8,-4
31071.0,2019-11-19,"(1105.75, 1365.0]",3,5,-2
,,,,2.0,
31073.0,2019-11-19,"(475.468, 609.0]",2,3,-1
31073.0,2019-11-19,"(875.0, 1008.0]",1,1,0
31074.0,2019-11-19,"(903.5, 1134.25]",1,2,-1
31074.0,2019-11-19,"(1134.25, 1365.0]",1,1,0
31075.0,2019-11-19,"(969.0, 1113.0]",1,1,0
31076.0,2019-11-19,"(420.275, 602.25]",1,1,0
31076.0,2019-11-19,"(964.75, 1146.0]",2,1,1
31077.0,2019-11-19,"(467.123, 687.25]",1,8,-7
31077.0,2019-11-19,"(687.25, 906.5]",4,5,-1
31077.0,2019-11-19,"(906.5, 1125.75]",3,6,-3
31077.0,2019-11-19,"(1125.75, 1345.0]",2,2,0
31078.0,2019-11-19,"(474.393, 626.75]",4,4,0
31078.0,2019-11-19,"(626.75, 778.5]",2,3,-1
31078.0,2019-11-19,"(930.25, 1082.0]",1,1,0
31079.0,2019-11-19,"(902.5, 1156.25]",2,5,-3
31079.0,2019-11-19,"(1156.25, 1410.0]",8,1,7
31080.0,2019-11-19,"(392.01, 640.5]",2,14,-12
31080.0,2019-11-19,"(640.5, 888.0]",1,3,-2
31080.0,2019-11-19,"(888.0, 1135.5]",4,9,-5
31080.0,2019-11-19,"(1135.5, 1383.0]",6,8,-2
31081.0,2019-11-19,"(483.35, 646.5]",3,3,0
31081.0,2019-11-19,"(646.5, 809.0]",2,4,-2
31081.0,2019-11-19,"(809.0, 971.5]",2,3,-1
31081.0,2019-11-19,"(971.5, 1134.0]",2,5,-3
31082.0,2019-11-19,"(767.514, 889.5]",1,2,-1
31082.0,2019-11-19,"(1011.0, 1132.5]",2,1,1
31083.0,2019-11-19,"(574.75, 744.5]",1,3,-2
31083.0,2019-11-19,"(914.25, 1084.0]",3,1,2
31084.0,2019-11-19,"(585.261, 770.75]",3,4,-1
31084.0,2019-11-19,"(770.75, 955.5]",1,2,-1
31085.0,2019-11-19,"(399.36, 560.0]",1,2,-1
31085.0,2019-11-19,"(880.0, 1040.0]",3,1,2
31086.0,2019-11-19,"(456.166, 665.5]",1,2,-1
31086.0,2019-11-19,"(874.0, 1082.5]",2,2,0
31086.0,2019-11-19,"(1082.5, 1291.0]",1,2,-1
31087.0,2019-11-19,"(649.75, 832.5]",1,2,-1
31087.0,2019-11-19,"(832.5, 1015.25]",2,3,-1
31087.0,2019-11-19,"(1015.25, 1198.0]",4,2,2
31088.0,2019-11-19,"(849.5, 1040.25]",1,2,-1
31088.0,2019-11-19,"(1040.25, 1231.0]",6,1,5
31089.0,2019-11-19,"(224.877, 506.75]",3,5,-2
31089.0,2019-11-19,"(506.75, 787.5]",6,17,-11
31089.0,2019-11-19,"(787.5, 1068.25]",4,15,-11
31089.0,2019-11-19,"(1068.25, 1349.0]",4,12,-8
31090.0,2019-11-19,"(884.0, 1036.0]",1,3,-2
31091.0,2019-11-19,"(86.916, 359.0]",1,1,0
31091.0,2019-11-19,"(630.0, 901.0]",1,3,-2
31091.0,2019-11-19,"(901.0, 1172.0]",6,1,5
31092.0,2019-11-19,"(671.0, 748.5]",1,1,0
31092.0,2019-11-19,"(748.5, 826.0]",1,1,0
,,,,1.0,
,,,,2.0,
,,,,2.0,
,,,,1.0,
31094.0,2019-11-19,"(679.588, 783.0]",2,3,-1
31094.0,2019-11-19,"(989.0, 1092.0]",1,2,-1
,,,,1.0,
,,,,2.0,
31096.0,2019-11-19,"(943.5, 1158.25]",2,2,0
31096.0,2019-11-19,"(1158.25, 1373.0]",1,3,-2
31097.0,2019-11-19,"(327.25, 632.5]",2,1,1
31097.0,2019-11-19,"(632.5, 937.75]",2,3,-1
31097.0,2019-11-19,"(937.75, 1243.0]",3,4,-1
31098.0,2019-11-19,"(429.1, 655.0]",6,14,-8
31098.0,2019-11-19,"(880.0, 1105.0]",7,1,6
31098.0,2019-11-19,"(1105.0, 1330.0]",2,10,-8
31099.0,2019-11-19,"(675.25, 877.5]",1,1,0
31099.0,2019-11-19,"(877.5, 1079.75]",1,2,-1
31100.0,2019-11-19,"(427.257, 613.75]",17,20,-3
31100.0,2019-11-19,"(613.75, 799.5]",3,6,-3
31100.0,2019-11-19,"(799.5, 985.25]",3,6,-3
31100.0,2019-11-19,"(985.25, 1171.0]",3,21,-18
31101.0,2019-11-19,"(7.624, 353.0]",1,3,-2
31101.0,2019-11-19,"(353.0, 697.0]",9,37,-28
31101.0,2019-11-19,"(697.0, 1041.0]",18,28,-10
31101.0,2019-11-19,"(1041.0, 1385.0]",43,68,-25
31102.0,2019-11-19,"(240.949, 504.75]",3,16,-13
31102.0,2019-11-19,"(504.75, 767.5]",1,20,-19
31102.0,2019-11-19,"(1030.25, 1293.0]",17,11,6
31103.0,2019-11-19,"(318.923, 589.25]",2,34,-32
31103.0,2019-11-19,"(589.25, 858.5]",1,10,-9
31103.0,2019-11-19,"(858.5, 1127.75]",11,27,-16
31103.0,2019-11-19,"(1127.75, 1397.0]",10,13,-3
31104.0,2019-11-19,"(359.25, 711.5]",7,4,3
31104.0,2019-11-19,"(711.5, 1063.75]",8,16,-8
31104.0,2019-11-19,"(1063.75, 1416.0]",17,14,3
31105.0,2019-11-19,"(280.964, 541.0]",2,18,-16
31105.0,2019-11-19,"(541.0, 800.0]",1,4,-3
31105.0,2019-11-19,"(800.0, 1059.0]",2,3,-1
31105.0,2019-11-19,"(1059.0, 1318.0]",3,6,-3
31106.0,2019-11-19,"(852.0, 1051.0]",1,11,-10
31106.0,2019-11-19,"(1051.0, 1250.0]",4,1,3
31107.0,2019-11-19,"(338.908, 613.0]",2,25,-23
31107.0,2019-11-19,"(613.0, 886.0]",2,6,-4
31107.0,2019-11-19,"(886.0, 1159.0]",17,27,-10
31107.0,2019-11-19,"(1159.0, 1432.0]",9,11,-2
31108.0,2019-11-19,"(21.752, 335.0]",1,1,0
31108.0,2019-11-19,"(335.0, 647.0]",10,33,-23
31108.0,2019-11-19,"(647.0, 959.0]",20,37,-17
31108.0,2019-11-19,"(959.0, 1271.0]",33,47,-14
31109.0,2019-11-19,"(326.925, 596.75]",9,28,-19
31109.0,2019-11-19,"(596.75, 865.5]",6,14,-8
31109.0,2019-11-19,"(865.5, 1134.25]",22,33,-11
31109.0,2019-11-19,"(1134.25, 1403.0]",5,14,-9
31110.0,2019-11-19,"(325.942, 591.5]",15,38,-23
31110.0,2019-11-19,"(591.5, 856.0]",11,23,-12
31110.0,2019-11-19,"(856.0, 1120.5]",16,34,-18
31110.0,2019-11-19,"(1120.5, 1385.0]",15,33,-18
31111.0,2019-11-19,"(332.956, 595.0]",10,27,-17
31111.0,2019-11-19,"(595.0, 856.0]",3,8,-5
31111.0,2019-11-19,"(856.0, 1117.0]",18,24,-6
31111.0,2019-11-19,"(1117.0, 1378.0]",10,16,-6
31112.0,2019-11-19,"(317.202, 517.5]",1,3,-2
31112.0,2019-11-19,"(717.0, 916.5]",1,3,-2
31112.0,2019-11-19,"(916.5, 1116.0]",4,1,3
31113.0,2019-11-19,"(32.594, 385.5]",1,2,-1
31113.0,2019-11-19,"(385.5, 737.0]",1,21,-20
31113.0,2019-11-19,"(737.0, 1088.5]",5,13,-8
31113.0,2019-11-19,"(1088.5, 1440.0]",13,23,-10
31114.0,2019-11-19,"(12.58, 369.0]",1,1,0
31114.0,2019-11-19,"(724.0, 1079.0]",17,23,-6
31114.0,2019-11-19,"(1079.0, 1434.0]",22,33,-11
31115.0,2019-11-19,"(456.061, 691.75]",2,20,-18
31115.0,2019-11-19,"(691.75, 926.5]",1,6,-5
31115.0,2019-11-19,"(926.5, 1161.25]",11,16,-5
31115.0,2019-11-19,"(1161.25, 1396.0]",15,25,-10
31116.0,2019-11-19,"(318.976, 576.0]",9,31,-22
31116.0,2019-11-19,"(576.0, 832.0]",4,4,0
31116.0,2019-11-19,"(832.0, 1088.0]",10,15,-5
31116.0,2019-11-19,"(1088.0, 1344.0]",18,28,-10
31117.0,2019-11-19,"(307.894, 585.5]",3,16,-13
31117.0,2019-11-19,"(585.5, 862.0]",2,3,-1
31117.0,2019-11-19,"(862.0, 1138.5]",12,18,-6
31117.0,2019-11-19,"(1138.5, 1415.0]",9,22,-13
31118.0,2019-11-19,"(364.028, 608.0]",4,23,-19
31118.0,2019-11-19,"(608.0, 851.0]",2,2,0
31118.0,2019-11-19,"(851.0, 1094.0]",9,14,-5
31118.0,2019-11-19,"(1094.0, 1337.0]",12,15,-3
31119.0,2019-11-19,"(10.657, 347.75]",3,5,-2
31119.0,2019-11-19,"(347.75, 683.5]",7,23,-16
31119.0,2019-11-19,"(683.5, 1019.25]",12,20,-8
31119.0,2019-11-19,"(1019.25, 1355.0]",26,48,-22
31120.0,2019-11-19,"(258.906, 533.5]",4,14,-10
31120.0,2019-11-19,"(533.5, 807.0]",4,11,-7
31120.0,2019-11-19,"(807.0, 1080.5]",7,16,-9
31120.0,2019-11-19,"(1080.5, 1354.0]",12,16,-4
31121.0,2019-11-19,"(348.961, 609.75]",18,31,-13
31121.0,2019-11-19,"(609.75, 869.5]",2,6,-4
31121.0,2019-11-19,"(869.5, 1129.25]",2,9,-7
31121.0,2019-11-19,"(1129.25, 1389.0]",6,13,-7
31122.0,2019-11-19,"(447.047, 686.25]",3,15,-12
31122.0,2019-11-19,"(686.25, 924.5]",1,1,0
31122.0,2019-11-19,"(924.5, 1162.75]",8,17,-9
31122.0,2019-11-19,"(1162.75, 1401.0]",8,12,-4
31123.0,2019-11-19,"(391.001, 641.75]",2,22,-20
31123.0,2019-11-19,"(641.75, 891.5]",1,8,-7
31123.0,2019-11-19,"(891.5, 1141.25]",8,14,-6
31123.0,2019-11-19,"(1141.25, 1391.0]",5,7,-2
31124.0,2019-11-19,"(353.927, 623.25]",12,39,-27
31124.0,2019-11-19,"(623.25, 891.5]",4,25,-21
31124.0,2019-11-19,"(891.5, 1159.75]",17,57,-40
31124.0,2019-11-19,"(1159.75, 1428.0]",16,35,-19
31125.0,2019-11-19,"(361.75, 698.5]",9,4,5
31125.0,2019-11-19,"(698.5, 1035.25]",14,26,-12
31125.0,2019-11-19,"(1035.25, 1372.0]",35,26,9
31126.0,2019-11-19,"(405.991, 659.25]",3,25,-22
31126.0,2019-11-19,"(659.25, 911.5]",6,11,-5
31126.0,2019-11-19,"(911.5, 1163.75]",17,23,-6
31126.0,2019-11-19,"(1163.75, 1416.0]",10,17,-7
31127.0,2019-11-19,"(325.0, 644.0]",18,1,17
31127.0,2019-11-19,"(644.0, 963.0]",15,24,-9
31127.0,2019-11-19,"(963.0, 1282.0]",16,30,-14
31128.0,2019-11-19,"(306.871, 590.25]",32,46,-14
31128.0,2019-11-19,"(590.25, 872.5]",25,43,-18
31128.0,2019-11-19,"(872.5, 1154.75]",23,39,-16
31128.0,2019-11-19,"(1154.75, 1437.0]",5,22,-17
31129.0,2019-11-19,"(461.041, 701.75]",17,23,-6
31129.0,2019-11-19,"(701.75, 941.5]",6,8,-2
31129.0,2019-11-19,"(941.5, 1181.25]",9,15,-6
31129.0,2019-11-19,"(1181.25, 1421.0]",4,15,-11
31130.0,2019-11-19,"(365.041, 605.75]",4,12,-8
31130.0,2019-11-19,"(605.75, 845.5]",1,10,-9
31130.0,2019-11-19,"(845.5, 1085.25]",3,5,-2
31130.0,2019-11-19,"(1085.25, 1325.0]",11,17,-6
31131.0,2019-11-19,"(394.003, 644.25]",1,11,-10
31131.0,2019-11-19,"(644.25, 893.5]",1,3,-2
31131.0,2019-11-19,"(893.5, 1142.75]",3,5,-2
31131.0,2019-11-19,"(1142.75, 1392.0]",7,9,-2
31200.0,2019-11-19,"(291.862, 577.5]",28,40,-12
31200.0,2019-11-19,"(577.5, 862.0]",14,25,-11
31200.0,2019-11-19,"(862.0, 1146.5]",30,65,-35
31200.0,2019-11-19,"(1146.5, 1431.0]",14,33,-19
31201.0,2019-11-19,"(296.883, 577.25]",22,51,-29
31201.0,2019-11-19,"(577.25, 856.5]",15,32,-17
31201.0,2019-11-19,"(856.5, 1135.75]",32,53,-21
31201.0,2019-11-19,"(1135.75, 1415.0]",30,57,-27
31202.0,2019-11-19,"(353.918, 625.5]",18,36,-18
31202.0,2019-11-19,"(625.5, 896.0]",9,23,-14
31202.0,2019-11-19,"(896.0, 1166.5]",26,39,-13
31202.0,2019-11-19,"(1166.5, 1437.0]",12,27,-15
31203.0,2019-11-19,"(351.0, 687.0]",12,1,11
31203.0,2019-11-19,"(687.0, 1023.0]",20,39,-19
31203.0,2019-11-19,"(1023.0, 1359.0]",34,36,-2
31204.0,2019-11-19,"(468.172, 676.0]",17,20,-3
31204.0,2019-11-19,"(676.0, 883.0]",1,4,-3
31204.0,2019-11-19,"(883.0, 1090.0]",4,14,-10
31204.0,2019-11-19,"(1090.0, 1297.0]",4,14,-10
31205.0,2019-11-19,"(348.918, 620.5]",38,43,-5
31205.0,2019-11-19,"(620.5, 891.0]",21,31,-10
31205.0,2019-11-19,"(891.0, 1161.5]",15,33,-18
31205.0,2019-11-19,"(1161.5, 1432.0]",3,25,-22
31206.0,2019-11-19,"(352.13, 570.5]",4,5,-1
31206.0,2019-11-19,"(570.5, 788.0]",1,3,-2
31206.0,2019-11-19,"(788.0, 1005.5]",2,7,-5
31206.0,2019-11-19,"(1005.5, 1223.0]",5,15,-10
31207.0,2019-11-19,"(616.5, 889.0]",1,10,-9
31207.0,2019-11-19,"(889.0, 1161.5]",2,2,0
31207.0,2019-11-19,"(1161.5, 1434.0]",2,4,-2
31208.0,2019-11-19,"(321.183, 526.25]",14,18,-4
31208.0,2019-11-19,"(730.5, 934.75]",2,9,-7
31208.0,2019-11-19,"(934.75, 1139.0]",8,20,-12
31209.0,2019-11-19,"(534.354, 696.5]",2,2,0
31209.0,2019-11-19,"(696.5, 858.0]",3,5,-2
31209.0,2019-11-19,"(858.0, 1019.5]",1,1,0
31209.0,2019-11-19,"(1019.5, 1181.0]",4,5,-1
31211.0,2019-11-19,"(391.027, 635.25]",11,15,-4
31211.0,2019-11-19,"(635.25, 878.5]",3,6,-3
31211.0,2019-11-19,"(878.5, 1121.75]",7,14,-7
31211.0,2019-11-19,"(1121.75, 1365.0]",5,13,-8
31212.0,2019-11-19,"(359.958, 621.5]",25,43,-18
31212.0,2019-11-19,"(621.5, 882.0]",8,21,-13
31212.0,2019-11-19,"(882.0, 1142.5]",16,35,-19
31212.0,2019-11-19,"(1142.5, 1403.0]",11,18,-7
31213.0,2019-11-19,"(415.12, 636.0]",33,47,-14
31213.0,2019-11-19,"(636.0, 856.0]",11,23,-12
31213.0,2019-11-19,"(856.0, 1076.0]",13,27,-14
31213.0,2019-11-19,"(1076.0, 1296.0]",18,44,-26
31214.0,2019-11-19,"(134.755, 447.25]",1,3,-2
31214.0,2019-11-19,"(447.25, 758.5]",13,40,-27
31214.0,2019-11-19,"(758.5, 1069.75]",18,32,-14
31214.0,2019-11-19,"(1069.75, 1381.0]",25,41,-16
31215.0,2019-11-19,"(396.966, 656.5]",31,33,-2
31215.0,2019-11-19,"(656.5, 915.0]",4,7,-3
31215.0,2019-11-19,"(915.0, 1173.5]",14,29,-15
31215.0,2019-11-19,"(1173.5, 1432.0]",2,6,-4
31216.0,2019-11-19,"(358.185, 562.75]",15,15,0
31216.0,2019-11-19,"(562.75, 766.5]",5,9,-4
31216.0,2019-11-19,"(766.5, 970.25]",3,7,-4
31216.0,2019-11-19,"(970.25, 1174.0]",4,25,-21
31217.0,2019-11-19,"(322.0, 573.0]",16,17,-1
31217.0,2019-11-19,"(573.0, 823.0]",4,6,-2
31217.0,2019-11-19,"(823.0, 1073.0]",9,25,-16
31217.0,2019-11-19,"(1073.0, 1323.0]",1,5,-4
31218.0,2019-11-19,"(325.941, 591.75]",17,34,-17
31218.0,2019-11-19,"(591.75, 856.5]",6,8,-2
31218.0,2019-11-19,"(856.5, 1121.25]",15,33,-18
31218.0,2019-11-19,"(1121.25, 1386.0]",4,6,-2
31219.0,2019-11-19,"(359.075, 591.25]",13,13,0
31219.0,2019-11-19,"(591.25, 822.5]",9,10,-1
31219.0,2019-11-19,"(822.5, 1053.75]",4,19,-15
31219.0,2019-11-19,"(1053.75, 1285.0]",2,5,-3
31220.0,2019-11-19,"(297.271, 480.25]",7,12,-5
31220.0,2019-11-19,"(480.25, 662.5]",13,14,-1
31220.0,2019-11-19,"(662.5, 844.75]",2,5,-3
31221.0,2019-11-19,"(381.063, 616.25]",27,28,-1
31221.0,2019-11-19,"(616.25, 850.5]",9,19,-10
31221.0,2019-11-19,"(850.5, 1084.75]",8,27,-19
31221.0,2019-11-19,"(1084.75, 1319.0]",12,31,-19
31222.0,2019-11-19,"(374.026, 618.5]",20,21,-1
31222.0,2019-11-19,"(618.5, 862.0]",4,8,-4
31222.0,2019-11-19,"(862.0, 1105.5]",8,27,-19
31222.0,2019-11-19,"(1105.5, 1349.0]",5,20,-15
31223.0,2019-11-19,"(28.693, 356.75]",3,4,-1
31223.0,2019-11-19,"(356.75, 683.5]",10,33,-23
31223.0,2019-11-19,"(683.5, 1010.25]",6,14,-8
31223.0,2019-11-19,"(1010.25, 1337.0]",29,46,-17
31224.0,2019-11-19,"(460.129, 678.75]",21,23,-2
31224.0,2019-11-19,"(678.75, 896.5]",9,17,-8
31224.0,2019-11-19,"(896.5, 1114.25]",10,22,-12
31224.0,2019-11-19,"(1114.25, 1332.0]",2,9,-7
31225.0,2019-11-19,"(454.255, 641.25]",9,14,-5
31225.0,2019-11-19,"(641.25, 827.5]",7,11,-4
31225.0,2019-11-19,"(827.5, 1013.75]",16,24,-8
31225.0,2019-11-19,"(1013.75, 1200.0]",10,19,-9
31226.0,2019-11-19,"(326.002, 576.5]",4,9,-5
31226.0,2019-11-19,"(826.0, 1075.5]",3,2,1
31226.0,2019-11-19,"(1075.5, 1325.0]",7,8,-1
31227.0,2019-11-19,"(423.053, 660.75]",55,62,-7
31227.0,2019-11-19,"(660.75, 897.5]",9,17,-8
31227.0,2019-11-19,"(897.5, 1134.25]",5,21,-16
31227.0,2019-11-19,"(1134.25, 1371.0]",3,3,0
31228.0,2019-11-19,"(184.754, 497.5]",10,11,-1
31228.0,2019-11-19,"(497.5, 809.0]",20,28,-8
31228.0,2019-11-19,"(809.0, 1120.5]",26,56,-30
31228.0,2019-11-19,"(1120.5, 1432.0]",14,37,-23
31229.0,2019-11-19,"(192.758, 504.5]",15,42,-27
31229.0,2019-11-19,"(504.5, 815.0]",13,34,-21
31229.0,2019-11-19,"(815.0, 1125.5]",36,63,-27
31229.0,2019-11-19,"(1125.5, 1436.0]",34,58,-24
31230.0,2019-11-19,"(407.005, 656.75]",52,62,-10
31230.0,2019-11-19,"(656.75, 905.5]",15,18,-3
31230.0,2019-11-19,"(905.5, 1154.25]",18,60,-42
31230.0,2019-11-19,"(1154.25, 1403.0]",4,11,-7
31231.0,2019-11-19,"(324.996, 577.0]",20,21,-1
31231.0,2019-11-19,"(577.0, 828.0]",5,10,-5
31231.0,2019-11-19,"(828.0, 1079.0]",16,31,-15
31231.0,2019-11-19,"(1079.0, 1330.0]",4,13,-9
31232.0,2019-11-19,"(296.88, 578.0]",16,19,-3
31232.0,2019-11-19,"(578.0, 858.0]",4,5,-1
31232.0,2019-11-19,"(858.0, 1138.0]",8,16,-8
31232.0,2019-11-19,"(1138.0, 1418.0]",3,12,-9
31233.0,2019-11-19,"(161.986, 416.5]",3,5,-2
31233.0,2019-11-19,"(416.5, 670.0]",49,54,-5
31233.0,2019-11-19,"(670.0, 923.5]",10,17,-7
31233.0,2019-11-19,"(923.5, 1177.0]",16,39,-23
31234.0,2019-11-19,"(352.97, 611.5]",18,31,-13
31234.0,2019-11-19,"(611.5, 869.0]",17,25,-8
31234.0,2019-11-19,"(869.0, 1126.5]",16,26,-10
31234.0,2019-11-19,"(1126.5, 1384.0]",9,17,-8
31235.0,2019-11-19,"(466.244, 656.0]",9,10,-1
31235.0,2019-11-19,"(656.0, 845.0]",5,9,-4
31235.0,2019-11-19,"(845.0, 1034.0]",3,5,-2
31235.0,2019-11-19,"(1034.0, 1223.0]",2,5,-3
31236.0,2019-11-19,"(406.017, 652.75]",19,21,-2
31236.0,2019-11-19,"(652.75, 898.5]",10,18,-8
31236.0,2019-11-19,"(898.5, 1144.25]",12,37,-25
31236.0,2019-11-19,"(1144.25, 1390.0]",4,13,-9
31237.0,2019-11-19,"(332.904, 608.0]",5,13,-8
31237.0,2019-11-19,"(608.0, 882.0]",13,26,-13
31237.0,2019-11-19,"(882.0, 1156.0]",17,29,-12
31237.0,2019-11-19,"(1156.0, 1430.0]",7,19,-12
31238.0,2019-11-19,"(55.672, 389.0]",2,3,-1
31238.0,2019-11-19,"(389.0, 721.0]",25,30,-5
31238.0,2019-11-19,"(721.0, 1053.0]",7,24,-17
31238.0,2019-11-19,"(1053.0, 1385.0]",7,25,-18
31239.0,2019-11-19,"(435.064, 670.0]",34,39,-5
31239.0,2019-11-19,"(670.0, 904.0]",7,16,-9
31239.0,2019-11-19,"(904.0, 1138.0]",10,34,-24
31239.0,2019-11-19,"(1138.0, 1372.0]",8,16,-8
31240.0,2019-11-19,"(955.843, 995.25]",1,3,-2
31240.0,2019-11-19,"(1034.5, 1073.75]",1,3,-2
31240.0,2019-11-19,"(1073.75, 1113.0]",1,2,-1
31241.0,2019-11-19,"(21.614, 369.5]",1,4,-3
31241.0,2019-11-19,"(369.5, 716.0]",41,81,-40
31241.0,2019-11-19,"(716.0, 1062.5]",7,27,-20
31241.0,2019-11-19,"(1062.5, 1409.0]",24,51,-27
31242.0,2019-11-19,"(297.176, 504.0]",12,14,-2
31242.0,2019-11-19,"(504.0, 710.0]",17,21,-4
31242.0,2019-11-19,"(710.0, 916.0]",9,14,-5
31242.0,2019-11-19,"(916.0, 1122.0]",4,25,-21
31243.0,2019-11-19,"(376.017, 622.75]",31,35,-4
31243.0,2019-11-19,"(622.75, 868.5]",6,11,-5
31243.0,2019-11-19,"(868.5, 1114.25]",16,50,-34
31243.0,2019-11-19,"(1114.25, 1360.0]",4,13,-9
31244.0,2019-11-19,"(41.62, 388.0]",1,2,-1
31244.0,2019-11-19,"(388.0, 733.0]",14,31,-17
31244.0,2019-11-19,"(733.0, 1078.0]",13,26,-13
31244.0,2019-11-19,"(1078.0, 1423.0]",10,13,-3
31245.0,2019-11-19,"(217.789, 521.75]",8,21,-13
31245.0,2019-11-19,"(521.75, 824.5]",11,24,-13
31245.0,2019-11-19,"(824.5, 1127.25]",12,21,-9
31245.0,2019-11-19,"(1127.25, 1430.0]",12,20,-8
31246.0,2019-11-19,"(395.992, 649.0]",20,34,-14
31246.0,2019-11-19,"(649.0, 901.0]",13,21,-8
31246.0,2019-11-19,"(901.0, 1153.0]",17,39,-22
31246.0,2019-11-19,"(1153.0, 1405.0]",4,16,-12
31247.0,2019-11-19,"(402.994, 655.5]",18,27,-9
31247.0,2019-11-19,"(655.5, 907.0]",16,25,-9
31247.0,2019-11-19,"(907.0, 1158.5]",12,34,-22
31247.0,2019-11-19,"(1158.5, 1410.0]",4,10,-6
31248.0,2019-11-19,"(357.923, 628.25]",7,14,-7
31248.0,2019-11-19,"(628.25, 897.5]",9,18,-9
31248.0,2019-11-19,"(897.5, 1166.75]",14,28,-14
31248.0,2019-11-19,"(1166.75, 1436.0]",2,5,-3
31249.0,2019-11-19,"(448.194, 650.5]",4,7,-3
31249.0,2019-11-19,"(650.5, 852.0]",6,10,-4
31249.0,2019-11-19,"(852.0, 1053.5]",8,14,-6
31249.0,2019-11-19,"(1053.5, 1255.0]",9,18,-9
31250.0,2019-11-19,"(110.677, 442.75]",1,2,-1
31250.0,2019-11-19,"(442.75, 773.5]",22,28,-6
31250.0,2019-11-19,"(773.5, 1104.25]",5,19,-14
31250.0,2019-11-19,"(1104.25, 1435.0]",6,21,-15
31251.0,2019-11-19,"(248.846, 538.5]",16,32,-16
31251.0,2019-11-19,"(538.5, 827.0]",13,27,-14
31251.0,2019-11-19,"(827.0, 1115.5]",19,41,-22
31251.0,2019-11-19,"(1115.5, 1404.0]",9,17,-8
31252.0,2019-11-19,"(392.962, 653.5]",20,22,-2
31252.0,2019-11-19,"(653.5, 913.0]",6,12,-6
31252.0,2019-11-19,"(913.0, 1172.5]",4,25,-21
31252.0,2019-11-19,"(1172.5, 1432.0]",1,3,-2
31253.0,2019-11-19,"(389.126, 608.5]",25,27,-2
31253.0,2019-11-19,"(608.5, 827.0]",11,14,-3
31253.0,2019-11-19,"(827.0, 1045.5]",4,10,-6
31253.0,2019-11-19,"(1045.5, 1264.0]",5,22,-17
31254.0,2019-11-19,"(401.997, 653.75]",27,31,-4
31254.0,2019-11-19,"(653.75, 904.5]",6,14,-8
31254.0,2019-11-19,"(904.5, 1155.25]",9,31,-22
31254.0,2019-11-19,"(1155.25, 1406.0]",1,3,-2
31255.0,2019-11-19,"(427.035, 669.25]",22,32,-10
31255.0,2019-11-19,"(669.25, 910.5]",5,10,-5
31255.0,2019-11-19,"(910.5, 1151.75]",4,22,-18
31255.0,2019-11-19,"(1151.75, 1393.0]",6,7,-1
31256.0,2019-11-19,"(283.049, 521.75]",4,4,0
31256.0,2019-11-19,"(521.75, 759.5]",9,11,-2
31256.0,2019-11-19,"(759.5, 997.25]",5,9,-4
31256.0,2019-11-19,"(997.25, 1235.0]",5,21,-16
31257.0,2019-11-19,"(48.678, 380.5]",1,3,-2
31257.0,2019-11-19,"(380.5, 711.0]",22,39,-17
31257.0,2019-11-19,"(711.0, 1041.5]",20,39,-19
31257.0,2019-11-19,"(1041.5, 1372.0]",13,40,-27
31258.0,2019-11-19,"(62.633, 405.75]",1,2,-1
31258.0,2019-11-19,"(405.75, 747.5]",9,19,-10
31258.0,2019-11-19,"(747.5, 1089.25]",22,43,-21
31258.0,2019-11-19,"(1089.25, 1431.0]",11,22,-11
31259.0,2019-11-19,"(453.154, 665.5]",8,8,0
31259.0,2019-11-19,"(877.0, 1088.5]",1,3,-2
31259.0,2019-11-19,"(1088.5, 1300.0]",1,9,-8
31260.0,2019-11-19,"(387.018, 633.5]",19,23,-4
31260.0,2019-11-19,"(633.5, 879.0]",4,9,-5
31260.0,2019-11-19,"(879.0, 1124.5]",4,20,-16
31260.0,2019-11-19,"(1124.5, 1370.0]",1,4,-3
31261.0,2019-11-19,"(411.276, 593.0]",9,9,0
31261.0,2019-11-19,"(593.0, 774.0]",1,3,-2
31261.0,2019-11-19,"(774.0, 955.0]",3,8,-5
31261.0,2019-11-19,"(955.0, 1136.0]",1,14,-13
31262.0,2019-11-19,"(321.5, 623.0]",12,1,11
31262.0,2019-11-19,"(623.0, 924.5]",3,13,-10
31262.0,2019-11-19,"(924.5, 1226.0]",5,6,-1
31263.0,2019-11-19,"(357.076, 589.0]",24,38,-14
31263.0,2019-11-19,"(589.0, 820.0]",8,15,-7
31263.0,2019-11-19,"(820.0, 1051.0]",10,28,-18
31263.0,2019-11-19,"(1051.0, 1282.0]",13,31,-18
31264.0,2019-11-19,"(-0.115, 279.75]",1,2,-1
31264.0,2019-11-19,"(279.75, 558.5]",13,18,-5
31264.0,2019-11-19,"(558.5, 837.25]",11,14,-3
31264.0,2019-11-19,"(837.25, 1116.0]",9,28,-19
31265.0,2019-11-19,"(377.95, 641.5]",17,37,-20
31265.0,2019-11-19,"(641.5, 904.0]",4,14,-10
31265.0,2019-11-19,"(904.0, 1166.5]",33,59,-26
31265.0,2019-11-19,"(1166.5, 1429.0]",5,16,-11
31266.0,2019-11-19,"(291.889, 570.75]",10,30,-20
31266.0,2019-11-19,"(570.75, 848.5]",2,11,-9
31266.0,2019-11-19,"(848.5, 1126.25]",22,40,-18
31266.0,2019-11-19,"(1126.25, 1404.0]",17,20,-3
31267.0,2019-11-19,"(397.006, 646.5]",30,50,-20
31267.0,2019-11-19,"(646.5, 895.0]",16,24,-8
31267.0,2019-11-19,"(895.0, 1143.5]",14,27,-13
31267.0,2019-11-19,"(1143.5, 1392.0]",9,23,-14
31268.0,2019-11-19,"(364.975, 622.25]",18,57,-39
31268.0,2019-11-19,"(622.25, 878.5]",7,11,-4
31268.0,2019-11-19,"(878.5, 1134.75]",17,21,-4
31268.0,2019-11-19,"(1134.75, 1391.0]",18,34,-16
31269.0,2019-11-19,"(392.071, 625.25]",9,17,-8
31269.0,2019-11-19,"(625.25, 857.5]",7,13,-6
31269.0,2019-11-19,"(857.5, 1089.75]",4,14,-10
31269.0,2019-11-19,"(1089.75, 1322.0]",2,6,-4
31270.0,2019-11-19,"(446.126, 665.5]",11,16,-5
31270.0,2019-11-19,"(665.5, 884.0]",4,8,-4
31270.0,2019-11-19,"(884.0, 1102.5]",10,27,-17
31270.0,2019-11-19,"(1102.5, 1321.0]",6,12,-6
31271.0,2019-11-19,"(416.163, 626.25]",14,15,-1
31271.0,2019-11-19,"(626.25, 835.5]",5,10,-5
31271.0,2019-11-19,"(835.5, 1044.75]",3,12,-9
31271.0,2019-11-19,"(1044.75, 1254.0]",4,14,-10
31272.0,2019-11-19,"(377.043, 617.25]",28,30,-2
31272.0,2019-11-19,"(617.25, 856.5]",9,17,-8
31272.0,2019-11-19,"(856.5, 1095.75]",7,25,-18
31272.0,2019-11-19,"(1095.75, 1335.0]",4,14,-10
31273.0,2019-11-19,"(491.383, 646.25]",1,5,-4
31273.0,2019-11-19,"(800.5, 954.75]",2,3,-1
31273.0,2019-11-19,"(954.75, 1109.0]",4,5,-1
31274.0,2019-11-19,"(392.072, 625.0]",15,17,-2
31274.0,2019-11-19,"(625.0, 857.0]",6,10,-4
31274.0,2019-11-19,"(857.0, 1089.0]",5,14,-9
31274.0,2019-11-19,"(1089.0, 1321.0]",5,18,-13
31275.0,2019-11-19,"(127.69, 456.5]",6,7,-1
31275.0,2019-11-19,"(456.5, 784.0]",25,40,-15
31275.0,2019-11-19,"(784.0, 1111.5]",24,51,-27
31275.0,2019-11-19,"(1111.5, 1439.0]",7,18,-11
31276.0,2019-11-19,"(421.119, 642.25]",25,27,-2
31276.0,2019-11-19,"(642.25, 862.5]",4,10,-6
31276.0,2019-11-19,"(862.5, 1082.75]",5,21,-16
31276.0,2019-11-19,"(1082.75, 1303.0]",4,18,-14
31277.0,2019-11-19,"(391.193, 593.75]",39,47,-8
31277.0,2019-11-19,"(593.75, 795.5]",12,21,-9
31277.0,2019-11-19,"(795.5, 997.25]",9,26,-17
31277.0,2019-11-19,"(997.25, 1199.0]",11,25,-14
31278.0,2019-11-19,"(27.68, 359.0]",1,2,-1
31278.0,2019-11-19,"(359.0, 689.0]",11,31,-20
31278.0,2019-11-19,"(689.0, 1019.0]",6,14,-8
31278.0,2019-11-19,"(1019.0, 1349.0]",26,37,-11
31279.0,2019-11-19,"(397.302, 572.5]",24,26,-2
31279.0,2019-11-19,"(572.5, 747.0]",9,12,-3
31279.0,2019-11-19,"(747.0, 921.5]",5,8,-3
31279.0,2019-11-19,"(921.5, 1096.0]",10,33,-23
31280.0,2019-11-19,"(352.046, 591.5]",5,21,-16
31280.0,2019-11-19,"(591.5, 830.0]",4,8,-4
31280.0,2019-11-19,"(830.0, 1068.5]",6,8,-2
31280.0,2019-11-19,"(1068.5, 1307.0]",22,29,-7
31000.0,2019-11-20,"(989.818, 1035.5]",1,2,-1
31000.0,2019-11-20,"(1126.5, 1172.0]",1,2,-1
31001.0,2019-11-20,"(1082.868, 1116.0]",1,2,-1
31002.0,2019-11-20,"(336.24, 527.0]",3,5,-2
31002.0,2019-11-20,"(527.0, 717.0]",2,6,-4
31002.0,2019-11-20,"(717.0, 907.0]",1,1,0
31002.0,2019-11-20,"(907.0, 1097.0]",3,7,-4
31003.0,2019-11-20,"(381.224, 576.0]",2,5,-3
31003.0,2019-11-20,"(576.0, 770.0]",1,2,-1
31003.0,2019-11-20,"(770.0, 964.0]",3,4,-1
31003.0,2019-11-20,"(964.0, 1158.0]",2,6,-4
31004.0,2019-11-20,"(492.417, 638.75]",1,4,-3
31004.0,2019-11-20,"(930.25, 1076.0]",3,3,0
31005.0,2019-11-20,"(420.217, 616.75]",8,9,-1
31005.0,2019-11-20,"(616.75, 812.5]",1,2,-1
31005.0,2019-11-20,"(812.5, 1008.25]",2,3,-1
31005.0,2019-11-20,"(1008.25, 1204.0]",1,12,-11
31006.0,2019-11-20,"(307.0, 611.0]",1,2,-1
31006.0,2019-11-20,"(915.0, 1219.0]",1,1,0
31007.0,2019-11-20,"(419.107, 643.25]",9,24,-15
31007.0,2019-11-20,"(643.25, 866.5]",5,9,-4
31007.0,2019-11-20,"(866.5, 1089.75]",11,24,-13
31007.0,2019-11-20,"(1089.75, 1313.0]",5,11,-6
31009.0,2019-11-20,"(435.28, 616.0]",3,3,0
31009.0,2019-11-20,"(976.0, 1156.0]",2,1,1
31010.0,2019-11-20,"(412.22, 608.0]",1,2,-1
31010.0,2019-11-20,"(608.0, 803.0]",1,1,0
31010.0,2019-11-20,"(803.0, 998.0]",1,1,0
31010.0,2019-11-20,"(998.0, 1193.0]",2,2,0
31011.0,2019-11-20,"(321.049, 559.75]",6,9,-3
31011.0,2019-11-20,"(559.75, 797.5]",4,6,-2
31011.0,2019-11-20,"(797.5, 1035.25]",3,6,-3
31011.0,2019-11-20,"(1035.25, 1273.0]",1,5,-4
31012.0,2019-11-20,"(385.301, 560.75]",7,9,-2
31012.0,2019-11-20,"(560.75, 735.5]",1,1,0
31013.0,2019-11-20,"(16.707, 341.25]",2,2,0
31013.0,2019-11-20,"(664.5, 987.75]",3,4,-1
31013.0,2019-11-20,"(987.75, 1311.0]",10,6,4
31014.0,2019-11-20,"(304.938, 571.5]",26,33,-7
31014.0,2019-11-20,"(571.5, 837.0]",7,12,-5
31014.0,2019-11-20,"(837.0, 1102.5]",7,20,-13
31014.0,2019-11-20,"(1102.5, 1368.0]",4,11,-7
31015.0,2019-11-20,"(4.739, 321.25]",2,2,0
31015.0,2019-11-20,"(321.25, 636.5]",21,28,-7
31015.0,2019-11-20,"(636.5, 951.75]",7,9,-2
31015.0,2019-11-20,"(951.75, 1267.0]",4,8,-4
31016.0,2019-11-20,"(441.177, 647.75]",5,9,-4
31016.0,2019-11-20,"(647.75, 853.5]",2,6,-4
31016.0,2019-11-20,"(853.5, 1059.25]",4,5,-1
31016.0,2019-11-20,"(1059.25, 1265.0]",3,3,0
31017.0,2019-11-20,"(495.074, 727.5]",4,6,-2
31017.0,2019-11-20,"(727.5, 959.0]",1,4,-3
31018.0,2019-11-20,"(664.5, 889.0]",1,10,-9
31018.0,2019-11-20,"(889.0, 1113.5]",2,1,1
31018.0,2019-11-20,"(1113.5, 1338.0]",2,2,0
31019.0,2019-11-20,"(1108.25, 1326.0]",2,2,0
31020.0,2019-11-20,"(520.256, 707.0]",1,2,-1
31020.0,2019-11-20,"(707.0, 893.0]",2,5,-3
31020.0,2019-11-20,"(893.0, 1079.0]",1,2,-1
31020.0,2019-11-20,"(1079.0, 1265.0]",2,2,0
31021.0,2019-11-20,"(415.214, 612.5]",2,4,-2
31021.0,2019-11-20,"(612.5, 809.0]",1,1,0
31021.0,2019-11-20,"(809.0, 1005.5]",1,1,0
31021.0,2019-11-20,"(1005.5, 1202.0]",3,8,-5
31022.0,2019-11-20,"(491.232, 684.0]",1,5,-4
31022.0,2019-11-20,"(684.0, 876.0]",1,1,0
31022.0,2019-11-20,"(876.0, 1068.0]",3,5,-2
31022.0,2019-11-20,"(1068.0, 1260.0]",4,12,-8
31023.0,2019-11-20,"(430.056, 667.0]",2,3,-1
31023.0,2019-11-20,"(667.0, 903.0]",2,4,-2
31023.0,2019-11-20,"(903.0, 1139.0]",4,6,-2
31023.0,2019-11-20,"(1139.0, 1375.0]",2,5,-3
31024.0,2019-11-20,"(364.018, 610.5]",8,15,-7
31024.0,2019-11-20,"(610.5, 856.0]",2,4,-2
31024.0,2019-11-20,"(856.0, 1101.5]",5,10,-5
31024.0,2019-11-20,"(1101.5, 1347.0]",2,8,-6
31025.0,2019-11-20,"(905.25, 1090.0]",1,2,-1
31026.0,2019-11-20,"(484.244, 674.0]",1,3,-2
31026.0,2019-11-20,"(863.0, 1052.0]",1,1,0
31026.0,2019-11-20,"(1052.0, 1241.0]",5,2,3
31027.0,2019-11-20,"(926.0, 1098.5]",2,2,0
31027.0,2019-11-20,"(1098.5, 1271.0]",2,4,-2
31028.0,2019-11-20,"(391.272, 574.0]",1,2,-1
31028.0,2019-11-20,"(938.0, 1120.0]",1,1,0
31029.0,2019-11-20,"(853.5, 1057.25]",4,7,-3
31029.0,2019-11-20,"(1057.25, 1261.0]",4,2,2
31030.0,2019-11-20,"(887.0, 1135.5]",4,8,-4
31030.0,2019-11-20,"(1135.5, 1384.0]",2,1,1
31031.0,2019-11-20,"(352.196, 554.0]",1,5,-4
31031.0,2019-11-20,"(554.0, 755.0]",1,2,-1
31031.0,2019-11-20,"(755.0, 956.0]",2,4,-2
31031.0,2019-11-20,"(956.0, 1157.0]",2,3,-1
31032.0,2019-11-20,"(800.5, 989.75]",1,2,-1
31032.0,2019-11-20,"(989.75, 1179.0]",2,2,0
31033.0,2019-11-20,"(926.25, 1235.0]",1,1,0
31034.0,2019-11-20,"(477.061, 712.75]",4,7,-3
31034.0,2019-11-20,"(1182.25, 1417.0]",2,1,1
31035.0,2019-11-20,"(551.25, 752.5]",1,4,-3
31035.0,2019-11-20,"(752.5, 953.75]",1,1,0
31035.0,2019-11-20,"(953.75, 1155.0]",5,1,4
31036.0,2019-11-20,"(574.25, 759.5]",2,4,-2
31036.0,2019-11-20,"(944.75, 1130.0]",3,3,0
31037.0,2019-11-20,"(351.945, 616.75]",13,17,-4
31037.0,2019-11-20,"(616.75, 880.5]",5,10,-5
31037.0,2019-11-20,"(880.5, 1144.25]",6,20,-14
31037.0,2019-11-20,"(1144.25, 1408.0]",1,5,-4
31038.0,2019-11-20,"(556.5, 753.0]",2,3,-1
31038.0,2019-11-20,"(949.5, 1146.0]",3,3,0
31039.0,2019-11-20,"(460.345, 624.75]",4,10,-6
31039.0,2019-11-20,"(624.75, 788.5]",3,6,-3
31039.0,2019-11-20,"(952.25, 1116.0]",2,1,1
31040.0,2019-11-20,"(454.125, 673.75]",2,2,0
31040.0,2019-11-20,"(673.75, 892.5]",1,1,0
31040.0,2019-11-20,"(1111.25, 1330.0]",1,1,0
31041.0,2019-11-20,"(454.378, 610.5]",3,5,-2
31041.0,2019-11-20,"(610.5, 766.0]",1,1,0
31042.0,2019-11-20,"(436.084, 666.0]",12,14,-2
31042.0,2019-11-20,"(1124.0, 1353.0]",1,2,-1
31043.0,2019-11-20,"(399.168, 608.0]",2,5,-3
31043.0,2019-11-20,"(608.0, 816.0]",1,3,-2
31043.0,2019-11-20,"(1024.0, 1232.0]",5,9,-4
31044.0,2019-11-20,"(332.169, 540.75]",3,4,-1
31044.0,2019-11-20,"(540.75, 748.5]",1,1,0
31044.0,2019-11-20,"(956.25, 1164.0]",3,1,2
31045.0,2019-11-20,"(424.996, 677.0]",1,3,-2
31045.0,2019-11-20,"(677.0, 928.0]",2,3,-1
31045.0,2019-11-20,"(928.0, 1179.0]",2,6,-4
31046.0,2019-11-20,"(430.75, 465.5]",1,1,0
31047.0,2019-11-20,"(334.01, 582.5]",14,22,-8
31047.0,2019-11-20,"(582.5, 830.0]",4,6,-2
31047.0,2019-11-20,"(830.0, 1077.5]",10,20,-10
31047.0,2019-11-20,"(1077.5, 1325.0]",7,18,-11
31048.0,2019-11-20,"(403.143, 618.25]",6,10,-4
31048.0,2019-11-20,"(618.25, 832.5]",1,3,-2
31048.0,2019-11-20,"(832.5, 1046.75]",2,4,-2
31048.0,2019-11-20,"(1046.75, 1261.0]",1,6,-5
31049.0,2019-11-20,"(507.481, 637.75]",1,3,-2
31050.0,2019-11-20,"(50.693, 378.75]",1,1,0
31050.0,2019-11-20,"(1032.25, 1359.0]",3,3,0
31051.0,2019-11-20,"(539.0, 777.0]",2,5,-3
31051.0,2019-11-20,"(777.0, 1015.0]",2,4,-2
31051.0,2019-11-20,"(1015.0, 1253.0]",3,3,0
31052.0,2019-11-20,"(263.029, 506.75]",2,4,-2
31052.0,2019-11-20,"(506.75, 749.5]",6,7,-1
31052.0,2019-11-20,"(992.25, 1235.0]",3,10,-7
31053.0,2019-11-20,"(1172.25, 1364.0]",2,1,1
31054.0,2019-11-20,"(749.25, 999.0]",1,1,0
31055.0,2019-11-20,"(454.305, 628.75]",2,5,-3
31055.0,2019-11-20,"(802.5, 976.25]",1,1,0
31055.0,2019-11-20,"(976.25, 1150.0]",2,1,1
31056.0,2019-11-20,"(112.095, 339.25]",1,1,0
31056.0,2019-11-20,"(791.75, 1018.0]",1,2,-1
,,,,2.0,
31058.0,2019-11-20,"(554.0, 556.5]",1,2,-1
31058.0,2019-11-20,"(556.5, 559.0]",1,1,0
31059.0,2019-11-20,"(1016.0, 1214.0]",3,1,2
31060.0,2019-11-20,"(946.75, 1228.0]",3,1,2
31061.0,2019-11-20,"(1090.997, 1091.75]",1,1,0
31062.0,2019-11-20,"(581.583, 686.25]",3,6,-3
31062.0,2019-11-20,"(686.25, 790.5]",2,4,-2
31062.0,2019-11-20,"(894.75, 999.0]",1,2,-1
31063.0,2019-11-20,"(742.5, 766.0]",1,1,0
31064.0,2019-11-20,"(515.325, 684.75]",1,3,-2
31064.0,2019-11-20,"(684.75, 853.5]",2,4,-2
31064.0,2019-11-20,"(1022.25, 1191.0]",6,12,-6
31065.0,2019-11-20,"(1052.75, 1254.0]",2,2,0
31066.0,2019-11-20,"(469.112, 692.0]",1,3,-2
31066.0,2019-11-20,"(914.0, 1136.0]",1,1,0
31066.0,2019-11-20,"(1136.0, 1358.0]",1,3,-2
31067.0,2019-11-20,"(929.0, 1183.5]",3,3,0
31067.0,2019-11-20,"(1183.5, 1438.0]",1,3,-2
31068.0,2019-11-20,"(706.0, 916.0]",1,1,0
31068.0,2019-11-20,"(1126.0, 1336.0]",2,1,1
31069.0,2019-11-20,"(435.302, 610.5]",1,7,-6
31069.0,2019-11-20,"(610.5, 785.0]",1,2,-1
31069.0,2019-11-20,"(785.0, 959.5]",3,4,-1
31069.0,2019-11-20,"(959.5, 1134.0]",4,7,-3
31070.0,2019-11-20,"(804.0, 887.0]",1,2,-1
31071.0,2019-11-20,"(315.035, 557.25]",2,7,-5
31071.0,2019-11-20,"(557.25, 798.5]",1,1,0
31071.0,2019-11-20,"(798.5, 1039.75]",1,2,-1
31071.0,2019-11-20,"(1039.75, 1281.0]",7,10,-3
,,,,1.0,
,,,,1.0,
,,,,1.0,
31073.0,2019-11-20,"(498.355, 660.25]",1,2,-1
31073.0,2019-11-20,"(660.25, 821.5]",1,1,0
31073.0,2019-11-20,"(821.5, 982.75]",1,2,-1
31073.0,2019-11-20,"(982.75, 1144.0]",1,3,-2
31074.0,2019-11-20,"(430.112, 653.0]",1,1,0
31074.0,2019-11-20,"(875.0, 1097.0]",1,3,-2
31074.0,2019-11-20,"(1097.0, 1319.0]",5,6,-1
31075.0,2019-11-20,"(969.5, 1113.0]",2,1,1
31076.0,2019-11-20,"(428.229, 621.75]",1,1,0
31076.0,2019-11-20,"(621.75, 814.5]",1,1,0
31076.0,2019-11-20,"(1007.25, 1200.0]",2,3,-1
31077.0,2019-11-20,"(372.038, 613.5]",10,19,-9
31077.0,2019-11-20,"(613.5, 854.0]",1,4,-3
31077.0,2019-11-20,"(854.0, 1094.5]",3,5,-2
31077.0,2019-11-20,"(1094.5, 1335.0]",4,5,-1
31078.0,2019-11-20,"(479.478, 610.5]",7,8,-1
31079.0,2019-11-20,"(402.977, 659.75]",2,11,-9
31079.0,2019-11-20,"(915.5, 1171.25]",2,2,0
31079.0,2019-11-20,"(1171.25, 1427.0]",6,2,4
31080.0,2019-11-20,"(809.0, 1062.5]",2,7,-5
31080.0,2019-11-20,"(1062.5, 1316.0]",9,5,4
31081.0,2019-11-20,"(475.209, 673.75]",2,3,-1
31081.0,2019-11-20,"(871.5, 1069.25]",3,5,-2
31081.0,2019-11-20,"(1069.25, 1267.0]",1,2,-1
31082.0,2019-11-20,"(264.0, 528.0]",2,1,1
31082.0,2019-11-20,"(792.0, 1056.0]",1,2,-1
31083.0,2019-11-20,"(614.5, 832.0]",3,3,0
31083.0,2019-11-20,"(832.0, 1049.5]",3,4,-1
31083.0,2019-11-20,"(1049.5, 1267.0]",5,4,1
31084.0,2019-11-20,"(356.094, 583.5]",1,2,-1
31084.0,2019-11-20,"(583.5, 810.0]",6,6,0
31085.0,2019-11-20,"(400.282, 580.5]",1,2,-1
31085.0,2019-11-20,"(939.5, 1119.0]",2,1,1
31086.0,2019-11-20,"(1002.0, 1227.0]",1,2,-1
31087.0,2019-11-20,"(771.5, 917.75]",1,2,-1
31087.0,2019-11-20,"(917.75, 1064.0]",2,1,1
31088.0,2019-11-20,"(986.5, 1185.0]",5,4,1
31089.0,2019-11-20,"(411.077, 642.75]",10,14,-4
31089.0,2019-11-20,"(642.75, 873.5]",1,4,-3
31089.0,2019-11-20,"(873.5, 1104.25]",4,14,-10
31089.0,2019-11-20,"(1104.25, 1335.0]",3,13,-10
,,,,1.0,
,,,,2.0,
31091.0,2019-11-20,"(-0.288, 323.0]",1,1,0
31091.0,2019-11-20,"(967.0, 1289.0]",7,7,0
31092.0,2019-11-20,"(670.75, 877.5]",1,1,0
31092.0,2019-11-20,"(1084.25, 1291.0]",1,1,0
,,,,1.0,
,,,,5.0,
,,,,2.0,
,,,,2.0,
31094.0,2019-11-20,"(278.5, 557.0]",1,1,0
31094.0,2019-11-20,"(835.5, 1114.0]",1,1,0
,,,,2.0,
31096.0,2019-11-20,"(954.75, 1084.0]",1,1,0
31097.0,2019-11-20,"(373.176, 580.0]",2,5,-3
31097.0,2019-11-20,"(580.0, 786.0]",1,3,-2
31097.0,2019-11-20,"(992.0, 1198.0]",4,7,-3
31098.0,2019-11-20,"(429.134, 646.5]",7,16,-9
31098.0,2019-11-20,"(646.5, 863.0]",2,3,-1
31098.0,2019-11-20,"(863.0, 1079.5]",4,12,-8
31098.0,2019-11-20,"(1079.5, 1296.0]",2,7,-5
31099.0,2019-11-20,"(320.197, 521.75]",1,3,-2
31099.0,2019-11-20,"(923.25, 1124.0]",2,1,1
31100.0,2019-11-20,"(402.255, 589.25]",18,21,-3
31100.0,2019-11-20,"(589.25, 775.5]",2,4,-2
31100.0,2019-11-20,"(775.5, 961.75]",3,7,-4
31100.0,2019-11-20,"(961.75, 1148.0]",3,20,-17
31101.0,2019-11-20,"(52.635, 395.25]",2,8,-6
31101.0,2019-11-20,"(395.25, 736.5]",10,54,-44
31101.0,2019-11-20,"(736.5, 1077.75]",24,37,-13
31101.0,2019-11-20,"(1077.75, 1419.0]",39,64,-25
31102.0,2019-11-20,"(241.838, 533.5]",1,22,-21
31102.0,2019-11-20,"(824.0, 1114.5]",7,18,-11
31102.0,2019-11-20,"(1114.5, 1405.0]",17,11,6
31103.0,2019-11-20,"(330.944, 596.0]",3,32,-29
31103.0,2019-11-20,"(596.0, 860.0]",5,13,-8
31103.0,2019-11-20,"(860.0, 1124.0]",8,15,-7
31103.0,2019-11-20,"(1124.0, 1388.0]",7,11,-4
31104.0,2019-11-20,"(15.586, 370.5]",4,9,-5
31104.0,2019-11-20,"(370.5, 724.0]",7,14,-7
31104.0,2019-11-20,"(724.0, 1077.5]",20,33,-13
31104.0,2019-11-20,"(1077.5, 1431.0]",19,34,-15
31105.0,2019-11-20,"(310.876, 593.0]",4,10,-6
31105.0,2019-11-20,"(593.0, 874.0]",2,3,-1
31105.0,2019-11-20,"(874.0, 1155.0]",3,5,-2
31105.0,2019-11-20,"(1155.0, 1436.0]",2,5,-3
31106.0,2019-11-20,"(455.021, 700.75]",3,17,-14
31106.0,2019-11-20,"(945.5, 1190.25]",3,3,0
31106.0,2019-11-20,"(1190.25, 1435.0]",2,4,-2
31107.0,2019-11-20,"(383.051, 621.25]",6,27,-21
31107.0,2019-11-20,"(621.25, 858.5]",4,10,-6
31107.0,2019-11-20,"(858.5, 1095.75]",13,21,-8
31107.0,2019-11-20,"(1095.75, 1333.0]",17,26,-9
31108.0,2019-11-20,"(366.99, 620.5]",9,32,-23
31108.0,2019-11-20,"(620.5, 873.0]",12,24,-12
31108.0,2019-11-20,"(873.0, 1125.5]",21,40,-19
31108.0,2019-11-20,"(1125.5, 1378.0]",13,15,-2
31109.0,2019-11-20,"(34.627, 379.25]",2,5,-3
31109.0,2019-11-20,"(379.25, 722.5]",9,23,-14
31109.0,2019-11-20,"(722.5, 1065.75]",12,20,-8
31109.0,2019-11-20,"(1065.75, 1409.0]",18,28,-10
31110.0,2019-11-20,"(327.939, 594.25]",18,43,-25
31110.0,2019-11-20,"(594.25, 859.5]",18,30,-12
31110.0,2019-11-20,"(859.5, 1124.75]",17,32,-15
31110.0,2019-11-20,"(1124.75, 1390.0]",15,27,-12
31111.0,2019-11-20,"(10.627, 355.25]",2,2,0
31111.0,2019-11-20,"(355.25, 698.5]",3,20,-17
31111.0,2019-11-20,"(698.5, 1041.75]",3,6,-3
31111.0,2019-11-20,"(1041.75, 1385.0]",14,17,-3
31112.0,2019-11-20,"(349.056, 586.0]",1,6,-5
31112.0,2019-11-20,"(586.0, 822.0]",2,2,0
31112.0,2019-11-20,"(1058.0, 1294.0]",6,8,-2
31113.0,2019-11-20,"(728.0, 1082.0]",6,5,1
31113.0,2019-11-20,"(1082.0, 1436.0]",20,22,-2
31114.0,2019-11-20,"(54.679, 386.25]",1,6,-5
31114.0,2019-11-20,"(386.25, 716.5]",2,13,-11
31114.0,2019-11-20,"(716.5, 1046.75]",6,14,-8
31114.0,2019-11-20,"(1046.75, 1377.0]",21,37,-16
31115.0,2019-11-20,"(538.0, 726.0]",4,19,-15
31115.0,2019-11-20,"(726.0, 914.0]",1,6,-5
31115.0,2019-11-20,"(914.0, 1102.0]",10,4,6
31116.0,2019-11-20,"(304.873, 587.75]",5,26,-21
31116.0,2019-11-20,"(587.75, 869.5]",3,5,-2
31116.0,2019-11-20,"(869.5, 1151.25]",22,28,-6
31116.0,2019-11-20,"(1151.25, 1433.0]",10,14,-4
31117.0,2019-11-20,"(52.767, 362.25]",1,4,-3
31117.0,2019-11-20,"(362.25, 670.5]",2,12,-10
31117.0,2019-11-20,"(670.5, 978.75]",5,12,-7
31117.0,2019-11-20,"(978.75, 1287.0]",10,25,-15
31118.0,2019-11-20,"(453.079, 684.25]",2,18,-16
31118.0,2019-11-20,"(914.5, 1144.75]",11,13,-2
31118.0,2019-11-20,"(1144.75, 1375.0]",8,10,-2
31119.0,2019-11-20,"(19.583, 375.25]",3,7,-4
31119.0,2019-11-20,"(375.25, 729.5]",7,21,-14
31119.0,2019-11-20,"(729.5, 1083.75]",16,20,-4
31119.0,2019-11-20,"(1083.75, 1438.0]",13,30,-17
31120.0,2019-11-20,"(405.057, 641.75]",4,24,-20
31120.0,2019-11-20,"(877.5, 1113.25]",8,4,4
31120.0,2019-11-20,"(1113.25, 1349.0]",12,12,0
31121.0,2019-11-20,"(21.619, 368.25]",2,4,-2
31121.0,2019-11-20,"(368.25, 713.5]",15,25,-10
31121.0,2019-11-20,"(713.5, 1058.75]",2,8,-6
31121.0,2019-11-20,"(1058.75, 1404.0]",9,24,-15
31122.0,2019-11-20,"(335.901, 611.75]",1,20,-19
31122.0,2019-11-20,"(611.75, 886.5]",1,2,-1
31122.0,2019-11-20,"(886.5, 1161.25]",10,20,-10
31122.0,2019-11-20,"(1161.25, 1436.0]",9,12,-3
31123.0,2019-11-20,"(352.001, 602.75]",1,16,-15
31123.0,2019-11-20,"(602.75, 852.5]",3,5,-2
31123.0,2019-11-20,"(852.5, 1102.25]",4,11,-7
31123.0,2019-11-20,"(1102.25, 1352.0]",7,9,-2
31124.0,2019-11-20,"(135.707, 460.25]",6,13,-7
31124.0,2019-11-20,"(460.25, 783.5]",17,47,-30
31124.0,2019-11-20,"(783.5, 1106.75]",20,56,-36
31124.0,2019-11-20,"(1106.75, 1430.0]",17,35,-18
31125.0,2019-11-20,"(345.968, 605.0]",4,14,-10
31125.0,2019-11-20,"(605.0, 863.0]",6,11,-5
31125.0,2019-11-20,"(863.0, 1121.0]",24,35,-11
31125.0,2019-11-20,"(1121.0, 1379.0]",9,16,-7
31126.0,2019-11-20,"(324.016, 571.0]",8,31,-23
31126.0,2019-11-20,"(571.0, 817.0]",3,4,-1
31126.0,2019-11-20,"(817.0, 1063.0]",13,17,-4
31126.0,2019-11-20,"(1063.0, 1309.0]",18,28,-10
31127.0,2019-11-20,"(428.014, 675.5]",15,21,-6
31127.0,2019-11-20,"(675.5, 922.0]",12,22,-10
31127.0,2019-11-20,"(922.0, 1168.5]",24,45,-21
31127.0,2019-11-20,"(1168.5, 1415.0]",6,22,-16
31128.0,2019-11-20,"(307.876, 590.0]",25,39,-14
31128.0,2019-11-20,"(590.0, 871.0]",15,22,-7
31128.0,2019-11-20,"(871.0, 1152.0]",17,34,-17
31128.0,2019-11-20,"(1152.0, 1433.0]",8,18,-10
31129.0,2019-11-20,"(0.761, 311.75]",1,1,0
31129.0,2019-11-20,"(311.75, 621.5]",9,10,-1
31129.0,2019-11-20,"(621.5, 931.25]",5,16,-11
31129.0,2019-11-20,"(931.25, 1241.0]",7,17,-10
31130.0,2019-11-20,"(7.722, 328.5]",1,1,0
31130.0,2019-11-20,"(328.5, 648.0]",6,27,-21
31130.0,2019-11-20,"(967.5, 1287.0]",13,3,10
31131.0,2019-11-20,"(393.995, 646.25]",1,17,-16
31131.0,2019-11-20,"(646.25, 897.5]",1,6,-5
31131.0,2019-11-20,"(897.5, 1148.75]",6,12,-6
31131.0,2019-11-20,"(1148.75, 1400.0]",3,6,-3
31200.0,2019-11-20,"(289.851, 578.25]",40,53,-13
31200.0,2019-11-20,"(578.25, 865.5]",22,41,-19
31200.0,2019-11-20,"(865.5, 1152.75]",28,65,-37
31200.0,2019-11-20,"(1152.75, 1440.0]",12,28,-16
31201.0,2019-11-20,"(297.883, 578.25]",25,60,-35
31201.0,2019-11-20,"(578.25, 857.5]",15,29,-14
31201.0,2019-11-20,"(857.5, 1136.75]",37,56,-19
31201.0,2019-11-20,"(1136.75, 1416.0]",19,42,-23
31202.0,2019-11-20,"(379.5, 718.0]",19,3,16
31202.0,2019-11-20,"(718.0, 1056.5]",27,45,-18
31202.0,2019-11-20,"(1056.5, 1395.0]",15,40,-25
31203.0,2019-11-20,"(389.25, 730.5]",13,4,9
31203.0,2019-11-20,"(730.5, 1071.75]",12,35,-23
31203.0,2019-11-20,"(1071.75, 1413.0]",31,19,12
31204.0,2019-11-20,"(9.643, 350.25]",1,2,-1
31204.0,2019-11-20,"(350.25, 689.5]",14,17,-3
31204.0,2019-11-20,"(689.5, 1028.75]",15,30,-15
31204.0,2019-11-20,"(1028.75, 1368.0]",8,23,-15
31205.0,2019-11-20,"(410.007, 659.25]",32,36,-4
31205.0,2019-11-20,"(659.25, 907.5]",12,24,-12
31205.0,2019-11-20,"(907.5, 1155.75]",15,42,-27
31205.0,2019-11-20,"(1155.75, 1404.0]",6,20,-14
31206.0,2019-11-20,"(418.231, 611.25]",8,9,-1
31206.0,2019-11-20,"(611.25, 803.5]",1,1,0
31206.0,2019-11-20,"(995.75, 1188.0]",2,3,-1
31207.0,2019-11-20,"(759.25, 970.5]",1,2,-1
31207.0,2019-11-20,"(970.5, 1181.75]",3,2,1
31207.0,2019-11-20,"(1181.75, 1393.0]",4,5,-1
31208.0,2019-11-20,"(319.929, 588.75]",19,22,-3
31208.0,2019-11-20,"(588.75, 856.5]",5,7,-2
31208.0,2019-11-20,"(856.5, 1124.25]",3,14,-11
31208.0,2019-11-20,"(1124.25, 1392.0]",4,4,0
31209.0,2019-11-20,"(487.359, 648.25]",3,5,-2
31209.0,2019-11-20,"(648.25, 808.5]",1,2,-1
31209.0,2019-11-20,"(808.5, 968.75]",2,3,-1
31209.0,2019-11-20,"(968.75, 1129.0]",4,8,-4
31211.0,2019-11-20,"(393.259, 579.25]",13,16,-3
31211.0,2019-11-20,"(579.25, 764.5]",3,7,-4
31211.0,2019-11-20,"(764.5, 949.75]",2,3,-1
31211.0,2019-11-20,"(949.75, 1135.0]",3,7,-4
31212.0,2019-11-20,"(35.618, 382.5]",3,3,0
31212.0,2019-11-20,"(382.5, 728.0]",29,45,-16
31212.0,2019-11-20,"(728.0, 1073.5]",11,28,-17
31212.0,2019-11-20,"(1073.5, 1419.0]",13,36,-23
31213.0,2019-11-20,"(398.188, 602.0]",34,47,-13
31213.0,2019-11-20,"(602.0, 805.0]",12,25,-13
31213.0,2019-11-20,"(805.0, 1008.0]",10,19,-9
31213.0,2019-11-20,"(1008.0, 1211.0]",19,48,-29
31214.0,2019-11-20,"(3.625, 348.75]",1,3,-2
31214.0,2019-11-20,"(348.75, 692.5]",7,28,-21
31214.0,2019-11-20,"(692.5, 1036.25]",12,27,-15
31214.0,2019-11-20,"(1036.25, 1380.0]",39,60,-21
31215.0,2019-11-20,"(439.125, 658.75]",33,34,-1
31215.0,2019-11-20,"(658.75, 877.5]",3,5,-2
31215.0,2019-11-20,"(877.5, 1096.25]",5,13,-8
31215.0,2019-11-20,"(1096.25, 1315.0]",3,5,-2
31216.0,2019-11-20,"(405.182, 610.5]",28,30,-2
31216.0,2019-11-20,"(610.5, 815.0]",4,9,-5
31216.0,2019-11-20,"(815.0, 1019.5]",5,8,-3
31216.0,2019-11-20,"(1019.5, 1224.0]",5,28,-23
31217.0,2019-11-20,"(321.95, 585.5]",16,18,-2
31217.0,2019-11-20,"(585.5, 848.0]",6,10,-4
31217.0,2019-11-20,"(848.0, 1110.5]",5,22,-17
31217.0,2019-11-20,"(1110.5, 1373.0]",3,3,0
31218.0,2019-11-20,"(386.061, 621.75]",18,36,-18
31218.0,2019-11-20,"(621.75, 856.5]",3,6,-3
31218.0,2019-11-20,"(856.5, 1091.25]",11,19,-8
31218.0,2019-11-20,"(1091.25, 1326.0]",3,5,-2
31219.0,2019-11-20,"(330.044, 570.0]",16,16,0
31219.0,2019-11-20,"(570.0, 809.0]",11,16,-5
31219.0,2019-11-20,"(809.0, 1048.0]",4,14,-10
31220.0,2019-11-20,"(276.24, 467.0]",10,14,-4
31220.0,2019-11-20,"(467.0, 657.0]",12,16,-4
31220.0,2019-11-20,"(657.0, 847.0]",6,16,-10
31220.0,2019-11-20,"(847.0, 1037.0]",3,16,-13
31221.0,2019-11-20,"(380.979, 637.25]",39,41,-2
31221.0,2019-11-20,"(637.25, 892.5]",12,15,-3
31221.0,2019-11-20,"(892.5, 1147.75]",12,38,-26
31221.0,2019-11-20,"(1147.75, 1403.0]",5,9,-4
31222.0,2019-11-20,"(324.08, 555.0]",17,18,-1
31222.0,2019-11-20,"(555.0, 785.0]",5,5,0
31222.0,2019-11-20,"(785.0, 1015.0]",3,8,-5
31222.0,2019-11-20,"(1015.0, 1245.0]",1,27,-26
31223.0,2019-11-20,"(4.625, 349.75]",1,2,-1
31223.0,2019-11-20,"(349.75, 693.5]",10,35,-25
31223.0,2019-11-20,"(693.5, 1037.25]",9,19,-10
31223.0,2019-11-20,"(1037.25, 1381.0]",18,31,-13
31224.0,2019-11-20,"(422.194, 624.5]",17,20,-3
31224.0,2019-11-20,"(624.5, 826.0]",5,9,-4
31224.0,2019-11-20,"(826.0, 1027.5]",4,11,-7
31224.0,2019-11-20,"(1027.5, 1229.0]",4,13,-9
31225.0,2019-11-20,"(366.069, 599.75]",10,15,-5
31225.0,2019-11-20,"(599.75, 832.5]",7,12,-5
31225.0,2019-11-20,"(832.5, 1065.25]",9,20,-11
31225.0,2019-11-20,"(1065.25, 1298.0]",5,11,-6
31226.0,2019-11-20,"(226.971, 485.25]",2,5,-3
31226.0,2019-11-20,"(485.25, 742.5]",3,6,-3
31226.0,2019-11-20,"(742.5, 999.75]",4,7,-3
31226.0,2019-11-20,"(999.75, 1257.0]",4,9,-5
31227.0,2019-11-20,"(359.25, 652.5]",57,1,56
31227.0,2019-11-20,"(652.5, 945.75]",12,63,-51
31227.0,2019-11-20,"(945.75, 1239.0]",5,19,-14
31228.0,2019-11-20,"(31.699, 358.25]",3,4,-1
31228.0,2019-11-20,"(358.25, 683.5]",22,31,-9
31228.0,2019-11-20,"(683.5, 1008.75]",21,41,-20
31228.0,2019-11-20,"(1008.75, 1334.0]",25,61,-36
31229.0,2019-11-20,"(1.62, 348.0]",1,2,-1
31229.0,2019-11-20,"(348.0, 693.0]",9,52,-43
31229.0,2019-11-20,"(693.0, 1038.0]",34,60,-26
31229.0,2019-11-20,"(1038.0, 1383.0]",36,57,-21
31230.0,2019-11-20,"(373.031, 616.25]",59,72,-13
31230.0,2019-11-20,"(616.25, 858.5]",10,18,-8
31230.0,2019-11-20,"(858.5, 1100.75]",16,34,-18
31230.0,2019-11-20,"(1100.75, 1343.0]",5,24,-19
31231.0,2019-11-20,"(330.917, 602.75]",29,32,-3
31231.0,2019-11-20,"(602.75, 873.5]",6,18,-12
31231.0,2019-11-20,"(873.5, 1144.25]",5,16,-11
31232.0,2019-11-20,"(294.901, 570.75]",22,25,-3
31232.0,2019-11-20,"(570.75, 845.5]",7,13,-6
31232.0,2019-11-20,"(845.5, 1120.25]",13,23,-10
31232.0,2019-11-20,"(1120.25, 1395.0]",7,18,-11
31233.0,2019-11-20,"(4.743, 320.25]",2,4,-2
31233.0,2019-11-20,"(320.25, 634.5]",41,47,-6
31233.0,2019-11-20,"(634.5, 948.75]",7,12,-5
31233.0,2019-11-20,"(948.75, 1263.0]",8,18,-10
31234.0,2019-11-20,"(319.894, 597.5]",14,33,-19
31234.0,2019-11-20,"(597.5, 874.0]",12,20,-8
31234.0,2019-11-20,"(874.0, 1150.5]",22,37,-15
31234.0,2019-11-20,"(1150.5, 1427.0]",7,13,-6
31235.0,2019-11-20,"(385.97, 644.5]",10,10,0
31235.0,2019-11-20,"(902.0, 1159.5]",3,3,0
31236.0,2019-11-20,"(462.157, 673.75]",20,27,-7
31236.0,2019-11-20,"(673.75, 884.5]",15,25,-10
31236.0,2019-11-20,"(884.5, 1095.25]",9,28,-19
31236.0,2019-11-20,"(1095.25, 1306.0]",3,15,-12
31237.0,2019-11-20,"(354.0, 682.0]",10,1,9
31237.0,2019-11-20,"(682.0, 1010.0]",10,18,-8
31237.0,2019-11-20,"(1010.0, 1338.0]",16,21,-5
31238.0,2019-11-20,"(24.784, 330.0]",1,3,-2
31238.0,2019-11-20,"(330.0, 634.0]",26,30,-4
31238.0,2019-11-20,"(634.0, 938.0]",9,19,-10
31238.0,2019-11-20,"(938.0, 1242.0]",7,35,-28
31239.0,2019-11-20,"(385.159, 596.25]",25,27,-2
31239.0,2019-11-20,"(596.25, 806.5]",6,10,-4
31239.0,2019-11-20,"(806.5, 1016.75]",8,14,-6
31239.0,2019-11-20,"(1016.75, 1227.0]",12,40,-28
31240.0,2019-11-20,"(766.67, 849.5]",2,4,-2
31240.0,2019-11-20,"(849.5, 932.0]",1,2,-1
31240.0,2019-11-20,"(1014.5, 1097.0]",2,2,0
31241.0,2019-11-20,"(29.612, 378.0]",2,7,-5
31241.0,2019-11-20,"(378.0, 725.0]",32,68,-36
31241.0,2019-11-20,"(725.0, 1072.0]",12,36,-24
31241.0,2019-11-20,"(1072.0, 1419.0]",18,41,-23
31242.0,2019-11-20,"(405.212, 603.0]",32,34,-2
31242.0,2019-11-20,"(603.0, 800.0]",6,12,-6
31242.0,2019-11-20,"(800.0, 997.0]",3,13,-10
31242.0,2019-11-20,"(997.0, 1194.0]",1,30,-29
31243.0,2019-11-20,"(384.994, 637.5]",36,39,-3
31243.0,2019-11-20,"(637.5, 889.0]",7,10,-3
31243.0,2019-11-20,"(889.0, 1140.5]",10,44,-34
31243.0,2019-11-20,"(1140.5, 1392.0]",2,7,-5
31244.0,2019-11-20,"(27.628, 372.0]",1,1,0
31244.0,2019-11-20,"(372.0, 715.0]",17,29,-12
31244.0,2019-11-20,"(715.0, 1058.0]",11,26,-15
31244.0,2019-11-20,"(1058.0, 1401.0]",9,16,-7
31245.0,2019-11-20,"(6.596, 359.0]",1,2,-1
31245.0,2019-11-20,"(359.0, 710.0]",12,30,-18
31245.0,2019-11-20,"(710.0, 1061.0]",13,30,-17
31245.0,2019-11-20,"(1061.0, 1412.0]",11,21,-10
31246.0,2019-11-20,"(349.92, 621.0]",19,28,-9
31246.0,2019-11-20,"(621.0, 891.0]",7,19,-12
31246.0,2019-11-20,"(891.0, 1161.0]",18,31,-13
31246.0,2019-11-20,"(1161.0, 1431.0]",5,11,-6
31247.0,2019-11-20,"(4.858, 291.5]",1,2,-1
31247.0,2019-11-20,"(291.5, 577.0]",12,17,-5
31247.0,2019-11-20,"(577.0, 862.5]",16,25,-9
31247.0,2019-11-20,"(862.5, 1148.0]",14,34,-20
31248.0,2019-11-20,"(349.973, 607.75]",10,16,-6
31248.0,2019-11-20,"(607.75, 864.5]",12,16,-4
31248.0,2019-11-20,"(864.5, 1121.25]",15,27,-12
31248.0,2019-11-20,"(1121.25, 1378.0]",7,10,-3
31249.0,2019-11-20,"(349.087, 578.25]",6,10,-4
31249.0,2019-11-20,"(578.25, 806.5]",5,11,-6
31249.0,2019-11-20,"(806.5, 1034.75]",1,2,-1
31249.0,2019-11-20,"(1034.75, 1263.0]",7,14,-7
31250.0,2019-11-20,"(429.243, 619.25]",20,23,-3
31250.0,2019-11-20,"(619.25, 808.5]",7,14,-7
31250.0,2019-11-20,"(808.5, 997.75]",4,9,-5
31250.0,2019-11-20,"(997.75, 1187.0]",2,20,-18
31251.0,2019-11-20,"(1.594, 354.5]",3,3,0
31251.0,2019-11-20,"(354.5, 706.0]",25,48,-23
31251.0,2019-11-20,"(706.0, 1057.5]",16,30,-14
31251.0,2019-11-20,"(1057.5, 1409.0]",12,25,-13
31252.0,2019-11-20,"(384.014, 631.5]",20,22,-2
31252.0,2019-11-20,"(631.5, 878.0]",3,7,-4
31252.0,2019-11-20,"(878.0, 1124.5]",4,15,-11
31253.0,2019-11-20,"(375.973, 633.75]",28,30,-2
31253.0,2019-11-20,"(633.75, 890.5]",12,20,-8
31253.0,2019-11-20,"(890.5, 1147.25]",8,27,-19
31253.0,2019-11-20,"(1147.25, 1404.0]",1,1,0
31254.0,2019-11-20,"(411.07, 644.5]",27,30,-3
31254.0,2019-11-20,"(644.5, 877.0]",4,7,-3
31254.0,2019-11-20,"(877.0, 1109.5]",2,26,-24
31254.0,2019-11-20,"(1109.5, 1342.0]",3,8,-5
31255.0,2019-11-20,"(367.958, 629.5]",25,41,-16
31255.0,2019-11-20,"(629.5, 890.0]",4,9,-5
31255.0,2019-11-20,"(890.0, 1150.5]",8,23,-15
31255.0,2019-11-20,"(1150.5, 1411.0]",4,8,-4
31256.0,2019-11-20,"(269.005, 518.75]",8,8,0
31256.0,2019-11-20,"(518.75, 767.5]",8,9,-1
31256.0,2019-11-20,"(767.5, 1016.25]",1,9,-8
31256.0,2019-11-20,"(1016.25, 1265.0]",11,24,-13
31257.0,2019-11-20,"(49.656, 387.0]",3,3,0
31257.0,2019-11-20,"(387.0, 723.0]",24,35,-11
31257.0,2019-11-20,"(723.0, 1059.0]",19,39,-20
31257.0,2019-11-20,"(1059.0, 1395.0]",9,30,-21
31258.0,2019-11-20,"(323.901, 599.75]",20,41,-21
31258.0,2019-11-20,"(599.75, 874.5]",10,21,-11
31258.0,2019-11-20,"(874.5, 1149.25]",17,31,-14
31258.0,2019-11-20,"(1149.25, 1424.0]",3,9,-6
31259.0,2019-11-20,"(428.274, 610.5]",9,10,-1
31259.0,2019-11-20,"(610.5, 792.0]",1,1,0
31259.0,2019-11-20,"(792.0, 973.5]",2,4,-2
31259.0,2019-11-20,"(973.5, 1155.0]",3,16,-13
31260.0,2019-11-20,"(390.993, 643.75]",17,21,-4
31260.0,2019-11-20,"(643.75, 895.5]",2,6,-4
31260.0,2019-11-20,"(895.5, 1147.25]",3,19,-16
31260.0,2019-11-20,"(1147.25, 1399.0]",2,2,0
31261.0,2019-11-20,"(410.327, 579.25]",15,15,0
31261.0,2019-11-20,"(747.5, 915.75]",1,7,-6
31261.0,2019-11-20,"(915.75, 1084.0]",1,6,-5
31262.0,2019-11-20,"(417.169, 625.75]",12,14,-2
31262.0,2019-11-20,"(625.75, 833.5]",3,5,-2
31262.0,2019-11-20,"(833.5, 1041.25]",3,8,-5
31262.0,2019-11-20,"(1041.25, 1249.0]",2,14,-12
31263.0,2019-11-20,"(316.896, 594.0]",27,38,-11
31263.0,2019-11-20,"(594.0, 870.0]",10,22,-12
31263.0,2019-11-20,"(870.0, 1146.0]",20,43,-23
31263.0,2019-11-20,"(1146.0, 1422.0]",1,5,-4
31264.0,2019-11-20,"(384.981, 640.75]",18,23,-5
31264.0,2019-11-20,"(640.75, 895.5]",3,6,-3
31264.0,2019-11-20,"(895.5, 1150.25]",11,23,-12
31265.0,2019-11-20,"(357.0, 713.0]",19,3,16
31265.0,2019-11-20,"(713.0, 1069.0]",32,47,-15
31265.0,2019-11-20,"(1069.0, 1425.0]",19,51,-32
31266.0,2019-11-20,"(30.613, 378.75]",1,10,-9
31266.0,2019-11-20,"(378.75, 725.5]",9,33,-24
31266.0,2019-11-20,"(725.5, 1072.25]",18,38,-20
31266.0,2019-11-20,"(1072.25, 1419.0]",27,42,-15
31267.0,2019-11-20,"(-0.383, 346.75]",1,1,0
31267.0,2019-11-20,"(346.75, 692.5]",19,41,-22
31267.0,2019-11-20,"(692.5, 1038.25]",17,35,-18
31267.0,2019-11-20,"(1038.25, 1384.0]",18,41,-23
31268.0,2019-11-20,"(333.907, 608.25]",21,66,-45
31268.0,2019-11-20,"(608.25, 881.5]",8,15,-7
31268.0,2019-11-20,"(881.5, 1154.75]",20,32,-12
31268.0,2019-11-20,"(1154.75, 1428.0]",11,14,-3
31269.0,2019-11-20,"(386.998, 638.5]",7,18,-11
31269.0,2019-11-20,"(638.5, 889.0]",8,15,-7
31269.0,2019-11-20,"(889.0, 1139.5]",5,13,-8
31269.0,2019-11-20,"(1139.5, 1390.0]",11,19,-8
31270.0,2019-11-20,"(408.02, 654.0]",20,28,-8
31270.0,2019-11-20,"(654.0, 899.0]",8,16,-8
31270.0,2019-11-20,"(899.0, 1144.0]",10,23,-13
31270.0,2019-11-20,"(1144.0, 1389.0]",2,5,-3
31271.0,2019-11-20,"(460.06, 696.0]",18,20,-2
31271.0,2019-11-20,"(696.0, 931.0]",5,14,-9
31271.0,2019-11-20,"(931.0, 1166.0]",4,15,-11
31271.0,2019-11-20,"(1166.0, 1401.0]",4,5,-1
31272.0,2019-11-20,"(4.574, 362.5]",2,2,0
31272.0,2019-11-20,"(362.5, 719.0]",38,41,-3
31272.0,2019-11-20,"(719.0, 1075.5]",20,45,-25
31272.0,2019-11-20,"(1075.5, 1432.0]",1,14,-13
31273.0,2019-11-20,"(470.335, 637.25]",1,4,-3
31273.0,2019-11-20,"(637.25, 803.5]",2,4,-2
31273.0,2019-11-20,"(803.5, 969.75]",2,3,-1
31273.0,2019-11-20,"(969.75, 1136.0]",5,6,-1
31274.0,2019-11-20,"(402.037, 643.75]",22,24,-2
31274.0,2019-11-20,"(643.75, 884.5]",4,8,-4
31274.0,2019-11-20,"(884.5, 1125.25]",6,14,-8
31274.0,2019-11-20,"(1125.25, 1366.0]",2,16,-14
31275.0,2019-11-20,"(88.705, 413.75]",3,5,-2
31275.0,2019-11-20,"(413.75, 737.5]",29,48,-19
31275.0,2019-11-20,"(737.5, 1061.25]",16,27,-11
31275.0,2019-11-20,"(1061.25, 1385.0]",14,34,-20
31276.0,2019-11-20,"(434.229, 627.75]",23,29,-6
31276.0,2019-11-20,"(627.75, 820.5]",9,16,-7
31276.0,2019-11-20,"(820.5, 1013.25]",6,11,-5
31276.0,2019-11-20,"(1013.25, 1206.0]",1,22,-21
31277.0,2019-11-20,"(287.92, 559.0]",32,37,-5
31277.0,2019-11-20,"(559.0, 829.0]",26,37,-11
31277.0,2019-11-20,"(829.0, 1099.0]",13,48,-35
31277.0,2019-11-20,"(1099.0, 1369.0]",3,7,-4
31278.0,2019-11-20,"(294.017, 540.75]",4,27,-23
31278.0,2019-11-20,"(540.75, 786.5]",4,7,-3
31278.0,2019-11-20,"(786.5, 1032.25]",8,16,-8
31278.0,2019-11-20,"(1032.25, 1278.0]",30,43,-13
31279.0,2019-11-20,"(438.34, 604.0]",27,32,-5
31279.0,2019-11-20,"(604.0, 769.0]",6,10,-4
31279.0,2019-11-20,"(769.0, 934.0]",6,15,-9
31279.0,2019-11-20,"(934.0, 1099.0]",12,38,-26
31280.0,2019-11-20,"(349.915, 622.25]",7,34,-27
31280.0,2019-11-20,"(622.25, 893.5]",3,6,-3
31280.0,2019-11-20,"(893.5, 1164.75]",13,20,-7
31280.0,2019-11-20,"(1164.75, 1436.0]",9,11,-2
31000.0,2019-11-21,"(960.25, 1115.0]",1,1,0
31001.0,2019-11-21,"(713.0, 883.0]",1,1,0
31001.0,2019-11-21,"(883.0, 1053.0]",2,2,0
31001.0,2019-11-21,"(1053.0, 1223.0]",3,3,0
31002.0,2019-11-21,"(359.256, 546.0]",3,6,-3
31002.0,2019-11-21,"(546.0, 732.0]",2,3,-1
31002.0,2019-11-21,"(732.0, 918.0]",2,3,-1
31002.0,2019-11-21,"(918.0, 1104.0]",4,7,-3
31003.0,2019-11-21,"(436.22, 632.0]",3,4,-1
31003.0,2019-11-21,"(632.0, 827.0]",2,4,-2
31003.0,2019-11-21,"(827.0, 1022.0]",3,3,0
31003.0,2019-11-21,"(1022.0, 1217.0]",2,7,-5
31004.0,2019-11-21,"(936.75, 1102.0]",2,1,1
31005.0,2019-11-21,"(420.068, 654.0]",5,8,-3
31005.0,2019-11-21,"(654.0, 887.0]",2,4,-2
31005.0,2019-11-21,"(887.0, 1120.0]",3,9,-6
31005.0,2019-11-21,"(1120.0, 1353.0]",1,3,-2
31006.0,2019-11-21,"(550.5, 729.0]",1,1,0
31006.0,2019-11-21,"(729.0, 907.5]",2,2,0
31006.0,2019-11-21,"(907.5, 1086.0]",1,5,-4
31007.0,2019-11-21,"(362.941, 628.75]",9,27,-18
31007.0,2019-11-21,"(628.75, 893.5]",5,8,-3
31007.0,2019-11-21,"(893.5, 1158.25]",7,21,-14
31007.0,2019-11-21,"(1158.25, 1423.0]",3,5,-2
31009.0,2019-11-21,"(429.08, 660.0]",3,3,0
31009.0,2019-11-21,"(660.0, 890.0]",1,3,-2
31010.0,2019-11-21,"(429.078, 660.5]",2,2,0
31010.0,2019-11-21,"(660.5, 891.0]",1,4,-3
31010.0,2019-11-21,"(891.0, 1121.5]",3,4,-1
31010.0,2019-11-21,"(1121.5, 1352.0]",1,2,-1
31011.0,2019-11-21,"(332.101, 557.75]",5,8,-3
31011.0,2019-11-21,"(557.75, 782.5]",7,11,-4
31011.0,2019-11-21,"(1007.25, 1232.0]",3,4,-1
31012.0,2019-11-21,"(367.391, 520.25]",3,3,0
31012.0,2019-11-21,"(520.25, 672.5]",3,4,-1
31013.0,2019-11-21,"(521.096, 748.0]",1,3,-2
31013.0,2019-11-21,"(974.0, 1200.0]",3,2,1
31013.0,2019-11-21,"(1200.0, 1426.0]",3,5,-2
31014.0,2019-11-21,"(346.998, 598.5]",20,28,-8
31014.0,2019-11-21,"(598.5, 849.0]",8,14,-6
31014.0,2019-11-21,"(849.0, 1099.5]",15,29,-14
31014.0,2019-11-21,"(1099.5, 1350.0]",6,13,-7
31015.0,2019-11-21,"(304.974, 562.5]",17,19,-2
31015.0,2019-11-21,"(562.5, 819.0]",2,5,-3
31015.0,2019-11-21,"(819.0, 1075.5]",2,7,-5
31015.0,2019-11-21,"(1075.5, 1332.0]",5,9,-4
31016.0,2019-11-21,"(442.169, 650.75]",4,12,-8
31016.0,2019-11-21,"(650.75, 858.5]",5,6,-1
31016.0,2019-11-21,"(858.5, 1066.25]",1,5,-4
31016.0,2019-11-21,"(1066.25, 1274.0]",6,8,-2
31017.0,2019-11-21,"(459.317, 630.75]",6,9,-3
31017.0,2019-11-21,"(630.75, 801.5]",2,5,-3
31017.0,2019-11-21,"(801.5, 972.25]",1,3,-2
31017.0,2019-11-21,"(972.25, 1143.0]",2,7,-5
31018.0,2019-11-21,"(18.822, 314.5]",1,1,0
31018.0,2019-11-21,"(609.0, 903.5]",2,6,-4
31018.0,2019-11-21,"(903.5, 1198.0]",7,6,1
31019.0,2019-11-21,"(389.002, 639.5]",2,3,-1
31019.0,2019-11-21,"(639.5, 889.0]",1,3,-2
31019.0,2019-11-21,"(889.0, 1138.5]",3,5,-2
31020.0,2019-11-21,"(828.5, 995.25]",1,2,-1
31021.0,2019-11-21,"(374.055, 611.25]",1,7,-6
31021.0,2019-11-21,"(1083.75, 1320.0]",4,2,2
31022.0,2019-11-21,"(493.113, 715.75]",6,13,-7
31022.0,2019-11-21,"(715.75, 937.5]",4,6,-2
31022.0,2019-11-21,"(937.5, 1159.25]",5,13,-8
31022.0,2019-11-21,"(1159.25, 1381.0]",1,4,-3
31023.0,2019-11-21,"(315.5, 618.0]",1,1,0
31023.0,2019-11-21,"(618.0, 920.5]",1,2,-1
31023.0,2019-11-21,"(920.5, 1223.0]",1,1,0
31024.0,2019-11-21,"(402.001, 652.75]",6,12,-6
31024.0,2019-11-21,"(652.75, 902.5]",1,5,-4
31024.0,2019-11-21,"(902.5, 1152.25]",6,11,-5
31024.0,2019-11-21,"(1152.25, 1402.0]",3,10,-7
31025.0,2019-11-21,"(493.241, 683.75]",2,3,-1
31025.0,2019-11-21,"(683.75, 873.5]",1,1,0
31025.0,2019-11-21,"(1063.25, 1253.0]",1,2,-1
31026.0,2019-11-21,"(390.5, 718.0]",2,1,1
31026.0,2019-11-21,"(718.0, 1045.5]",3,6,-3
31026.0,2019-11-21,"(1045.5, 1373.0]",3,6,-3
31027.0,2019-11-21,"(582.186, 786.5]",1,4,-3
31027.0,2019-11-21,"(786.5, 990.0]",2,3,-1
31027.0,2019-11-21,"(1193.5, 1397.0]",2,3,-1
31028.0,2019-11-21,"(460.344, 625.0]",1,2,-1
31028.0,2019-11-21,"(789.0, 953.0]",1,1,0
31028.0,2019-11-21,"(953.0, 1117.0]",1,2,-1
31029.0,2019-11-21,"(448.151, 661.25]",1,12,-11
31029.0,2019-11-21,"(873.5, 1085.75]",3,5,-2
31029.0,2019-11-21,"(1085.75, 1298.0]",7,7,0
31030.0,2019-11-21,"(921.0, 1156.5]",5,9,-4
31030.0,2019-11-21,"(1156.5, 1392.0]",3,3,0
31031.0,2019-11-21,"(8.734, 326.5]",2,2,0
31031.0,2019-11-21,"(326.5, 643.0]",1,6,-5
31031.0,2019-11-21,"(643.0, 959.5]",2,3,-1
31031.0,2019-11-21,"(959.5, 1276.0]",4,5,-1
31032.0,2019-11-21,"(841.0, 1055.5]",1,1,0
31032.0,2019-11-21,"(1055.5, 1270.0]",3,1,2
31033.0,2019-11-21,"(535.557, 646.75]",1,1,0
31034.0,2019-11-21,"(102.804, 403.0]",1,1,0
31034.0,2019-11-21,"(403.0, 702.0]",4,7,-3
31034.0,2019-11-21,"(1001.0, 1300.0]",2,3,-1
31035.0,2019-11-21,"(453.029, 696.75]",2,7,-5
31035.0,2019-11-21,"(696.75, 939.5]",1,3,-2
31035.0,2019-11-21,"(939.5, 1182.25]",3,4,-1
31035.0,2019-11-21,"(1182.25, 1425.0]",1,4,-3
31036.0,2019-11-21,"(407.009, 655.75]",1,5,-4
31036.0,2019-11-21,"(655.75, 903.5]",1,2,-1
31036.0,2019-11-21,"(903.5, 1151.25]",5,5,0
31036.0,2019-11-21,"(1151.25, 1399.0]",1,1,0
31037.0,2019-11-21,"(382.128, 601.0]",15,20,-5
31037.0,2019-11-21,"(601.0, 819.0]",1,1,0
31037.0,2019-11-21,"(819.0, 1037.0]",4,13,-9
31037.0,2019-11-21,"(1037.0, 1255.0]",5,22,-17
31038.0,2019-11-21,"(705.449, 843.75]",1,1,0
31038.0,2019-11-21,"(843.75, 981.5]",1,1,0
31038.0,2019-11-21,"(981.5, 1119.25]",3,4,-1
31039.0,2019-11-21,"(458.182, 663.5]",3,8,-5
31039.0,2019-11-21,"(663.5, 868.0]",2,3,-1
31039.0,2019-11-21,"(868.0, 1072.5]",2,8,-6
31039.0,2019-11-21,"(1072.5, 1277.0]",2,3,-1
31040.0,2019-11-21,"(340.25, 581.5]",2,1,1
31040.0,2019-11-21,"(581.5, 822.75]",1,2,-1
31040.0,2019-11-21,"(822.75, 1064.0]",2,2,0
31041.0,2019-11-21,"(464.36, 625.0]",1,3,-2
31042.0,2019-11-21,"(465.192, 668.0]",10,14,-4
31042.0,2019-11-21,"(668.0, 870.0]",4,5,-1
31042.0,2019-11-21,"(870.0, 1072.0]",1,12,-11
31042.0,2019-11-21,"(1072.0, 1274.0]",1,2,-1
31043.0,2019-11-21,"(453.283, 633.25]",1,2,-1
31043.0,2019-11-21,"(633.25, 812.5]",1,2,-1
31044.0,2019-11-21,"(951.0, 1129.0]",3,5,-2
31045.0,2019-11-21,"(6.756, 319.0]",1,1,0
31045.0,2019-11-21,"(319.0, 630.0]",1,1,0
31045.0,2019-11-21,"(630.0, 941.0]",1,3,-2
31045.0,2019-11-21,"(941.0, 1252.0]",2,3,-1
31046.0,2019-11-21,"(395.973, 653.75]",2,5,-3
31046.0,2019-11-21,"(653.75, 910.5]",1,2,-1
31046.0,2019-11-21,"(910.5, 1167.25]",1,2,-1
31046.0,2019-11-21,"(1167.25, 1424.0]",1,1,0
31047.0,2019-11-21,"(336.955, 599.25]",17,30,-13
31047.0,2019-11-21,"(599.25, 860.5]",3,7,-4
31047.0,2019-11-21,"(860.5, 1121.75]",10,21,-11
31047.0,2019-11-21,"(1121.75, 1383.0]",1,10,-9
31048.0,2019-11-21,"(467.092, 695.0]",4,8,-4
31048.0,2019-11-21,"(695.0, 922.0]",1,3,-2
31048.0,2019-11-21,"(922.0, 1149.0]",3,6,-3
31048.0,2019-11-21,"(1149.0, 1376.0]",1,3,-2
31049.0,2019-11-21,"(576.283, 756.25]",1,4,-3
31049.0,2019-11-21,"(935.5, 1114.75]",1,3,-2
31049.0,2019-11-21,"(1114.75, 1294.0]",1,1,0
31050.0,2019-11-21,"(587.5, 625.0]",1,1,0
31051.0,2019-11-21,"(564.25, 826.5]",1,4,-3
31051.0,2019-11-21,"(826.5, 1088.75]",4,2,2
31051.0,2019-11-21,"(1088.75, 1351.0]",4,6,-2
31052.0,2019-11-21,"(527.369, 685.75]",3,3,0
31052.0,2019-11-21,"(1001.25, 1159.0]",3,8,-5
31053.0,2019-11-21,"(896.0, 989.5]",1,1,0
31054.0,2019-11-21,"(837.0, 1116.0]",1,1,0
31055.0,2019-11-21,"(501.206, 700.5]",1,3,-2
31055.0,2019-11-21,"(899.0, 1097.5]",1,1,0
,,,,1.0,
,,,,1.0,
,,,,2.0,
,,,,2.0,
31059.0,2019-11-21,"(700.782, 755.5]",2,3,-1
31059.0,2019-11-21,"(864.5, 919.0]",1,1,0
31060.0,2019-11-21,"(637.347, 801.25]",2,2,0
31060.0,2019-11-21,"(801.25, 964.5]",2,2,0
31060.0,2019-11-21,"(1127.75, 1291.0]",1,2,-1
31061.0,2019-11-21,"(1074.999, 1075.25]",1,1,0
31062.0,2019-11-21,"(505.456, 642.0]",2,4,-2
31062.0,2019-11-21,"(778.0, 914.0]",1,2,-1
31062.0,2019-11-21,"(914.0, 1050.0]",2,3,-1
31063.0,2019-11-21,"(765.0, 1020.0]",2,1,1
31064.0,2019-11-21,"(491.331, 659.25]",3,6,-3
31064.0,2019-11-21,"(826.5, 993.75]",2,4,-2
31064.0,2019-11-21,"(993.75, 1161.0]",2,4,-2
31065.0,2019-11-21,"(595.25, 819.5]",1,1,0
31065.0,2019-11-21,"(819.5, 1043.75]",1,3,-2
31066.0,2019-11-21,"(487.184, 692.0]",1,3,-2
31066.0,2019-11-21,"(692.0, 896.0]",1,2,-1
31066.0,2019-11-21,"(896.0, 1100.0]",1,2,-1
31066.0,2019-11-21,"(1100.0, 1304.0]",1,1,0
31067.0,2019-11-21,"(799.5, 989.75]",1,3,-2
31067.0,2019-11-21,"(989.75, 1180.0]",3,1,2
31068.0,2019-11-21,"(1082.25, 1249.0]",2,1,1
31069.0,2019-11-21,"(389.181, 594.75]",2,9,-7
31069.0,2019-11-21,"(594.75, 799.5]",3,3,0
31069.0,2019-11-21,"(799.5, 1004.25]",1,5,-4
31069.0,2019-11-21,"(1004.25, 1209.0]",4,5,-1
31070.0,2019-11-21,"(979.5, 1184.75]",2,2,0
31070.0,2019-11-21,"(1184.75, 1390.0]",5,3,2
31071.0,2019-11-21,"(325.968, 585.0]",2,7,-5
31071.0,2019-11-21,"(843.0, 1101.0]",6,1,5
31071.0,2019-11-21,"(1101.0, 1359.0]",8,9,-1
,,,,1.0,
,,,,1.0,
31073.0,2019-11-21,"(500.501, 625.75]",2,3,-1
31073.0,2019-11-21,"(875.25, 1000.0]",1,1,0
31074.0,2019-11-21,"(422.115, 644.25]",2,4,-2
31074.0,2019-11-21,"(865.5, 1086.75]",1,2,-1
31074.0,2019-11-21,"(1086.75, 1308.0]",2,2,0
31075.0,2019-11-21,"(822.0, 969.5]",1,2,-1
31075.0,2019-11-21,"(969.5, 1117.0]",3,1,2
31076.0,2019-11-21,"(715.661, 800.75]",1,2,-1
31076.0,2019-11-21,"(970.25, 1055.0]",1,1,0
31077.0,2019-11-21,"(188.845, 478.75]",1,1,0
31077.0,2019-11-21,"(478.75, 767.5]",1,8,-7
31077.0,2019-11-21,"(767.5, 1056.25]",7,8,-1
31077.0,2019-11-21,"(1056.25, 1345.0]",5,6,-1
31078.0,2019-11-21,"(471.452, 609.0]",8,8,0
31078.0,2019-11-21,"(609.0, 746.0]",2,6,-4
31079.0,2019-11-21,"(67.66, 404.0]",1,2,-1
31079.0,2019-11-21,"(404.0, 739.0]",5,14,-9
31079.0,2019-11-21,"(739.0, 1074.0]",1,2,-1
31079.0,2019-11-21,"(1074.0, 1409.0]",4,6,-2
31080.0,2019-11-21,"(343.939, 610.25]",1,10,-9
31080.0,2019-11-21,"(610.25, 875.5]",1,3,-2
31080.0,2019-11-21,"(875.5, 1140.75]",8,14,-6
31080.0,2019-11-21,"(1140.75, 1406.0]",4,4,0
31081.0,2019-11-21,"(473.27, 656.5]",2,3,-1
31081.0,2019-11-21,"(1021.5, 1204.0]",2,1,1
31082.0,2019-11-21,"(595.876, 627.0]",1,1,0
31082.0,2019-11-21,"(689.0, 720.0]",1,1,0
31083.0,2019-11-21,"(845.0, 1064.0]",4,4,0
31083.0,2019-11-21,"(1064.0, 1283.0]",2,1,1
31084.0,2019-11-21,"(484.101, 709.75]",10,10,0
31084.0,2019-11-21,"(709.75, 934.5]",1,2,-1
31084.0,2019-11-21,"(1159.25, 1384.0]",2,6,-4
31085.0,2019-11-21,"(401.235, 593.25]",1,6,-5
31085.0,2019-11-21,"(975.75, 1167.0]",2,2,0
31086.0,2019-11-21,"(861.5, 1126.75]",2,3,-1
31086.0,2019-11-21,"(1126.75, 1392.0]",4,3,1
,,,,1.0,
,,,,1.0,
31088.0,2019-11-21,"(905.0, 1133.5]",5,6,-1
31088.0,2019-11-21,"(1133.5, 1362.0]",2,1,1
31089.0,2019-11-21,"(408.126, 627.5]",10,14,-4
31089.0,2019-11-21,"(627.5, 846.0]",1,3,-2
31089.0,2019-11-21,"(846.0, 1064.5]",6,14,-8
31089.0,2019-11-21,"(1064.5, 1283.0]",5,23,-18
31090.0,2019-11-21,"(647.0, 812.0]",1,1,0
31090.0,2019-11-21,"(977.0, 1142.0]",3,2,1
31091.0,2019-11-21,"(8.887, 288.25]",1,1,0
31091.0,2019-11-21,"(844.75, 1123.0]",4,5,-1
31092.0,2019-11-21,"(1176.5, 1411.0]",2,2,0
31093.0,2019-11-21,"(919.5, 1094.0]",1,3,-2
31094.0,2019-11-21,"(1075.75, 1134.0]",1,1,0
,,,,2.0,
31096.0,2019-11-21,"(1033.876, 1065.0]",1,2,-1
31096.0,2019-11-21,"(1127.0, 1158.0]",1,1,0
31097.0,2019-11-21,"(393.166, 602.5]",4,5,-1
31097.0,2019-11-21,"(602.5, 811.0]",1,2,-1
31097.0,2019-11-21,"(811.0, 1019.5]",1,3,-2
31097.0,2019-11-21,"(1019.5, 1228.0]",3,7,-4
31098.0,2019-11-21,"(423.116, 645.0]",8,12,-4
31098.0,2019-11-21,"(645.0, 866.0]",2,2,0
31098.0,2019-11-21,"(866.0, 1087.0]",10,15,-5
31099.0,2019-11-21,"(652.5, 812.0]",1,2,-1
31099.0,2019-11-21,"(971.5, 1131.0]",2,1,1
31100.0,2019-11-21,"(440.192, 643.0]",16,18,-2
31100.0,2019-11-21,"(643.0, 845.0]",6,9,-3
31100.0,2019-11-21,"(845.0, 1047.0]",1,7,-6
31100.0,2019-11-21,"(1047.0, 1249.0]",3,15,-12
31101.0,2019-11-21,"(21.592, 375.0]",1,2,-1
31101.0,2019-11-21,"(375.0, 727.0]",11,40,-29
31101.0,2019-11-21,"(727.0, 1079.0]",29,47,-18
31101.0,2019-11-21,"(1079.0, 1431.0]",32,54,-22
31102.0,2019-11-21,"(317.9, 594.0]",3,26,-23
31102.0,2019-11-21,"(869.0, 1144.0]",9,2,7
31102.0,2019-11-21,"(1144.0, 1419.0]",16,17,-1
31103.0,2019-11-21,"(28.61, 377.5]",1,3,-2
31103.0,2019-11-21,"(377.5, 725.0]",1,40,-39
31103.0,2019-11-21,"(725.0, 1072.5]",9,29,-20
31103.0,2019-11-21,"(1072.5, 1420.0]",9,23,-14
31104.0,2019-11-21,"(372.0, 728.0]",4,5,-1
31104.0,2019-11-21,"(728.0, 1084.0]",13,19,-6
31104.0,2019-11-21,"(1084.0, 1440.0]",18,27,-9
31105.0,2019-11-21,"(21.583, 377.25]",1,1,0
31105.0,2019-11-21,"(377.25, 731.5]",4,21,-17
31105.0,2019-11-21,"(731.5, 1085.75]",3,12,-9
31105.0,2019-11-21,"(1085.75, 1440.0]",5,10,-5
31106.0,2019-11-21,"(449.29, 627.5]",1,10,-9
31106.0,2019-11-21,"(805.0, 982.5]",1,1,0
31106.0,2019-11-21,"(982.5, 1160.0]",5,7,-2
31107.0,2019-11-21,"(336.938, 603.5]",3,22,-19
31107.0,2019-11-21,"(603.5, 869.0]",3,9,-6
31107.0,2019-11-21,"(869.0, 1134.5]",11,19,-8
31107.0,2019-11-21,"(1134.5, 1400.0]",17,25,-8
31108.0,2019-11-21,"(16.647, 356.25]",1,1,0
31108.0,2019-11-21,"(356.25, 694.5]",6,27,-21
31108.0,2019-11-21,"(694.5, 1032.75]",24,48,-24
31108.0,2019-11-21,"(1032.75, 1371.0]",23,33,-10
31109.0,2019-11-21,"(86.666, 421.5]",2,7,-5
31109.0,2019-11-21,"(421.5, 755.0]",7,22,-15
31109.0,2019-11-21,"(755.0, 1088.5]",11,23,-12
31109.0,2019-11-21,"(1088.5, 1422.0]",22,31,-9
31110.0,2019-11-21,"(70.701, 396.75]",2,3,-1
31110.0,2019-11-21,"(396.75, 721.5]",16,46,-30
31110.0,2019-11-21,"(721.5, 1046.25]",11,23,-12
31110.0,2019-11-21,"(1046.25, 1371.0]",28,49,-21
31111.0,2019-11-21,"(18.622, 364.5]",2,4,-2
31111.0,2019-11-21,"(364.5, 709.0]",4,20,-16
31111.0,2019-11-21,"(709.0, 1053.5]",6,8,-2
31111.0,2019-11-21,"(1053.5, 1398.0]",16,23,-7
31112.0,2019-11-21,"(42.945, 307.75]",1,1,0
31112.0,2019-11-21,"(307.75, 571.5]",1,3,-2
31112.0,2019-11-21,"(571.5, 835.25]",1,5,-4
31112.0,2019-11-21,"(835.25, 1099.0]",4,5,-1
31113.0,2019-11-21,"(315.915, 588.25]",1,15,-14
31113.0,2019-11-21,"(588.25, 859.5]",1,7,-6
31113.0,2019-11-21,"(859.5, 1130.75]",2,6,-4
31113.0,2019-11-21,"(1130.75, 1402.0]",14,22,-8
31114.0,2019-11-21,"(7.571, 366.25]",2,5,-3
31114.0,2019-11-21,"(366.25, 723.5]",5,25,-20
31114.0,2019-11-21,"(723.5, 1080.75]",18,26,-8
31114.0,2019-11-21,"(1080.75, 1438.0]",29,50,-21
31115.0,2019-11-21,"(240.982, 496.5]",1,13,-12
31115.0,2019-11-21,"(496.5, 751.0]",1,8,-7
31115.0,2019-11-21,"(751.0, 1005.5]",6,9,-3
31115.0,2019-11-21,"(1005.5, 1260.0]",17,26,-9
31116.0,2019-11-21,"(370.949, 634.75]",5,27,-22
31116.0,2019-11-21,"(634.75, 897.5]",6,12,-6
31116.0,2019-11-21,"(897.5, 1160.25]",22,27,-5
31116.0,2019-11-21,"(1160.25, 1423.0]",3,7,-4
31117.0,2019-11-21,"(334.037, 575.75]",1,11,-10
31117.0,2019-11-21,"(575.75, 816.5]",8,15,-7
31117.0,2019-11-21,"(816.5, 1057.25]",6,18,-12
31117.0,2019-11-21,"(1057.25, 1298.0]",10,22,-12
31118.0,2019-11-21,"(427.99, 681.5]",2,16,-14
31118.0,2019-11-21,"(681.5, 934.0]",4,9,-5
31118.0,2019-11-21,"(934.0, 1186.5]",9,14,-5
31118.0,2019-11-21,"(1186.5, 1439.0]",8,11,-3
31119.0,2019-11-21,"(76.65, 415.5]",4,11,-7
31119.0,2019-11-21,"(415.5, 753.0]",6,15,-9
31119.0,2019-11-21,"(753.0, 1090.5]",16,28,-12
31119.0,2019-11-21,"(1090.5, 1428.0]",19,35,-16
31120.0,2019-11-21,"(402.0, 734.0]",5,3,2
31120.0,2019-11-21,"(734.0, 1066.0]",2,24,-22
31120.0,2019-11-21,"(1066.0, 1398.0]",13,4,9
31121.0,2019-11-21,"(23.616, 371.0]",2,6,-4
31121.0,2019-11-21,"(371.0, 717.0]",20,36,-16
31121.0,2019-11-21,"(717.0, 1063.0]",4,10,-6
31121.0,2019-11-21,"(1063.0, 1409.0]",14,21,-7
31122.0,2019-11-21,"(458.116, 680.0]",4,22,-18
31122.0,2019-11-21,"(680.0, 901.0]",1,2,-1
31122.0,2019-11-21,"(901.0, 1122.0]",8,14,-6
31122.0,2019-11-21,"(1122.0, 1343.0]",4,11,-7
31123.0,2019-11-21,"(610.5, 872.0]",2,13,-11
31123.0,2019-11-21,"(872.0, 1133.5]",4,5,-1
31123.0,2019-11-21,"(1133.5, 1395.0]",4,9,-5
31124.0,2019-11-21,"(424.25, 760.5]",13,2,11
31124.0,2019-11-21,"(760.5, 1096.75]",15,65,-50
31124.0,2019-11-21,"(1096.75, 1433.0]",18,48,-30
31125.0,2019-11-21,"(1.646, 341.5]",1,1,0
31125.0,2019-11-21,"(341.5, 680.0]",4,26,-22
31125.0,2019-11-21,"(680.0, 1018.5]",7,13,-6
31125.0,2019-11-21,"(1018.5, 1357.0]",35,54,-19
31126.0,2019-11-21,"(408.046, 647.5]",2,23,-21
31126.0,2019-11-21,"(886.0, 1124.5]",18,10,8
31126.0,2019-11-21,"(1124.5, 1363.0]",12,24,-12
31127.0,2019-11-21,"(57.696, 385.0]",1,2,-1
31127.0,2019-11-21,"(385.0, 711.0]",14,19,-5
31127.0,2019-11-21,"(711.0, 1037.0]",20,42,-22
31127.0,2019-11-21,"(1037.0, 1363.0]",12,31,-19
31128.0,2019-11-21,"(58.656, 396.0]",2,4,-2
31128.0,2019-11-21,"(396.0, 732.0]",38,52,-14
31128.0,2019-11-21,"(732.0, 1068.0]",18,28,-10
31128.0,2019-11-21,"(1068.0, 1404.0]",9,25,-16
31129.0,2019-11-21,"(426.187, 630.25]",10,13,-3
31129.0,2019-11-21,"(630.25, 833.5]",5,8,-3
31129.0,2019-11-21,"(833.5, 1036.75]",6,17,-11
31129.0,2019-11-21,"(1036.75, 1240.0]",6,9,-3
31130.0,2019-11-21,"(11.653, 349.75]",1,1,0
31130.0,2019-11-21,"(349.75, 686.5]",2,11,-9
31130.0,2019-11-21,"(686.5, 1023.25]",7,13,-6
31130.0,2019-11-21,"(1023.25, 1360.0]",10,16,-6
31131.0,2019-11-21,"(593.75, 827.5]",1,11,-10
31131.0,2019-11-21,"(827.5, 1061.25]",1,2,-1
31131.0,2019-11-21,"(1061.25, 1295.0]",4,3,1
31200.0,2019-11-21,"(361.25, 710.5]",45,1,44
31200.0,2019-11-21,"(710.5, 1059.75]",24,65,-41
31200.0,2019-11-21,"(1059.75, 1409.0]",22,52,-30
31201.0,2019-11-21,"(213.827, 508.25]",19,38,-19
31201.0,2019-11-21,"(508.25, 801.5]",17,41,-24
31201.0,2019-11-21,"(801.5, 1094.75]",54,95,-41
31201.0,2019-11-21,"(1094.75, 1388.0]",34,76,-42
31202.0,2019-11-21,"(0.601, 351.75]",2,2,0
31202.0,2019-11-21,"(351.75, 701.5]",13,29,-16
31202.0,2019-11-21,"(701.5, 1051.25]",21,36,-15
31202.0,2019-11-21,"(1051.25, 1401.0]",23,44,-21
31203.0,2019-11-21,"(18.583, 374.25]",2,4,-2
31203.0,2019-11-21,"(374.25, 728.5]",8,31,-23
31203.0,2019-11-21,"(728.5, 1082.75]",27,49,-22
31203.0,2019-11-21,"(1082.75, 1437.0]",32,51,-19
31204.0,2019-11-21,"(414.25, 755.5]",14,1,13
31204.0,2019-11-21,"(755.5, 1096.75]",15,22,-7
31204.0,2019-11-21,"(1096.75, 1438.0]",6,27,-21
31205.0,2019-11-21,"(401.25, 738.5]",35,1,34
31205.0,2019-11-21,"(738.5, 1075.75]",30,37,-7
31205.0,2019-11-21,"(1075.75, 1413.0]",5,50,-45
31206.0,2019-11-21,"(387.337, 553.75]",8,9,-1
31206.0,2019-11-21,"(719.5, 885.25]",1,1,0
31206.0,2019-11-21,"(885.25, 1051.0]",6,2,4
31207.0,2019-11-21,"(877.5, 1143.25]",3,8,-5
31207.0,2019-11-21,"(1143.25, 1409.0]",8,3,5
31208.0,2019-11-21,"(324.913, 597.75]",16,22,-6
31208.0,2019-11-21,"(597.75, 869.5]",3,4,-1
31208.0,2019-11-21,"(869.5, 1141.25]",6,18,-12
31208.0,2019-11-21,"(1141.25, 1413.0]",3,4,-1
31209.0,2019-11-21,"(564.229, 757.75]",1,1,0
31209.0,2019-11-21,"(950.5, 1143.25]",7,1,6
31209.0,2019-11-21,"(1143.25, 1336.0]",4,11,-7
31211.0,2019-11-21,"(397.097, 623.75]",9,11,-2
31211.0,2019-11-21,"(623.75, 849.5]",1,2,-1
31211.0,2019-11-21,"(849.5, 1075.25]",6,13,-7
31211.0,2019-11-21,"(1075.25, 1301.0]",3,11,-8
31212.0,2019-11-21,"(331.941, 597.75]",37,51,-14
31212.0,2019-11-21,"(597.75, 862.5]",11,23,-12
31212.0,2019-11-21,"(862.5, 1127.25]",18,35,-17
31212.0,2019-11-21,"(1127.25, 1392.0]",9,19,-10
31213.0,2019-11-21,"(302.898, 579.5]",35,49,-14
31213.0,2019-11-21,"(579.5, 855.0]",10,23,-13
31213.0,2019-11-21,"(855.0, 1130.5]",21,42,-21
31213.0,2019-11-21,"(1130.5, 1406.0]",2,12,-10
31214.0,2019-11-21,"(279.861, 565.75]",11,38,-27
31214.0,2019-11-21,"(565.75, 850.5]",9,19,-10
31214.0,2019-11-21,"(850.5, 1135.25]",31,46,-15
31214.0,2019-11-21,"(1135.25, 1420.0]",20,33,-13
31215.0,2019-11-21,"(449.096, 676.0]",35,37,-2
31215.0,2019-11-21,"(676.0, 902.0]",3,5,-2
31215.0,2019-11-21,"(902.0, 1128.0]",8,20,-12
31215.0,2019-11-21,"(1128.0, 1354.0]",4,14,-10
31216.0,2019-11-21,"(408.188, 612.0]",19,21,-2
31216.0,2019-11-21,"(612.0, 815.0]",4,6,-2
31216.0,2019-11-21,"(815.0, 1018.0]",3,4,-1
31216.0,2019-11-21,"(1018.0, 1221.0]",4,29,-25
31217.0,2019-11-21,"(322.252, 510.0]",13,15,-2
31217.0,2019-11-21,"(510.0, 697.0]",4,6,-2
31217.0,2019-11-21,"(697.0, 884.0]",1,7,-6
31217.0,2019-11-21,"(884.0, 1071.0]",4,17,-13
31218.0,2019-11-21,"(326.106, 550.5]",14,30,-16
31218.0,2019-11-21,"(550.5, 774.0]",5,6,-1
31218.0,2019-11-21,"(774.0, 997.5]",4,10,-6
31218.0,2019-11-21,"(997.5, 1221.0]",8,17,-9
31219.0,2019-11-21,"(359.125, 578.75]",16,16,0
31219.0,2019-11-21,"(578.75, 797.5]",4,5,-1
31219.0,2019-11-21,"(797.5, 1016.25]",10,21,-11
31219.0,2019-11-21,"(1016.25, 1235.0]",1,7,-6
31220.0,2019-11-21,"(292.215, 489.25]",10,14,-4
31220.0,2019-11-21,"(489.25, 685.5]",11,13,-2
31220.0,2019-11-21,"(685.5, 881.75]",3,7,-4
31220.0,2019-11-21,"(881.75, 1078.0]",2,18,-16
31221.0,2019-11-21,"(10.635, 353.25]",1,2,-1
31221.0,2019-11-21,"(353.25, 694.5]",38,38,0
31221.0,2019-11-21,"(694.5, 1035.75]",17,34,-17
31221.0,2019-11-21,"(1035.75, 1377.0]",12,32,-20
31222.0,2019-11-21,"(383.053, 620.75]",19,21,-2
31222.0,2019-11-21,"(620.75, 857.5]",4,7,-3
31222.0,2019-11-21,"(857.5, 1094.25]",5,27,-22
31222.0,2019-11-21,"(1094.25, 1331.0]",4,9,-5
31223.0,2019-11-21,"(48.643, 389.25]",1,3,-2
31223.0,2019-11-21,"(389.25, 728.5]",8,28,-20
31223.0,2019-11-21,"(728.5, 1067.75]",12,29,-17
31223.0,2019-11-21,"(1067.75, 1407.0]",16,30,-14
31224.0,2019-11-21,"(360.119, 581.25]",17,19,-2
31224.0,2019-11-21,"(581.25, 801.5]",10,15,-5
31224.0,2019-11-21,"(801.5, 1021.75]",5,12,-7
31224.0,2019-11-21,"(1021.75, 1242.0]",4,20,-16
31225.0,2019-11-21,"(386.987, 641.25]",9,15,-6
31225.0,2019-11-21,"(641.25, 894.5]",6,12,-6
31225.0,2019-11-21,"(894.5, 1147.75]",1,13,-12
31225.0,2019-11-21,"(1147.75, 1401.0]",4,8,-4
31226.0,2019-11-21,"(269.03, 512.5]",3,5,-2
31226.0,2019-11-21,"(512.5, 755.0]",3,6,-3
31226.0,2019-11-21,"(755.0, 997.5]",6,13,-7
31226.0,2019-11-21,"(997.5, 1240.0]",5,8,-3
31227.0,2019-11-21,"(70.777, 377.75]",3,4,-1
31227.0,2019-11-21,"(377.75, 683.5]",52,53,-1
31227.0,2019-11-21,"(683.5, 989.25]",8,12,-4
31227.0,2019-11-21,"(989.25, 1295.0]",9,30,-21
31228.0,2019-11-21,"(65.696, 393.0]",4,4,0
31228.0,2019-11-21,"(393.0, 719.0]",23,28,-5
31228.0,2019-11-21,"(719.0, 1045.0]",24,45,-21
31228.0,2019-11-21,"(1045.0, 1371.0]",21,40,-19
31229.0,2019-11-21,"(10.635, 353.25]",1,7,-6
31229.0,2019-11-21,"(353.25, 694.5]",12,41,-29
31229.0,2019-11-21,"(694.5, 1035.75]",24,38,-14
31229.0,2019-11-21,"(1035.75, 1377.0]",49,92,-43
31230.0,2019-11-21,"(397.025, 641.75]",51,60,-9
31230.0,2019-11-21,"(641.75, 885.5]",14,23,-9
31230.0,2019-11-21,"(885.5, 1129.25]",23,47,-24
31230.0,2019-11-21,"(1129.25, 1373.0]",5,20,-15
31231.0,2019-11-21,"(323.909, 597.75]",22,25,-3
31231.0,2019-11-21,"(597.75, 870.5]",10,17,-7
31231.0,2019-11-21,"(870.5, 1143.25]",11,30,-19
31232.0,2019-11-21,"(295.904, 571.0]",17,25,-8
31232.0,2019-11-21,"(571.0, 845.0]",8,13,-5
31232.0,2019-11-21,"(845.0, 1119.0]",16,31,-15
31232.0,2019-11-21,"(1119.0, 1393.0]",2,9,-7
31233.0,2019-11-21,"(0.642, 341.5]",2,4,-2
31233.0,2019-11-21,"(341.5, 681.0]",57,60,-3
31233.0,2019-11-21,"(681.0, 1020.5]",15,27,-12
31233.0,2019-11-21,"(1020.5, 1360.0]",11,43,-32
31234.0,2019-11-21,"(26.589, 380.75]",2,3,-1
31234.0,2019-11-21,"(380.75, 733.5]",22,44,-22
31234.0,2019-11-21,"(733.5, 1086.25]",18,34,-16
31234.0,2019-11-21,"(1086.25, 1439.0]",10,29,-19
31235.0,2019-11-21,"(385.196, 587.0]",10,11,-1
31235.0,2019-11-21,"(587.0, 788.0]",3,3,0
31235.0,2019-11-21,"(788.0, 989.0]",7,14,-7
31235.0,2019-11-21,"(989.0, 1190.0]",4,7,-3
31236.0,2019-11-21,"(409.991, 663.25]",22,25,-3
31236.0,2019-11-21,"(663.25, 915.5]",13,31,-18
31236.0,2019-11-21,"(915.5, 1167.75]",5,22,-17
31236.0,2019-11-21,"(1167.75, 1420.0]",2,4,-2
31237.0,2019-11-21,"(4.704, 330.0]",2,5,-3
31237.0,2019-11-21,"(330.0, 654.0]",8,18,-10
31237.0,2019-11-21,"(654.0, 978.0]",10,19,-9
31237.0,2019-11-21,"(978.0, 1302.0]",14,23,-9
31238.0,2019-11-21,"(53.773, 361.75]",1,2,-1
31238.0,2019-11-21,"(361.75, 668.5]",20,24,-4
31238.0,2019-11-21,"(668.5, 975.25]",8,15,-7
31238.0,2019-11-21,"(975.25, 1282.0]",8,28,-20
31239.0,2019-11-21,"(360.128, 579.0]",25,28,-3
31239.0,2019-11-21,"(579.0, 797.0]",8,15,-7
31239.0,2019-11-21,"(797.0, 1015.0]",5,17,-12
31239.0,2019-11-21,"(1015.0, 1233.0]",14,40,-26
31240.0,2019-11-21,"(389.32, 560.0]",1,2,-1
31240.0,2019-11-21,"(560.0, 730.0]",2,6,-4
31240.0,2019-11-21,"(730.0, 900.0]",2,4,-2
31240.0,2019-11-21,"(900.0, 1070.0]",3,6,-3
31241.0,2019-11-21,"(60.641, 401.75]",4,7,-3
31241.0,2019-11-21,"(401.75, 741.5]",33,62,-29
31241.0,2019-11-21,"(741.5, 1081.25]",12,44,-32
31241.0,2019-11-21,"(1081.25, 1421.0]",22,36,-14
31242.0,2019-11-21,"(319.101, 544.75]",23,25,-2
31242.0,2019-11-21,"(544.75, 769.5]",17,26,-9
31242.0,2019-11-21,"(769.5, 994.25]",6,25,-19
31242.0,2019-11-21,"(994.25, 1219.0]",2,30,-28
31243.0,2019-11-21,"(376.95, 640.5]",35,38,-3
31243.0,2019-11-21,"(640.5, 903.0]",4,4,0
31243.0,2019-11-21,"(903.0, 1165.5]",7,38,-31
31243.0,2019-11-21,"(1165.5, 1428.0]",3,10,-7
31244.0,2019-11-21,"(166.794, 469.5]",4,7,-3
31244.0,2019-11-21,"(469.5, 771.0]",18,30,-12
31244.0,2019-11-21,"(771.0, 1072.5]",14,35,-21
31244.0,2019-11-21,"(1072.5, 1374.0]",12,18,-6
31245.0,2019-11-21,"(4.574, 362.5]",1,1,0
31245.0,2019-11-21,"(362.5, 719.0]",11,32,-21
31245.0,2019-11-21,"(719.0, 1075.5]",13,25,-12
31245.0,2019-11-21,"(1075.5, 1432.0]",16,28,-12
31246.0,2019-11-21,"(7.604, 358.0]",2,2,0
31246.0,2019-11-21,"(358.0, 707.0]",20,31,-11
31246.0,2019-11-21,"(707.0, 1056.0]",13,23,-10
31246.0,2019-11-21,"(1056.0, 1405.0]",18,37,-19
31247.0,2019-11-21,"(412.07, 645.5]",13,23,-10
31247.0,2019-11-21,"(645.5, 878.0]",11,19,-8
31247.0,2019-11-21,"(878.0, 1110.5]",18,38,-20
31248.0,2019-11-21,"(350.054, 587.5]",13,21,-8
31248.0,2019-11-21,"(587.5, 824.0]",8,22,-14
31248.0,2019-11-21,"(824.0, 1060.5]",16,33,-17
31248.0,2019-11-21,"(1060.5, 1297.0]",5,15,-10
31249.0,2019-11-21,"(342.151, 555.25]",3,5,-2
31249.0,2019-11-21,"(555.25, 767.5]",7,15,-8
31249.0,2019-11-21,"(767.5, 979.75]",6,12,-6
31249.0,2019-11-21,"(979.75, 1192.0]",8,20,-12
31250.0,2019-11-21,"(347.979, 604.25]",21,23,-2
31250.0,2019-11-21,"(604.25, 859.5]",5,10,-5
31250.0,2019-11-21,"(859.5, 1114.75]",7,23,-16
31250.0,2019-11-21,"(1114.75, 1370.0]",4,13,-9
31251.0,2019-11-21,"(366.935, 634.25]",20,34,-14
31251.0,2019-11-21,"(634.25, 900.5]",3,8,-5
31251.0,2019-11-21,"(900.5, 1166.75]",11,26,-15
31251.0,2019-11-21,"(1166.75, 1433.0]",10,16,-6
31252.0,2019-11-21,"(190.89, 469.5]",2,3,-1
31252.0,2019-11-21,"(469.5, 747.0]",14,16,-2
31252.0,2019-11-21,"(747.0, 1024.5]",6,19,-13
31252.0,2019-11-21,"(1024.5, 1302.0]",3,14,-11
31253.0,2019-11-21,"(404.975, 662.25]",14,19,-5
31253.0,2019-11-21,"(662.25, 918.5]",18,28,-10
31253.0,2019-11-21,"(918.5, 1174.75]",11,27,-16
31254.0,2019-11-21,"(383.084, 613.0]",24,26,-2
31254.0,2019-11-21,"(613.0, 842.0]",2,8,-6
31254.0,2019-11-21,"(842.0, 1071.0]",7,29,-22
31254.0,2019-11-21,"(1071.0, 1300.0]",4,11,-7
31255.0,2019-11-21,"(347.75, 671.5]",23,1,22
31255.0,2019-11-21,"(671.5, 995.25]",4,32,-28
31255.0,2019-11-21,"(995.25, 1319.0]",13,12,1
31256.0,2019-11-21,"(283.995, 536.25]",7,9,-2
31256.0,2019-11-21,"(536.25, 787.5]",10,11,-1
31256.0,2019-11-21,"(787.5, 1038.75]",3,9,-6
31256.0,2019-11-21,"(1038.75, 1290.0]",7,20,-13
31257.0,2019-11-21,"(58.72, 380.0]",2,3,-1
31257.0,2019-11-21,"(380.0, 700.0]",21,32,-11
31257.0,2019-11-21,"(700.0, 1020.0]",14,27,-13
31257.0,2019-11-21,"(1020.0, 1340.0]",13,39,-26
31258.0,2019-11-21,"(6.622, 352.5]",3,3,0
31258.0,2019-11-21,"(352.5, 697.0]",20,31,-11
31258.0,2019-11-21,"(697.0, 1041.5]",27,63,-36
31258.0,2019-11-21,"(1041.5, 1386.0]",4,6,-2
31259.0,2019-11-21,"(452.275, 634.25]",12,12,0
31259.0,2019-11-21,"(634.25, 815.5]",2,2,0
31259.0,2019-11-21,"(996.75, 1178.0]",2,2,0
31260.0,2019-11-21,"(382.97, 641.5]",18,23,-5
31260.0,2019-11-21,"(641.5, 899.0]",3,5,-2
31260.0,2019-11-21,"(899.0, 1156.5]",7,20,-13
31260.0,2019-11-21,"(1156.5, 1414.0]",3,6,-3
31261.0,2019-11-21,"(449.011, 697.25]",9,9,0
31261.0,2019-11-21,"(697.25, 944.5]",1,3,-2
31261.0,2019-11-21,"(944.5, 1191.75]",1,12,-11
31261.0,2019-11-21,"(1191.75, 1439.0]",1,3,-2
31262.0,2019-11-21,"(322.033, 564.75]",13,14,-1
31262.0,2019-11-21,"(564.75, 806.5]",3,4,-1
31262.0,2019-11-21,"(806.5, 1048.25]",5,12,-7
31262.0,2019-11-21,"(1048.25, 1290.0]",5,16,-11
31263.0,2019-11-21,"(341.974, 599.5]",28,45,-17
31263.0,2019-11-21,"(599.5, 856.0]",11,20,-9
31263.0,2019-11-21,"(856.0, 1112.5]",16,35,-19
31263.0,2019-11-21,"(1112.5, 1369.0]",8,20,-12
31264.0,2019-11-21,"(366.975, 624.25]",12,18,-6
31264.0,2019-11-21,"(624.25, 880.5]",5,8,-3
31264.0,2019-11-21,"(880.5, 1136.75]",9,24,-15
31264.0,2019-11-21,"(1136.75, 1393.0]",4,12,-8
31265.0,2019-11-21,"(358.5, 714.0]",18,1,17
31265.0,2019-11-21,"(714.0, 1069.5]",19,41,-22
31265.0,2019-11-21,"(1069.5, 1425.0]",28,43,-15
31266.0,2019-11-21,"(60.656, 398.0]",5,11,-6
31266.0,2019-11-21,"(398.0, 734.0]",8,31,-23
31266.0,2019-11-21,"(734.0, 1070.0]",23,41,-18
31266.0,2019-11-21,"(1070.0, 1406.0]",21,31,-10
31267.0,2019-11-21,"(0.639, 342.25]",2,2,0
31267.0,2019-11-21,"(342.25, 682.5]",26,39,-13
31267.0,2019-11-21,"(682.5, 1022.75]",15,29,-14
31267.0,2019-11-21,"(1022.75, 1363.0]",25,54,-29
31268.0,2019-11-21,"(323.92, 595.0]",11,44,-33
31268.0,2019-11-21,"(595.0, 865.0]",2,5,-3
31268.0,2019-11-21,"(865.0, 1135.0]",26,34,-8
31268.0,2019-11-21,"(1135.0, 1405.0]",14,27,-13
31269.0,2019-11-21,"(92.665, 427.75]",3,4,-1
31269.0,2019-11-21,"(427.75, 761.5]",11,26,-15
31269.0,2019-11-21,"(761.5, 1095.25]",9,19,-10
31269.0,2019-11-21,"(1095.25, 1429.0]",2,7,-5
31270.0,2019-11-21,"(392.021, 637.75]",17,21,-4
31270.0,2019-11-21,"(637.75, 882.5]",5,12,-7
31270.0,2019-11-21,"(882.5, 1127.25]",10,24,-14
31270.0,2019-11-21,"(1127.25, 1372.0]",3,12,-9
31271.0,2019-11-21,"(386.149, 599.75]",16,26,-10
31271.0,2019-11-21,"(599.75, 812.5]",12,16,-4
31271.0,2019-11-21,"(812.5, 1025.25]",4,11,-7
31271.0,2019-11-21,"(1025.25, 1238.0]",6,21,-15
31272.0,2019-11-21,"(52.632, 396.0]",1,2,-1
31272.0,2019-11-21,"(396.0, 738.0]",30,37,-7
31272.0,2019-11-21,"(738.0, 1080.0]",10,31,-21
31272.0,2019-11-21,"(1080.0, 1422.0]",3,11,-8
31273.0,2019-11-21,"(367.182, 572.5]",1,4,-3
31273.0,2019-11-21,"(777.0, 981.5]",2,1,1
31273.0,2019-11-21,"(981.5, 1186.0]",5,3,2
31274.0,2019-11-21,"(395.124, 615.0]",19,23,-4
31274.0,2019-11-21,"(615.0, 834.0]",6,7,-1
31274.0,2019-11-21,"(834.0, 1053.0]",2,9,-7
31274.0,2019-11-21,"(1053.0, 1272.0]",6,11,-5
31275.0,2019-11-21,"(22.596, 375.0]",3,7,-4
31275.0,2019-11-21,"(375.0, 726.0]",26,40,-14
31275.0,2019-11-21,"(726.0, 1077.0]",16,39,-23
31275.0,2019-11-21,"(1077.0, 1428.0]",19,43,-24
31276.0,2019-11-21,"(1.854, 289.5]",1,2,-1
31276.0,2019-11-21,"(289.5, 576.0]",25,27,-2
31276.0,2019-11-21,"(576.0, 862.5]",3,10,-7
31276.0,2019-11-21,"(862.5, 1149.0]",5,29,-24
31277.0,2019-11-21,"(414.082, 644.5]",48,57,-9
31277.0,2019-11-21,"(644.5, 874.0]",17,19,-2
31277.0,2019-11-21,"(874.0, 1103.5]",12,38,-26
31277.0,2019-11-21,"(1103.5, 1333.0]",4,19,-15
31278.0,2019-11-21,"(4.575, 362.25]",2,4,-2
31278.0,2019-11-21,"(362.25, 718.5]",9,37,-28
31278.0,2019-11-21,"(718.5, 1074.75]",17,33,-16
31278.0,2019-11-21,"(1074.75, 1431.0]",30,43,-13
31279.0,2019-11-21,"(385.21, 583.5]",25,28,-3
31279.0,2019-11-21,"(583.5, 781.0]",2,6,-4
31279.0,2019-11-21,"(781.0, 978.5]",5,15,-10
31279.0,2019-11-21,"(978.5, 1176.0]",6,27,-21
31280.0,2019-11-21,"(361.011, 609.25]",4,22,-18
31280.0,2019-11-21,"(609.25, 856.5]",1,2,-1
31280.0,2019-11-21,"(856.5, 1103.75]",10,11,-1
31280.0,2019-11-21,"(1103.75, 1351.0]",15,19,-4
,,,,2.0,
31001.0,2019-11-22,"(1022.796, 1074.0]",1,1,0
31001.0,2019-11-22,"(1176.0, 1227.0]",1,1,0
31002.0,2019-11-22,"(446.36, 607.0]",4,7,-3
31002.0,2019-11-22,"(607.0, 767.0]",1,1,0
31002.0,2019-11-22,"(927.0, 1087.0]",3,7,-4
31003.0,2019-11-22,"(434.266, 618.5]",3,4,-1
31003.0,2019-11-22,"(802.0, 985.5]",3,5,-2
31003.0,2019-11-22,"(985.5, 1169.0]",2,5,-3
31004.0,2019-11-22,"(966.5, 1142.0]",4,2,2
31005.0,2019-11-22,"(416.258, 602.5]",8,9,-1
31005.0,2019-11-22,"(788.0, 973.5]",2,3,-1
31005.0,2019-11-22,"(973.5, 1159.0]",4,17,-13
31006.0,2019-11-22,"(702.5, 862.75]",1,2,-1
31006.0,2019-11-22,"(862.75, 1023.0]",1,2,-1
31007.0,2019-11-22,"(433.213, 630.75]",6,19,-13
31007.0,2019-11-22,"(827.5, 1024.25]",6,9,-3
31007.0,2019-11-22,"(1024.25, 1221.0]",3,13,-10
31009.0,2019-11-22,"(438.258, 624.5]",5,5,0
31009.0,2019-11-22,"(995.5, 1181.0]",1,1,0
31010.0,2019-11-22,"(441.215, 638.25]",2,3,-1
31010.0,2019-11-22,"(834.5, 1030.75]",4,1,3
31011.0,2019-11-22,"(317.161, 527.75]",4,6,-2
31011.0,2019-11-22,"(527.75, 737.5]",2,2,0
31011.0,2019-11-22,"(737.5, 947.25]",1,2,-1
31011.0,2019-11-22,"(947.25, 1157.0]",4,6,-2
31012.0,2019-11-22,"(156.173, 363.75]",1,2,-1
31012.0,2019-11-22,"(363.75, 570.5]",4,4,0
31013.0,2019-11-22,"(737.25, 956.5]",1,1,0
31013.0,2019-11-22,"(956.5, 1175.75]",2,4,-2
31013.0,2019-11-22,"(1175.75, 1395.0]",2,5,-3
31014.0,2019-11-22,"(38.67, 372.5]",1,1,0
31014.0,2019-11-22,"(372.5, 705.0]",16,20,-4
31014.0,2019-11-22,"(705.0, 1037.5]",5,13,-8
31014.0,2019-11-22,"(1037.5, 1370.0]",6,9,-3
31015.0,2019-11-22,"(307.909, 581.75]",13,14,-1
31015.0,2019-11-22,"(581.75, 854.5]",1,4,-3
31015.0,2019-11-22,"(854.5, 1127.25]",5,12,-7
31015.0,2019-11-22,"(1127.25, 1400.0]",3,5,-2
31016.0,2019-11-22,"(442.249, 630.75]",4,6,-2
31016.0,2019-11-22,"(630.75, 818.5]",3,3,0
31016.0,2019-11-22,"(1006.25, 1194.0]",4,7,-3
31017.0,2019-11-22,"(315.25, 619.5]",1,1,0
31017.0,2019-11-22,"(619.5, 923.75]",1,3,-2
31017.0,2019-11-22,"(923.75, 1228.0]",2,3,-1
31018.0,2019-11-22,"(389.284, 569.0]",1,8,-7
31018.0,2019-11-22,"(927.0, 1106.0]",2,2,0
31019.0,2019-11-22,"(402.135, 619.25]",1,2,-1
31019.0,2019-11-22,"(619.25, 835.5]",1,1,0
31019.0,2019-11-22,"(1051.75, 1268.0]",1,3,-2
31020.0,2019-11-22,"(400.316, 572.0]",3,5,-2
31020.0,2019-11-22,"(743.0, 914.0]",1,1,0
31020.0,2019-11-22,"(914.0, 1085.0]",1,3,-2
31021.0,2019-11-22,"(5.602, 356.5]",1,2,-1
31021.0,2019-11-22,"(356.5, 706.0]",2,6,-4
31021.0,2019-11-22,"(706.0, 1055.5]",1,7,-6
31021.0,2019-11-22,"(1055.5, 1405.0]",4,9,-5
31022.0,2019-11-22,"(472.108, 696.0]",3,6,-3
31022.0,2019-11-22,"(696.0, 919.0]",1,6,-5
31022.0,2019-11-22,"(919.0, 1142.0]",4,8,-4
31022.0,2019-11-22,"(1142.0, 1365.0]",1,3,-2
31023.0,2019-11-22,"(425.112, 648.0]",3,4,-1
31023.0,2019-11-22,"(1092.0, 1314.0]",2,1,1
31024.0,2019-11-22,"(353.124, 573.0]",4,9,-5
31024.0,2019-11-22,"(792.0, 1011.0]",3,1,2
31024.0,2019-11-22,"(1011.0, 1230.0]",4,6,-2
31025.0,2019-11-22,"(816.25, 963.0]",2,2,0
31026.0,2019-11-22,"(364.75, 631.5]",1,1,0
31026.0,2019-11-22,"(898.25, 1165.0]",2,3,-1
31027.0,2019-11-22,"(1009.5, 1151.0]",1,2,-1
31028.0,2019-11-22,"(431.4, 582.0]",2,3,-1
31029.0,2019-11-22,"(998.5, 1182.0]",3,5,-2
31030.0,2019-11-22,"(2.594, 355.5]",1,1,0
31030.0,2019-11-22,"(707.0, 1058.5]",2,7,-5
31030.0,2019-11-22,"(1058.5, 1410.0]",3,2,1
31031.0,2019-11-22,"(1026.75, 1355.0]",3,1,2
31032.0,2019-11-22,"(760.0, 906.0]",1,3,-2
31033.0,2019-11-22,"(296.25, 395.0]",1,1,0
31034.0,2019-11-22,"(491.085, 720.75]",3,5,-2
31034.0,2019-11-22,"(949.5, 1178.25]",2,2,0
31034.0,2019-11-22,"(1178.25, 1407.0]",2,3,-1
31035.0,2019-11-22,"(17.687, 347.25]",1,2,-1
31035.0,2019-11-22,"(675.5, 1003.75]",1,1,0
31035.0,2019-11-22,"(1003.75, 1332.0]",5,1,4
31036.0,2019-11-22,"(940.5, 1123.0]",8,7,1
31037.0,2019-11-22,"(357.131, 575.25]",16,27,-11
31037.0,2019-11-22,"(575.25, 792.5]",4,5,-1
31037.0,2019-11-22,"(792.5, 1009.75]",4,11,-7
31037.0,2019-11-22,"(1009.75, 1227.0]",5,20,-15
31038.0,2019-11-22,"(422.334, 589.5]",2,6,-4
31038.0,2019-11-22,"(922.5, 1089.0]",2,1,1
31039.0,2019-11-22,"(425.069, 658.75]",4,10,-6
31039.0,2019-11-22,"(891.5, 1124.25]",8,1,7
31039.0,2019-11-22,"(1124.25, 1357.0]",1,10,-9
31040.0,2019-11-22,"(454.255, 641.25]",3,3,0
31041.0,2019-11-22,"(518.5, 644.0]",2,2,0
31041.0,2019-11-22,"(644.0, 769.0]",2,2,0
31041.0,2019-11-22,"(894.0, 1019.0]",1,1,0
31042.0,2019-11-22,"(438.203, 638.25]",12,12,0
31042.0,2019-11-22,"(638.25, 837.5]",1,1,0
31042.0,2019-11-22,"(837.5, 1036.75]",3,12,-9
31043.0,2019-11-22,"(437.336, 604.0]",1,2,-1
31043.0,2019-11-22,"(936.0, 1102.0]",1,3,-2
31044.0,2019-11-22,"(476.16, 687.0]",3,7,-4
31044.0,2019-11-22,"(897.0, 1107.0]",4,6,-2
31044.0,2019-11-22,"(1107.0, 1317.0]",2,3,-1
31045.0,2019-11-22,"(501.401, 651.75]",1,4,-3
31045.0,2019-11-22,"(951.25, 1101.0]",4,1,3
31046.0,2019-11-22,"(504.498, 630.5]",1,1,0
31047.0,2019-11-22,"(352.007, 601.25]",7,15,-8
31047.0,2019-11-22,"(849.5, 1097.75]",7,1,6
31047.0,2019-11-22,"(1097.75, 1346.0]",3,11,-8
31048.0,2019-11-22,"(406.095, 633.25]",2,3,-1
31048.0,2019-11-22,"(633.25, 859.5]",1,2,-1
31048.0,2019-11-22,"(859.5, 1085.75]",1,4,-3
31048.0,2019-11-22,"(1085.75, 1312.0]",1,4,-3
31049.0,2019-11-22,"(424.209, 622.75]",1,2,-1
31049.0,2019-11-22,"(622.75, 820.5]",1,1,0
31049.0,2019-11-22,"(1018.25, 1216.0]",3,6,-3
31050.0,2019-11-22,"(398.319, 569.25]",1,3,-2
31050.0,2019-11-22,"(909.75, 1080.0]",2,1,1
31051.0,2019-11-22,"(554.0, 803.0]",1,3,-2
31051.0,2019-11-22,"(803.0, 1052.0]",1,1,0
31051.0,2019-11-22,"(1052.0, 1301.0]",3,2,1
31052.0,2019-11-22,"(519.303, 694.25]",4,5,-1
31052.0,2019-11-22,"(868.5, 1042.75]",1,3,-2
31052.0,2019-11-22,"(1042.75, 1217.0]",1,2,-1
31053.0,2019-11-22,"(15.5, 141.0]",1,1,0
31054.0,2019-11-22,"(995.25, 999.0]",1,1,0
31055.0,2019-11-22,"(691.5, 887.0]",1,1,0
31055.0,2019-11-22,"(887.0, 1082.5]",1,1,0
31055.0,2019-11-22,"(1082.5, 1278.0]",2,1,1
31056.0,2019-11-22,"(30.688, 360.0]",1,1,0
31056.0,2019-11-22,"(1016.0, 1344.0]",4,1,3
,,,,2.0,
,,,,2.0,
31059.0,2019-11-22,"(948.0, 1115.0]",1,1,0
31060.0,2019-11-22,"(1002.5, 1330.0]",1,1,0
31061.0,2019-11-22,"(908.83, 951.5]",1,1,0
31061.0,2019-11-22,"(1036.5, 1079.0]",1,2,-1
31062.0,2019-11-22,"(441.365, 600.75]",4,8,-4
31062.0,2019-11-22,"(918.25, 1077.0]",2,2,0
31063.0,2019-11-22,"(866.0, 1024.0]",1,1,0
31064.0,2019-11-22,"(299.282, 479.5]",3,5,-2
31064.0,2019-11-22,"(479.5, 659.0]",1,3,-2
31064.0,2019-11-22,"(838.5, 1018.0]",1,1,0
31065.0,2019-11-22,"(633.0, 755.5]",1,1,0
31065.0,2019-11-22,"(755.5, 878.0]",2,1,1
31066.0,2019-11-22,"(411.347, 575.25]",1,2,-1
31066.0,2019-11-22,"(738.5, 901.75]",1,2,-1
31066.0,2019-11-22,"(901.75, 1065.0]",1,1,0
31067.0,2019-11-22,"(425.282, 605.5]",3,5,-2
31067.0,2019-11-22,"(964.5, 1144.0]",4,1,3
31068.0,2019-11-22,"(729.5, 893.0]",1,1,0
31068.0,2019-11-22,"(1056.5, 1220.0]",1,2,-1
31069.0,2019-11-22,"(397.15, 610.5]",2,8,-6
31069.0,2019-11-22,"(823.0, 1035.5]",4,6,-2
31069.0,2019-11-22,"(1035.5, 1248.0]",6,7,-1
31070.0,2019-11-22,"(696.5, 855.0]",1,2,-1
31070.0,2019-11-22,"(1013.5, 1172.0]",3,1,2
31071.0,2019-11-22,"(149.926, 419.5]",1,3,-2
31071.0,2019-11-22,"(419.5, 688.0]",2,6,-4
31071.0,2019-11-22,"(688.0, 956.5]",1,1,0
31071.0,2019-11-22,"(956.5, 1225.0]",5,7,-2
,,,,1.0,
,,,,1.0,
31073.0,2019-11-22,"(491.433, 633.75]",2,3,-1
31073.0,2019-11-22,"(633.75, 775.5]",1,1,0
31073.0,2019-11-22,"(775.5, 917.25]",1,1,0
31073.0,2019-11-22,"(917.25, 1059.0]",1,1,0
31074.0,2019-11-22,"(903.0, 1113.5]",2,1,1
31074.0,2019-11-22,"(1113.5, 1324.0]",2,4,-2
31075.0,2019-11-22,"(962.5, 1114.0]",1,3,-2
31076.0,2019-11-22,"(983.5, 1145.0]",2,1,1
31077.0,2019-11-22,"(690.0, 896.0]",2,4,-2
31077.0,2019-11-22,"(896.0, 1102.0]",8,2,6
31077.0,2019-11-22,"(1102.0, 1308.0]",2,12,-10
31078.0,2019-11-22,"(479.409, 627.75]",8,8,0
31078.0,2019-11-22,"(923.25, 1071.0]",1,1,0
31079.0,2019-11-22,"(101.673, 434.75]",1,2,-1
31079.0,2019-11-22,"(434.75, 766.5]",1,8,-7
31079.0,2019-11-22,"(766.5, 1098.25]",7,8,-1
31079.0,2019-11-22,"(1098.25, 1430.0]",2,4,-2
31080.0,2019-11-22,"(664.5, 918.0]",2,8,-6
31080.0,2019-11-22,"(918.0, 1171.5]",7,2,5
31080.0,2019-11-22,"(1171.5, 1425.0]",1,14,-13
31081.0,2019-11-22,"(494.191, 697.25]",1,1,0
,,,,2.0,
31083.0,2019-11-22,"(408.375, 565.25]",1,4,-3
31083.0,2019-11-22,"(877.75, 1034.0]",1,1,0
31084.0,2019-11-22,"(212.92, 484.0]",2,3,-1
31084.0,2019-11-22,"(484.0, 754.0]",2,3,-1
31084.0,2019-11-22,"(1024.0, 1294.0]",2,3,-1
31085.0,2019-11-22,"(850.75, 989.0]",1,2,-1
,,,,2.0,
,,,,1.0,
,,,,1.0,
,,,,1.0,
31088.0,2019-11-22,"(744.0, 919.5]",1,1,0
31088.0,2019-11-22,"(919.5, 1095.0]",2,1,1
31089.0,2019-11-22,"(326.0, 650.0]",7,1,6
31089.0,2019-11-22,"(650.0, 974.0]",3,12,-9
31089.0,2019-11-22,"(974.0, 1298.0]",2,8,-6
31090.0,2019-11-22,"(889.25, 1042.0]",1,3,-2
31091.0,2019-11-22,"(980.25, 1172.0]",6,7,-1
31092.0,2019-11-22,"(917.5, 1167.75]",2,3,-1
31092.0,2019-11-22,"(1167.75, 1418.0]",1,3,-2
,,,,1.0,
,,,,4.0,
,,,,1.0,
,,,,1.0,
,,,,1.0,
,,,,1.0,
,,,,2.0,
31096.0,2019-11-22,"(834.0, 1112.0]",3,1,2
31097.0,2019-11-22,"(451.246, 640.5]",3,4,-1
31097.0,2019-11-22,"(640.5, 829.0]",1,1,0
31097.0,2019-11-22,"(1017.5, 1206.0]",1,5,-4
31098.0,2019-11-22,"(427.148, 641.0]",5,13,-8
31098.0,2019-11-22,"(854.0, 1067.0]",8,15,-7
31099.0,2019-11-22,"(892.0, 1058.0]",1,1,0
31099.0,2019-11-22,"(1058.0, 1224.0]",1,1,0
31100.0,2019-11-22,"(437.001, 687.75]",16,17,-1
31100.0,2019-11-22,"(687.75, 937.5]",1,5,-4
31100.0,2019-11-22,"(937.5, 1187.25]",2,16,-14
31100.0,2019-11-22,"(1187.25, 1437.0]",4,6,-2
31101.0,2019-11-22,"(378.25, 731.5]",12,4,8
31101.0,2019-11-22,"(731.5, 1084.75]",32,46,-14
31101.0,2019-11-22,"(1084.75, 1438.0]",38,49,-11
31102.0,2019-11-22,"(46.621, 392.75]",1,1,0
31102.0,2019-11-22,"(392.75, 737.5]",3,27,-24
31102.0,2019-11-22,"(737.5, 1082.25]",8,17,-9
31102.0,2019-11-22,"(1082.25, 1427.0]",9,14,-5
31103.0,2019-11-22,"(6.581, 362.75]",3,4,-1
31103.0,2019-11-22,"(717.5, 1072.25]",4,31,-27
31103.0,2019-11-22,"(1072.25, 1427.0]",8,23,-15
31104.0,2019-11-22,"(73.64, 415.0]",1,4,-3
31104.0,2019-11-22,"(415.0, 755.0]",1,2,-1
31104.0,2019-11-22,"(755.0, 1095.0]",21,29,-8
31104.0,2019-11-22,"(1095.0, 1435.0]",21,45,-24
31105.0,2019-11-22,"(354.961, 615.75]",2,17,-15
31105.0,2019-11-22,"(875.5, 1135.25]",6,4,2
31105.0,2019-11-22,"(1135.25, 1395.0]",1,8,-7
31106.0,2019-11-22,"(968.75, 1152.0]",4,4,0
31107.0,2019-11-22,"(393.75, 732.5]",2,3,-1
31107.0,2019-11-22,"(732.5, 1071.25]",11,19,-8
31107.0,2019-11-22,"(1071.25, 1410.0]",22,18,4
31108.0,2019-11-22,"(279.843, 570.25]",7,31,-24
31108.0,2019-11-22,"(570.25, 859.5]",4,9,-5
31108.0,2019-11-22,"(859.5, 1148.75]",32,55,-23
31108.0,2019-11-22,"(1148.75, 1438.0]",18,26,-8
31109.0,2019-11-22,"(35.617, 382.75]",1,3,-2
31109.0,2019-11-22,"(382.75, 728.5]",9,29,-20
31109.0,2019-11-22,"(728.5, 1074.25]",16,20,-4
31109.0,2019-11-22,"(1074.25, 1420.0]",8,16,-8
31110.0,2019-11-22,"(76.647, 416.25]",7,9,-2
31110.0,2019-11-22,"(416.25, 754.5]",10,33,-23
31110.0,2019-11-22,"(754.5, 1092.75]",21,36,-15
31110.0,2019-11-22,"(1092.75, 1431.0]",16,35,-19
31111.0,2019-11-22,"(33.607, 383.25]",2,4,-2
31111.0,2019-11-22,"(383.25, 731.5]",5,22,-17
31111.0,2019-11-22,"(731.5, 1079.75]",12,22,-10
31111.0,2019-11-22,"(1079.75, 1428.0]",16,23,-7
31112.0,2019-11-22,"(395.209, 593.75]",1,7,-6
31112.0,2019-11-22,"(791.5, 989.25]",1,1,0
31112.0,2019-11-22,"(989.25, 1187.0]",1,1,0
31113.0,2019-11-22,"(359.5, 713.0]",2,4,-2
31113.0,2019-11-22,"(713.0, 1066.5]",8,9,-1
31113.0,2019-11-22,"(1066.5, 1420.0]",10,14,-4
31114.0,2019-11-22,"(5.684, 336.0]",3,6,-3
31114.0,2019-11-22,"(336.0, 665.0]",2,31,-29
31114.0,2019-11-22,"(665.0, 994.0]",8,18,-10
31114.0,2019-11-22,"(994.0, 1323.0]",29,42,-13
31115.0,2019-11-22,"(348.911, 622.25]",1,21,-20
31115.0,2019-11-22,"(622.25, 894.5]",1,5,-4
31115.0,2019-11-22,"(894.5, 1166.75]",10,16,-6
31115.0,2019-11-22,"(1166.75, 1439.0]",5,10,-5
31116.0,2019-11-22,"(36.641, 377.75]",3,6,-3
31116.0,2019-11-22,"(377.75, 717.5]",3,23,-20
31116.0,2019-11-22,"(717.5, 1057.25]",13,20,-7
31116.0,2019-11-22,"(1057.25, 1397.0]",17,25,-8
31117.0,2019-11-22,"(335.966, 595.5]",1,17,-16
31117.0,2019-11-22,"(595.5, 854.0]",2,5,-3
31117.0,2019-11-22,"(854.0, 1112.5]",3,15,-12
31117.0,2019-11-22,"(1112.5, 1371.0]",7,14,-7
31118.0,2019-11-22,"(375.943, 641.25]",4,18,-14
31118.0,2019-11-22,"(905.5, 1169.75]",15,1,14
31118.0,2019-11-22,"(1169.75, 1434.0]",5,18,-13
31119.0,2019-11-22,"(3.602, 354.5]",4,7,-3
31119.0,2019-11-22,"(354.5, 704.0]",5,16,-11
31119.0,2019-11-22,"(704.0, 1053.5]",14,21,-7
31119.0,2019-11-22,"(1053.5, 1403.0]",15,29,-14
31120.0,2019-11-22,"(216.784, 522.0]",3,13,-10
31120.0,2019-11-22,"(522.0, 826.0]",2,5,-3
31120.0,2019-11-22,"(826.0, 1130.0]",9,18,-9
31120.0,2019-11-22,"(1130.0, 1434.0]",7,11,-4
31121.0,2019-11-22,"(34.682, 365.5]",2,3,-1
31121.0,2019-11-22,"(365.5, 695.0]",9,22,-13
31121.0,2019-11-22,"(695.0, 1024.5]",3,11,-8
31121.0,2019-11-22,"(1024.5, 1354.0]",11,16,-5
31122.0,2019-11-22,"(-0.433, 359.25]",1,2,-1
31122.0,2019-11-22,"(359.25, 717.5]",1,4,-3
31122.0,2019-11-22,"(717.5, 1075.75]",4,8,-4
31122.0,2019-11-22,"(1075.75, 1434.0]",11,17,-6
31123.0,2019-11-22,"(875.0, 1148.0]",4,6,-2
31123.0,2019-11-22,"(1148.0, 1421.0]",6,7,-1
31124.0,2019-11-22,"(44.611, 393.25]",2,4,-2
31124.0,2019-11-22,"(393.25, 740.5]",9,40,-31
31124.0,2019-11-22,"(740.5, 1087.75]",14,50,-36
31124.0,2019-11-22,"(1087.75, 1435.0]",15,51,-36
31125.0,2019-11-22,"(348.046, 587.5]",7,32,-25
31125.0,2019-11-22,"(587.5, 826.0]",2,3,-1
31125.0,2019-11-22,"(826.0, 1064.5]",17,24,-7
31125.0,2019-11-22,"(1064.5, 1303.0]",20,25,-5
31126.0,2019-11-22,"(324.022, 569.5]",3,25,-22
31126.0,2019-11-22,"(814.0, 1058.5]",15,21,-6
31126.0,2019-11-22,"(1058.5, 1303.0]",18,26,-8
31127.0,2019-11-22,"(447.017, 693.75]",12,17,-5
31127.0,2019-11-22,"(693.75, 939.5]",4,10,-6
31127.0,2019-11-22,"(939.5, 1185.25]",11,26,-15
31127.0,2019-11-22,"(1185.25, 1431.0]",3,6,-3
31128.0,2019-11-22,"(-0.432, 359.0]",3,4,-1
31128.0,2019-11-22,"(359.0, 717.0]",26,39,-13
31128.0,2019-11-22,"(717.0, 1075.0]",11,23,-12
31128.0,2019-11-22,"(1075.0, 1433.0]",12,19,-7
31129.0,2019-11-22,"(490.057, 726.75]",10,11,-1
31129.0,2019-11-22,"(726.75, 962.5]",4,7,-3
31129.0,2019-11-22,"(962.5, 1198.25]",2,6,-4
31129.0,2019-11-22,"(1198.25, 1434.0]",2,6,-4
31130.0,2019-11-22,"(387.042, 627.5]",3,13,-10
31130.0,2019-11-22,"(627.5, 867.0]",3,6,-3
31130.0,2019-11-22,"(867.0, 1106.5]",8,13,-5
31130.0,2019-11-22,"(1106.5, 1346.0]",9,14,-5
31131.0,2019-11-22,"(382.953, 645.75]",1,6,-5
31131.0,2019-11-22,"(645.75, 907.5]",1,2,-1
31131.0,2019-11-22,"(907.5, 1169.25]",3,6,-3
31131.0,2019-11-22,"(1169.25, 1431.0]",5,6,-1
31200.0,2019-11-22,"(15.6, 367.0]",2,6,-4
31200.0,2019-11-22,"(367.0, 717.0]",30,47,-17
31200.0,2019-11-22,"(717.0, 1067.0]",23,44,-21
31200.0,2019-11-22,"(1067.0, 1417.0]",16,40,-24
31201.0,2019-11-22,"(97.723, 418.25]",3,5,-2
31201.0,2019-11-22,"(418.25, 737.5]",12,27,-15
31201.0,2019-11-22,"(737.5, 1056.75]",38,62,-24
31201.0,2019-11-22,"(1056.75, 1376.0]",34,62,-28
31202.0,2019-11-22,"(-0.431, 358.75]",2,4,-2
31202.0,2019-11-22,"(358.75, 716.5]",10,29,-19
31202.0,2019-11-22,"(716.5, 1074.25]",30,51,-21
31202.0,2019-11-22,"(1074.25, 1432.0]",20,31,-11
31203.0,2019-11-22,"(335.902, 611.5]",10,37,-27
31203.0,2019-11-22,"(611.5, 886.0]",5,13,-8
31203.0,2019-11-22,"(886.0, 1160.5]",28,43,-15
31203.0,2019-11-22,"(1160.5, 1435.0]",23,37,-14
31204.0,2019-11-22,"(116.687, 446.25]",1,4,-3
31204.0,2019-11-22,"(446.25, 774.5]",11,12,-1
31204.0,2019-11-22,"(774.5, 1102.75]",7,27,-20
31204.0,2019-11-22,"(1102.75, 1431.0]",2,4,-2
31205.0,2019-11-22,"(404.75, 734.5]",15,1,14
31205.0,2019-11-22,"(734.5, 1064.25]",17,22,-5
31205.0,2019-11-22,"(1064.25, 1394.0]",6,43,-37
31206.0,2019-11-22,"(446.412, 594.0]",6,7,-1
31206.0,2019-11-22,"(594.0, 741.0]",1,1,0
31206.0,2019-11-22,"(741.0, 888.0]",1,2,-1
31206.0,2019-11-22,"(888.0, 1035.0]",2,10,-8
31207.0,2019-11-22,"(463.063, 698.25]",1,8,-7
31207.0,2019-11-22,"(1166.75, 1401.0]",4,6,-2
31208.0,2019-11-22,"(319.186, 523.5]",10,11,-1
31208.0,2019-11-22,"(523.5, 727.0]",2,3,-1
31208.0,2019-11-22,"(727.0, 930.5]",3,8,-5
31208.0,2019-11-22,"(930.5, 1134.0]",4,10,-6
31209.0,2019-11-22,"(409.994, 662.5]",2,3,-1
31209.0,2019-11-22,"(662.5, 914.0]",4,5,-1
31209.0,2019-11-22,"(914.0, 1165.5]",4,10,-6
31209.0,2019-11-22,"(1165.5, 1417.0]",4,6,-2
31211.0,2019-11-22,"(395.016, 642.0]",12,14,-2
31211.0,2019-11-22,"(642.0, 888.0]",2,2,0
31211.0,2019-11-22,"(888.0, 1134.0]",6,12,-6
31212.0,2019-11-22,"(317.936, 585.0]",27,42,-15
31212.0,2019-11-22,"(585.0, 851.0]",6,7,-1
31212.0,2019-11-22,"(851.0, 1117.0]",14,29,-15
31212.0,2019-11-22,"(1117.0, 1383.0]",7,11,-4
31213.0,2019-11-22,"(126.741, 442.75]",1,4,-3
31213.0,2019-11-22,"(442.75, 757.5]",32,52,-20
31213.0,2019-11-22,"(757.5, 1072.25]",17,26,-9
31213.0,2019-11-22,"(1072.25, 1387.0]",5,14,-9
31214.0,2019-11-22,"(9.6, 361.0]",3,4,-1
31214.0,2019-11-22,"(361.0, 711.0]",8,34,-26
31214.0,2019-11-22,"(711.0, 1061.0]",24,39,-15
31214.0,2019-11-22,"(1061.0, 1411.0]",29,43,-14
31215.0,2019-11-22,"(427.0, 678.0]",18,18,0
31215.0,2019-11-22,"(678.0, 928.0]",6,13,-7
31215.0,2019-11-22,"(928.0, 1178.0]",3,14,-11
31216.0,2019-11-22,"(411.02, 657.0]",26,28,-2
31216.0,2019-11-22,"(657.0, 902.0]",3,7,-4
31216.0,2019-11-22,"(902.0, 1147.0]",7,27,-20
31216.0,2019-11-22,"(1147.0, 1392.0]",1,6,-5
31217.0,2019-11-22,"(370.247, 559.25]",5,7,-2
31217.0,2019-11-22,"(559.25, 747.5]",1,2,-1
31217.0,2019-11-22,"(747.5, 935.75]",1,2,-1
31217.0,2019-11-22,"(935.75, 1124.0]",1,7,-6
31218.0,2019-11-22,"(391.282, 571.5]",12,22,-10
31218.0,2019-11-22,"(571.5, 751.0]",2,3,-1
31218.0,2019-11-22,"(751.0, 930.5]",1,2,-1
31218.0,2019-11-22,"(930.5, 1110.0]",3,5,-2
31219.0,2019-11-22,"(436.253, 623.75]",12,13,-1
31219.0,2019-11-22,"(623.75, 810.5]",3,5,-2
31219.0,2019-11-22,"(810.5, 997.25]",5,14,-9
31219.0,2019-11-22,"(997.25, 1184.0]",4,6,-2
31220.0,2019-11-22,"(282.015, 529.25]",15,15,0
31220.0,2019-11-22,"(529.25, 775.5]",1,3,-2
31220.0,2019-11-22,"(775.5, 1021.75]",2,14,-12
31220.0,2019-11-22,"(1021.75, 1268.0]",1,5,-4
31221.0,2019-11-22,"(379.75, 670.5]",36,1,35
31221.0,2019-11-22,"(670.5, 961.25]",1,40,-39
31221.0,2019-11-22,"(961.25, 1252.0]",12,6,6
31222.0,2019-11-22,"(467.079, 698.25]",12,12,0
31222.0,2019-11-22,"(698.25, 928.5]",1,3,-2
31222.0,2019-11-22,"(928.5, 1158.75]",5,20,-15
31222.0,2019-11-22,"(1158.75, 1389.0]",5,7,-2
31223.0,2019-11-22,"(37.673, 370.75]",2,4,-2
31223.0,2019-11-22,"(370.75, 702.5]",18,39,-21
31223.0,2019-11-22,"(702.5, 1034.25]",11,24,-13
31223.0,2019-11-22,"(1034.25, 1366.0]",17,32,-15
31224.0,2019-11-22,"(273.994, 526.5]",9,11,-2
31224.0,2019-11-22,"(526.5, 778.0]",9,10,-1
31224.0,2019-11-22,"(778.0, 1029.5]",6,16,-10
31224.0,2019-11-22,"(1029.5, 1281.0]",5,16,-11
31225.0,2019-11-22,"(427.061, 662.75]",11,14,-3
31225.0,2019-11-22,"(662.75, 897.5]",2,3,-1
31225.0,2019-11-22,"(897.5, 1132.25]",7,14,-7
31225.0,2019-11-22,"(1132.25, 1367.0]",3,4,-1
31226.0,2019-11-22,"(324.951, 588.25]",5,9,-4
31226.0,2019-11-22,"(850.5, 1112.75]",10,1,9
31226.0,2019-11-22,"(1112.75, 1375.0]",3,19,-16
31227.0,2019-11-22,"(414.998, 666.5]",48,52,-4
31227.0,2019-11-22,"(666.5, 917.0]",7,10,-3
31227.0,2019-11-22,"(917.0, 1167.5]",3,21,-18
31227.0,2019-11-22,"(1167.5, 1418.0]",2,3,-1
31228.0,2019-11-22,"(35.604, 386.0]",3,4,-1
31228.0,2019-11-22,"(386.0, 735.0]",19,26,-7
31228.0,2019-11-22,"(735.0, 1084.0]",27,49,-22
31228.0,2019-11-22,"(1084.0, 1433.0]",25,40,-15
31229.0,2019-11-22,"(42.613, 390.75]",1,7,-6
31229.0,2019-11-22,"(390.75, 737.5]",16,40,-24
31229.0,2019-11-22,"(737.5, 1084.25]",39,57,-18
31229.0,2019-11-22,"(1084.25, 1431.0]",26,50,-24
31230.0,2019-11-22,"(405.019, 651.25]",48,58,-10
31230.0,2019-11-22,"(651.25, 896.5]",5,14,-9
31230.0,2019-11-22,"(896.5, 1141.75]",18,54,-36
31230.0,2019-11-22,"(1141.75, 1387.0]",4,10,-6
31231.0,2019-11-22,"(403.988, 658.0]",17,21,-4
31231.0,2019-11-22,"(658.0, 911.0]",4,8,-4
31231.0,2019-11-22,"(911.0, 1164.0]",5,15,-10
31231.0,2019-11-22,"(1164.0, 1417.0]",1,3,-2
31232.0,2019-11-22,"(294.866, 579.5]",13,16,-3
31232.0,2019-11-22,"(579.5, 863.0]",7,8,-1
31232.0,2019-11-22,"(863.0, 1146.5]",23,39,-16
31232.0,2019-11-22,"(1146.5, 1430.0]",7,25,-18
31233.0,2019-11-22,"(7.689, 336.75]",1,2,-1
31233.0,2019-11-22,"(336.75, 664.5]",35,43,-8
31233.0,2019-11-22,"(664.5, 992.25]",9,16,-7
31233.0,2019-11-22,"(992.25, 1320.0]",11,26,-15
31234.0,2019-11-22,"(310.873, 593.75]",10,26,-16
31234.0,2019-11-22,"(593.75, 875.5]",8,13,-5
31234.0,2019-11-22,"(875.5, 1157.25]",21,37,-16
31234.0,2019-11-22,"(1157.25, 1439.0]",4,11,-7
31235.0,2019-11-22,"(432.333, 599.75]",5,6,-1
31235.0,2019-11-22,"(599.75, 766.5]",3,3,0
31235.0,2019-11-22,"(933.25, 1100.0]",2,7,-5
31236.0,2019-11-22,"(36.705, 361.75]",1,2,-1
31236.0,2019-11-22,"(361.75, 685.5]",14,19,-5
31236.0,2019-11-22,"(685.5, 1009.25]",9,19,-10
31236.0,2019-11-22,"(1009.25, 1333.0]",7,21,-14
31237.0,2019-11-22,"(12.615, 360.25]",2,3,-1
31237.0,2019-11-22,"(360.25, 706.5]",4,12,-8
31237.0,2019-11-22,"(706.5, 1052.75]",13,22,-9
31237.0,2019-11-22,"(1052.75, 1399.0]",13,25,-12
31238.0,2019-11-22,"(48.654, 386.5]",1,1,0
31238.0,2019-11-22,"(386.5, 723.0]",18,22,-4
31238.0,2019-11-22,"(723.0, 1059.5]",10,24,-14
31238.0,2019-11-22,"(1059.5, 1396.0]",3,13,-10
31239.0,2019-11-22,"(376.186, 580.5]",26,31,-5
31239.0,2019-11-22,"(580.5, 784.0]",3,7,-4
31239.0,2019-11-22,"(784.0, 987.5]",13,27,-14
31239.0,2019-11-22,"(987.5, 1191.0]",6,26,-20
31240.0,2019-11-22,"(846.712, 919.0]",1,2,-1
31240.0,2019-11-22,"(1063.0, 1135.0]",2,4,-2
31241.0,2019-11-22,"(13.599, 365.25]",3,7,-4
31241.0,2019-11-22,"(365.25, 715.5]",24,51,-27
31241.0,2019-11-22,"(715.5, 1065.75]",13,28,-15
31241.0,2019-11-22,"(1065.75, 1416.0]",13,34,-21
31242.0,2019-11-22,"(302.917, 574.75]",28,30,-2
31242.0,2019-11-22,"(574.75, 845.5]",7,14,-7
31242.0,2019-11-22,"(845.5, 1116.25]",5,30,-25
31242.0,2019-11-22,"(1116.25, 1387.0]",1,4,-3
31243.0,2019-11-22,"(375.962, 636.5]",21,25,-4
31243.0,2019-11-22,"(636.5, 896.0]",2,2,0
31243.0,2019-11-22,"(896.0, 1155.5]",5,21,-16
31243.0,2019-11-22,"(1155.5, 1415.0]",3,5,-2
31244.0,2019-11-22,"(185.825, 480.75]",6,10,-4
31244.0,2019-11-22,"(480.75, 774.5]",7,13,-6
31244.0,2019-11-22,"(774.5, 1068.25]",5,19,-14
31244.0,2019-11-22,"(1068.25, 1362.0]",6,16,-10
31245.0,2019-11-22,"(382.971, 641.25]",11,23,-12
31245.0,2019-11-22,"(641.25, 898.5]",4,7,-3
31245.0,2019-11-22,"(898.5, 1155.75]",17,26,-9
31245.0,2019-11-22,"(1155.75, 1413.0]",5,17,-12
31246.0,2019-11-22,"(390.5, 705.0]",16,1,15
31246.0,2019-11-22,"(705.0, 1019.5]",6,23,-17
31246.0,2019-11-22,"(1019.5, 1334.0]",22,17,5
31247.0,2019-11-22,"(425.075, 657.25]",12,22,-10
31247.0,2019-11-22,"(657.25, 888.5]",2,5,-3
31247.0,2019-11-22,"(888.5, 1119.75]",9,21,-12
31247.0,2019-11-22,"(1119.75, 1351.0]",13,14,-1
31248.0,2019-11-22,"(388.953, 651.75]",9,16,-7
31248.0,2019-11-22,"(651.75, 913.5]",2,2,0
31248.0,2019-11-22,"(913.5, 1175.25]",20,36,-16
31248.0,2019-11-22,"(1175.25, 1437.0]",1,8,-7
31249.0,2019-11-22,"(450.165, 659.75]",6,10,-4
31249.0,2019-11-22,"(659.75, 868.5]",2,6,-4
31249.0,2019-11-22,"(868.5, 1077.25]",9,14,-5
31249.0,2019-11-22,"(1077.25, 1286.0]",2,3,-1
31250.0,2019-11-22,"(410.07, 643.5]",17,22,-5
31250.0,2019-11-22,"(643.5, 876.0]",5,9,-4
31250.0,2019-11-22,"(876.0, 1108.5]",4,14,-10
31250.0,2019-11-22,"(1108.5, 1341.0]",2,8,-6
31251.0,2019-11-22,"(22.895, 300.25]",2,3,-1
31251.0,2019-11-22,"(300.25, 576.5]",7,16,-9
31251.0,2019-11-22,"(576.5, 852.75]",5,8,-3
31251.0,2019-11-22,"(852.75, 1129.0]",16,31,-15
31252.0,2019-11-22,"(410.118, 631.5]",19,20,-1
31252.0,2019-11-22,"(631.5, 852.0]",6,8,-2
31252.0,2019-11-22,"(852.0, 1072.5]",2,11,-9
31252.0,2019-11-22,"(1072.5, 1293.0]",3,13,-10
31253.0,2019-11-22,"(394.235, 586.25]",17,19,-2
31253.0,2019-11-22,"(586.25, 777.5]",2,4,-2
31253.0,2019-11-22,"(777.5, 968.75]",2,5,-3
31253.0,2019-11-22,"(968.75, 1160.0]",1,20,-19
31254.0,2019-11-22,"(436.006, 685.5]",28,33,-5
31254.0,2019-11-22,"(685.5, 934.0]",3,8,-5
31254.0,2019-11-22,"(934.0, 1182.5]",7,25,-18
31254.0,2019-11-22,"(1182.5, 1431.0]",1,7,-6
31255.0,2019-11-22,"(78.772, 387.0]",1,2,-1
31255.0,2019-11-22,"(387.0, 694.0]",20,28,-8
31255.0,2019-11-22,"(694.0, 1001.0]",6,12,-6
31255.0,2019-11-22,"(1001.0, 1308.0]",6,19,-13
31256.0,2019-11-22,"(283.968, 543.0]",9,10,-1
31256.0,2019-11-22,"(543.0, 801.0]",5,7,-2
31256.0,2019-11-22,"(801.0, 1059.0]",9,18,-9
31256.0,2019-11-22,"(1059.0, 1317.0]",14,31,-17
31257.0,2019-11-22,"(333.023, 578.25]",18,28,-10
31257.0,2019-11-22,"(578.25, 822.5]",3,3,0
31257.0,2019-11-22,"(822.5, 1066.75]",16,32,-16
31257.0,2019-11-22,"(1066.75, 1311.0]",10,29,-19
31258.0,2019-11-22,"(391.069, 624.75]",6,10,-4
31258.0,2019-11-22,"(624.75, 857.5]",3,9,-6
31258.0,2019-11-22,"(857.5, 1090.25]",6,15,-9
31258.0,2019-11-22,"(1090.25, 1323.0]",6,20,-14
31259.0,2019-11-22,"(136.012, 384.0]",1,1,0
31259.0,2019-11-22,"(384.0, 631.0]",17,17,0
31259.0,2019-11-22,"(878.0, 1125.0]",3,1,2
31260.0,2019-11-22,"(388.05, 626.5]",10,12,-2
31260.0,2019-11-22,"(626.5, 864.0]",1,4,-3
31260.0,2019-11-22,"(864.0, 1101.5]",4,14,-10
31260.0,2019-11-22,"(1101.5, 1339.0]",3,4,-1
31261.0,2019-11-22,"(62.022, 307.5]",1,1,0
31261.0,2019-11-22,"(307.5, 552.0]",10,10,0
31262.0,2019-11-22,"(417.089, 645.75]",10,10,0
31262.0,2019-11-22,"(645.75, 873.5]",1,2,-1
31262.0,2019-11-22,"(873.5, 1101.25]",4,12,-8
31263.0,2019-11-22,"(368.938, 635.5]",32,46,-14
31263.0,2019-11-22,"(635.5, 901.0]",5,10,-5
31263.0,2019-11-22,"(901.0, 1166.5]",16,36,-20
31263.0,2019-11-22,"(1166.5, 1432.0]",8,13,-5
31264.0,2019-11-22,"(387.999, 639.25]",13,18,-5
31264.0,2019-11-22,"(639.25, 889.5]",3,5,-2
31264.0,2019-11-22,"(889.5, 1139.75]",9,23,-14
31264.0,2019-11-22,"(1139.75, 1390.0]",3,5,-2
31265.0,2019-11-22,"(39.613, 387.75]",3,6,-3
31265.0,2019-11-22,"(387.75, 734.5]",13,36,-23
31265.0,2019-11-22,"(734.5, 1081.25]",15,32,-17
31265.0,2019-11-22,"(1081.25, 1428.0]",26,42,-16
31266.0,2019-11-22,"(77.7, 404.0]",1,7,-6
31266.0,2019-11-22,"(404.0, 729.0]",10,32,-22
31266.0,2019-11-22,"(729.0, 1054.0]",16,29,-13
31266.0,2019-11-22,"(1054.0, 1379.0]",23,40,-17
31267.0,2019-11-22,"(16.599, 368.25]",1,2,-1
31267.0,2019-11-22,"(368.25, 718.5]",30,53,-23
31267.0,2019-11-22,"(718.5, 1068.75]",9,26,-17
31267.0,2019-11-22,"(1068.75, 1419.0]",11,23,-12
31268.0,2019-11-22,"(26.593, 379.75]",3,4,-1
31268.0,2019-11-22,"(379.75, 731.5]",16,49,-33
31268.0,2019-11-22,"(731.5, 1083.25]",22,36,-14
31268.0,2019-11-22,"(1083.25, 1435.0]",17,30,-13
31269.0,2019-11-22,"(427.209, 625.75]",8,11,-3
31269.0,2019-11-22,"(823.5, 1021.25]",6,13,-7
31269.0,2019-11-22,"(1021.25, 1219.0]",5,15,-10
31270.0,2019-11-22,"(362.999, 614.25]",15,18,-3
31270.0,2019-11-22,"(614.25, 864.5]",1,2,-1
31270.0,2019-11-22,"(864.5, 1114.75]",8,23,-15
31270.0,2019-11-22,"(1114.75, 1365.0]",5,8,-3
31271.0,2019-11-22,"(405.188, 609.0]",16,17,-1
31271.0,2019-11-22,"(812.0, 1015.0]",1,1,0
31271.0,2019-11-22,"(1015.0, 1218.0]",4,3,1
31272.0,2019-11-22,"(312.985, 567.75]",18,20,-2
31272.0,2019-11-22,"(567.75, 821.5]",5,6,-1
31272.0,2019-11-22,"(821.5, 1075.25]",7,27,-20
31272.0,2019-11-22,"(1075.25, 1329.0]",4,8,-4
31273.0,2019-11-22,"(465.346, 629.5]",1,3,-2
31273.0,2019-11-22,"(956.5, 1120.0]",4,2,2
31274.0,2019-11-22,"(350.5, 684.0]",22,1,21
31274.0,2019-11-22,"(684.0, 1017.5]",5,26,-21
31274.0,2019-11-22,"(1017.5, 1351.0]",4,7,-3
31275.0,2019-11-22,"(124.736, 442.0]",7,11,-4
31275.0,2019-11-22,"(442.0, 758.0]",18,36,-18
31275.0,2019-11-22,"(758.0, 1074.0]",12,28,-16
31275.0,2019-11-22,"(1074.0, 1390.0]",14,23,-9
31276.0,2019-11-22,"(427.221, 622.75]",23,23,0
31276.0,2019-11-22,"(622.75, 817.5]",4,9,-5
31276.0,2019-11-22,"(817.5, 1012.25]",2,9,-7
31276.0,2019-11-22,"(1012.25, 1207.0]",3,23,-20
31277.0,2019-11-22,"(295.922, 566.5]",31,35,-4
31277.0,2019-11-22,"(566.5, 836.0]",11,19,-8
31277.0,2019-11-22,"(836.0, 1105.5]",10,31,-21
31278.0,2019-11-22,"(5.658, 342.5]",2,3,-1
31278.0,2019-11-22,"(342.5, 678.0]",7,31,-24
31278.0,2019-11-22,"(678.0, 1013.5]",12,19,-7
31278.0,2019-11-22,"(1013.5, 1349.0]",16,33,-17
31279.0,2019-11-22,"(362.262, 547.5]",23,26,-3
31279.0,2019-11-22,"(547.5, 732.0]",4,6,-2
31279.0,2019-11-22,"(732.0, 916.5]",1,7,-6
31279.0,2019-11-22,"(916.5, 1101.0]",7,31,-24
31280.0,2019-11-22,"(73.691, 402.25]",2,5,-3
31280.0,2019-11-22,"(402.25, 729.5]",9,22,-13
31280.0,2019-11-22,"(729.5, 1056.75]",4,9,-5
31280.0,2019-11-22,"(1056.75, 1384.0]",10,22,-12
,,,,1.0,
,,,,1.0,
31001.0,2019-11-23,"(593.528, 712.0]",4,10,-6
31001.0,2019-11-23,"(712.0, 830.0]",1,3,-2
31001.0,2019-11-23,"(830.0, 948.0]",2,2,0
31001.0,2019-11-23,"(948.0, 1066.0]",1,2,-1
31002.0,2019-11-23,"(616.365, 775.75]",2,3,-1
31002.0,2019-11-23,"(934.5, 1093.25]",1,3,-2
31003.0,2019-11-23,"(589.673, 671.75]",1,4,-3
31003.0,2019-11-23,"(835.25, 917.0]",2,1,1
31004.0,2019-11-23,"(814.993, 816.75]",1,1,0
31005.0,2019-11-23,"(595.571, 703.25]",3,3,0
31005.0,2019-11-23,"(703.25, 810.5]",2,2,0
31005.0,2019-11-23,"(810.5, 917.75]",1,3,-2
31005.0,2019-11-23,"(917.75, 1025.0]",3,4,-1
31006.0,2019-11-23,"(516.321, 686.75]",2,3,-1
31006.0,2019-11-23,"(686.75, 856.5]",1,2,-1
31006.0,2019-11-23,"(856.5, 1026.25]",1,5,-4
31007.0,2019-11-23,"(564.534, 681.5]",1,3,-2
31007.0,2019-11-23,"(798.0, 914.5]",1,1,0
31007.0,2019-11-23,"(914.5, 1031.0]",1,1,0
31009.0,2019-11-23,"(481.5, 642.0]",1,1,0
31010.0,2019-11-23,"(672.796, 724.0]",1,2,-1
31010.0,2019-11-23,"(724.0, 775.0]",3,5,-2
31010.0,2019-11-23,"(775.0, 826.0]",1,3,-2
31010.0,2019-11-23,"(826.0, 877.0]",2,4,-2
31011.0,2019-11-23,"(417.582, 522.5]",2,2,0
31011.0,2019-11-23,"(731.5, 836.0]",1,1,0
31012.0,2019-11-23,"(452.25, 603.0]",1,1,0
31013.0,2019-11-23,"(518.456, 655.0]",1,2,-1
31013.0,2019-11-23,"(655.0, 791.0]",2,3,-1
31013.0,2019-11-23,"(791.0, 927.0]",1,2,-1
31014.0,2019-11-23,"(60.654, 398.5]",5,7,-2
31014.0,2019-11-23,"(398.5, 735.0]",3,8,-5
31014.0,2019-11-23,"(735.0, 1071.5]",6,8,-2
31014.0,2019-11-23,"(1071.5, 1408.0]",2,2,0
31015.0,2019-11-23,"(292.561, 402.75]",1,1,0
31015.0,2019-11-23,"(512.5, 622.25]",4,1,3
31016.0,2019-11-23,"(514.118, 735.5]",1,4,-3
31016.0,2019-11-23,"(956.0, 1176.5]",2,2,0
31016.0,2019-11-23,"(1176.5, 1397.0]",1,1,0
31017.0,2019-11-23,"(512.306, 686.5]",1,3,-2
31017.0,2019-11-23,"(1033.5, 1207.0]",1,1,0
31018.0,2019-11-23,"(711.75, 832.0]",1,1,0
31019.0,2019-11-23,"(605.75, 780.0]",1,1,0
31020.0,2019-11-23,"(463.212, 661.0]",1,1,0
31020.0,2019-11-23,"(858.0, 1055.0]",1,2,-1
31021.0,2019-11-23,"(478.306, 652.5]",1,1,0
31021.0,2019-11-23,"(652.5, 826.0]",3,4,-1
31022.0,2019-11-23,"(617.462, 752.5]",3,5,-2
31022.0,2019-11-23,"(752.5, 887.0]",3,4,-1
31022.0,2019-11-23,"(1021.5, 1156.0]",2,1,1
31023.0,2019-11-23,"(446.246, 635.5]",3,4,-1
31023.0,2019-11-23,"(635.5, 824.0]",1,2,-1
31023.0,2019-11-23,"(1012.5, 1201.0]",1,2,-1
,,,,1.0,
,,,,1.0,
,,,,2.0,
31025.0,2019-11-23,"(520.532, 638.0]",1,1,0
31025.0,2019-11-23,"(755.0, 872.0]",1,2,-1
31025.0,2019-11-23,"(872.0, 989.0]",1,2,-1
31026.0,2019-11-23,"(556.563, 666.25]",2,3,-1
31026.0,2019-11-23,"(775.5, 884.75]",1,1,0
31026.0,2019-11-23,"(884.75, 994.0]",5,1,4
,,,,1.0,
,,,,1.0,
31028.0,2019-11-23,"(854.0, 989.5]",1,1,0
31029.0,2019-11-23,"(469.343, 634.25]",1,3,-2
31029.0,2019-11-23,"(634.25, 798.5]",3,5,-2
31029.0,2019-11-23,"(798.5, 962.75]",1,3,-2
31029.0,2019-11-23,"(962.75, 1127.0]",1,2,-1
31030.0,2019-11-23,"(124.738, 441.5]",1,1,0
31030.0,2019-11-23,"(757.0, 1072.5]",3,2,1
,,,,1.0,
,,,,3.0,
31032.0,2019-11-23,"(634.5, 846.0]",1,1,0
31033.0,2019-11-23,"(527.669, 610.75]",1,1,0
31033.0,2019-11-23,"(610.75, 693.5]",1,2,-1
31033.0,2019-11-23,"(693.5, 776.25]",2,4,-2
31033.0,2019-11-23,"(776.25, 859.0]",3,7,-4
31034.0,2019-11-23,"(784.5, 861.25]",1,2,-1
31034.0,2019-11-23,"(861.25, 938.0]",1,2,-1
31035.0,2019-11-23,"(143.112, 366.0]",1,2,-1
31035.0,2019-11-23,"(366.0, 588.0]",1,1,0
31035.0,2019-11-23,"(588.0, 810.0]",3,3,0
31035.0,2019-11-23,"(810.0, 1032.0]",1,3,-2
31036.0,2019-11-23,"(494.522, 614.5]",1,3,-2
31036.0,2019-11-23,"(853.5, 973.0]",1,2,-1
31037.0,2019-11-23,"(139.851, 428.25]",1,2,-1
31037.0,2019-11-23,"(428.25, 715.5]",6,6,0
31037.0,2019-11-23,"(715.5, 1002.75]",1,4,-3
31037.0,2019-11-23,"(1002.75, 1290.0]",2,5,-3
,,,,2.0,
31039.0,2019-11-23,"(601.651, 689.25]",1,2,-1
31039.0,2019-11-23,"(689.25, 776.5]",2,6,-4
31039.0,2019-11-23,"(863.75, 951.0]",1,4,-3
31040.0,2019-11-23,"(100.5, 134.0]",1,1,0
31041.0,2019-11-23,"(659.813, 706.75]",3,3,0
31041.0,2019-11-23,"(800.25, 847.0]",1,2,-1
31042.0,2019-11-23,"(70.724, 391.0]",1,1,0
31042.0,2019-11-23,"(391.0, 710.0]",1,2,-1
31042.0,2019-11-23,"(710.0, 1029.0]",5,7,-2
31042.0,2019-11-23,"(1029.0, 1348.0]",2,3,-1
31043.0,2019-11-23,"(598.593, 700.75]",1,2,-1
31043.0,2019-11-23,"(802.5, 904.25]",1,2,-1
31043.0,2019-11-23,"(904.25, 1006.0]",2,3,-1
31044.0,2019-11-23,"(610.46, 746.0]",1,3,-2
31044.0,2019-11-23,"(746.0, 881.0]",6,7,-1
31044.0,2019-11-23,"(881.0, 1016.0]",1,3,-2
31044.0,2019-11-23,"(1016.0, 1151.0]",1,1,0
31045.0,2019-11-23,"(548.556, 660.0]",1,2,-1
,,,,2.0,
31047.0,2019-11-23,"(502.5, 722.25]",3,3,0
31047.0,2019-11-23,"(722.25, 942.0]",1,4,-3
31048.0,2019-11-23,"(460.163, 670.25]",2,2,0
31048.0,2019-11-23,"(1088.75, 1298.0]",1,1,0
31049.0,2019-11-23,"(639.0, 808.0]",2,2,0
31050.0,2019-11-23,"(243.0, 324.0]",1,1,0
31051.0,2019-11-23,"(621.0, 849.0]",3,3,0
31051.0,2019-11-23,"(1077.0, 1305.0]",1,5,-4
31052.0,2019-11-23,"(255.598, 356.5]",1,2,-1
31052.0,2019-11-23,"(557.5, 658.0]",1,2,-1
31053.0,2019-11-23,"(112.897, 138.75]",1,1,0
,,,,2.0,
31055.0,2019-11-23,"(618.692, 696.0]",1,1,0
,,,,2.0,
,,,,2.0,
,,,,2.0,
31059.0,2019-11-23,"(718.516, 840.0]",1,2,-1
31059.0,2019-11-23,"(1082.0, 1203.0]",1,1,0
31060.0,2019-11-23,"(747.549, 860.75]",3,6,-3
31060.0,2019-11-23,"(973.5, 1086.25]",1,1,0
31061.0,2019-11-23,"(515.896, 542.0]",1,1,0
31061.0,2019-11-23,"(594.0, 620.0]",1,2,-1
31062.0,2019-11-23,"(478.552, 591.0]",4,7,-3
31062.0,2019-11-23,"(591.0, 703.0]",3,7,-4
31062.0,2019-11-23,"(703.0, 815.0]",5,9,-4
31062.0,2019-11-23,"(815.0, 927.0]",4,11,-7
,,,,2.0,
31064.0,2019-11-23,"(687.706, 761.5]",2,4,-2
31064.0,2019-11-23,"(761.5, 835.0]",1,2,-1
31064.0,2019-11-23,"(835.0, 908.5]",2,4,-2
31064.0,2019-11-23,"(908.5, 982.0]",6,12,-6
31065.0,2019-11-23,"(103.442, 243.5]",2,4,-2
31066.0,2019-11-23,"(223.014, 470.5]",1,3,-2
31066.0,2019-11-23,"(470.5, 717.0]",2,5,-3
31066.0,2019-11-23,"(717.0, 963.5]",1,1,0
31066.0,2019-11-23,"(963.5, 1210.0]",1,1,0
31067.0,2019-11-23,"(540.316, 712.0]",3,5,-2
31067.0,2019-11-23,"(712.0, 883.0]",1,2,-1
31067.0,2019-11-23,"(1054.0, 1225.0]",1,2,-1
31068.0,2019-11-23,"(686.0, 708.0]",1,1,0
,,,,1.0,
,,,,2.0,
,,,,1.0,
31070.0,2019-11-23,"(596.365, 755.75]",2,6,-4
31070.0,2019-11-23,"(755.75, 914.5]",1,3,-2
31070.0,2019-11-23,"(1073.25, 1232.0]",1,2,-1
31071.0,2019-11-23,"(411.455, 548.25]",1,3,-2
31071.0,2019-11-23,"(548.25, 684.5]",2,5,-3
31071.0,2019-11-23,"(684.5, 820.75]",2,4,-2
31071.0,2019-11-23,"(820.75, 957.0]",8,11,-3
,,,,2.0,
31073.0,2019-11-23,"(952.0, 985.0]",2,1,1
31074.0,2019-11-23,"(533.25, 627.5]",2,1,1
31075.0,2019-11-23,"(226.253, 413.75]",2,5,-3
31075.0,2019-11-23,"(600.5, 787.25]",2,3,-1
31075.0,2019-11-23,"(787.25, 974.0]",2,4,-2
31076.0,2019-11-23,"(596.0, 638.0]",1,1,0
31077.0,2019-11-23,"(372.078, 603.5]",2,6,-4
31077.0,2019-11-23,"(603.5, 834.0]",11,18,-7
31078.0,2019-11-23,"(739.997, 740.75]",1,1,0
31079.0,2019-11-23,"(627.372, 785.0]",3,4,-1
31079.0,2019-11-23,"(785.0, 942.0]",1,1,0
31079.0,2019-11-23,"(942.0, 1099.0]",1,2,-1
31079.0,2019-11-23,"(1099.0, 1256.0]",1,1,0
31080.0,2019-11-23,"(90.201, 290.75]",1,1,0
31080.0,2019-11-23,"(690.25, 890.0]",6,2,4
31081.0,2019-11-23,"(230.25, 460.5]",1,1,0
31081.0,2019-11-23,"(690.75, 921.0]",1,1,0
31082.0,2019-11-23,"(857.5, 944.0]",2,1,1
,,,,1.0,
,,,,1.0,
31084.0,2019-11-23,"(795.5, 881.75]",1,1,0
31084.0,2019-11-23,"(881.75, 968.0]",1,1,0
,,,,2.0,
31086.0,2019-11-23,"(613.679, 694.25]",1,2,-1
31086.0,2019-11-23,"(854.75, 935.0]",1,2,-1
,,,,1.0,
,,,,1.0,
,,,,1.0,
,,,,2.0,
31089.0,2019-11-23,"(120.821, 416.75]",1,2,-1
31089.0,2019-11-23,"(711.5, 1006.25]",6,3,3
31089.0,2019-11-23,"(1006.25, 1301.0]",1,15,-14
31090.0,2019-11-23,"(692.932, 710.0]",1,1,0
31090.0,2019-11-23,"(744.0, 761.0]",1,1,0
31091.0,2019-11-23,"(120.357, 281.75]",1,1,0
31091.0,2019-11-23,"(442.5, 603.25]",1,1,0
31092.0,2019-11-23,"(903.0, 918.0]",2,1,1
31093.0,2019-11-23,"(988.5, 1114.0]",1,1,0
,,,,2.0,
,,,,2.0,
31096.0,2019-11-23,"(610.705, 684.75]",1,2,-1
31096.0,2019-11-23,"(832.25, 906.0]",1,1,0
31097.0,2019-11-23,"(763.0, 879.0]",2,1,1
31098.0,2019-11-23,"(496.5, 622.0]",1,2,-1
31098.0,2019-11-23,"(622.0, 747.0]",2,2,0
31098.0,2019-11-23,"(872.0, 997.0]",1,2,-1
31099.0,2019-11-23,"(846.0, 876.5]",1,1,0
31099.0,2019-11-23,"(876.5, 907.0]",1,1,0
31100.0,2019-11-23,"(331.75, 499.5]",1,1,0
31100.0,2019-11-23,"(499.5, 667.25]",2,2,0
31100.0,2019-11-23,"(667.25, 835.0]",2,2,0
31101.0,2019-11-23,"(50.614, 398.5]",3,8,-5
31101.0,2019-11-23,"(398.5, 745.0]",30,48,-18
31101.0,2019-11-23,"(745.0, 1091.5]",44,68,-24
31101.0,2019-11-23,"(1091.5, 1438.0]",10,14,-4
31102.0,2019-11-23,"(134.769, 443.75]",1,2,-1
31102.0,2019-11-23,"(443.75, 751.5]",5,20,-15
31102.0,2019-11-23,"(751.5, 1059.25]",4,11,-7
31102.0,2019-11-23,"(1059.25, 1367.0]",4,6,-2
31103.0,2019-11-23,"(327.25, 626.5]",3,4,-1
31103.0,2019-11-23,"(626.5, 925.75]",12,12,0
31103.0,2019-11-23,"(925.75, 1225.0]",2,39,-37
31104.0,2019-11-23,"(13.579, 370.25]",1,8,-7
31104.0,2019-11-23,"(370.25, 725.5]",8,20,-12
31104.0,2019-11-23,"(725.5, 1080.75]",19,35,-16
31104.0,2019-11-23,"(1080.75, 1436.0]",9,12,-3
31105.0,2019-11-23,"(638.75, 823.5]",1,3,-2
31105.0,2019-11-23,"(823.5, 1008.25]",6,5,1
31105.0,2019-11-23,"(1008.25, 1193.0]",2,13,-11
31106.0,2019-11-23,"(634.0, 935.5]",1,1,0
31107.0,2019-11-23,"(31.623, 377.25]",3,6,-3
31107.0,2019-11-23,"(377.25, 721.5]",11,33,-22
31107.0,2019-11-23,"(721.5, 1065.75]",7,19,-12
31107.0,2019-11-23,"(1065.75, 1410.0]",2,6,-4
31108.0,2019-11-23,"(17.638, 359.5]",2,3,-1
31108.0,2019-11-23,"(359.5, 700.0]",4,21,-17
31108.0,2019-11-23,"(700.0, 1040.5]",15,27,-12
31108.0,2019-11-23,"(1040.5, 1381.0]",3,7,-4
31109.0,2019-11-23,"(14.628, 359.0]",2,7,-5
31109.0,2019-11-23,"(359.0, 702.0]",9,22,-13
31109.0,2019-11-23,"(702.0, 1045.0]",14,23,-9
31109.0,2019-11-23,"(1045.0, 1388.0]",5,10,-5
31110.0,2019-11-23,"(21.605, 371.75]",3,5,-2
31110.0,2019-11-23,"(371.75, 720.5]",16,28,-12
31110.0,2019-11-23,"(720.5, 1069.25]",13,30,-17
31110.0,2019-11-23,"(1069.25, 1418.0]",6,12,-6
31111.0,2019-11-23,"(23.644, 364.0]",3,11,-8
31111.0,2019-11-23,"(364.0, 703.0]",6,9,-3
31111.0,2019-11-23,"(703.0, 1042.0]",9,13,-4
31111.0,2019-11-23,"(1042.0, 1381.0]",3,7,-4
31112.0,2019-11-23,"(79.124, 299.0]",1,1,0
31112.0,2019-11-23,"(299.0, 518.0]",1,1,0
31112.0,2019-11-23,"(518.0, 737.0]",4,5,-1
31112.0,2019-11-23,"(737.0, 956.0]",3,6,-3
31113.0,2019-11-23,"(40.972, 299.0]",1,2,-1
31113.0,2019-11-23,"(556.0, 813.0]",5,5,0
31113.0,2019-11-23,"(813.0, 1070.0]",6,19,-13
31114.0,2019-11-23,"(52.648, 392.0]",3,7,-4
31114.0,2019-11-23,"(392.0, 730.0]",8,23,-15
31114.0,2019-11-23,"(730.0, 1068.0]",8,24,-16
31114.0,2019-11-23,"(1068.0, 1406.0]",6,9,-3
31115.0,2019-11-23,"(17.66, 354.0]",2,3,-1
31115.0,2019-11-23,"(354.0, 689.0]",1,10,-9
31115.0,2019-11-23,"(689.0, 1024.0]",7,12,-5
31115.0,2019-11-23,"(1024.0, 1359.0]",3,7,-4
31116.0,2019-11-23,"(377.25, 707.5]",17,1,16
31116.0,2019-11-23,"(707.5, 1037.75]",14,34,-20
31116.0,2019-11-23,"(1037.75, 1368.0]",4,27,-23
31117.0,2019-11-23,"(28.605, 378.75]",2,3,-1
31117.0,2019-11-23,"(378.75, 727.5]",2,11,-9
31117.0,2019-11-23,"(727.5, 1076.25]",10,18,-8
31117.0,2019-11-23,"(1076.25, 1425.0]",2,6,-4
31118.0,2019-11-23,"(381.25, 676.5]",1,1,0
31118.0,2019-11-23,"(676.5, 971.75]",6,7,-1
31118.0,2019-11-23,"(971.75, 1267.0]",3,14,-11
31119.0,2019-11-23,"(128.814, 426.5]",2,3,-1
31119.0,2019-11-23,"(426.5, 723.0]",14,34,-20
31119.0,2019-11-23,"(723.0, 1019.5]",13,26,-13
31119.0,2019-11-23,"(1019.5, 1316.0]",4,11,-7
31120.0,2019-11-23,"(224.881, 505.75]",1,3,-2
31120.0,2019-11-23,"(505.75, 785.5]",3,14,-11
31120.0,2019-11-23,"(785.5, 1065.25]",3,7,-4
31120.0,2019-11-23,"(1065.25, 1345.0]",2,3,-1
31121.0,2019-11-23,"(24.807, 324.25]",2,4,-2
31121.0,2019-11-23,"(324.25, 622.5]",8,10,-2
31121.0,2019-11-23,"(622.5, 920.75]",4,16,-12
31121.0,2019-11-23,"(920.75, 1219.0]",8,13,-5
31122.0,2019-11-23,"(167.83, 461.5]",4,5,-1
31122.0,2019-11-23,"(461.5, 754.0]",3,7,-4
31122.0,2019-11-23,"(754.0, 1046.5]",6,17,-11
31122.0,2019-11-23,"(1046.5, 1339.0]",1,5,-4
31123.0,2019-11-23,"(51.849, 340.75]",4,5,-1
31123.0,2019-11-23,"(340.75, 628.5]",2,9,-7
31123.0,2019-11-23,"(628.5, 916.25]",2,4,-2
31123.0,2019-11-23,"(916.25, 1204.0]",1,3,-2
31124.0,2019-11-23,"(23.594, 376.5]",2,3,-1
31124.0,2019-11-23,"(376.5, 728.0]",23,48,-25
31124.0,2019-11-23,"(728.0, 1079.5]",18,49,-31
31124.0,2019-11-23,"(1079.5, 1431.0]",7,16,-9
31125.0,2019-11-23,"(11.597, 363.75]",2,3,-1
31125.0,2019-11-23,"(363.75, 714.5]",19,38,-19
31125.0,2019-11-23,"(714.5, 1065.25]",13,25,-12
31125.0,2019-11-23,"(1065.25, 1416.0]",8,13,-5
31126.0,2019-11-23,"(486.057, 722.75]",4,26,-22
31126.0,2019-11-23,"(722.75, 958.5]",8,23,-15
31126.0,2019-11-23,"(958.5, 1194.25]",4,9,-5
31126.0,2019-11-23,"(1194.25, 1430.0]",2,6,-4
31127.0,2019-11-23,"(208.799, 510.25]",1,1,0
31127.0,2019-11-23,"(510.25, 810.5]",3,7,-4
31127.0,2019-11-23,"(810.5, 1110.75]",8,9,-1
31127.0,2019-11-23,"(1110.75, 1411.0]",3,5,-2
31128.0,2019-11-23,"(360.75, 669.5]",6,2,4
31128.0,2019-11-23,"(669.5, 978.25]",15,11,4
31128.0,2019-11-23,"(978.25, 1287.0]",4,31,-27
31129.0,2019-11-23,"(603.454, 740.5]",10,17,-7
31129.0,2019-11-23,"(740.5, 877.0]",1,4,-3
31129.0,2019-11-23,"(877.0, 1013.5]",5,10,-5
31129.0,2019-11-23,"(1013.5, 1150.0]",1,3,-2
31130.0,2019-11-23,"(382.116, 604.0]",1,7,-6
31130.0,2019-11-23,"(604.0, 825.0]",3,11,-8
31130.0,2019-11-23,"(825.0, 1046.0]",3,3,0
31130.0,2019-11-23,"(1046.0, 1267.0]",3,4,-1
31131.0,2019-11-23,"(38.81, 337.5]",1,1,0
31131.0,2019-11-23,"(635.0, 932.5]",2,6,-4
31131.0,2019-11-23,"(932.5, 1230.0]",2,8,-6
31200.0,2019-11-23,"(12.669, 346.75]",3,8,-5
31200.0,2019-11-23,"(346.75, 679.5]",15,23,-8
31200.0,2019-11-23,"(679.5, 1012.25]",34,50,-16
31200.0,2019-11-23,"(1012.25, 1345.0]",7,11,-4
31201.0,2019-11-23,"(4.607, 354.25]",7,17,-10
31201.0,2019-11-23,"(354.25, 702.5]",29,48,-19
31201.0,2019-11-23,"(702.5, 1050.75]",38,73,-35
31201.0,2019-11-23,"(1050.75, 1399.0]",14,24,-10
31202.0,2019-11-23,"(82.668, 417.0]",2,6,-4
31202.0,2019-11-23,"(417.0, 750.0]",28,50,-22
31202.0,2019-11-23,"(750.0, 1083.0]",22,43,-21
31202.0,2019-11-23,"(1083.0, 1416.0]",4,8,-4
31203.0,2019-11-23,"(4.654, 342.5]",1,3,-2
31203.0,2019-11-23,"(342.5, 679.0]",6,23,-17
31203.0,2019-11-23,"(679.0, 1015.5]",26,47,-21
31203.0,2019-11-23,"(1015.5, 1352.0]",12,23,-11
31204.0,2019-11-23,"(5.639, 347.25]",1,3,-2
31204.0,2019-11-23,"(347.25, 687.5]",1,1,0
31204.0,2019-11-23,"(687.5, 1027.75]",4,8,-4
31204.0,2019-11-23,"(1027.75, 1368.0]",1,2,-1
31205.0,2019-11-23,"(418.183, 623.25]",4,5,-1
31205.0,2019-11-23,"(623.25, 827.5]",6,9,-3
31205.0,2019-11-23,"(827.5, 1031.75]",4,11,-7
31205.0,2019-11-23,"(1031.75, 1236.0]",2,4,-2
,,,,1.0,
,,,,1.0,
,,,,2.0,
31207.0,2019-11-23,"(571.211, 769.25]",1,7,-6
31207.0,2019-11-23,"(769.25, 966.5]",2,5,-3
31207.0,2019-11-23,"(1163.75, 1361.0]",1,2,-1
31208.0,2019-11-23,"(186.273, 368.75]",1,1,0
31208.0,2019-11-23,"(550.5, 732.25]",2,2,0
31208.0,2019-11-23,"(732.25, 914.0]",6,8,-2
31209.0,2019-11-23,"(361.75, 654.5]",2,2,0
31209.0,2019-11-23,"(654.5, 947.25]",2,3,-1
31209.0,2019-11-23,"(947.25, 1240.0]",5,4,1
31211.0,2019-11-23,"(336.5, 671.0]",1,2,-1
31211.0,2019-11-23,"(671.0, 1005.5]",7,1,6
31211.0,2019-11-23,"(1005.5, 1340.0]",3,10,-7
31212.0,2019-11-23,"(14.624, 360.0]",1,2,-1
31212.0,2019-11-23,"(360.0, 704.0]",6,15,-9
31212.0,2019-11-23,"(704.0, 1048.0]",10,19,-9
31212.0,2019-11-23,"(1048.0, 1392.0]",1,3,-2
31213.0,2019-11-23,"(180.995, 433.25]",1,1,0
31213.0,2019-11-23,"(433.25, 684.5]",9,13,-4
31213.0,2019-11-23,"(684.5, 935.75]",7,15,-8
31213.0,2019-11-23,"(935.75, 1187.0]",6,14,-8
31214.0,2019-11-23,"(100.708, 425.0]",1,2,-1
31214.0,2019-11-23,"(425.0, 748.0]",14,34,-20
31214.0,2019-11-23,"(748.0, 1071.0]",21,37,-16
31214.0,2019-11-23,"(1071.0, 1394.0]",4,11,-7
31215.0,2019-11-23,"(46.018, 292.5]",1,2,-1
31215.0,2019-11-23,"(292.5, 538.0]",1,1,0
31215.0,2019-11-23,"(538.0, 783.5]",7,9,-2
31215.0,2019-11-23,"(783.5, 1029.0]",9,12,-3
31216.0,2019-11-23,"(297.954, 560.5]",1,1,0
31216.0,2019-11-23,"(560.5, 822.0]",3,3,0
31216.0,2019-11-23,"(822.0, 1083.5]",1,3,-2
31217.0,2019-11-23,"(740.609, 838.75]",1,1,0
31217.0,2019-11-23,"(838.75, 936.5]",3,6,-3
31217.0,2019-11-23,"(1034.25, 1132.0]",1,1,0
31218.0,2019-11-23,"(645.5, 762.0]",2,2,0
31218.0,2019-11-23,"(878.5, 995.0]",2,2,0
31219.0,2019-11-23,"(388.309, 561.75]",1,2,-1
31219.0,2019-11-23,"(561.75, 734.5]",6,7,-1
31219.0,2019-11-23,"(734.5, 907.25]",5,7,-2
31219.0,2019-11-23,"(907.25, 1080.0]",1,13,-12
31220.0,2019-11-23,"(758.5, 770.0]",1,1,0
31221.0,2019-11-23,"(93.802, 394.5]",1,3,-2
31221.0,2019-11-23,"(394.5, 694.0]",6,6,0
31221.0,2019-11-23,"(694.0, 993.5]",7,10,-3
31221.0,2019-11-23,"(993.5, 1293.0]",4,7,-3
31222.0,2019-11-23,"(538.276, 720.0]",1,2,-1
31222.0,2019-11-23,"(720.0, 901.0]",4,10,-6
31222.0,2019-11-23,"(901.0, 1082.0]",3,5,-2
31223.0,2019-11-23,"(9.581, 365.75]",5,9,-4
31223.0,2019-11-23,"(365.75, 720.5]",9,13,-4
31223.0,2019-11-23,"(720.5, 1075.25]",13,26,-13
31223.0,2019-11-23,"(1075.25, 1430.0]",2,3,-1
31224.0,2019-11-23,"(560.634, 652.5]",2,2,0
31224.0,2019-11-23,"(652.5, 744.0]",1,2,-1
31224.0,2019-11-23,"(744.0, 835.5]",3,3,0
31224.0,2019-11-23,"(835.5, 927.0]",2,3,-1
31225.0,2019-11-23,"(216.917, 488.75]",1,2,-1
31225.0,2019-11-23,"(488.75, 759.5]",1,5,-4
31225.0,2019-11-23,"(759.5, 1030.25]",9,13,-4
31226.0,2019-11-23,"(70.697, 397.75]",1,1,0
31226.0,2019-11-23,"(397.75, 723.5]",1,7,-6
31226.0,2019-11-23,"(1049.25, 1375.0]",1,1,0
31227.0,2019-11-23,"(567.361, 727.75]",7,7,0
31227.0,2019-11-23,"(887.5, 1047.25]",4,1,3
31227.0,2019-11-23,"(1047.25, 1207.0]",3,7,-4
31228.0,2019-11-23,"(21.762, 332.5]",1,3,-2
31228.0,2019-11-23,"(332.5, 642.0]",8,14,-6
31228.0,2019-11-23,"(642.0, 951.5]",25,35,-10
31228.0,2019-11-23,"(951.5, 1261.0]",8,19,-11
31229.0,2019-11-23,"(0.582, 356.5]",7,12,-5
31229.0,2019-11-23,"(356.5, 711.0]",22,49,-27
31229.0,2019-11-23,"(711.0, 1065.5]",31,71,-40
31229.0,2019-11-23,"(1065.5, 1420.0]",9,14,-5
31230.0,2019-11-23,"(0.792, 304.0]",1,1,0
31230.0,2019-11-23,"(304.0, 606.0]",5,11,-6
31230.0,2019-11-23,"(606.0, 908.0]",13,21,-8
31230.0,2019-11-23,"(908.0, 1210.0]",10,16,-6
31231.0,2019-11-23,"(580.336, 747.0]",4,6,-2
31231.0,2019-11-23,"(747.0, 913.0]",7,16,-9
31231.0,2019-11-23,"(913.0, 1079.0]",4,4,0
31232.0,2019-11-23,"(207.985, 462.75]",2,4,-2
31232.0,2019-11-23,"(462.75, 716.5]",7,13,-6
31232.0,2019-11-23,"(716.5, 970.25]",25,36,-11
31232.0,2019-11-23,"(970.25, 1224.0]",9,12,-3
31233.0,2019-11-23,"(331.5, 654.0]",2,2,0
31233.0,2019-11-23,"(654.0, 976.5]",6,2,4
31233.0,2019-11-23,"(976.5, 1299.0]",5,7,-2
31234.0,2019-11-23,"(19.712, 343.0]",1,2,-1
31234.0,2019-11-23,"(343.0, 665.0]",8,12,-4
31234.0,2019-11-23,"(665.0, 987.0]",8,17,-9
31234.0,2019-11-23,"(987.0, 1309.0]",6,11,-5
31235.0,2019-11-23,"(665.673, 747.75]",4,4,0
31235.0,2019-11-23,"(747.75, 829.5]",2,4,-2
31235.0,2019-11-23,"(911.25, 993.0]",3,5,-2
31236.0,2019-11-23,"(80.689, 409.75]",3,4,-1
31236.0,2019-11-23,"(409.75, 737.5]",7,11,-4
31236.0,2019-11-23,"(737.5, 1065.25]",5,13,-8
31236.0,2019-11-23,"(1065.25, 1393.0]",2,6,-4
31237.0,2019-11-23,"(116.814, 414.5]",1,2,-1
31237.0,2019-11-23,"(414.5, 711.0]",4,15,-11
31237.0,2019-11-23,"(711.0, 1007.5]",9,13,-4
31237.0,2019-11-23,"(1007.5, 1304.0]",6,12,-6
31238.0,2019-11-23,"(80.897, 357.75]",1,1,0
31238.0,2019-11-23,"(357.75, 633.5]",3,5,-2
31238.0,2019-11-23,"(633.5, 909.25]",8,12,-4
31238.0,2019-11-23,"(909.25, 1185.0]",4,4,0
31239.0,2019-11-23,"(313.145, 527.75]",2,2,0
31239.0,2019-11-23,"(527.75, 741.5]",24,37,-13
31239.0,2019-11-23,"(741.5, 955.25]",9,12,-3
31239.0,2019-11-23,"(955.25, 1169.0]",2,4,-2
31240.0,2019-11-23,"(504.544, 619.0]",1,2,-1
31240.0,2019-11-23,"(619.0, 733.0]",6,13,-7
31240.0,2019-11-23,"(733.0, 847.0]",1,6,-5
31240.0,2019-11-23,"(847.0, 961.0]",3,7,-4
31241.0,2019-11-23,"(16.683, 347.25]",5,6,-1
31241.0,2019-11-23,"(347.25, 676.5]",9,21,-12
31241.0,2019-11-23,"(676.5, 1005.75]",12,35,-23
31241.0,2019-11-23,"(1005.75, 1335.0]",11,20,-9
31242.0,2019-11-23,"(494.0, 741.0]",1,1,0
31242.0,2019-11-23,"(741.0, 988.0]",1,1,0
31243.0,2019-11-23,"(20.08, 251.0]",1,1,0
31243.0,2019-11-23,"(481.0, 711.0]",2,2,0
31243.0,2019-11-23,"(711.0, 941.0]",14,7,7
31244.0,2019-11-23,"(72.77, 381.5]",1,2,-1
31244.0,2019-11-23,"(381.5, 689.0]",2,5,-3
31244.0,2019-11-23,"(689.0, 996.5]",4,8,-4
31244.0,2019-11-23,"(996.5, 1304.0]",8,12,-4
31245.0,2019-11-23,"(33.729, 352.75]",4,6,-2
31245.0,2019-11-23,"(352.75, 670.5]",7,13,-6
31245.0,2019-11-23,"(670.5, 988.25]",13,33,-20
31245.0,2019-11-23,"(988.25, 1306.0]",4,10,-6
31246.0,2019-11-23,"(123.847, 413.25]",1,3,-2
31246.0,2019-11-23,"(413.25, 701.5]",13,18,-5
31246.0,2019-11-23,"(701.5, 989.75]",17,30,-13
31246.0,2019-11-23,"(989.75, 1278.0]",9,17,-8
31247.0,2019-11-23,"(432.159, 643.25]",12,17,-5
31247.0,2019-11-23,"(643.25, 853.5]",16,26,-10
31247.0,2019-11-23,"(853.5, 1063.75]",5,8,-3
31247.0,2019-11-23,"(1063.75, 1274.0]",4,9,-5
31248.0,2019-11-23,"(460.216, 657.0]",9,14,-5
31248.0,2019-11-23,"(657.0, 853.0]",31,45,-14
31248.0,2019-11-23,"(853.0, 1049.0]",20,44,-24
31248.0,2019-11-23,"(1049.0, 1245.0]",2,6,-4
31249.0,2019-11-23,"(629.363, 789.25]",4,10,-6
31249.0,2019-11-23,"(789.25, 948.5]",14,28,-14
31249.0,2019-11-23,"(948.5, 1107.75]",2,6,-4
31249.0,2019-11-23,"(1107.75, 1267.0]",1,2,-1
31250.0,2019-11-23,"(511.503, 636.25]",2,2,0
31250.0,2019-11-23,"(760.5, 884.75]",4,1,3
31250.0,2019-11-23,"(884.75, 1009.0]",3,4,-1
31251.0,2019-11-23,"(294.033, 536.75]",2,4,-2
31251.0,2019-11-23,"(536.75, 778.5]",5,10,-5
31251.0,2019-11-23,"(778.5, 1020.25]",4,8,-4
31251.0,2019-11-23,"(1020.25, 1262.0]",3,7,-4
31252.0,2019-11-23,"(895.792, 948.0]",1,1,0
31252.0,2019-11-23,"(1000.0, 1052.0]",1,1,0
31253.0,2019-11-23,"(638.287, 817.25]",4,4,0
31253.0,2019-11-23,"(817.25, 995.5]",1,4,-3
31254.0,2019-11-23,"(664.0, 932.0]",4,1,3
31254.0,2019-11-23,"(932.0, 1200.0]",2,6,-4
31255.0,2019-11-23,"(527.123, 747.25]",4,6,-2
31255.0,2019-11-23,"(747.25, 966.5]",3,6,-3
31255.0,2019-11-23,"(966.5, 1185.75]",2,3,-1
31255.0,2019-11-23,"(1185.75, 1405.0]",1,3,-2
31256.0,2019-11-23,"(324.25, 618.5]",2,1,1
31256.0,2019-11-23,"(618.5, 912.75]",13,2,11
31256.0,2019-11-23,"(912.75, 1207.0]",5,20,-15
31257.0,2019-11-23,"(335.25, 665.5]",13,1,12
31257.0,2019-11-23,"(665.5, 995.75]",16,13,3
31257.0,2019-11-23,"(995.75, 1326.0]",3,41,-38
31258.0,2019-11-23,"(91.834, 384.5]",1,2,-1
31258.0,2019-11-23,"(384.5, 676.0]",6,16,-10
31258.0,2019-11-23,"(676.0, 967.5]",27,53,-26
31258.0,2019-11-23,"(967.5, 1259.0]",9,16,-7
,,,,1.0,
,,,,1.0,
31260.0,2019-11-23,"(570.661, 655.75]",2,2,0
31260.0,2019-11-23,"(655.75, 740.5]",1,3,-2
31260.0,2019-11-23,"(825.25, 910.0]",1,3,-2
31261.0,2019-11-23,"(19.001, 269.75]",1,2,-1
31261.0,2019-11-23,"(519.5, 769.25]",2,2,0
31261.0,2019-11-23,"(769.25, 1019.0]",4,10,-6
31262.0,2019-11-23,"(84.977, 341.75]",1,2,-1
31262.0,2019-11-23,"(341.75, 597.5]",4,4,0
31262.0,2019-11-23,"(597.5, 853.25]",9,16,-7
31262.0,2019-11-23,"(853.25, 1109.0]",6,8,-2
31263.0,2019-11-23,"(118.839, 410.25]",2,3,-1
31263.0,2019-11-23,"(410.25, 700.5]",8,12,-4
31263.0,2019-11-23,"(700.5, 990.75]",10,19,-9
31263.0,2019-11-23,"(990.75, 1281.0]",6,14,-8
31264.0,2019-11-23,"(510.473, 642.75]",3,5,-2
31264.0,2019-11-23,"(642.75, 774.5]",5,8,-3
31264.0,2019-11-23,"(774.5, 906.25]",4,5,-1
31264.0,2019-11-23,"(906.25, 1038.0]",1,13,-12
31265.0,2019-11-23,"(163.796, 466.0]",2,5,-3
31265.0,2019-11-23,"(466.0, 767.0]",9,17,-8
31265.0,2019-11-23,"(767.0, 1068.0]",12,30,-18
31265.0,2019-11-23,"(1068.0, 1369.0]",4,8,-4
31266.0,2019-11-23,"(453.25, 779.5]",6,3,3
31266.0,2019-11-23,"(779.5, 1105.75]",17,28,-11
31266.0,2019-11-23,"(1105.75, 1432.0]",4,30,-26
31267.0,2019-11-23,"(16.849, 305.75]",4,4,0
31267.0,2019-11-23,"(305.75, 593.5]",4,6,-2
31267.0,2019-11-23,"(593.5, 881.25]",17,24,-7
31267.0,2019-11-23,"(881.25, 1169.0]",5,11,-6
31268.0,2019-11-23,"(14.71, 338.5]",1,7,-6
31268.0,2019-11-23,"(338.5, 661.0]",6,11,-5
31268.0,2019-11-23,"(661.0, 983.5]",14,24,-10
31268.0,2019-11-23,"(983.5, 1306.0]",13,16,-3
31269.0,2019-11-23,"(560.511, 683.25]",7,13,-6
31269.0,2019-11-23,"(683.25, 805.5]",4,8,-4
31269.0,2019-11-23,"(805.5, 927.75]",1,2,-1
31269.0,2019-11-23,"(927.75, 1050.0]",1,4,-3
31270.0,2019-11-23,"(526.25, 759.5]",2,2,0
31270.0,2019-11-23,"(759.5, 992.75]",13,5,8
31270.0,2019-11-23,"(992.75, 1226.0]",2,21,-19
31271.0,2019-11-23,"(493.384, 648.0]",9,9,0
31271.0,2019-11-23,"(648.0, 802.0]",3,8,-5
31271.0,2019-11-23,"(802.0, 956.0]",3,8,-5
31271.0,2019-11-23,"(956.0, 1110.0]",5,11,-6
31272.0,2019-11-23,"(552.322, 722.5]",7,10,-3
31272.0,2019-11-23,"(722.5, 892.0]",11,15,-4
31272.0,2019-11-23,"(892.0, 1061.5]",6,13,-7
31272.0,2019-11-23,"(1061.5, 1231.0]",1,2,-1
31273.0,2019-11-23,"(477.702, 552.5]",5,11,-6
31273.0,2019-11-23,"(552.5, 627.0]",4,8,-4
31273.0,2019-11-23,"(701.5, 776.0]",1,2,-1
31274.0,2019-11-23,"(615.317, 786.75]",10,10,0
31274.0,2019-11-23,"(786.75, 957.5]",9,12,-3
31274.0,2019-11-23,"(957.5, 1128.25]",4,8,-4
31274.0,2019-11-23,"(1128.25, 1299.0]",1,3,-2
31275.0,2019-11-23,"(191.917, 463.75]",5,7,-2
31275.0,2019-11-23,"(463.75, 734.5]",6,8,-2
31275.0,2019-11-23,"(734.5, 1005.25]",4,19,-15
31275.0,2019-11-23,"(1005.25, 1276.0]",7,8,-1
31276.0,2019-11-23,"(590.611, 688.25]",1,2,-1
31276.0,2019-11-23,"(688.25, 785.5]",3,5,-2
31276.0,2019-11-23,"(882.75, 980.0]",1,2,-1
31277.0,2019-11-23,"(446.397, 597.75]",5,6,-1
31277.0,2019-11-23,"(597.75, 748.5]",4,9,-5
31277.0,2019-11-23,"(748.5, 899.25]",5,13,-8
31277.0,2019-11-23,"(899.25, 1050.0]",9,14,-5
31278.0,2019-11-23,"(24.604, 375.0]",2,5,-3
31278.0,2019-11-23,"(375.0, 724.0]",9,17,-8
31278.0,2019-11-23,"(724.0, 1073.0]",17,32,-15
31278.0,2019-11-23,"(1073.0, 1422.0]",3,7,-4
31279.0,2019-11-23,"(584.377, 740.75]",2,2,0
31279.0,2019-11-23,"(1052.25, 1208.0]",1,1,0
31280.0,2019-11-23,"(142.919, 414.25]",2,2,0
31280.0,2019-11-23,"(414.25, 684.5]",12,21,-9
31280.0,2019-11-23,"(684.5, 954.75]",9,20,-11
31280.0,2019-11-23,"(954.75, 1225.0]",2,4,-2
31000.0,2019-11-24,"(709.5, 1064.25]",1,1,0
31000.0,2019-11-24,"(1064.25, 1419.0]",1,1,0
31001.0,2019-11-24,"(747.554, 859.5]",1,2,-1
31001.0,2019-11-24,"(859.5, 971.0]",1,2,-1
31001.0,2019-11-24,"(971.0, 1082.5]",1,3,-2
31001.0,2019-11-24,"(1082.5, 1194.0]",1,1,0
31002.0,2019-11-24,"(826.453, 963.75]",2,4,-2
31002.0,2019-11-24,"(963.75, 1100.5]",1,1,0
31003.0,2019-11-24,"(486.499, 612.25]",1,1,0
31003.0,2019-11-24,"(862.75, 988.0]",1,1,0
,,,,2.0,
31005.0,2019-11-24,"(566.511, 689.25]",2,2,0
31005.0,2019-11-24,"(689.25, 811.5]",3,4,-1
31005.0,2019-11-24,"(811.5, 933.75]",1,2,-1
31005.0,2019-11-24,"(933.75, 1056.0]",2,5,-3
31006.0,2019-11-24,"(562.178, 768.5]",1,1,0
31006.0,2019-11-24,"(768.5, 974.0]",1,2,-1
31006.0,2019-11-24,"(1179.5, 1385.0]",1,1,0
31007.0,2019-11-24,"(587.2, 788.0]",1,2,-1
31007.0,2019-11-24,"(788.0, 988.0]",2,3,-1
31007.0,2019-11-24,"(988.0, 1188.0]",1,2,-1
,,,,1.0,
,,,,3.0,
31010.0,2019-11-24,"(707.5, 821.75]",1,1,0
31010.0,2019-11-24,"(821.75, 936.0]",1,2,-1
31011.0,2019-11-24,"(494.693, 571.75]",1,2,-1
31011.0,2019-11-24,"(648.5, 725.25]",2,2,0
,,,,2.0,
31013.0,2019-11-24,"(742.54, 858.0]",3,5,-2
31013.0,2019-11-24,"(1088.0, 1203.0]",2,3,-1
31014.0,2019-11-24,"(535.148, 749.0]",4,4,0
31014.0,2019-11-24,"(749.0, 962.0]",5,8,-3
31014.0,2019-11-24,"(962.0, 1175.0]",2,5,-3
31014.0,2019-11-24,"(1175.0, 1388.0]",1,1,0
31015.0,2019-11-24,"(448.03, 691.5]",4,5,-1
31015.0,2019-11-24,"(691.5, 934.0]",4,5,-1
31015.0,2019-11-24,"(934.0, 1176.5]",2,4,-2
31015.0,2019-11-24,"(1176.5, 1419.0]",1,1,0
31016.0,2019-11-24,"(563.436, 705.0]",2,5,-3
31016.0,2019-11-24,"(846.0, 987.0]",1,6,-5
31016.0,2019-11-24,"(987.0, 1128.0]",1,2,-1
31017.0,2019-11-24,"(663.282, 843.5]",2,5,-3
31017.0,2019-11-24,"(843.5, 1023.0]",3,3,0
31017.0,2019-11-24,"(1023.0, 1202.5]",1,3,-2
31018.0,2019-11-24,"(712.25, 878.5]",1,1,0
31018.0,2019-11-24,"(1044.75, 1211.0]",1,1,0
31019.0,2019-11-24,"(771.503, 896.25]",2,3,-1
31020.0,2019-11-24,"(786.76, 847.0]",1,1,0
31020.0,2019-11-24,"(847.0, 907.0]",1,3,-2
31020.0,2019-11-24,"(967.0, 1027.0]",2,1,1
31021.0,2019-11-24,"(629.24, 820.0]",2,2,0
31021.0,2019-11-24,"(820.0, 1010.0]",1,4,-3
31022.0,2019-11-24,"(529.303, 704.25]",2,3,-1
31022.0,2019-11-24,"(704.25, 878.5]",2,6,-4
31022.0,2019-11-24,"(878.5, 1052.75]",4,6,-2
31022.0,2019-11-24,"(1052.75, 1227.0]",2,3,-1
31023.0,2019-11-24,"(856.523, 976.25]",1,4,-3
31024.0,2019-11-24,"(627.669, 710.75]",1,4,-3
31024.0,2019-11-24,"(793.5, 876.25]",1,1,0
31025.0,2019-11-24,"(818.25, 942.5]",1,2,-1
31025.0,2019-11-24,"(942.5, 1066.75]",2,1,1
,,,,1.0,
,,,,2.0,
,,,,1.0,
31027.0,2019-11-24,"(984.0, 1057.0]",1,1,0
,,,,1.0,
,,,,1.0,
,,,,1.0,
31029.0,2019-11-24,"(745.586, 849.5]",3,4,-1
31029.0,2019-11-24,"(953.0, 1056.5]",1,2,-1
31029.0,2019-11-24,"(1056.5, 1160.0]",1,1,0
31030.0,2019-11-24,"(29.041, 269.75]",1,1,0
31030.0,2019-11-24,"(509.5, 749.25]",2,3,-1
31030.0,2019-11-24,"(749.25, 989.0]",2,2,0
31031.0,2019-11-24,"(793.75, 958.5]",1,1,0
31031.0,2019-11-24,"(1123.25, 1288.0]",2,1,1
31032.0,2019-11-24,"(810.5, 875.0]",1,1,0
31033.0,2019-11-24,"(1142.874, 1174.5]",1,1,0
31034.0,2019-11-24,"(774.0, 895.5]",1,1,0
31035.0,2019-11-24,"(1041.75, 1281.0]",3,1,2
,,,,1.0,
,,,,1.0,
,,,,2.0,
31037.0,2019-11-24,"(350.75, 638.5]",5,1,4
31037.0,2019-11-24,"(638.5, 926.25]",4,6,-2
31037.0,2019-11-24,"(926.25, 1214.0]",2,9,-7
,,,,2.0,
31039.0,2019-11-24,"(930.518, 1051.5]",3,6,-3
31040.0,2019-11-24,"(1059.0, 1155.0]",1,1,0
31040.0,2019-11-24,"(1251.0, 1347.0]",1,1,0
31041.0,2019-11-24,"(778.25, 801.5]",3,1,2
31041.0,2019-11-24,"(824.75, 848.0]",4,3,1
31042.0,2019-11-24,"(848.594, 950.5]",3,4,-1
31042.0,2019-11-24,"(950.5, 1052.0]",3,5,-2
31042.0,2019-11-24,"(1052.0, 1153.5]",3,4,-1
31043.0,2019-11-24,"(893.5, 1008.0]",2,1,1
,,,,2.0,
31045.0,2019-11-24,"(590.431, 733.25]",3,4,-1
31045.0,2019-11-24,"(1017.75, 1160.0]",1,2,-1
31046.0,2019-11-24,"(572.232, 765.0]",1,1,0
31046.0,2019-11-24,"(765.0, 957.0]",1,2,-1
31047.0,2019-11-24,"(554.57, 662.5]",1,2,-1
31047.0,2019-11-24,"(877.5, 985.0]",2,1,1
31048.0,2019-11-24,"(572.416, 719.0]",2,3,-1
31048.0,2019-11-24,"(719.0, 865.0]",1,1,0
31049.0,2019-11-24,"(663.731, 731.25]",1,2,-1
31049.0,2019-11-24,"(731.25, 798.5]",3,3,0
31050.0,2019-11-24,"(334.197, 535.75]",1,1,0
31050.0,2019-11-24,"(736.5, 937.25]",1,1,0
31050.0,2019-11-24,"(937.25, 1138.0]",1,1,0
31051.0,2019-11-24,"(754.607, 853.25]",1,3,-2
31051.0,2019-11-24,"(853.25, 951.5]",2,3,-1
31051.0,2019-11-24,"(1049.75, 1148.0]",1,2,-1
31052.0,2019-11-24,"(1036.841, 1076.75]",2,2,0
31053.0,2019-11-24,"(717.0, 956.0]",1,1,0
,,,,2.0,
31055.0,2019-11-24,"(601.321, 771.75]",1,2,-1
31055.0,2019-11-24,"(771.75, 941.5]",1,2,-1
31055.0,2019-11-24,"(1111.25, 1281.0]",1,1,0
31056.0,2019-11-24,"(744.5, 959.0]",3,1,2
31056.0,2019-11-24,"(1173.5, 1388.0]",1,4,-3
,,,,2.0,
,,,,1.0,
,,,,1.0,
,,,,2.0,
31060.0,2019-11-24,"(540.167, 749.25]",1,1,0
31060.0,2019-11-24,"(749.25, 957.5]",1,3,-2
31060.0,2019-11-24,"(957.5, 1165.75]",1,1,0
31061.0,2019-11-24,"(590.237, 781.75]",1,1,0
31061.0,2019-11-24,"(1163.25, 1354.0]",1,2,-1
31062.0,2019-11-24,"(744.735, 811.25]",1,2,-1
31062.0,2019-11-24,"(811.25, 877.5]",4,9,-5
31062.0,2019-11-24,"(877.5, 943.75]",4,7,-3
31062.0,2019-11-24,"(943.75, 1010.0]",4,8,-4
,,,,2.0,
31064.0,2019-11-24,"(508.447, 647.25]",3,4,-1
31064.0,2019-11-24,"(647.25, 785.5]",4,10,-6
31064.0,2019-11-24,"(785.5, 923.75]",8,14,-6
31064.0,2019-11-24,"(923.75, 1062.0]",9,20,-11
31065.0,2019-11-24,"(814.0, 826.0]",1,1,0
,,,,1.0,
,,,,1.0,
31067.0,2019-11-24,"(684.324, 854.0]",1,2,-1
31067.0,2019-11-24,"(1192.0, 1361.0]",2,4,-2
31068.0,2019-11-24,"(714.364, 874.0]",3,6,-3
31068.0,2019-11-24,"(1033.0, 1192.0]",1,2,-1
31068.0,2019-11-24,"(1192.0, 1351.0]",1,1,0
31069.0,2019-11-24,"(842.75, 991.0]",1,1,0
31070.0,2019-11-24,"(634.337, 800.75]",2,5,-3
31070.0,2019-11-24,"(800.75, 966.5]",1,2,-1
31070.0,2019-11-24,"(1132.25, 1298.0]",1,1,0
31071.0,2019-11-24,"(488.288, 667.0]",1,2,-1
31071.0,2019-11-24,"(667.0, 845.0]",3,7,-4
31071.0,2019-11-24,"(845.0, 1023.0]",3,7,-4
31071.0,2019-11-24,"(1023.0, 1201.0]",1,3,-2
,,,,1.0,
,,,,2.0,
31073.0,2019-11-24,"(762.711, 835.25]",1,1,0
31073.0,2019-11-24,"(979.75, 1052.0]",1,2,-1
,,,,1.0,
,,,,1.0,
31075.0,2019-11-24,"(1004.498, 1005.0]",1,2,-1
,,,,2.0,
31077.0,2019-11-24,"(549.195, 751.25]",2,4,-2
31077.0,2019-11-24,"(751.25, 952.5]",1,4,-3
31077.0,2019-11-24,"(1153.75, 1355.0]",2,1,1
,,,,1.0,
,,,,2.0,
31079.0,2019-11-24,"(552.165, 761.75]",1,4,-3
31079.0,2019-11-24,"(970.5, 1179.25]",3,5,-2
31079.0,2019-11-24,"(1179.25, 1388.0]",1,1,0
31080.0,2019-11-24,"(657.5, 773.0]",1,2,-1
31080.0,2019-11-24,"(888.5, 1004.0]",1,4,-3
,,,,1.0,
,,,,1.0,
,,,,1.0,
,,,,1.0,
,,,,1.0,
,,,,1.0,
31083.0,2019-11-24,"(769.0, 873.0]",1,1,0
31083.0,2019-11-24,"(873.0, 977.0]",2,1,1
31083.0,2019-11-24,"(977.0, 1081.0]",2,3,-1
31084.0,2019-11-24,"(953.987, 957.25]",1,1,0
31084.0,2019-11-24,"(963.75, 967.0]",1,3,-2
31085.0,2019-11-24,"(666.455, 803.25]",1,1,0
31086.0,2019-11-24,"(752.75, 815.5]",2,2,0
31086.0,2019-11-24,"(878.0, 940.5]",2,3,-1
31086.0,2019-11-24,"(940.5, 1003.0]",2,2,0
31087.0,2019-11-24,"(1112.843, 1152.25]",1,2,-1
31087.0,2019-11-24,"(1230.75, 1270.0]",1,1,0
,,,,1.0,
,,,,2.0,
31089.0,2019-11-24,"(372.5, 719.0]",2,1,1
31089.0,2019-11-24,"(719.0, 1065.5]",3,3,0
31089.0,2019-11-24,"(1065.5, 1412.0]",3,9,-6
31090.0,2019-11-24,"(510.0, 680.0]",1,1,0
31091.0,2019-11-24,"(926.0, 1048.0]",1,1,0
31092.0,2019-11-24,"(656.0, 700.0]",1,1,0
,,,,1.0,
,,,,1.0,
,,,,2.0,
,,,,2.0,
,,,,2.0,
,,,,1.0,
,,,,2.0,
31097.0,2019-11-24,"(517.174, 724.5]",1,1,0
31097.0,2019-11-24,"(724.5, 931.0]",2,4,-2
31097.0,2019-11-24,"(931.0, 1137.5]",1,3,-2
31097.0,2019-11-24,"(1137.5, 1344.0]",1,1,0
31098.0,2019-11-24,"(468.445, 607.75]",1,2,-1
31098.0,2019-11-24,"(885.25, 1024.0]",3,1,2
31099.0,2019-11-24,"(586.645, 675.75]",1,3,-2
31100.0,2019-11-24,"(390.262, 575.5]",1,1,0
31100.0,2019-11-24,"(575.5, 760.0]",2,2,0
31100.0,2019-11-24,"(760.0, 944.5]",1,3,-2
31100.0,2019-11-24,"(944.5, 1129.0]",1,2,-1
31101.0,2019-11-24,"(50.617, 397.75]",1,5,-4
31101.0,2019-11-24,"(397.75, 743.5]",22,43,-21
31101.0,2019-11-24,"(743.5, 1089.25]",42,63,-21
31101.0,2019-11-24,"(1089.25, 1435.0]",16,27,-11
31102.0,2019-11-24,"(17.746, 332.5]",1,2,-1
31102.0,2019-11-24,"(332.5, 646.0]",1,9,-8
31102.0,2019-11-24,"(646.0, 959.5]",7,19,-12
31102.0,2019-11-24,"(959.5, 1273.0]",9,17,-8
31103.0,2019-11-24,"(145.851, 434.25]",1,2,-1
31103.0,2019-11-24,"(434.25, 721.5]",6,25,-19
31103.0,2019-11-24,"(721.5, 1008.75]",10,37,-27
31103.0,2019-11-24,"(1008.75, 1296.0]",5,14,-9
31104.0,2019-11-24,"(60.729, 379.75]",1,3,-2
31104.0,2019-11-24,"(379.75, 697.5]",4,16,-12
31104.0,2019-11-24,"(697.5, 1015.25]",11,20,-9
31104.0,2019-11-24,"(1015.25, 1333.0]",13,24,-11
31105.0,2019-11-24,"(631.5, 842.0]",1,1,0
31105.0,2019-11-24,"(842.0, 1052.5]",2,2,0
31105.0,2019-11-24,"(1052.5, 1263.0]",1,3,-2
31106.0,2019-11-24,"(804.486, 933.5]",2,5,-3
31106.0,2019-11-24,"(933.5, 1062.0]",1,2,-1
31106.0,2019-11-24,"(1190.5, 1319.0]",1,1,0
31107.0,2019-11-24,"(201.841, 492.75]",2,2,0
31107.0,2019-11-24,"(492.75, 782.5]",10,22,-12
31107.0,2019-11-24,"(782.5, 1072.25]",12,30,-18
31107.0,2019-11-24,"(1072.25, 1362.0]",8,14,-6
31108.0,2019-11-24,"(468.084, 698.0]",3,7,-4
31108.0,2019-11-24,"(698.0, 927.0]",8,23,-15
31108.0,2019-11-24,"(927.0, 1156.0]",14,26,-12
31108.0,2019-11-24,"(1156.0, 1385.0]",4,8,-4
31109.0,2019-11-24,"(211.786, 516.5]",2,3,-1
31109.0,2019-11-24,"(516.5, 820.0]",10,21,-11
31109.0,2019-11-24,"(820.0, 1123.5]",9,18,-9
31109.0,2019-11-24,"(1123.5, 1427.0]",7,15,-8
31110.0,2019-11-24,"(383.108, 607.0]",8,14,-6
31110.0,2019-11-24,"(607.0, 830.0]",10,24,-14
31110.0,2019-11-24,"(830.0, 1053.0]",14,19,-5
31110.0,2019-11-24,"(1053.0, 1276.0]",8,14,-6
31111.0,2019-11-24,"(104.685, 434.75]",1,6,-5
31111.0,2019-11-24,"(434.75, 763.5]",8,17,-9
31111.0,2019-11-24,"(763.5, 1092.25]",11,19,-8
31111.0,2019-11-24,"(1092.25, 1421.0]",4,9,-5
31112.0,2019-11-24,"(792.5, 865.0]",3,2,1
31112.0,2019-11-24,"(865.0, 937.5]",1,3,-2
31112.0,2019-11-24,"(937.5, 1010.0]",2,2,0
31113.0,2019-11-24,"(722.5, 943.0]",8,7,1
31113.0,2019-11-24,"(943.0, 1163.5]",3,17,-14
31113.0,2019-11-24,"(1163.5, 1384.0]",1,13,-12
31114.0,2019-11-24,"(405.25, 740.5]",4,2,2
31114.0,2019-11-24,"(740.5, 1075.75]",8,12,-4
31114.0,2019-11-24,"(1075.75, 1411.0]",8,27,-19
31115.0,2019-11-24,"(464.168, 673.0]",1,7,-6
31115.0,2019-11-24,"(673.0, 881.0]",4,13,-9
31115.0,2019-11-24,"(881.0, 1089.0]",3,7,-4
31115.0,2019-11-24,"(1089.0, 1297.0]",3,4,-1
31116.0,2019-11-24,"(437.008, 686.0]",5,11,-6
31116.0,2019-11-24,"(686.0, 934.0]",8,18,-10
31116.0,2019-11-24,"(934.0, 1182.0]",7,17,-10
31116.0,2019-11-24,"(1182.0, 1430.0]",6,7,-1
31117.0,2019-11-24,"(461.142, 676.5]",4,8,-4
31117.0,2019-11-24,"(676.5, 891.0]",1,3,-2
31117.0,2019-11-24,"(891.0, 1105.5]",4,11,-7
31117.0,2019-11-24,"(1105.5, 1320.0]",5,10,-5
31118.0,2019-11-24,"(439.129, 657.75]",2,8,-6
31118.0,2019-11-24,"(657.75, 875.5]",1,11,-10
31118.0,2019-11-24,"(875.5, 1093.25]",8,11,-3
31118.0,2019-11-24,"(1093.25, 1311.0]",3,6,-3
31119.0,2019-11-24,"(467.175, 674.25]",10,20,-10
31119.0,2019-11-24,"(674.25, 880.5]",13,30,-17
31119.0,2019-11-24,"(880.5, 1086.75]",10,21,-11
31119.0,2019-11-24,"(1086.75, 1293.0]",6,11,-5
31120.0,2019-11-24,"(483.251, 671.25]",3,7,-4
31120.0,2019-11-24,"(671.25, 858.5]",2,11,-9
31120.0,2019-11-24,"(858.5, 1045.75]",1,5,-4
31120.0,2019-11-24,"(1045.75, 1233.0]",2,3,-1
31121.0,2019-11-24,"(470.311, 643.25]",1,6,-5
31121.0,2019-11-24,"(643.25, 815.5]",2,4,-2
31121.0,2019-11-24,"(815.5, 987.75]",6,8,-2
31121.0,2019-11-24,"(987.75, 1160.0]",4,6,-2
31122.0,2019-11-24,"(521.19, 724.5]",6,8,-2
31122.0,2019-11-24,"(724.5, 927.0]",4,10,-6
31122.0,2019-11-24,"(927.0, 1129.5]",1,7,-6
31122.0,2019-11-24,"(1129.5, 1332.0]",5,13,-8
31123.0,2019-11-24,"(684.75, 924.5]",4,6,-2
31123.0,2019-11-24,"(924.5, 1164.25]",3,15,-12
31123.0,2019-11-24,"(1164.25, 1404.0]",3,12,-9
31124.0,2019-11-24,"(339.25, 661.5]",4,2,2
31124.0,2019-11-24,"(661.5, 983.75]",11,15,-4
31124.0,2019-11-24,"(983.75, 1306.0]",11,26,-15
31125.0,2019-11-24,"(390.003, 640.25]",2,11,-9
31125.0,2019-11-24,"(640.25, 889.5]",14,34,-20
31125.0,2019-11-24,"(889.5, 1138.75]",19,32,-13
31125.0,2019-11-24,"(1138.75, 1388.0]",9,14,-5
31126.0,2019-11-24,"(116.798, 418.5]",1,1,0
31126.0,2019-11-24,"(418.5, 719.0]",3,26,-23
31126.0,2019-11-24,"(719.0, 1019.5]",10,31,-21
31126.0,2019-11-24,"(1019.5, 1320.0]",16,19,-3
31127.0,2019-11-24,"(32.678, 364.5]",1,2,-1
31127.0,2019-11-24,"(364.5, 695.0]",4,7,-3
31127.0,2019-11-24,"(695.0, 1025.5]",8,12,-4
31127.0,2019-11-24,"(1025.5, 1356.0]",4,11,-7
31128.0,2019-11-24,"(340.902, 616.5]",10,14,-4
31128.0,2019-11-24,"(616.5, 891.0]",9,17,-8
31128.0,2019-11-24,"(891.0, 1165.5]",16,34,-18
31128.0,2019-11-24,"(1165.5, 1440.0]",4,6,-2
31129.0,2019-11-24,"(567.255, 754.25]",2,2,0
31129.0,2019-11-24,"(754.25, 940.5]",9,17,-8
31129.0,2019-11-24,"(940.5, 1126.75]",1,7,-6
31129.0,2019-11-24,"(1126.75, 1313.0]",3,3,0
31130.0,2019-11-24,"(486.266, 670.5]",4,11,-7
31130.0,2019-11-24,"(670.5, 854.0]",5,10,-5
31130.0,2019-11-24,"(854.0, 1037.5]",5,9,-4
31130.0,2019-11-24,"(1037.5, 1221.0]",9,12,-3
31131.0,2019-11-24,"(164.772, 473.0]",1,1,0
31131.0,2019-11-24,"(473.0, 780.0]",4,10,-6
31131.0,2019-11-24,"(780.0, 1087.0]",1,7,-6
31131.0,2019-11-24,"(1087.0, 1394.0]",3,5,-2
31200.0,2019-11-24,"(209.825, 504.75]",4,4,0
31200.0,2019-11-24,"(504.75, 798.5]",52,79,-27
31200.0,2019-11-24,"(798.5, 1092.25]",20,39,-19
31200.0,2019-11-24,"(1092.25, 1386.0]",4,10,-6
31201.0,2019-11-24,"(107.806, 407.5]",1,3,-2
31201.0,2019-11-24,"(407.5, 706.0]",13,20,-7
31201.0,2019-11-24,"(706.0, 1004.5]",26,56,-30
31201.0,2019-11-24,"(1004.5, 1303.0]",17,32,-15
31202.0,2019-11-24,"(29.684, 360.0]",1,2,-1
31202.0,2019-11-24,"(360.0, 689.0]",14,20,-6
31202.0,2019-11-24,"(689.0, 1018.0]",29,45,-16
31202.0,2019-11-24,"(1018.0, 1347.0]",17,36,-19
31203.0,2019-11-24,"(76.701, 402.75]",1,2,-1
31203.0,2019-11-24,"(402.75, 727.5]",18,32,-14
31203.0,2019-11-24,"(727.5, 1052.25]",24,41,-17
31203.0,2019-11-24,"(1052.25, 1377.0]",15,23,-8
31204.0,2019-11-24,"(514.0, 766.0]",10,1,9
31204.0,2019-11-24,"(766.0, 1018.0]",5,12,-7
31204.0,2019-11-24,"(1018.0, 1270.0]",3,13,-10
31205.0,2019-11-24,"(431.355, 593.25]",3,4,-1
31205.0,2019-11-24,"(593.25, 754.5]",4,4,0
31205.0,2019-11-24,"(754.5, 915.75]",8,11,-3
31205.0,2019-11-24,"(915.75, 1077.0]",1,6,-5
31206.0,2019-11-24,"(546.0, 728.0]",1,1,0
31207.0,2019-11-24,"(731.25, 833.5]",2,2,0
31207.0,2019-11-24,"(833.5, 935.75]",1,6,-5
31208.0,2019-11-24,"(619.397, 770.75]",3,6,-3
31208.0,2019-11-24,"(770.75, 921.5]",5,6,-1
31208.0,2019-11-24,"(921.5, 1072.25]",1,1,0
31208.0,2019-11-24,"(1072.25, 1223.0]",2,7,-5
31209.0,2019-11-24,"(492.518, 613.5]",3,3,0
31209.0,2019-11-24,"(734.0, 854.5]",1,3,-2
31209.0,2019-11-24,"(854.5, 975.0]",5,2,3
31211.0,2019-11-24,"(622.678, 703.5]",1,3,-2
31211.0,2019-11-24,"(703.5, 784.0]",1,2,-1
31211.0,2019-11-24,"(784.0, 864.5]",3,4,-1
31212.0,2019-11-24,"(466.066, 700.5]",4,9,-5
31212.0,2019-11-24,"(700.5, 934.0]",10,17,-7
31212.0,2019-11-24,"(934.0, 1167.5]",7,15,-8
31212.0,2019-11-24,"(1167.5, 1401.0]",3,4,-1
31213.0,2019-11-24,"(531.262, 716.5]",5,7,-2
31213.0,2019-11-24,"(716.5, 901.0]",7,8,-1
31213.0,2019-11-24,"(901.0, 1085.5]",7,11,-4
31213.0,2019-11-24,"(1085.5, 1270.0]",1,3,-2
31214.0,2019-11-24,"(97.739, 414.25]",1,1,0
31214.0,2019-11-24,"(414.25, 729.5]",15,29,-14
31214.0,2019-11-24,"(729.5, 1044.75]",23,52,-29
31214.0,2019-11-24,"(1044.75, 1360.0]",21,34,-13
31215.0,2019-11-24,"(477.039, 718.25]",7,7,0
31215.0,2019-11-24,"(718.25, 958.5]",4,11,-7
31215.0,2019-11-24,"(958.5, 1198.75]",2,4,-2
31216.0,2019-11-24,"(707.542, 822.5]",1,2,-1
31216.0,2019-11-24,"(937.0, 1051.5]",2,4,-2
31216.0,2019-11-24,"(1051.5, 1166.0]",2,5,-3
,,,,2.0,
31218.0,2019-11-24,"(882.75, 888.0]",2,2,0
31219.0,2019-11-24,"(568.55, 681.5]",3,5,-2
31219.0,2019-11-24,"(681.5, 794.0]",1,2,-1
31219.0,2019-11-24,"(794.0, 906.5]",6,8,-2
31219.0,2019-11-24,"(906.5, 1019.0]",9,11,-2
31220.0,2019-11-24,"(619.499, 745.25]",1,2,-1
31220.0,2019-11-24,"(745.25, 870.5]",1,1,0
31220.0,2019-11-24,"(870.5, 995.75]",1,1,0
31221.0,2019-11-24,"(348.128, 567.0]",1,1,0
31221.0,2019-11-24,"(567.0, 785.0]",4,4,0
31221.0,2019-11-24,"(785.0, 1003.0]",1,3,-2
31221.0,2019-11-24,"(1003.0, 1221.0]",3,8,-5
31222.0,2019-11-24,"(827.0, 924.0]",2,3,-1
31222.0,2019-11-24,"(1021.0, 1118.0]",1,5,-4
31223.0,2019-11-24,"(380.25, 732.5]",11,1,10
31223.0,2019-11-24,"(732.5, 1084.75]",13,19,-6
31223.0,2019-11-24,"(1084.75, 1437.0]",2,30,-28
31224.0,2019-11-24,"(511.453, 648.75]",1,2,-1
31224.0,2019-11-24,"(648.75, 785.5]",3,6,-3
31224.0,2019-11-24,"(785.5, 922.25]",2,5,-3
31224.0,2019-11-24,"(922.25, 1059.0]",3,8,-5
31225.0,2019-11-24,"(465.296, 642.0]",5,7,-2
31225.0,2019-11-24,"(642.0, 818.0]",1,4,-3
31225.0,2019-11-24,"(818.0, 994.0]",10,12,-2
31225.0,2019-11-24,"(994.0, 1170.0]",7,10,-3
31226.0,2019-11-24,"(617.484, 747.0]",2,3,-1
31226.0,2019-11-24,"(747.0, 876.0]",5,9,-4
31226.0,2019-11-24,"(1005.0, 1134.0]",5,8,-3
31227.0,2019-11-24,"(443.254, 630.5]",2,6,-4
31227.0,2019-11-24,"(817.0, 1003.5]",1,2,-1
31227.0,2019-11-24,"(1003.5, 1190.0]",3,3,0
31228.0,2019-11-24,"(73.702, 399.5]",1,1,0
31228.0,2019-11-24,"(399.5, 724.0]",5,8,-3
31228.0,2019-11-24,"(724.0, 1048.5]",24,40,-16
31228.0,2019-11-24,"(1048.5, 1373.0]",13,23,-10
31229.0,2019-11-24,"(324.009, 572.75]",4,13,-9
31229.0,2019-11-24,"(572.75, 820.5]",30,51,-21
31229.0,2019-11-24,"(820.5, 1068.25]",18,36,-18
31229.0,2019-11-24,"(1068.25, 1316.0]",11,23,-12
31230.0,2019-11-24,"(521.379, 677.25]",3,3,0
31230.0,2019-11-24,"(677.25, 832.5]",10,22,-12
31230.0,2019-11-24,"(832.5, 987.75]",14,17,-3
31230.0,2019-11-24,"(987.75, 1143.0]",4,11,-7
31231.0,2019-11-24,"(791.568, 900.0]",5,7,-2
31231.0,2019-11-24,"(1008.0, 1116.0]",1,2,-1
31232.0,2019-11-24,"(351.968, 611.0]",4,6,-2
31232.0,2019-11-24,"(611.0, 869.0]",15,22,-7
31232.0,2019-11-24,"(869.0, 1127.0]",9,17,-8
31232.0,2019-11-24,"(1127.0, 1385.0]",7,10,-3
31233.0,2019-11-24,"(382.0, 701.0]",5,1,4
31233.0,2019-11-24,"(701.0, 1020.0]",2,5,-3
31233.0,2019-11-24,"(1020.0, 1339.0]",2,7,-5
31234.0,2019-11-24,"(115.713, 438.75]",1,1,0
31234.0,2019-11-24,"(438.75, 760.5]",12,20,-8
31234.0,2019-11-24,"(760.5, 1082.25]",6,13,-7
31234.0,2019-11-24,"(1082.25, 1404.0]",5,8,-3
31235.0,2019-11-24,"(573.595, 675.25]",1,2,-1
31235.0,2019-11-24,"(675.25, 776.5]",1,1,0
31235.0,2019-11-24,"(877.75, 979.0]",1,1,0
31236.0,2019-11-24,"(538.157, 749.75]",5,10,-5
31236.0,2019-11-24,"(749.75, 960.5]",7,12,-5
31236.0,2019-11-24,"(960.5, 1171.25]",6,12,-6
31236.0,2019-11-24,"(1171.25, 1382.0]",3,7,-4
31237.0,2019-11-24,"(388.005, 637.75]",1,3,-2
31237.0,2019-11-24,"(637.75, 886.5]",6,16,-10
31237.0,2019-11-24,"(886.5, 1135.25]",7,18,-11
31237.0,2019-11-24,"(1135.25, 1384.0]",7,9,-2
31238.0,2019-11-24,"(33.81, 332.5]",1,1,0
31238.0,2019-11-24,"(630.0, 927.5]",10,2,8
31238.0,2019-11-24,"(927.5, 1225.0]",4,19,-15
31239.0,2019-11-24,"(465.259, 651.25]",6,8,-2
31239.0,2019-11-24,"(651.25, 836.5]",4,8,-4
31239.0,2019-11-24,"(836.5, 1021.75]",2,3,-1
31239.0,2019-11-24,"(1021.75, 1207.0]",3,6,-3
31240.0,2019-11-24,"(886.0, 956.0]",3,2,1
31241.0,2019-11-24,"(148.731, 467.25]",1,4,-3
31241.0,2019-11-24,"(467.25, 784.5]",13,39,-26
31241.0,2019-11-24,"(784.5, 1101.75]",9,22,-13
31241.0,2019-11-24,"(1101.75, 1419.0]",14,21,-7
31242.0,2019-11-24,"(558.479, 689.25]",3,4,-1
31242.0,2019-11-24,"(689.25, 819.5]",2,6,-4
31242.0,2019-11-24,"(819.5, 949.75]",2,3,-1
31242.0,2019-11-24,"(949.75, 1080.0]",1,5,-4
31243.0,2019-11-24,"(45.987, 300.25]",1,2,-1
31243.0,2019-11-24,"(300.25, 553.5]",1,1,0
31243.0,2019-11-24,"(553.5, 806.75]",4,6,-2
31243.0,2019-11-24,"(806.75, 1060.0]",10,17,-7
31244.0,2019-11-24,"(190.909, 464.75]",1,1,0
31244.0,2019-11-24,"(464.75, 737.5]",1,6,-5
31244.0,2019-11-24,"(737.5, 1010.25]",9,16,-7
31244.0,2019-11-24,"(1010.25, 1283.0]",6,9,-3
31245.0,2019-11-24,"(480.5, 785.0]",10,1,9
31245.0,2019-11-24,"(785.0, 1089.5]",9,17,-8
31245.0,2019-11-24,"(1089.5, 1394.0]",4,15,-11
31246.0,2019-11-24,"(447.168, 656.0]",10,12,-2
31246.0,2019-11-24,"(656.0, 864.0]",11,18,-7
31246.0,2019-11-24,"(864.0, 1072.0]",21,40,-19
31246.0,2019-11-24,"(1072.0, 1280.0]",7,9,-2
31247.0,2019-11-24,"(536.485, 665.75]",3,5,-2
31247.0,2019-11-24,"(665.75, 794.5]",9,13,-4
31247.0,2019-11-24,"(794.5, 923.25]",13,28,-15
31247.0,2019-11-24,"(923.25, 1052.0]",23,36,-13
31248.0,2019-11-24,"(647.578, 753.5]",7,11,-4
31248.0,2019-11-24,"(753.5, 859.0]",13,21,-8
31248.0,2019-11-24,"(859.0, 964.5]",10,26,-16
31248.0,2019-11-24,"(964.5, 1070.0]",8,16,-8
31249.0,2019-11-24,"(678.461, 813.75]",7,12,-5
31249.0,2019-11-24,"(813.75, 948.5]",5,11,-6
31249.0,2019-11-24,"(948.5, 1083.25]",7,8,-1
31249.0,2019-11-24,"(1083.25, 1218.0]",3,4,-1
31250.0,2019-11-24,"(556.386, 710.5]",1,1,0
31250.0,2019-11-24,"(864.0, 1017.5]",1,1,0
31250.0,2019-11-24,"(1017.5, 1171.0]",1,1,0
31251.0,2019-11-24,"(464.077, 695.75]",6,17,-11
31251.0,2019-11-24,"(695.75, 926.5]",2,8,-6
31251.0,2019-11-24,"(926.5, 1157.25]",1,5,-4
31251.0,2019-11-24,"(1157.25, 1388.0]",1,2,-1
31252.0,2019-11-24,"(523.553, 635.75]",1,1,0
31252.0,2019-11-24,"(747.5, 859.25]",2,2,0
31252.0,2019-11-24,"(859.25, 971.0]",1,2,-1
31253.0,2019-11-24,"(683.538, 799.5]",2,2,0
31253.0,2019-11-24,"(915.0, 1030.5]",1,1,0
31253.0,2019-11-24,"(1030.5, 1146.0]",1,1,0
31254.0,2019-11-24,"(30.602, 381.5]",1,1,0
31254.0,2019-11-24,"(381.5, 731.0]",2,5,-3
31254.0,2019-11-24,"(731.0, 1080.5]",10,13,-3
31254.0,2019-11-24,"(1080.5, 1430.0]",7,14,-7
31255.0,2019-11-24,"(538.139, 754.25]",2,5,-3
31255.0,2019-11-24,"(754.25, 969.5]",5,8,-3
31255.0,2019-11-24,"(969.5, 1184.75]",2,3,-1
31256.0,2019-11-24,"(566.436, 708.0]",3,6,-3
31256.0,2019-11-24,"(708.0, 849.0]",3,7,-4
31256.0,2019-11-24,"(849.0, 990.0]",8,8,0
31256.0,2019-11-24,"(990.0, 1131.0]",2,4,-2
31257.0,2019-11-24,"(445.008, 694.0]",4,7,-3
31257.0,2019-11-24,"(694.0, 942.0]",15,21,-6
31257.0,2019-11-24,"(942.0, 1190.0]",7,20,-13
31257.0,2019-11-24,"(1190.0, 1438.0]",3,9,-6
31258.0,2019-11-24,"(681.44, 822.0]",19,27,-8
31258.0,2019-11-24,"(822.0, 962.0]",24,53,-29
31258.0,2019-11-24,"(962.0, 1102.0]",11,36,-25
31258.0,2019-11-24,"(1102.0, 1242.0]",7,8,-1
,,,,1.0,
,,,,1.0,
,,,,1.0,
31260.0,2019-11-24,"(570.231, 763.25]",2,4,-2
31260.0,2019-11-24,"(763.25, 955.5]",3,5,-2
31260.0,2019-11-24,"(955.5, 1147.75]",4,5,-1
31260.0,2019-11-24,"(1147.75, 1340.0]",1,1,0
31261.0,2019-11-24,"(783.5, 862.75]",2,1,1
31261.0,2019-11-24,"(862.75, 942.0]",4,2,2
31262.0,2019-11-24,"(728.496, 855.0]",3,4,-1
31262.0,2019-11-24,"(855.0, 981.0]",1,1,0
31262.0,2019-11-24,"(981.0, 1107.0]",3,4,-1
31262.0,2019-11-24,"(1107.0, 1233.0]",2,3,-1
31263.0,2019-11-24,"(388.101, 613.75]",4,11,-7
31263.0,2019-11-24,"(613.75, 838.5]",11,18,-7
31263.0,2019-11-24,"(838.5, 1063.25]",9,16,-7
31264.0,2019-11-24,"(744.354, 906.5]",19,28,-9
31264.0,2019-11-24,"(906.5, 1068.0]",5,10,-5
31264.0,2019-11-24,"(1068.0, 1229.5]",2,3,-1
31264.0,2019-11-24,"(1229.5, 1391.0]",1,3,-2
31265.0,2019-11-24,"(213.924, 484.0]",3,7,-4
31265.0,2019-11-24,"(484.0, 753.0]",6,7,-1
31265.0,2019-11-24,"(753.0, 1022.0]",8,13,-5
31265.0,2019-11-24,"(1022.0, 1291.0]",11,26,-15
31266.0,2019-11-24,"(68.649, 407.75]",1,2,-1
31266.0,2019-11-24,"(407.75, 745.5]",3,18,-15
31266.0,2019-11-24,"(745.5, 1083.25]",18,36,-18
31266.0,2019-11-24,"(1083.25, 1421.0]",9,15,-6
31267.0,2019-11-24,"(104.826, 399.5]",2,3,-1
31267.0,2019-11-24,"(399.5, 693.0]",2,8,-6
31267.0,2019-11-24,"(693.0, 986.5]",7,25,-18
31267.0,2019-11-24,"(986.5, 1280.0]",7,14,-7
31268.0,2019-11-24,"(389.5, 734.0]",10,3,7
31268.0,2019-11-24,"(734.0, 1078.5]",20,16,4
31268.0,2019-11-24,"(1078.5, 1423.0]",5,30,-25
31269.0,2019-11-24,"(540.299, 716.25]",7,16,-9
31269.0,2019-11-24,"(716.25, 891.5]",5,9,-4
31269.0,2019-11-24,"(891.5, 1066.75]",5,10,-5
31269.0,2019-11-24,"(1066.75, 1242.0]",5,7,-2
31270.0,2019-11-24,"(712.428, 856.0]",1,5,-4
31270.0,2019-11-24,"(856.0, 999.0]",3,5,-2
31270.0,2019-11-24,"(999.0, 1142.0]",1,4,-3
31270.0,2019-11-24,"(1142.0, 1285.0]",2,2,0
31271.0,2019-11-24,"(186.206, 385.5]",1,2,-1
31271.0,2019-11-24,"(584.0, 782.5]",7,3,4
31271.0,2019-11-24,"(782.5, 981.0]",12,16,-4
31272.0,2019-11-24,"(573.207, 772.25]",8,13,-5
31272.0,2019-11-24,"(772.25, 970.5]",14,27,-13
31272.0,2019-11-24,"(970.5, 1168.75]",1,7,-6
31273.0,2019-11-24,"(444.178, 650.5]",2,3,-1
31273.0,2019-11-24,"(650.5, 856.0]",2,6,-4
31273.0,2019-11-24,"(856.0, 1061.5]",4,7,-3
31273.0,2019-11-24,"(1061.5, 1267.0]",1,2,-1
31274.0,2019-11-24,"(509.358, 670.5]",5,7,-2
31274.0,2019-11-24,"(670.5, 831.0]",8,9,-1
31274.0,2019-11-24,"(831.0, 991.5]",6,8,-2
31274.0,2019-11-24,"(991.5, 1152.0]",7,13,-6
31275.0,2019-11-24,"(319.961, 580.75]",4,9,-5
31275.0,2019-11-24,"(580.75, 840.5]",12,31,-19
31275.0,2019-11-24,"(840.5, 1100.25]",8,11,-3
31275.0,2019-11-24,"(1100.25, 1360.0]",9,10,-1
31276.0,2019-11-24,"(736.321, 906.75]",1,3,-2
31276.0,2019-11-24,"(906.75, 1076.5]",2,4,-2
31276.0,2019-11-24,"(1076.5, 1246.25]",1,2,-1
31276.0,2019-11-24,"(1246.25, 1416.0]",1,2,-1
31277.0,2019-11-24,"(332.138, 548.5]",6,7,-1
31277.0,2019-11-24,"(548.5, 764.0]",5,7,-2
31277.0,2019-11-24,"(764.0, 979.5]",6,8,-2
31277.0,2019-11-24,"(979.5, 1195.0]",5,12,-7
31278.0,2019-11-24,"(154.8, 456.0]",2,3,-1
31278.0,2019-11-24,"(456.0, 756.0]",11,21,-10
31278.0,2019-11-24,"(756.0, 1056.0]",14,27,-13
31278.0,2019-11-24,"(1056.0, 1356.0]",13,20,-7
31279.0,2019-11-24,"(734.712, 807.0]",1,1,0
31279.0,2019-11-24,"(951.0, 1023.0]",2,1,1
31280.0,2019-11-24,"(468.256, 655.0]",4,5,-1
31280.0,2019-11-24,"(655.0, 841.0]",8,16,-8
31280.0,2019-11-24,"(841.0, 1027.0]",9,16,-7
31280.0,2019-11-24,"(1027.0, 1213.0]",6,10,-4
31000.0,2019-11-25,"(688.0, 751.0]",1,1,0
31001.0,2019-11-25,"(828.5, 1030.75]",1,1,0
31001.0,2019-11-25,"(1030.75, 1233.0]",3,2,1
31002.0,2019-11-25,"(450.34, 616.0]",4,6,-2
31002.0,2019-11-25,"(616.0, 781.0]",1,4,-3
31002.0,2019-11-25,"(781.0, 946.0]",2,3,-1
31002.0,2019-11-25,"(946.0, 1111.0]",2,5,-3
31003.0,2019-11-25,"(384.255, 571.25]",2,4,-2
31003.0,2019-11-25,"(571.25, 757.5]",1,2,-1
31003.0,2019-11-25,"(757.5, 943.75]",4,5,-1
31003.0,2019-11-25,"(943.75, 1130.0]",4,8,-4
31004.0,2019-11-25,"(926.0, 1157.0]",3,5,-2
31004.0,2019-11-25,"(1157.0, 1388.0]",2,1,1
31005.0,2019-11-25,"(436.051, 674.25]",8,8,0
31005.0,2019-11-25,"(674.25, 911.5]",1,3,-2
31005.0,2019-11-25,"(911.5, 1148.75]",2,8,-6
31005.0,2019-11-25,"(1148.75, 1386.0]",2,4,-2
31006.0,2019-11-25,"(650.398, 801.5]",2,3,-1
31006.0,2019-11-25,"(952.0, 1102.5]",1,1,0
31006.0,2019-11-25,"(1102.5, 1253.0]",2,3,-1
31007.0,2019-11-25,"(419.049, 657.75]",5,21,-16
31007.0,2019-11-25,"(657.75, 895.5]",6,10,-4
31007.0,2019-11-25,"(895.5, 1133.25]",14,23,-9
31009.0,2019-11-25,"(422.362, 582.5]",6,6,0
31009.0,2019-11-25,"(901.5, 1061.0]",1,3,-2
31010.0,2019-11-25,"(440.203, 640.25]",2,2,0
31010.0,2019-11-25,"(640.25, 839.5]",2,5,-3
31010.0,2019-11-25,"(1038.75, 1238.0]",2,1,1
31011.0,2019-11-25,"(374.149, 587.75]",4,5,-1
31011.0,2019-11-25,"(587.75, 800.5]",3,6,-3
31011.0,2019-11-25,"(800.5, 1013.25]",2,5,-3
31011.0,2019-11-25,"(1013.25, 1226.0]",1,3,-2
31012.0,2019-11-25,"(388.307, 562.25]",4,4,0
31012.0,2019-11-25,"(735.5, 908.75]",1,1,0
31013.0,2019-11-25,"(437.497, 563.75]",1,1,0
31013.0,2019-11-25,"(689.5, 815.25]",1,1,0
31013.0,2019-11-25,"(815.25, 941.0]",2,2,0
31014.0,2019-11-25,"(330.898, 607.5]",20,28,-8
31014.0,2019-11-25,"(607.5, 883.0]",9,12,-3
31014.0,2019-11-25,"(883.0, 1158.5]",10,21,-11
31014.0,2019-11-25,"(1158.5, 1434.0]",6,9,-3
31015.0,2019-11-25,"(304.936, 572.0]",16,19,-3
31015.0,2019-11-25,"(572.0, 838.0]",2,3,-1
31015.0,2019-11-25,"(838.0, 1104.0]",10,22,-12
31015.0,2019-11-25,"(1104.0, 1370.0]",2,2,0
31016.0,2019-11-25,"(504.315, 676.25]",3,9,-6
31016.0,2019-11-25,"(676.25, 847.5]",3,5,-2
31016.0,2019-11-25,"(847.5, 1018.75]",5,7,-2
31016.0,2019-11-25,"(1018.75, 1190.0]",3,10,-7
31017.0,2019-11-25,"(498.131, 716.25]",5,7,-2
31017.0,2019-11-25,"(933.5, 1150.75]",2,1,1
31017.0,2019-11-25,"(1150.75, 1368.0]",1,9,-8
31018.0,2019-11-25,"(388.111, 611.25]",1,5,-4
31018.0,2019-11-25,"(611.25, 833.5]",3,4,-1
31018.0,2019-11-25,"(833.5, 1055.75]",1,3,-2
31018.0,2019-11-25,"(1055.75, 1278.0]",4,6,-2
31019.0,2019-11-25,"(1035.602, 1135.5]",1,6,-5
31020.0,2019-11-25,"(538.153, 750.75]",1,2,-1
31020.0,2019-11-25,"(750.75, 962.5]",1,4,-3
31021.0,2019-11-25,"(353.927, 623.25]",2,4,-2
31021.0,2019-11-25,"(623.25, 891.5]",2,5,-3
31021.0,2019-11-25,"(891.5, 1159.75]",4,6,-2
31021.0,2019-11-25,"(1159.75, 1428.0]",2,2,0
31022.0,2019-11-25,"(698.75, 909.5]",4,5,-1
31022.0,2019-11-25,"(909.5, 1120.25]",3,7,-4
31022.0,2019-11-25,"(1120.25, 1331.0]",3,9,-6
31023.0,2019-11-25,"(540.299, 716.25]",1,1,0
31023.0,2019-11-25,"(1066.75, 1242.0]",1,1,0
31024.0,2019-11-25,"(413.091, 641.25]",4,8,-4
31024.0,2019-11-25,"(641.25, 868.5]",2,3,-1
31024.0,2019-11-25,"(868.5, 1095.75]",5,10,-5
31024.0,2019-11-25,"(1095.75, 1323.0]",4,7,-3
31025.0,2019-11-25,"(511.3, 687.0]",3,4,-1
31025.0,2019-11-25,"(687.0, 862.0]",1,5,-4
31025.0,2019-11-25,"(862.0, 1037.0]",1,1,0
31025.0,2019-11-25,"(1037.0, 1212.0]",2,3,-1
31026.0,2019-11-25,"(970.25, 1157.0]",1,1,0
31027.0,2019-11-25,"(865.5, 1056.75]",3,1,2
31027.0,2019-11-25,"(1056.75, 1248.0]",2,4,-2
31028.0,2019-11-25,"(481.335, 648.25]",1,2,-1
31028.0,2019-11-25,"(814.5, 980.75]",1,2,-1
31028.0,2019-11-25,"(980.75, 1147.0]",2,1,1
31029.0,2019-11-25,"(669.0, 893.0]",1,5,-4
31029.0,2019-11-25,"(893.0, 1117.0]",1,2,-1
31029.0,2019-11-25,"(1117.0, 1341.0]",4,3,1
31030.0,2019-11-25,"(347.96, 609.0]",1,10,-9
31030.0,2019-11-25,"(609.0, 869.0]",1,2,-1
31030.0,2019-11-25,"(869.0, 1129.0]",7,8,-1
31030.0,2019-11-25,"(1129.0, 1389.0]",3,4,-1
31031.0,2019-11-25,"(943.0, 1180.5]",3,3,0
31031.0,2019-11-25,"(1180.5, 1418.0]",2,4,-2
31032.0,2019-11-25,"(415.25, 485.5]",1,1,0
31033.0,2019-11-25,"(536.326, 705.5]",1,1,0
31033.0,2019-11-25,"(1042.5, 1211.0]",3,5,-2
31034.0,2019-11-25,"(478.115, 700.25]",2,3,-1
31034.0,2019-11-25,"(921.5, 1142.75]",2,6,-4
31034.0,2019-11-25,"(1142.75, 1364.0]",1,2,-1
31035.0,2019-11-25,"(334.925, 604.75]",2,4,-2
31035.0,2019-11-25,"(873.5, 1142.25]",4,2,2
31035.0,2019-11-25,"(1142.25, 1411.0]",4,6,-2
31036.0,2019-11-25,"(586.25, 774.5]",2,4,-2
31036.0,2019-11-25,"(962.75, 1151.0]",6,5,1
31037.0,2019-11-25,"(401.047, 640.25]",11,18,-7
31037.0,2019-11-25,"(640.25, 878.5]",2,5,-3
31037.0,2019-11-25,"(878.5, 1116.75]",5,21,-16
31037.0,2019-11-25,"(1116.75, 1355.0]",2,8,-6
31038.0,2019-11-25,"(695.583, 800.25]",2,4,-2
31038.0,2019-11-25,"(904.5, 1008.75]",1,2,-1
31038.0,2019-11-25,"(1008.75, 1113.0]",1,1,0
31039.0,2019-11-25,"(458.048, 697.0]",3,8,-5
31039.0,2019-11-25,"(697.0, 935.0]",2,3,-1
31040.0,2019-11-25,"(437.116, 659.0]",4,5,-1
31040.0,2019-11-25,"(659.0, 880.0]",2,2,0
31040.0,2019-11-25,"(1101.0, 1322.0]",1,6,-5
31041.0,2019-11-25,"(453.316, 625.0]",2,3,-1
31041.0,2019-11-25,"(625.0, 796.0]",1,1,0
31041.0,2019-11-25,"(796.0, 967.0]",1,2,-1
31041.0,2019-11-25,"(967.0, 1138.0]",2,4,-2
31042.0,2019-11-25,"(434.124, 654.0]",9,10,-1
31042.0,2019-11-25,"(654.0, 873.0]",4,7,-3
31042.0,2019-11-25,"(873.0, 1092.0]",1,9,-8
31043.0,2019-11-25,"(467.75, 536.5]",1,1,0
31044.0,2019-11-25,"(623.75, 770.5]",1,1,0
31044.0,2019-11-25,"(917.25, 1064.0]",2,1,1
31045.0,2019-11-25,"(512.382, 667.5]",2,4,-2
31045.0,2019-11-25,"(667.5, 822.0]",1,1,0
31045.0,2019-11-25,"(976.5, 1131.0]",3,4,-1
31046.0,2019-11-25,"(867.5, 1051.25]",1,1,0
31046.0,2019-11-25,"(1051.25, 1235.0]",2,1,1
31047.0,2019-11-25,"(23.708, 348.0]",1,1,0
31047.0,2019-11-25,"(348.0, 671.0]",19,31,-12
31047.0,2019-11-25,"(671.0, 994.0]",6,12,-6
31047.0,2019-11-25,"(994.0, 1317.0]",11,34,-23
31048.0,2019-11-25,"(406.116, 628.0]",3,4,-1
31048.0,2019-11-25,"(849.0, 1070.0]",3,1,2
31049.0,2019-11-25,"(581.285, 760.75]",1,2,-1
31049.0,2019-11-25,"(1118.25, 1297.0]",1,1,0
31050.0,2019-11-25,"(349.833, 391.75]",1,1,0
31051.0,2019-11-25,"(719.0, 927.5]",1,4,-3
31051.0,2019-11-25,"(927.5, 1136.0]",7,2,5
31052.0,2019-11-25,"(449.272, 632.0]",5,8,-3
31052.0,2019-11-25,"(632.0, 814.0]",2,2,0
31052.0,2019-11-25,"(814.0, 996.0]",1,1,0
31052.0,2019-11-25,"(996.0, 1178.0]",4,8,-4
31053.0,2019-11-25,"(877.5, 1170.0]",2,1,1
,,,,2.0,
31055.0,2019-11-25,"(926.75, 1072.0]",2,1,1
31056.0,2019-11-25,"(994.5, 1185.0]",2,2,0
,,,,2.0,
31058.0,2019-11-25,"(774.0, 1032.0]",1,1,0
31059.0,2019-11-25,"(746.5, 909.75]",4,1,3
31059.0,2019-11-25,"(909.75, 1073.0]",1,9,-8
31060.0,2019-11-25,"(835.71, 908.5]",2,4,-2
31060.0,2019-11-25,"(1053.5, 1126.0]",1,1,0
31061.0,2019-11-25,"(520.413, 667.75]",1,1,0
31061.0,2019-11-25,"(961.25, 1108.0]",2,3,-1
31062.0,2019-11-25,"(662.5, 827.0]",11,1,10
31062.0,2019-11-25,"(827.0, 991.5]",1,22,-21
31062.0,2019-11-25,"(991.5, 1156.0]",3,2,1
31063.0,2019-11-25,"(825.815, 872.25]",2,4,-2
31063.0,2019-11-25,"(918.5, 964.75]",1,1,0
31063.0,2019-11-25,"(964.75, 1011.0]",1,1,0
31064.0,2019-11-25,"(486.321, 656.75]",1,3,-2
31064.0,2019-11-25,"(656.75, 826.5]",8,16,-8
31064.0,2019-11-25,"(826.5, 996.25]",3,6,-3
31064.0,2019-11-25,"(996.25, 1166.0]",4,9,-5
31065.0,2019-11-25,"(753.5, 914.75]",1,3,-2
31065.0,2019-11-25,"(914.75, 1076.0]",2,1,1
,,,,1.0,
,,,,1.0,
31067.0,2019-11-25,"(952.5, 1181.75]",3,2,1
31068.0,2019-11-25,"(629.278, 810.5]",1,2,-1
31068.0,2019-11-25,"(991.0, 1171.5]",2,2,0
31068.0,2019-11-25,"(1171.5, 1352.0]",2,2,0
31069.0,2019-11-25,"(626.25, 824.5]",1,2,-1
31069.0,2019-11-25,"(824.5, 1022.75]",5,1,4
31069.0,2019-11-25,"(1022.75, 1221.0]",3,8,-5
31070.0,2019-11-25,"(823.5, 1021.0]",1,1,0
31070.0,2019-11-25,"(1218.5, 1416.0]",1,1,0
31071.0,2019-11-25,"(409.181, 614.75]",3,10,-7
31071.0,2019-11-25,"(614.75, 819.5]",10,18,-8
31071.0,2019-11-25,"(819.5, 1024.25]",1,2,-1
31071.0,2019-11-25,"(1024.25, 1229.0]",4,6,-2
,,,,2.0,
31073.0,2019-11-25,"(494.124, 714.0]",1,2,-1
31073.0,2019-11-25,"(933.0, 1152.0]",2,1,1
31073.0,2019-11-25,"(1152.0, 1371.0]",1,3,-2
31074.0,2019-11-25,"(857.0, 1025.0]",2,2,0
31074.0,2019-11-25,"(1025.0, 1193.0]",5,3,2
31075.0,2019-11-25,"(981.75, 1131.0]",2,1,1
31076.0,2019-11-25,"(428.363, 588.25]",1,2,-1
31076.0,2019-11-25,"(747.5, 906.75]",1,1,0
31076.0,2019-11-25,"(906.75, 1066.0]",1,1,0
31077.0,2019-11-25,"(395.09, 623.5]",1,9,-8
31077.0,2019-11-25,"(623.5, 851.0]",8,11,-3
31077.0,2019-11-25,"(851.0, 1078.5]",11,13,-2
31077.0,2019-11-25,"(1078.5, 1306.0]",1,2,-1
31078.0,2019-11-25,"(469.401, 619.75]",9,12,-3
31078.0,2019-11-25,"(919.25, 1069.0]",1,6,-5
31079.0,2019-11-25,"(323.971, 582.25]",1,9,-8
31079.0,2019-11-25,"(582.25, 839.5]",1,4,-3
31079.0,2019-11-25,"(839.5, 1096.75]",3,5,-2
31079.0,2019-11-25,"(1096.75, 1354.0]",5,6,-1
31080.0,2019-11-25,"(64.658, 401.5]",1,1,0
31080.0,2019-11-25,"(401.5, 737.0]",1,12,-11
31080.0,2019-11-25,"(737.0, 1072.5]",3,7,-4
31080.0,2019-11-25,"(1072.5, 1408.0]",4,4,0
31081.0,2019-11-25,"(474.36, 635.0]",2,2,0
31081.0,2019-11-25,"(795.0, 955.0]",1,1,0
,,,,2.0,
31083.0,2019-11-25,"(619.75, 853.5]",1,3,-2
31083.0,2019-11-25,"(853.5, 1087.25]",3,3,0
31083.0,2019-11-25,"(1087.25, 1321.0]",3,5,-2
31084.0,2019-11-25,"(565.47, 698.5]",3,3,0
,,,,1.0,
,,,,1.0,
31086.0,2019-11-25,"(583.25, 754.5]",1,3,-2
31086.0,2019-11-25,"(925.75, 1097.0]",4,1,3
31087.0,2019-11-25,"(987.0, 1145.0]",2,1,1
31088.0,2019-11-25,"(806.5, 1012.75]",1,4,-3
31088.0,2019-11-25,"(1012.75, 1219.0]",6,1,5
31089.0,2019-11-25,"(467.11, 690.5]",7,13,-6
31089.0,2019-11-25,"(690.5, 913.0]",1,3,-2
31089.0,2019-11-25,"(913.0, 1135.5]",4,18,-14
31089.0,2019-11-25,"(1135.5, 1358.0]",4,17,-13
31090.0,2019-11-25,"(669.75, 806.5]",1,1,0
31090.0,2019-11-25,"(943.25, 1080.0]",4,2,2
31091.0,2019-11-25,"(758.0, 953.5]",1,3,-2
31091.0,2019-11-25,"(953.5, 1149.0]",4,1,3
31092.0,2019-11-25,"(870.0, 1067.5]",2,1,1
31092.0,2019-11-25,"(1067.5, 1265.0]",1,3,-2
31093.0,2019-11-25,"(900.75, 1067.0]",1,2,-1
31094.0,2019-11-25,"(563.5, 845.25]",1,1,0
31094.0,2019-11-25,"(845.25, 1127.0]",1,1,0
,,,,2.0,
31096.0,2019-11-25,"(525.341, 690.75]",2,3,-1
31096.0,2019-11-25,"(855.5, 1020.25]",1,2,-1
31096.0,2019-11-25,"(1020.25, 1185.0]",1,2,-1
31097.0,2019-11-25,"(875.0, 1066.0]",2,1,1
31097.0,2019-11-25,"(1066.0, 1257.0]",2,3,-1
31098.0,2019-11-25,"(425.253, 612.75]",7,12,-5
31098.0,2019-11-25,"(986.25, 1173.0]",8,1,7
31099.0,2019-11-25,"(451.193, 653.75]",1,2,-1
31099.0,2019-11-25,"(1057.25, 1259.0]",3,4,-1
31100.0,2019-11-25,"(434.254, 621.5]",14,15,-1
31100.0,2019-11-25,"(621.5, 808.0]",1,4,-3
31100.0,2019-11-25,"(808.0, 994.5]",7,13,-6
31100.0,2019-11-25,"(994.5, 1181.0]",2,18,-16
31101.0,2019-11-25,"(281.859, 568.25]",8,41,-33
31101.0,2019-11-25,"(568.25, 853.5]",18,31,-13
31101.0,2019-11-25,"(853.5, 1138.75]",39,67,-28
31101.0,2019-11-25,"(1138.75, 1424.0]",24,36,-12
31102.0,2019-11-25,"(832.5, 1126.75]",9,12,-3
31102.0,2019-11-25,"(1126.75, 1421.0]",10,8,2
31103.0,2019-11-25,"(321.886, 601.5]",1,38,-37
31103.0,2019-11-25,"(601.5, 880.0]",1,14,-13
31103.0,2019-11-25,"(880.0, 1158.5]",13,29,-16
31103.0,2019-11-25,"(1158.5, 1437.0]",8,18,-10
31104.0,2019-11-25,"(45.713, 368.75]",1,6,-5
31104.0,2019-11-25,"(368.75, 690.5]",1,9,-8
31104.0,2019-11-25,"(690.5, 1012.25]",20,29,-9
31104.0,2019-11-25,"(1012.25, 1334.0]",15,27,-12
31105.0,2019-11-25,"(386.093, 613.75]",1,6,-5
31105.0,2019-11-25,"(613.75, 840.5]",2,3,-1
31105.0,2019-11-25,"(840.5, 1067.25]",5,13,-8
31105.0,2019-11-25,"(1067.25, 1294.0]",2,8,-6
31106.0,2019-11-25,"(451.264, 636.0]",1,8,-7
31106.0,2019-11-25,"(820.0, 1004.0]",1,1,0
31106.0,2019-11-25,"(1004.0, 1188.0]",5,1,4
31107.0,2019-11-25,"(250.825, 545.75]",2,21,-19
31107.0,2019-11-25,"(545.75, 839.5]",8,10,-2
31107.0,2019-11-25,"(839.5, 1133.25]",15,33,-18
31107.0,2019-11-25,"(1133.25, 1427.0]",9,15,-6
31108.0,2019-11-25,"(362.75, 706.5]",9,1,8
31108.0,2019-11-25,"(706.5, 1050.25]",25,22,3
31108.0,2019-11-25,"(1050.25, 1394.0]",21,44,-23
31109.0,2019-11-25,"(330.069, 563.75]",7,24,-17
31109.0,2019-11-25,"(563.75, 796.5]",1,3,-2
31109.0,2019-11-25,"(796.5, 1029.25]",12,24,-12
31109.0,2019-11-25,"(1029.25, 1262.0]",20,27,-7
31110.0,2019-11-25,"(314.897, 591.75]",16,42,-26
31110.0,2019-11-25,"(591.75, 867.5]",5,11,-6
31110.0,2019-11-25,"(867.5, 1143.25]",25,39,-14
31110.0,2019-11-25,"(1143.25, 1419.0]",4,9,-5
31111.0,2019-11-25,"(382.059, 618.25]",9,28,-19
31111.0,2019-11-25,"(618.25, 853.5]",1,3,-2
31111.0,2019-11-25,"(853.5, 1088.75]",7,9,-2
31111.0,2019-11-25,"(1088.75, 1324.0]",7,12,-5
31112.0,2019-11-25,"(525.257, 711.75]",1,5,-4
31112.0,2019-11-25,"(897.5, 1083.25]",1,3,-2
31112.0,2019-11-25,"(1083.25, 1269.0]",4,5,-1
31113.0,2019-11-25,"(86.683, 417.25]",2,4,-2
31113.0,2019-11-25,"(417.25, 746.5]",2,19,-17
31113.0,2019-11-25,"(746.5, 1075.75]",8,14,-6
31113.0,2019-11-25,"(1075.75, 1405.0]",9,20,-11
31114.0,2019-11-25,"(-1.42, 355.0]",2,2,0
31114.0,2019-11-25,"(355.0, 710.0]",5,27,-22
31114.0,2019-11-25,"(710.0, 1065.0]",12,26,-14
31114.0,2019-11-25,"(1065.0, 1420.0]",21,29,-8
31115.0,2019-11-25,"(347.013, 594.75]",1,19,-18
31115.0,2019-11-25,"(594.75, 841.5]",1,2,-1
31115.0,2019-11-25,"(841.5, 1088.25]",8,11,-3
31115.0,2019-11-25,"(1088.25, 1335.0]",10,17,-7
31116.0,2019-11-25,"(334.921, 605.75]",9,32,-23
31116.0,2019-11-25,"(605.75, 875.5]",2,4,-2
31116.0,2019-11-25,"(875.5, 1145.25]",21,25,-4
31116.0,2019-11-25,"(1145.25, 1415.0]",6,12,-6
31117.0,2019-11-25,"(170.908, 445.0]",1,8,-7
31117.0,2019-11-25,"(445.0, 718.0]",2,5,-3
31117.0,2019-11-25,"(718.0, 991.0]",2,4,-2
31117.0,2019-11-25,"(991.0, 1264.0]",1,2,-1
31118.0,2019-11-25,"(437.1, 663.0]",6,16,-10
31118.0,2019-11-25,"(888.0, 1113.0]",12,1,11
31118.0,2019-11-25,"(1113.0, 1338.0]",10,18,-8
31119.0,2019-11-25,"(343.925, 613.75]",9,22,-13
31119.0,2019-11-25,"(613.75, 882.5]",4,8,-4
31119.0,2019-11-25,"(882.5, 1151.25]",13,19,-6
31119.0,2019-11-25,"(1151.25, 1420.0]",10,16,-6
31120.0,2019-11-25,"(239.835, 532.25]",2,16,-14
31120.0,2019-11-25,"(532.25, 823.5]",3,4,-1
31120.0,2019-11-25,"(823.5, 1114.75]",6,9,-3
31120.0,2019-11-25,"(1114.75, 1406.0]",9,14,-5
31121.0,2019-11-25,"(191.783, 497.25]",6,10,-4
31121.0,2019-11-25,"(497.25, 801.5]",2,8,-6
31121.0,2019-11-25,"(801.5, 1105.75]",4,11,-7
31121.0,2019-11-25,"(1105.75, 1410.0]",5,10,-5
31122.0,2019-11-25,"(24.62, 371.0]",2,3,-1
31122.0,2019-11-25,"(371.0, 716.0]",3,7,-4
31122.0,2019-11-25,"(716.0, 1061.0]",8,14,-6
31122.0,2019-11-25,"(1061.0, 1406.0]",7,11,-4
31123.0,2019-11-25,"(364.25, 681.5]",1,1,0
31123.0,2019-11-25,"(998.75, 1316.0]",11,11,0
31124.0,2019-11-25,"(66.637, 408.75]",2,2,0
31124.0,2019-11-25,"(408.75, 749.5]",12,57,-45
31124.0,2019-11-25,"(749.5, 1090.25]",15,53,-38
31124.0,2019-11-25,"(1090.25, 1431.0]",21,48,-27
31125.0,2019-11-25,"(79.66, 416.0]",1,5,-4
31125.0,2019-11-25,"(416.0, 751.0]",8,29,-21
31125.0,2019-11-25,"(751.0, 1086.0]",17,28,-11
31125.0,2019-11-25,"(1086.0, 1421.0]",20,28,-8
31126.0,2019-11-25,"(392.052, 630.0]",3,25,-22
31126.0,2019-11-25,"(630.0, 867.0]",3,11,-8
31126.0,2019-11-25,"(867.0, 1104.0]",15,23,-8
31126.0,2019-11-25,"(1104.0, 1341.0]",15,23,-8
31127.0,2019-11-25,"(37.775, 345.25]",1,2,-1
31127.0,2019-11-25,"(345.25, 651.5]",7,10,-3
31127.0,2019-11-25,"(651.5, 957.75]",12,23,-11
31127.0,2019-11-25,"(957.75, 1264.0]",10,34,-24
31128.0,2019-11-25,"(-0.385, 347.25]",1,3,-2
31128.0,2019-11-25,"(347.25, 693.5]",26,36,-10
31128.0,2019-11-25,"(693.5, 1039.75]",19,38,-19
31128.0,2019-11-25,"(1039.75, 1386.0]",16,29,-13
31129.0,2019-11-25,"(469.041, 709.75]",16,21,-5
31129.0,2019-11-25,"(709.75, 949.5]",10,20,-10
31129.0,2019-11-25,"(949.5, 1189.25]",9,21,-12
31130.0,2019-11-25,"(27.626, 372.5]",2,3,-1
31130.0,2019-11-25,"(372.5, 716.0]",4,18,-14
31130.0,2019-11-25,"(716.0, 1059.5]",3,4,-1
31130.0,2019-11-25,"(1059.5, 1403.0]",18,20,-2
31131.0,2019-11-25,"(624.0, 869.0]",1,8,-7
31131.0,2019-11-25,"(869.0, 1114.0]",4,7,-3
31131.0,2019-11-25,"(1114.0, 1359.0]",5,11,-6
31200.0,2019-11-25,"(16.616, 364.0]",1,3,-2
31200.0,2019-11-25,"(364.0, 710.0]",32,44,-12
31200.0,2019-11-25,"(710.0, 1056.0]",17,34,-17
31200.0,2019-11-25,"(1056.0, 1402.0]",26,46,-20
31201.0,2019-11-25,"(5.609, 354.75]",2,3,-1
31201.0,2019-11-25,"(354.75, 702.5]",24,60,-36
31201.0,2019-11-25,"(702.5, 1050.25]",39,57,-18
31201.0,2019-11-25,"(1050.25, 1398.0]",29,63,-34
31202.0,2019-11-25,"(432.071, 665.25]",9,24,-15
31202.0,2019-11-25,"(665.25, 897.5]",4,9,-5
31202.0,2019-11-25,"(897.5, 1129.75]",25,40,-15
31202.0,2019-11-25,"(1129.75, 1362.0]",14,29,-15
31203.0,2019-11-25,"(331.928, 601.0]",10,30,-20
31203.0,2019-11-25,"(601.0, 869.0]",12,28,-16
31203.0,2019-11-25,"(869.0, 1137.0]",30,44,-14
31203.0,2019-11-25,"(1137.0, 1405.0]",8,22,-14
31204.0,2019-11-25,"(29.772, 338.0]",1,1,0
31204.0,2019-11-25,"(338.0, 645.0]",11,11,0
31204.0,2019-11-25,"(645.0, 952.0]",8,17,-9
31204.0,2019-11-25,"(952.0, 1259.0]",7,28,-21
31205.0,2019-11-25,"(135.706, 460.5]",1,2,-1
31205.0,2019-11-25,"(460.5, 784.0]",47,55,-8
31205.0,2019-11-25,"(784.0, 1107.5]",30,50,-20
31205.0,2019-11-25,"(1107.5, 1431.0]",4,27,-23
31206.0,2019-11-25,"(456.069, 689.75]",9,9,0
31206.0,2019-11-25,"(689.75, 922.5]",1,3,-2
31206.0,2019-11-25,"(922.5, 1155.25]",3,10,-7
31207.0,2019-11-25,"(1153.0, 1374.0]",3,1,2
31208.0,2019-11-25,"(393.258, 579.5]",10,11,-1
31208.0,2019-11-25,"(579.5, 765.0]",1,1,0
31208.0,2019-11-25,"(950.5, 1136.0]",4,2,2
31209.0,2019-11-25,"(826.0, 1054.0]",5,1,4
31211.0,2019-11-25,"(397.005, 646.75]",12,15,-3
31211.0,2019-11-25,"(646.75, 895.5]",5,10,-5
31211.0,2019-11-25,"(895.5, 1144.25]",7,17,-10
31212.0,2019-11-25,"(103.696, 431.0]",4,9,-5
31212.0,2019-11-25,"(431.0, 757.0]",23,33,-10
31212.0,2019-11-25,"(757.0, 1083.0]",16,40,-24
31212.0,2019-11-25,"(1083.0, 1409.0]",6,15,-9
31213.0,2019-11-25,"(368.068, 602.0]",28,43,-15
31213.0,2019-11-25,"(602.0, 835.0]",7,15,-8
31213.0,2019-11-25,"(835.0, 1068.0]",15,29,-14
31213.0,2019-11-25,"(1068.0, 1301.0]",10,20,-10
31214.0,2019-11-25,"(365.927, 635.25]",10,37,-27
31214.0,2019-11-25,"(635.25, 903.5]",11,22,-11
31214.0,2019-11-25,"(903.5, 1171.75]",33,50,-17
31214.0,2019-11-25,"(1171.75, 1440.0]",15,27,-12
31215.0,2019-11-25,"(45.701, 371.75]",1,2,-1
31215.0,2019-11-25,"(371.75, 696.5]",25,28,-3
31215.0,2019-11-25,"(696.5, 1021.25]",9,15,-6
31215.0,2019-11-25,"(1021.25, 1346.0]",4,12,-8
31216.0,2019-11-25,"(350.144, 565.0]",19,21,-2
31216.0,2019-11-25,"(565.0, 779.0]",1,3,-2
31216.0,2019-11-25,"(779.0, 993.0]",5,12,-7
31216.0,2019-11-25,"(993.0, 1207.0]",3,23,-20
31217.0,2019-11-25,"(383.173, 590.75]",16,19,-3
31217.0,2019-11-25,"(590.75, 797.5]",5,8,-3
31217.0,2019-11-25,"(797.5, 1004.25]",3,10,-7
31217.0,2019-11-25,"(1004.25, 1211.0]",1,6,-5
31218.0,2019-11-25,"(379.174, 586.5]",11,29,-18
31218.0,2019-11-25,"(586.5, 793.0]",6,12,-6
31218.0,2019-11-25,"(793.0, 999.5]",11,17,-6
31218.0,2019-11-25,"(999.5, 1206.0]",9,18,-9
31219.0,2019-11-25,"(400.154, 612.5]",15,15,0
31219.0,2019-11-25,"(612.5, 824.0]",2,7,-5
31219.0,2019-11-25,"(824.0, 1035.5]",13,25,-12
31219.0,2019-11-25,"(1035.5, 1247.0]",1,10,-9
31220.0,2019-11-25,"(283.19, 486.5]",10,13,-3
31220.0,2019-11-25,"(486.5, 689.0]",7,10,-3
31220.0,2019-11-25,"(689.0, 891.5]",5,9,-4
31220.0,2019-11-25,"(891.5, 1094.0]",5,24,-19
31221.0,2019-11-25,"(23.611, 372.25]",1,1,0
31221.0,2019-11-25,"(372.25, 719.5]",28,32,-4
31221.0,2019-11-25,"(719.5, 1066.75]",23,50,-27
31221.0,2019-11-25,"(1066.75, 1414.0]",9,25,-16
31222.0,2019-11-25,"(359.028, 603.0]",15,15,0
31222.0,2019-11-25,"(603.0, 846.0]",3,8,-5
31222.0,2019-11-25,"(846.0, 1089.0]",2,16,-14
31223.0,2019-11-25,"(44.611, 393.25]",1,2,-1
31223.0,2019-11-25,"(393.25, 740.5]",16,46,-30
31223.0,2019-11-25,"(740.5, 1087.75]",10,24,-14
31223.0,2019-11-25,"(1087.75, 1435.0]",14,21,-7
31224.0,2019-11-25,"(378.958, 640.5]",9,9,0
31224.0,2019-11-25,"(640.5, 901.0]",5,11,-6
31224.0,2019-11-25,"(901.0, 1161.5]",6,22,-16
31225.0,2019-11-25,"(424.036, 666.0]",7,13,-6
31225.0,2019-11-25,"(666.0, 907.0]",5,7,-2
31225.0,2019-11-25,"(907.0, 1148.0]",7,13,-6
31225.0,2019-11-25,"(1148.0, 1389.0]",2,4,-2
31226.0,2019-11-25,"(94.812, 393.0]",1,2,-1
31226.0,2019-11-25,"(393.0, 690.0]",3,10,-7
31226.0,2019-11-25,"(690.0, 987.0]",4,8,-4
31226.0,2019-11-25,"(987.0, 1284.0]",7,12,-5
31227.0,2019-11-25,"(450.324, 620.0]",55,59,-4
31227.0,2019-11-25,"(620.0, 789.0]",2,5,-3
31227.0,2019-11-25,"(789.0, 958.0]",3,6,-3
31227.0,2019-11-25,"(958.0, 1127.0]",8,18,-10
31228.0,2019-11-25,"(4.612, 353.0]",2,3,-1
31228.0,2019-11-25,"(353.0, 700.0]",19,32,-13
31228.0,2019-11-25,"(700.0, 1047.0]",24,40,-16
31228.0,2019-11-25,"(1047.0, 1394.0]",22,47,-25
31229.0,2019-11-25,"(375.0, 724.0]",14,5,9
31229.0,2019-11-25,"(724.0, 1073.0]",28,48,-20
31229.0,2019-11-25,"(1073.0, 1422.0]",28,48,-20
31230.0,2019-11-25,"(400.012, 648.0]",45,58,-13
31230.0,2019-11-25,"(648.0, 895.0]",11,19,-8
31230.0,2019-11-25,"(895.0, 1142.0]",19,42,-23
31230.0,2019-11-25,"(1142.0, 1389.0]",7,18,-11
31231.0,2019-11-25,"(394.981, 650.75]",22,24,-2
31231.0,2019-11-25,"(650.75, 905.5]",8,13,-5
31231.0,2019-11-25,"(905.5, 1160.25]",7,23,-16
31232.0,2019-11-25,"(339.95, 603.5]",13,17,-4
31232.0,2019-11-25,"(603.5, 866.0]",6,12,-6
31232.0,2019-11-25,"(866.0, 1128.5]",20,31,-11
31232.0,2019-11-25,"(1128.5, 1391.0]",2,11,-9
31233.0,2019-11-25,"(369.01, 617.5]",43,46,-3
31233.0,2019-11-25,"(617.5, 865.0]",13,22,-9
31233.0,2019-11-25,"(865.0, 1112.5]",18,39,-21
31233.0,2019-11-25,"(1112.5, 1360.0]",5,16,-11
31234.0,2019-11-25,"(28.732, 347.0]",1,1,0
31234.0,2019-11-25,"(347.0, 664.0]",18,36,-18
31234.0,2019-11-25,"(664.0, 981.0]",10,21,-11
31234.0,2019-11-25,"(981.0, 1298.0]",17,33,-16
31235.0,2019-11-25,"(462.419, 608.25]",5,5,0
31235.0,2019-11-25,"(608.25, 753.5]",4,6,-2
31235.0,2019-11-25,"(753.5, 898.75]",1,1,0
31235.0,2019-11-25,"(898.75, 1044.0]",1,5,-4
31236.0,2019-11-25,"(92.741, 408.75]",1,2,-1
31236.0,2019-11-25,"(408.75, 723.5]",26,37,-11
31236.0,2019-11-25,"(723.5, 1038.25]",16,40,-24
31236.0,2019-11-25,"(1038.25, 1353.0]",5,19,-14
31237.0,2019-11-25,"(139.706, 464.5]",1,4,-3
31237.0,2019-11-25,"(464.5, 788.0]",14,27,-13
31237.0,2019-11-25,"(788.0, 1111.5]",14,23,-9
31237.0,2019-11-25,"(1111.5, 1435.0]",12,23,-11
31238.0,2019-11-25,"(51.614, 399.5]",1,2,-1
31238.0,2019-11-25,"(399.5, 746.0]",10,19,-9
31238.0,2019-11-25,"(746.0, 1092.5]",10,36,-26
31238.0,2019-11-25,"(1092.5, 1439.0]",4,11,-7
31239.0,2019-11-25,"(404.153, 616.75]",29,34,-5
31239.0,2019-11-25,"(616.75, 828.5]",6,12,-6
31239.0,2019-11-25,"(828.5, 1040.25]",6,12,-6
31239.0,2019-11-25,"(1040.25, 1252.0]",6,20,-14
31240.0,2019-11-25,"(593.66, 679.0]",2,4,-2
31240.0,2019-11-25,"(679.0, 764.0]",3,6,-3
31240.0,2019-11-25,"(764.0, 849.0]",3,6,-3
31240.0,2019-11-25,"(849.0, 934.0]",2,4,-2
31241.0,2019-11-25,"(9.578, 366.5]",3,5,-2
31241.0,2019-11-25,"(366.5, 722.0]",23,51,-28
31241.0,2019-11-25,"(722.0, 1077.5]",9,26,-17
31241.0,2019-11-25,"(1077.5, 1433.0]",18,40,-22
31242.0,2019-11-25,"(397.218, 593.5]",31,31,0
31242.0,2019-11-25,"(593.5, 789.0]",16,18,-2
31242.0,2019-11-25,"(789.0, 984.5]",2,11,-9
31242.0,2019-11-25,"(984.5, 1180.0]",3,24,-21
31243.0,2019-11-25,"(354.014, 601.5]",35,40,-5
31243.0,2019-11-25,"(601.5, 848.0]",3,4,-1
31243.0,2019-11-25,"(848.0, 1094.5]",13,34,-21
31243.0,2019-11-25,"(1094.5, 1341.0]",9,20,-11
31244.0,2019-11-25,"(353.036, 595.0]",23,35,-12
31244.0,2019-11-25,"(595.0, 836.0]",5,10,-5
31244.0,2019-11-25,"(836.0, 1077.0]",8,27,-19
31244.0,2019-11-25,"(1077.0, 1318.0]",7,13,-6
31245.0,2019-11-25,"(385.956, 648.0]",6,21,-15
31245.0,2019-11-25,"(648.0, 909.0]",6,10,-4
31245.0,2019-11-25,"(909.0, 1170.0]",12,24,-12
31245.0,2019-11-25,"(1170.0, 1431.0]",5,8,-3
31246.0,2019-11-25,"(348.96, 610.0]",9,15,-6
31246.0,2019-11-25,"(610.0, 870.0]",11,18,-7
31246.0,2019-11-25,"(870.0, 1130.0]",14,34,-20
31246.0,2019-11-25,"(1130.0, 1390.0]",7,14,-7
31247.0,2019-11-25,"(439.144, 654.0]",25,37,-12
31247.0,2019-11-25,"(654.0, 868.0]",15,24,-9
31247.0,2019-11-25,"(868.0, 1082.0]",13,35,-22
31247.0,2019-11-25,"(1082.0, 1296.0]",6,14,-8
31248.0,2019-11-25,"(30.813, 328.75]",1,1,0
31248.0,2019-11-25,"(328.75, 625.5]",10,15,-5
31248.0,2019-11-25,"(625.5, 922.25]",19,37,-18
31248.0,2019-11-25,"(922.25, 1219.0]",20,29,-9
31249.0,2019-11-25,"(419.381, 574.75]",3,6,-3
31249.0,2019-11-25,"(574.75, 729.5]",10,22,-12
31249.0,2019-11-25,"(729.5, 884.25]",16,34,-18
31249.0,2019-11-25,"(884.25, 1039.0]",10,15,-5
31250.0,2019-11-25,"(410.082, 640.5]",14,16,-2
31250.0,2019-11-25,"(640.5, 870.0]",4,11,-7
31250.0,2019-11-25,"(870.0, 1099.5]",8,24,-16
31250.0,2019-11-25,"(1099.5, 1329.0]",4,11,-7
31251.0,2019-11-25,"(364.969, 623.75]",21,41,-20
31251.0,2019-11-25,"(623.75, 881.5]",7,11,-4
31251.0,2019-11-25,"(881.5, 1139.25]",9,27,-18
31251.0,2019-11-25,"(1139.25, 1397.0]",11,16,-5
31252.0,2019-11-25,"(470.049, 708.75]",14,14,0
31252.0,2019-11-25,"(708.75, 946.5]",1,2,-1
31253.0,2019-11-25,"(403.08, 634.0]",19,22,-3
31253.0,2019-11-25,"(634.0, 864.0]",9,15,-6
31253.0,2019-11-25,"(864.0, 1094.0]",12,26,-14
31253.0,2019-11-25,"(1094.0, 1324.0]",1,14,-13
31254.0,2019-11-25,"(459.23, 652.5]",23,26,-3
31254.0,2019-11-25,"(652.5, 845.0]",7,16,-9
31254.0,2019-11-25,"(845.0, 1037.5]",5,20,-15
31254.0,2019-11-25,"(1037.5, 1230.0]",7,23,-16
31255.0,2019-11-25,"(398.067, 632.25]",13,17,-4
31255.0,2019-11-25,"(632.25, 865.5]",3,9,-6
31255.0,2019-11-25,"(865.5, 1098.75]",7,19,-12
31255.0,2019-11-25,"(1098.75, 1332.0]",5,9,-4
31256.0,2019-11-25,"(277.093, 504.75]",6,6,0
31256.0,2019-11-25,"(504.75, 731.5]",11,13,-2
31256.0,2019-11-25,"(731.5, 958.25]",2,6,-4
31256.0,2019-11-25,"(958.25, 1185.0]",9,20,-11
31257.0,2019-11-25,"(32.731, 351.25]",4,4,0
31257.0,2019-11-25,"(351.25, 668.5]",16,29,-13
31257.0,2019-11-25,"(668.5, 985.75]",15,31,-16
31257.0,2019-11-25,"(985.75, 1303.0]",16,44,-28
31258.0,2019-11-25,"(452.202, 652.5]",8,14,-6
31258.0,2019-11-25,"(652.5, 852.0]",13,34,-21
31258.0,2019-11-25,"(852.0, 1051.5]",16,27,-11
31258.0,2019-11-25,"(1051.5, 1251.0]",4,8,-4
31259.0,2019-11-25,"(454.076, 686.0]",15,15,0
31259.0,2019-11-25,"(686.0, 917.0]",3,7,-4
31259.0,2019-11-25,"(917.0, 1148.0]",1,7,-6
31260.0,2019-11-25,"(389.072, 622.0]",14,17,-3
31260.0,2019-11-25,"(622.0, 854.0]",3,7,-4
31260.0,2019-11-25,"(854.0, 1086.0]",4,14,-10
31260.0,2019-11-25,"(1086.0, 1318.0]",4,8,-4
31261.0,2019-11-25,"(409.296, 586.0]",13,13,0
31261.0,2019-11-25,"(586.0, 762.0]",1,6,-5
31261.0,2019-11-25,"(762.0, 938.0]",3,6,-3
31261.0,2019-11-25,"(938.0, 1114.0]",7,16,-9
31262.0,2019-11-25,"(428.005, 677.75]",6,7,-1
31262.0,2019-11-25,"(677.75, 926.5]",3,6,-3
31262.0,2019-11-25,"(926.5, 1175.25]",6,17,-11
31262.0,2019-11-25,"(1175.25, 1424.0]",3,9,-6
31263.0,2019-11-25,"(364.06, 600.0]",20,37,-17
31263.0,2019-11-25,"(600.0, 835.0]",8,19,-11
31263.0,2019-11-25,"(835.0, 1070.0]",9,23,-14
31263.0,2019-11-25,"(1070.0, 1305.0]",8,20,-12
31264.0,2019-11-25,"(384.972, 643.0]",20,28,-8
31264.0,2019-11-25,"(643.0, 900.0]",7,14,-7
31264.0,2019-11-25,"(900.0, 1157.0]",7,18,-11
31264.0,2019-11-25,"(1157.0, 1414.0]",3,9,-6
31265.0,2019-11-25,"(294.871, 578.25]",12,31,-19
31265.0,2019-11-25,"(578.25, 860.5]",10,17,-7
31265.0,2019-11-25,"(860.5, 1142.75]",25,41,-16
31265.0,2019-11-25,"(1142.75, 1425.0]",10,22,-12
31266.0,2019-11-25,"(361.25, 702.5]",4,5,-1
31266.0,2019-11-25,"(702.5, 1043.75]",10,24,-14
31266.0,2019-11-25,"(1043.75, 1385.0]",32,20,12
31267.0,2019-11-25,"(414.986, 669.5]",25,47,-22
31267.0,2019-11-25,"(669.5, 923.0]",9,22,-13
31267.0,2019-11-25,"(923.0, 1176.5]",25,39,-14
31267.0,2019-11-25,"(1176.5, 1430.0]",10,18,-8
31268.0,2019-11-25,"(1.632, 345.0]",3,3,0
31268.0,2019-11-25,"(345.0, 687.0]",8,35,-27
31268.0,2019-11-25,"(687.0, 1029.0]",9,19,-10
31268.0,2019-11-25,"(1029.0, 1371.0]",26,44,-18
31269.0,2019-11-25,"(385.09, 613.5]",9,15,-6
31269.0,2019-11-25,"(613.5, 841.0]",4,9,-5
31269.0,2019-11-25,"(841.0, 1068.5]",7,11,-4
31269.0,2019-11-25,"(1068.5, 1296.0]",4,14,-10
31270.0,2019-11-25,"(264.971, 523.25]",13,18,-5
31270.0,2019-11-25,"(780.5, 1037.75]",7,16,-9
31270.0,2019-11-25,"(1037.75, 1295.0]",3,11,-8
31271.0,2019-11-25,"(382.165, 591.75]",21,27,-6
31271.0,2019-11-25,"(591.75, 800.5]",16,30,-14
31271.0,2019-11-25,"(800.5, 1009.25]",4,13,-9
31271.0,2019-11-25,"(1009.25, 1218.0]",6,22,-16
31272.0,2019-11-25,"(305.052, 543.0]",26,28,-2
31272.0,2019-11-25,"(543.0, 780.0]",2,5,-3
31272.0,2019-11-25,"(780.0, 1017.0]",10,25,-15
31272.0,2019-11-25,"(1017.0, 1254.0]",4,22,-18
31273.0,2019-11-25,"(420.177, 626.75]",1,4,-3
31273.0,2019-11-25,"(626.75, 832.5]",2,5,-3
31273.0,2019-11-25,"(832.5, 1038.25]",4,5,-1
31273.0,2019-11-25,"(1038.25, 1244.0]",3,5,-2
31274.0,2019-11-25,"(469.182, 674.5]",19,20,-1
31274.0,2019-11-25,"(674.5, 879.0]",7,11,-4
31274.0,2019-11-25,"(879.0, 1083.5]",7,18,-11
31274.0,2019-11-25,"(1083.5, 1288.0]",3,7,-4
31275.0,2019-11-25,"(323.912, 597.0]",12,29,-17
31275.0,2019-11-25,"(597.0, 869.0]",9,12,-3
31275.0,2019-11-25,"(869.0, 1141.0]",15,38,-23
31275.0,2019-11-25,"(1141.0, 1413.0]",7,14,-7
31276.0,2019-11-25,"(417.121, 637.75]",27,32,-5
31276.0,2019-11-25,"(637.75, 857.5]",5,9,-4
31276.0,2019-11-25,"(857.5, 1077.25]",1,11,-10
31276.0,2019-11-25,"(1077.25, 1297.0]",1,16,-15
31277.0,2019-11-25,"(276.118, 497.5]",21,24,-3
31277.0,2019-11-25,"(497.5, 718.0]",20,22,-2
31277.0,2019-11-25,"(718.0, 938.5]",16,25,-9
31277.0,2019-11-25,"(938.5, 1159.0]",4,32,-28
31278.0,2019-11-25,"(302.952, 566.0]",10,31,-21
31278.0,2019-11-25,"(566.0, 828.0]",7,14,-7
31278.0,2019-11-25,"(828.0, 1090.0]",17,28,-11
31278.0,2019-11-25,"(1090.0, 1352.0]",20,32,-12
31279.0,2019-11-25,"(448.057, 684.75]",22,23,-1
31279.0,2019-11-25,"(684.75, 920.5]",7,15,-8
31279.0,2019-11-25,"(920.5, 1156.25]",13,42,-29
31279.0,2019-11-25,"(1156.25, 1392.0]",2,8,-6
31280.0,2019-11-25,"(414.076, 646.0]",6,27,-21
31280.0,2019-11-25,"(646.0, 877.0]",3,7,-4
31280.0,2019-11-25,"(877.0, 1108.0]",11,15,-4
31280.0,2019-11-25,"(1108.0, 1339.0]",9,15,-6
31000.0,2019-11-26,"(812.709, 885.75]",2,3,-1
31000.0,2019-11-26,"(1031.25, 1104.0]",1,2,-1
31001.0,2019-11-26,"(784.0, 964.0]",1,4,-3
31001.0,2019-11-26,"(964.0, 1144.0]",1,1,0
31002.0,2019-11-26,"(437.279, 618.25]",4,6,-2
31002.0,2019-11-26,"(798.5, 978.75]",2,4,-2
31002.0,2019-11-26,"(978.75, 1159.0]",6,13,-7
31003.0,2019-11-26,"(383.213, 580.75]",2,5,-3
31003.0,2019-11-26,"(580.75, 777.5]",2,3,-1
31003.0,2019-11-26,"(777.5, 974.25]",2,3,-1
31004.0,2019-11-26,"(930.25, 1096.0]",1,1,0
31005.0,2019-11-26,"(405.197, 606.75]",5,5,0
31005.0,2019-11-26,"(606.75, 807.5]",2,3,-1
31005.0,2019-11-26,"(807.5, 1008.25]",3,6,-3
31005.0,2019-11-26,"(1008.25, 1209.0]",2,7,-5
31006.0,2019-11-26,"(1021.0, 1071.0]",1,1,0
31006.0,2019-11-26,"(1071.0, 1121.0]",1,1,0
31006.0,2019-11-26,"(1121.0, 1171.0]",1,2,-1
31007.0,2019-11-26,"(375.986, 630.5]",6,20,-14
31007.0,2019-11-26,"(630.5, 884.0]",5,10,-5
31007.0,2019-11-26,"(884.0, 1137.5]",13,30,-17
31007.0,2019-11-26,"(1137.5, 1391.0]",1,6,-5
31009.0,2019-11-26,"(381.25, 569.5]",6,7,-1
31009.0,2019-11-26,"(944.5, 1132.0]",2,1,1
31010.0,2019-11-26,"(601.25, 809.5]",2,3,-1
31010.0,2019-11-26,"(809.5, 1017.75]",1,3,-2
31010.0,2019-11-26,"(1017.75, 1226.0]",4,1,3
31011.0,2019-11-26,"(303.075, 535.25]",5,6,-1
31011.0,2019-11-26,"(535.25, 766.5]",2,4,-2
31011.0,2019-11-26,"(766.5, 997.75]",3,4,-1
31011.0,2019-11-26,"(997.75, 1229.0]",4,7,-3
31012.0,2019-11-26,"(386.055, 623.25]",6,9,-3
31012.0,2019-11-26,"(1095.75, 1332.0]",1,3,-2
31013.0,2019-11-26,"(708.25, 897.5]",1,3,-2
31013.0,2019-11-26,"(897.5, 1086.75]",4,1,3
31013.0,2019-11-26,"(1086.75, 1276.0]",3,5,-2
31014.0,2019-11-26,"(42.643, 383.25]",3,3,0
31014.0,2019-11-26,"(383.25, 722.5]",27,41,-14
31014.0,2019-11-26,"(722.5, 1061.75]",16,29,-13
31014.0,2019-11-26,"(1061.75, 1401.0]",11,14,-3
31015.0,2019-11-26,"(52.713, 375.75]",2,3,-1
31015.0,2019-11-26,"(375.75, 697.5]",13,14,-1
31015.0,2019-11-26,"(697.5, 1019.25]",6,12,-6
31015.0,2019-11-26,"(1019.25, 1341.0]",7,10,-3
31016.0,2019-11-26,"(439.16, 650.0]",7,16,-9
31016.0,2019-11-26,"(650.0, 860.0]",1,3,-2
31016.0,2019-11-26,"(860.0, 1070.0]",2,7,-5
31016.0,2019-11-26,"(1070.0, 1280.0]",5,6,-1
31017.0,2019-11-26,"(462.341, 627.75]",4,5,-1
31017.0,2019-11-26,"(627.75, 792.5]",1,4,-3
31018.0,2019-11-26,"(605.25, 817.5]",2,7,-5
31018.0,2019-11-26,"(817.5, 1029.75]",1,2,-1
31018.0,2019-11-26,"(1029.75, 1242.0]",3,1,2
31019.0,2019-11-26,"(834.592, 937.0]",1,3,-2
31020.0,2019-11-26,"(487.203, 687.25]",1,2,-1
31020.0,2019-11-26,"(687.25, 886.5]",1,3,-2
31020.0,2019-11-26,"(886.5, 1085.75]",2,4,-2
31021.0,2019-11-26,"(374.154, 586.5]",1,5,-4
31021.0,2019-11-26,"(586.5, 798.0]",1,1,0
31021.0,2019-11-26,"(798.0, 1009.5]",1,2,-1
31021.0,2019-11-26,"(1009.5, 1221.0]",2,7,-5
31022.0,2019-11-26,"(451.142, 666.5]",1,6,-5
31022.0,2019-11-26,"(881.0, 1095.5]",5,1,4
31022.0,2019-11-26,"(1095.5, 1310.0]",2,12,-10
31023.0,2019-11-26,"(544.141, 759.75]",1,1,0
31023.0,2019-11-26,"(759.75, 974.5]",1,1,0
31023.0,2019-11-26,"(974.5, 1189.25]",4,6,-2
31024.0,2019-11-26,"(413.062, 648.5]",5,11,-6
31024.0,2019-11-26,"(648.5, 883.0]",2,3,-1
31024.0,2019-11-26,"(883.0, 1117.5]",5,10,-5
31024.0,2019-11-26,"(1117.5, 1352.0]",5,13,-8
31025.0,2019-11-26,"(547.534, 664.5]",1,2,-1
31025.0,2019-11-26,"(664.5, 781.0]",2,5,-3
31025.0,2019-11-26,"(781.0, 897.5]",1,2,-1
31025.0,2019-11-26,"(897.5, 1014.0]",1,2,-1
31026.0,2019-11-26,"(774.0, 956.0]",2,2,0
31026.0,2019-11-26,"(956.0, 1138.0]",2,1,1
31027.0,2019-11-26,"(841.5, 985.75]",1,2,-1
31027.0,2019-11-26,"(985.75, 1130.0]",1,2,-1
31028.0,2019-11-26,"(430.269, 613.75]",4,4,0
31028.0,2019-11-26,"(613.75, 796.5]",1,3,-2
31028.0,2019-11-26,"(979.25, 1162.0]",1,5,-4
31029.0,2019-11-26,"(3.931, 272.25]",1,1,0
31029.0,2019-11-26,"(806.75, 1074.0]",4,4,0
31030.0,2019-11-26,"(445.143, 660.25]",1,11,-10
31030.0,2019-11-26,"(874.5, 1088.75]",5,2,3
31030.0,2019-11-26,"(1088.75, 1303.0]",5,6,-1
31031.0,2019-11-26,"(696.25, 933.5]",2,4,-2
31031.0,2019-11-26,"(933.5, 1170.75]",3,3,0
31031.0,2019-11-26,"(1170.75, 1408.0]",2,4,-2
31032.0,2019-11-26,"(729.354, 891.5]",1,2,-1
31032.0,2019-11-26,"(1053.0, 1214.5]",1,1,0
31033.0,2019-11-26,"(1173.5, 1263.25]",1,1,0
31034.0,2019-11-26,"(595.188, 799.0]",1,1,0
31034.0,2019-11-26,"(799.0, 1002.0]",1,4,-3
31034.0,2019-11-26,"(1002.0, 1205.0]",2,3,-1
31034.0,2019-11-26,"(1205.0, 1408.0]",2,3,-1
31035.0,2019-11-26,"(479.088, 708.0]",2,5,-3
31035.0,2019-11-26,"(936.0, 1164.0]",3,1,2
31035.0,2019-11-26,"(1164.0, 1392.0]",2,5,-3
31036.0,2019-11-26,"(577.5, 759.0]",1,5,-4
31036.0,2019-11-26,"(940.5, 1122.0]",5,2,3
31037.0,2019-11-26,"(399.095, 626.25]",14,18,-4
31037.0,2019-11-26,"(626.25, 852.5]",1,2,-1
31037.0,2019-11-26,"(852.5, 1078.75]",5,13,-8
31037.0,2019-11-26,"(1078.75, 1305.0]",1,7,-6
31038.0,2019-11-26,"(903.5, 1050.0]",2,1,1
31038.0,2019-11-26,"(1050.0, 1196.5]",2,3,-1
31038.0,2019-11-26,"(1196.5, 1343.0]",1,2,-1
31039.0,2019-11-26,"(445.142, 660.5]",3,7,-4
31039.0,2019-11-26,"(660.5, 875.0]",2,3,-1
31039.0,2019-11-26,"(1089.5, 1304.0]",1,3,-2
31040.0,2019-11-26,"(457.354, 619.5]",3,3,0
31040.0,2019-11-26,"(942.5, 1104.0]",2,1,1
31041.0,2019-11-26,"(531.453, 668.75]",1,1,0
31041.0,2019-11-26,"(805.5, 942.25]",3,6,-3
31041.0,2019-11-26,"(942.25, 1079.0]",2,5,-3
31042.0,2019-11-26,"(412.088, 641.0]",8,9,-1
31042.0,2019-11-26,"(641.0, 869.0]",4,9,-5
31042.0,2019-11-26,"(869.0, 1097.0]",6,18,-12
31042.0,2019-11-26,"(1097.0, 1325.0]",1,3,-2
31043.0,2019-11-26,"(476.232, 669.0]",2,2,0
31043.0,2019-11-26,"(669.0, 861.0]",1,2,-1
31043.0,2019-11-26,"(1053.0, 1245.0]",4,2,2
31044.0,2019-11-26,"(476.284, 656.0]",4,6,-2
31044.0,2019-11-26,"(1014.0, 1193.0]",3,1,2
31045.0,2019-11-26,"(512.091, 740.25]",2,3,-1
31045.0,2019-11-26,"(967.5, 1194.75]",2,2,0
31045.0,2019-11-26,"(1194.75, 1422.0]",1,2,-1
31046.0,2019-11-26,"(398.137, 614.75]",1,3,-2
31046.0,2019-11-26,"(830.5, 1046.25]",1,1,0
31046.0,2019-11-26,"(1046.25, 1262.0]",1,2,-1
31047.0,2019-11-26,"(350.996, 603.0]",12,19,-7
31047.0,2019-11-26,"(603.0, 854.0]",4,6,-2
31047.0,2019-11-26,"(854.0, 1105.0]",7,25,-18
31047.0,2019-11-26,"(1105.0, 1356.0]",2,11,-9
31048.0,2019-11-26,"(488.131, 706.25]",2,8,-6
31048.0,2019-11-26,"(923.5, 1140.75]",3,6,-3
31049.0,2019-11-26,"(537.538, 653.5]",1,2,-1
31049.0,2019-11-26,"(653.5, 769.0]",1,2,-1
31050.0,2019-11-26,"(644.75, 812.5]",1,2,-1
31050.0,2019-11-26,"(980.25, 1148.0]",1,1,0
31051.0,2019-11-26,"(11.654, 349.5]",1,2,-1
31051.0,2019-11-26,"(349.5, 686.0]",1,8,-7
31051.0,2019-11-26,"(686.0, 1022.5]",2,3,-1
31051.0,2019-11-26,"(1022.5, 1359.0]",4,4,0
31052.0,2019-11-26,"(441.278, 622.5]",1,2,-1
31052.0,2019-11-26,"(803.0, 983.5]",1,1,0
31052.0,2019-11-26,"(983.5, 1164.0]",2,1,1
,,,,1.0,
,,,,2.0,
31054.0,2019-11-26,"(966.75, 1006.0]",1,1,0
31055.0,2019-11-26,"(931.5, 1148.25]",2,1,1
31055.0,2019-11-26,"(1148.25, 1365.0]",1,2,-1
31056.0,2019-11-26,"(851.5, 992.0]",2,1,1
31057.0,2019-11-26,"(971.5, 1047.0]",1,1,0
,,,,2.0,
31059.0,2019-11-26,"(656.936, 673.0]",1,3,-2
31059.0,2019-11-26,"(705.0, 721.0]",1,1,0
31060.0,2019-11-26,"(819.809, 867.75]",1,2,-1
31060.0,2019-11-26,"(867.75, 915.5]",1,1,0
31060.0,2019-11-26,"(963.25, 1011.0]",1,2,-1
31061.0,2019-11-26,"(400.5, 534.0]",1,1,0
31062.0,2019-11-26,"(741.745, 805.75]",2,3,-1
31062.0,2019-11-26,"(869.5, 933.25]",1,1,0
31062.0,2019-11-26,"(933.25, 997.0]",1,3,-2
31063.0,2019-11-26,"(794.982, 799.5]",1,1,0
31064.0,2019-11-26,"(513.355, 675.25]",2,3,-1
31064.0,2019-11-26,"(675.25, 836.5]",6,11,-5
31064.0,2019-11-26,"(836.5, 997.75]",6,15,-9
31064.0,2019-11-26,"(997.75, 1159.0]",4,8,-4
31065.0,2019-11-26,"(607.0, 725.0]",2,2,0
31066.0,2019-11-26,"(931.682, 1011.5]",2,3,-1
31066.0,2019-11-26,"(1170.5, 1250.0]",2,4,-2
31067.0,2019-11-26,"(524.435, 666.25]",1,2,-1
31067.0,2019-11-26,"(948.75, 1090.0]",2,1,1
31068.0,2019-11-26,"(1190.838, 1231.5]",1,2,-1
31068.0,2019-11-26,"(1312.5, 1353.0]",1,1,0
31069.0,2019-11-26,"(435.261, 620.75]",2,9,-7
31069.0,2019-11-26,"(805.5, 990.25]",4,5,-1
31069.0,2019-11-26,"(990.25, 1175.0]",4,4,0
31070.0,2019-11-26,"(804.5, 977.25]",1,1,0
31070.0,2019-11-26,"(977.25, 1150.0]",3,1,2
31071.0,2019-11-26,"(297.107, 521.25]",3,8,-5
31071.0,2019-11-26,"(521.25, 744.5]",2,5,-3
31071.0,2019-11-26,"(744.5, 967.75]",3,6,-3
31071.0,2019-11-26,"(967.75, 1191.0]",9,13,-4
,,,,2.0,
31073.0,2019-11-26,"(456.578, 562.5]",2,3,-1
31073.0,2019-11-26,"(562.5, 668.0]",1,1,0
31074.0,2019-11-26,"(656.0, 793.0]",1,1,0
31074.0,2019-11-26,"(793.0, 930.0]",1,1,0
31074.0,2019-11-26,"(930.0, 1067.0]",1,1,0
31075.0,2019-11-26,"(964.0, 1120.0]",2,2,0
,,,,1.0,
,,,,1.0,
31077.0,2019-11-26,"(624.0, 845.0]",4,2,2
31077.0,2019-11-26,"(845.0, 1066.0]",1,7,-6
31077.0,2019-11-26,"(1066.0, 1287.0]",2,3,-1
31078.0,2019-11-26,"(448.318, 619.5]",4,4,0
31078.0,2019-11-26,"(960.5, 1131.0]",1,2,-1
31079.0,2019-11-26,"(404.001, 654.75]",1,8,-7
31079.0,2019-11-26,"(654.75, 904.5]",1,3,-2
31079.0,2019-11-26,"(904.5, 1154.25]",2,5,-3
31079.0,2019-11-26,"(1154.25, 1404.0]",3,4,-1
31080.0,2019-11-26,"(645.0, 884.0]",2,9,-7
31080.0,2019-11-26,"(884.0, 1123.0]",4,3,1
31080.0,2019-11-26,"(1123.0, 1362.0]",2,8,-6
31081.0,2019-11-26,"(492.33, 660.5]",2,3,-1
31081.0,2019-11-26,"(828.0, 995.5]",1,2,-1
31081.0,2019-11-26,"(995.5, 1163.0]",3,10,-7
31082.0,2019-11-26,"(1066.25, 1139.0]",1,1,0
31083.0,2019-11-26,"(782.0, 959.5]",2,3,-1
31083.0,2019-11-26,"(959.5, 1137.0]",5,2,3
31084.0,2019-11-26,"(518.284, 698.0]",7,8,-1
31084.0,2019-11-26,"(698.0, 877.0]",2,3,-1
31084.0,2019-11-26,"(1056.0, 1235.0]",1,3,-2
31085.0,2019-11-26,"(403.201, 603.75]",1,2,-1
31085.0,2019-11-26,"(803.5, 1003.25]",1,1,0
31085.0,2019-11-26,"(1003.25, 1203.0]",1,1,0
31086.0,2019-11-26,"(771.0, 920.0]",1,1,0
31086.0,2019-11-26,"(920.0, 1069.0]",1,1,0
31087.0,2019-11-26,"(751.5, 957.0]",2,1,1
31087.0,2019-11-26,"(957.0, 1162.5]",2,3,-1
31087.0,2019-11-26,"(1162.5, 1368.0]",1,3,-2
31088.0,2019-11-26,"(805.0, 1011.5]",1,4,-3
31088.0,2019-11-26,"(1011.5, 1218.0]",4,1,3
31089.0,2019-11-26,"(417.018, 663.5]",7,13,-6
31089.0,2019-11-26,"(663.5, 909.0]",4,7,-3
31089.0,2019-11-26,"(909.0, 1154.5]",5,13,-8
31089.0,2019-11-26,"(1154.5, 1400.0]",3,10,-7
31090.0,2019-11-26,"(575.361, 735.75]",1,2,-1
31090.0,2019-11-26,"(895.5, 1055.25]",1,1,0
31090.0,2019-11-26,"(1055.25, 1215.0]",1,1,0
31091.0,2019-11-26,"(883.5, 1107.25]",2,4,-2
31091.0,2019-11-26,"(1107.25, 1331.0]",3,3,0
31092.0,2019-11-26,"(1154.75, 1381.0]",2,1,1
31093.0,2019-11-26,"(736.576, 843.0]",1,2,-1
31094.0,2019-11-26,"(1023.75, 1078.0]",1,1,0
,,,,2.0,
31096.0,2019-11-26,"(1212.75, 1266.0]",3,1,2
31097.0,2019-11-26,"(574.317, 745.75]",1,1,0
31097.0,2019-11-26,"(916.5, 1087.25]",1,3,-2
31097.0,2019-11-26,"(1087.25, 1258.0]",3,4,-1
31098.0,2019-11-26,"(406.25, 594.5]",4,8,-4
31098.0,2019-11-26,"(782.0, 969.5]",2,3,-1
31098.0,2019-11-26,"(969.5, 1157.0]",4,8,-4
31099.0,2019-11-26,"(829.5, 1032.25]",1,2,-1
31099.0,2019-11-26,"(1032.25, 1235.0]",1,2,-1
31100.0,2019-11-26,"(473.066, 707.5]",17,20,-3
31100.0,2019-11-26,"(707.5, 941.0]",3,9,-6
31100.0,2019-11-26,"(941.0, 1174.5]",6,23,-17
31101.0,2019-11-26,"(3.576, 361.0]",1,5,-4
31101.0,2019-11-26,"(361.0, 717.0]",9,41,-32
31101.0,2019-11-26,"(717.0, 1073.0]",30,52,-22
31101.0,2019-11-26,"(1073.0, 1429.0]",37,60,-23
31102.0,2019-11-26,"(365.004, 615.0]",3,24,-21
31102.0,2019-11-26,"(864.0, 1113.0]",3,4,-1
31102.0,2019-11-26,"(1113.0, 1362.0]",7,12,-5
31103.0,2019-11-26,"(18.686, 348.5]",1,3,-2
31103.0,2019-11-26,"(348.5, 677.0]",2,35,-33
31103.0,2019-11-26,"(677.0, 1005.5]",5,20,-15
31103.0,2019-11-26,"(1005.5, 1334.0]",13,25,-12
31104.0,2019-11-26,"(26.648, 366.0]",1,2,-1
31104.0,2019-11-26,"(366.0, 704.0]",2,18,-16
31104.0,2019-11-26,"(704.0, 1042.0]",19,34,-15
31104.0,2019-11-26,"(1042.0, 1380.0]",16,34,-18
31105.0,2019-11-26,"(401.136, 618.0]",3,10,-7
31105.0,2019-11-26,"(834.0, 1050.0]",3,2,1
31105.0,2019-11-26,"(1050.0, 1266.0]",1,7,-6
31106.0,2019-11-26,"(435.109, 658.75]",5,15,-10
31106.0,2019-11-26,"(881.5, 1104.25]",7,1,6
31106.0,2019-11-26,"(1104.25, 1327.0]",1,10,-9
31107.0,2019-11-26,"(36.679, 368.25]",1,3,-2
31107.0,2019-11-26,"(368.25, 698.5]",7,28,-21
31107.0,2019-11-26,"(698.5, 1028.75]",15,32,-17
31107.0,2019-11-26,"(1028.75, 1359.0]",17,22,-5
31108.0,2019-11-26,"(407.058, 643.5]",8,33,-25
31108.0,2019-11-26,"(643.5, 879.0]",13,28,-15
31108.0,2019-11-26,"(879.0, 1114.5]",23,32,-9
31108.0,2019-11-26,"(1114.5, 1350.0]",14,20,-6
31109.0,2019-11-26,"(342.005, 591.75]",5,23,-18
31109.0,2019-11-26,"(591.75, 840.5]",9,17,-8
31109.0,2019-11-26,"(840.5, 1089.25]",20,29,-9
31109.0,2019-11-26,"(1089.25, 1338.0]",13,20,-7
31110.0,2019-11-26,"(151.767, 461.25]",2,11,-9
31110.0,2019-11-26,"(461.25, 769.5]",16,38,-22
31110.0,2019-11-26,"(769.5, 1077.75]",19,34,-15
31110.0,2019-11-26,"(1077.75, 1386.0]",14,31,-17
31111.0,2019-11-26,"(25.683, 356.25]",4,4,0
31111.0,2019-11-26,"(356.25, 685.5]",9,27,-18
31111.0,2019-11-26,"(685.5, 1014.75]",7,13,-6
31111.0,2019-11-26,"(1014.75, 1344.0]",19,29,-10
31112.0,2019-11-26,"(536.285, 715.75]",1,5,-4
31112.0,2019-11-26,"(715.75, 894.5]",6,6,0
31112.0,2019-11-26,"(894.5, 1073.25]",1,5,-4
31112.0,2019-11-26,"(1073.25, 1252.0]",3,4,-1
31113.0,2019-11-26,"(599.25, 858.5]",2,8,-6
31113.0,2019-11-26,"(858.5, 1117.75]",5,9,-4
31113.0,2019-11-26,"(1117.75, 1377.0]",8,7,1
31114.0,2019-11-26,"(8.671, 342.25]",1,3,-2
31114.0,2019-11-26,"(342.25, 674.5]",3,23,-20
31114.0,2019-11-26,"(674.5, 1006.75]",6,16,-10
31114.0,2019-11-26,"(1006.75, 1339.0]",24,34,-10
31115.0,2019-11-26,"(14.607, 364.25]",2,4,-2
31115.0,2019-11-26,"(364.25, 712.5]",1,13,-12
31115.0,2019-11-26,"(712.5, 1060.75]",9,13,-4
31115.0,2019-11-26,"(1060.75, 1409.0]",10,17,-7
31116.0,2019-11-26,"(322.941, 588.75]",9,35,-26
31116.0,2019-11-26,"(588.75, 853.5]",9,12,-3
31116.0,2019-11-26,"(853.5, 1118.25]",20,24,-4
31116.0,2019-11-26,"(1118.25, 1383.0]",4,6,-2
31117.0,2019-11-26,"(342.97, 601.5]",1,17,-16
31117.0,2019-11-26,"(859.0, 1116.5]",11,18,-7
31117.0,2019-11-26,"(1116.5, 1374.0]",9,16,-7
31118.0,2019-11-26,"(369.06, 605.0]",2,18,-16
31118.0,2019-11-26,"(840.0, 1075.0]",9,1,8
31118.0,2019-11-26,"(1075.0, 1310.0]",12,16,-4
31119.0,2019-11-26,"(345.957, 607.75]",9,27,-18
31119.0,2019-11-26,"(607.75, 868.5]",5,8,-3
31119.0,2019-11-26,"(868.5, 1129.25]",19,28,-9
31119.0,2019-11-26,"(1129.25, 1390.0]",7,17,-10
31120.0,2019-11-26,"(405.082, 635.5]",3,13,-10
31120.0,2019-11-26,"(635.5, 865.0]",2,12,-10
31120.0,2019-11-26,"(865.0, 1094.5]",8,11,-3
31120.0,2019-11-26,"(1094.5, 1324.0]",6,10,-4
31121.0,2019-11-26,"(388.128, 607.0]",11,16,-5
31121.0,2019-11-26,"(607.0, 825.0]",6,13,-7
31121.0,2019-11-26,"(825.0, 1043.0]",6,12,-6
31121.0,2019-11-26,"(1043.0, 1261.0]",7,15,-8
31122.0,2019-11-26,"(14.597, 366.75]",1,3,-2
31122.0,2019-11-26,"(366.75, 717.5]",3,16,-13
31122.0,2019-11-26,"(717.5, 1068.25]",9,16,-7
31122.0,2019-11-26,"(1068.25, 1419.0]",7,17,-10
31123.0,2019-11-26,"(607.25, 840.5]",1,21,-20
31123.0,2019-11-26,"(840.5, 1073.75]",3,1,2
31123.0,2019-11-26,"(1073.75, 1307.0]",7,7,0
31124.0,2019-11-26,"(10.578, 367.5]",1,2,-1
31124.0,2019-11-26,"(367.5, 723.0]",12,47,-35
31124.0,2019-11-26,"(723.0, 1078.5]",16,54,-38
31124.0,2019-11-26,"(1078.5, 1434.0]",17,45,-28
31125.0,2019-11-26,"(361.112, 584.0]",3,22,-19
31125.0,2019-11-26,"(584.0, 806.0]",6,9,-3
31125.0,2019-11-26,"(806.0, 1028.0]",9,16,-7
31125.0,2019-11-26,"(1028.0, 1250.0]",26,32,-6
31126.0,2019-11-26,"(347.916, 620.0]",3,25,-22
31126.0,2019-11-26,"(620.0, 891.0]",5,16,-11
31126.0,2019-11-26,"(891.0, 1162.0]",18,26,-8
31126.0,2019-11-26,"(1162.0, 1433.0]",12,17,-5
31127.0,2019-11-26,"(389.952, 653.0]",6,10,-4
31127.0,2019-11-26,"(653.0, 915.0]",8,12,-4
31127.0,2019-11-26,"(915.0, 1177.0]",14,29,-15
31127.0,2019-11-26,"(1177.0, 1439.0]",1,7,-6
31128.0,2019-11-26,"(307.884, 588.0]",21,27,-6
31128.0,2019-11-26,"(588.0, 867.0]",20,33,-13
31128.0,2019-11-26,"(867.0, 1146.0]",19,34,-15
31128.0,2019-11-26,"(1146.0, 1425.0]",7,16,-9
31129.0,2019-11-26,"(424.007, 673.25]",11,24,-13
31129.0,2019-11-26,"(673.25, 921.5]",13,24,-11
31129.0,2019-11-26,"(921.5, 1169.75]",12,24,-12
31129.0,2019-11-26,"(1169.75, 1418.0]",4,15,-11
31130.0,2019-11-26,"(415.018, 661.5]",5,18,-13
31130.0,2019-11-26,"(661.5, 907.0]",6,16,-10
31130.0,2019-11-26,"(907.0, 1152.5]",12,15,-3
31130.0,2019-11-26,"(1152.5, 1398.0]",6,9,-3
31131.0,2019-11-26,"(402.966, 662.5]",1,13,-12
31131.0,2019-11-26,"(921.0, 1179.5]",6,9,-3
31131.0,2019-11-26,"(1179.5, 1438.0]",5,7,-2
31200.0,2019-11-26,"(63.64, 405.0]",3,3,0
31200.0,2019-11-26,"(405.0, 745.0]",41,63,-22
31200.0,2019-11-26,"(745.0, 1085.0]",32,81,-49
31200.0,2019-11-26,"(1085.0, 1425.0]",11,33,-22
31201.0,2019-11-26,"(298.886, 578.5]",20,44,-24
31201.0,2019-11-26,"(578.5, 857.0]",23,43,-20
31201.0,2019-11-26,"(857.0, 1135.5]",45,70,-25
31201.0,2019-11-26,"(1135.5, 1414.0]",28,54,-26
31202.0,2019-11-26,"(175.781, 481.75]",6,15,-9
31202.0,2019-11-26,"(481.75, 786.5]",18,38,-20
31202.0,2019-11-26,"(786.5, 1091.25]",28,44,-16
31202.0,2019-11-26,"(1091.25, 1396.0]",13,29,-16
31203.0,2019-11-26,"(351.958, 613.5]",8,24,-16
31203.0,2019-11-26,"(613.5, 874.0]",19,31,-12
31203.0,2019-11-26,"(874.0, 1134.5]",18,32,-14
31203.0,2019-11-26,"(1134.5, 1395.0]",15,25,-10
31204.0,2019-11-26,"(465.146, 679.5]",11,12,-1
31204.0,2019-11-26,"(679.5, 893.0]",3,7,-4
31204.0,2019-11-26,"(893.0, 1106.5]",6,21,-15
31204.0,2019-11-26,"(1106.5, 1320.0]",3,4,-1
31205.0,2019-11-26,"(16.641, 357.75]",1,1,0
31205.0,2019-11-26,"(357.75, 697.5]",26,30,-4
31205.0,2019-11-26,"(697.5, 1037.25]",30,54,-24
31205.0,2019-11-26,"(1037.25, 1377.0]",6,27,-21
31206.0,2019-11-26,"(390.349, 553.75]",7,7,0
31206.0,2019-11-26,"(716.5, 879.25]",1,3,-2
31206.0,2019-11-26,"(879.25, 1042.0]",2,9,-7
31207.0,2019-11-26,"(574.75, 829.5]",1,8,-7
31207.0,2019-11-26,"(829.5, 1084.25]",1,1,0
31207.0,2019-11-26,"(1084.25, 1339.0]",6,2,4
31208.0,2019-11-26,"(121.704, 447.0]",6,7,-1
31208.0,2019-11-26,"(447.0, 771.0]",5,10,-5
31208.0,2019-11-26,"(771.0, 1095.0]",7,20,-13
31208.0,2019-11-26,"(1095.0, 1419.0]",3,5,-2
31209.0,2019-11-26,"(537.113, 759.75]",2,3,-1
31209.0,2019-11-26,"(759.75, 981.5]",2,4,-2
31209.0,2019-11-26,"(981.5, 1203.25]",10,14,-4
31209.0,2019-11-26,"(1203.25, 1425.0]",1,2,-1
31211.0,2019-11-26,"(395.197, 596.75]",8,11,-3
31211.0,2019-11-26,"(596.75, 797.5]",1,2,-1
31211.0,2019-11-26,"(797.5, 998.25]",2,5,-3
31211.0,2019-11-26,"(998.25, 1199.0]",3,8,-5
31212.0,2019-11-26,"(342.979, 599.25]",24,35,-11
31212.0,2019-11-26,"(599.25, 854.5]",7,13,-6
31212.0,2019-11-26,"(854.5, 1109.75]",9,28,-19
31212.0,2019-11-26,"(1109.75, 1365.0]",4,7,-3
31213.0,2019-11-26,"(363.016, 610.0]",28,40,-12
31213.0,2019-11-26,"(610.0, 856.0]",9,16,-7
31213.0,2019-11-26,"(856.0, 1102.0]",9,21,-12
31213.0,2019-11-26,"(1102.0, 1348.0]",6,11,-5
31214.0,2019-11-26,"(8.609, 357.75]",3,7,-4
31214.0,2019-11-26,"(357.75, 705.5]",12,32,-20
31214.0,2019-11-26,"(705.5, 1053.25]",25,48,-23
31214.0,2019-11-26,"(1053.25, 1401.0]",27,36,-9
31215.0,2019-11-26,"(408.045, 647.75]",21,22,-1
31215.0,2019-11-26,"(647.75, 886.5]",11,15,-4
31215.0,2019-11-26,"(886.5, 1125.25]",11,22,-11
31215.0,2019-11-26,"(1125.25, 1364.0]",6,10,-4
31216.0,2019-11-26,"(448.212, 646.0]",20,22,-2
31216.0,2019-11-26,"(646.0, 843.0]",6,11,-5
31216.0,2019-11-26,"(843.0, 1040.0]",8,15,-7
31216.0,2019-11-26,"(1040.0, 1237.0]",3,22,-19
31217.0,2019-11-26,"(40.685, 370.75]",4,7,-3
31217.0,2019-11-26,"(370.75, 699.5]",11,22,-11
31217.0,2019-11-26,"(699.5, 1028.25]",4,22,-18
31217.0,2019-11-26,"(1028.25, 1357.0]",3,6,-3
31218.0,2019-11-26,"(321.921, 592.75]",17,37,-20
31218.0,2019-11-26,"(592.75, 862.5]",7,10,-3
31218.0,2019-11-26,"(862.5, 1132.25]",13,26,-13
31218.0,2019-11-26,"(1132.25, 1402.0]",1,4,-3
31219.0,2019-11-26,"(385.024, 630.0]",18,18,0
31219.0,2019-11-26,"(630.0, 874.0]",8,13,-5
31219.0,2019-11-26,"(874.0, 1118.0]",10,39,-29
31219.0,2019-11-26,"(1118.0, 1362.0]",1,11,-10
31220.0,2019-11-26,"(283.212, 481.0]",9,11,-2
31220.0,2019-11-26,"(481.0, 678.0]",8,12,-4
31220.0,2019-11-26,"(678.0, 875.0]",5,12,-7
31221.0,2019-11-26,"(66.634, 409.5]",4,5,-1
31221.0,2019-11-26,"(409.5, 751.0]",29,35,-6
31221.0,2019-11-26,"(751.0, 1092.5]",6,28,-22
31221.0,2019-11-26,"(1092.5, 1434.0]",9,25,-16
31222.0,2019-11-26,"(385.11, 608.5]",19,19,0
31222.0,2019-11-26,"(608.5, 831.0]",10,18,-8
31222.0,2019-11-26,"(831.0, 1053.5]",5,22,-17
31222.0,2019-11-26,"(1053.5, 1276.0]",3,15,-12
31223.0,2019-11-26,"(-0.425, 357.25]",1,5,-4
31223.0,2019-11-26,"(357.25, 713.5]",11,33,-22
31223.0,2019-11-26,"(713.5, 1069.75]",12,24,-12
31223.0,2019-11-26,"(1069.75, 1426.0]",8,21,-13
31224.0,2019-11-26,"(424.214, 621.5]",19,22,-3
31224.0,2019-11-26,"(621.5, 818.0]",3,6,-3
31224.0,2019-11-26,"(818.0, 1014.5]",2,7,-5
31224.0,2019-11-26,"(1014.5, 1211.0]",5,18,-13
31225.0,2019-11-26,"(73.667, 408.25]",1,1,0
31225.0,2019-11-26,"(408.25, 741.5]",14,21,-7
31225.0,2019-11-26,"(741.5, 1074.75]",14,25,-11
31225.0,2019-11-26,"(1074.75, 1408.0]",9,14,-5
31226.0,2019-11-26,"(312.915, 585.25]",2,7,-5
31226.0,2019-11-26,"(585.25, 856.5]",4,5,-1
31226.0,2019-11-26,"(856.5, 1127.75]",8,12,-4
31226.0,2019-11-26,"(1127.75, 1399.0]",4,12,-8
31227.0,2019-11-26,"(427.119, 648.25]",38,46,-8
31227.0,2019-11-26,"(648.25, 868.5]",21,36,-15
31227.0,2019-11-26,"(868.5, 1088.75]",5,19,-14
31227.0,2019-11-26,"(1088.75, 1309.0]",3,7,-4
31228.0,2019-11-26,"(10.592, 364.0]",2,4,-2
31228.0,2019-11-26,"(364.0, 716.0]",26,40,-14
31228.0,2019-11-26,"(716.0, 1068.0]",19,47,-28
31228.0,2019-11-26,"(1068.0, 1420.0]",12,33,-21
31229.0,2019-11-26,"(79.649, 418.75]",7,17,-10
31229.0,2019-11-26,"(418.75, 756.5]",13,41,-28
31229.0,2019-11-26,"(756.5, 1094.25]",33,53,-20
31229.0,2019-11-26,"(1094.25, 1432.0]",29,43,-14
31230.0,2019-11-26,"(329.95, 593.5]",44,57,-13
31230.0,2019-11-26,"(593.5, 856.0]",18,24,-6
31230.0,2019-11-26,"(856.0, 1118.5]",14,47,-33
31230.0,2019-11-26,"(1118.5, 1381.0]",10,23,-13
31231.0,2019-11-26,"(321.906, 596.5]",19,23,-4
31231.0,2019-11-26,"(596.5, 870.0]",9,16,-7
31231.0,2019-11-26,"(870.0, 1143.5]",17,28,-11
31232.0,2019-11-26,"(295.938, 562.5]",18,23,-5
31232.0,2019-11-26,"(562.5, 828.0]",18,25,-7
31232.0,2019-11-26,"(828.0, 1093.5]",12,24,-12
31232.0,2019-11-26,"(1093.5, 1359.0]",7,12,-5
31233.0,2019-11-26,"(299.869, 583.75]",35,40,-5
31233.0,2019-11-26,"(583.75, 866.5]",16,23,-7
31233.0,2019-11-26,"(866.5, 1149.25]",24,50,-26
31233.0,2019-11-26,"(1149.25, 1432.0]",4,7,-3
31234.0,2019-11-26,"(468.085, 697.75]",15,30,-15
31234.0,2019-11-26,"(697.75, 926.5]",7,14,-7
31234.0,2019-11-26,"(926.5, 1155.25]",18,32,-14
31234.0,2019-11-26,"(1155.25, 1384.0]",4,10,-6
31235.0,2019-11-26,"(385.166, 594.5]",11,12,-1
31235.0,2019-11-26,"(594.5, 803.0]",10,23,-13
31235.0,2019-11-26,"(803.0, 1011.5]",3,9,-6
31235.0,2019-11-26,"(1011.5, 1220.0]",1,4,-3
31236.0,2019-11-26,"(464.118, 685.5]",16,23,-7
31236.0,2019-11-26,"(685.5, 906.0]",14,26,-12
31236.0,2019-11-26,"(906.0, 1126.5]",14,36,-22
31236.0,2019-11-26,"(1126.5, 1347.0]",2,12,-10
31237.0,2019-11-26,"(374.0, 722.0]",16,1,15
31237.0,2019-11-26,"(722.0, 1070.0]",16,37,-21
31237.0,2019-11-26,"(1070.0, 1418.0]",15,33,-18
31238.0,2019-11-26,"(47.766, 357.5]",2,3,-1
31238.0,2019-11-26,"(357.5, 666.0]",12,16,-4
31238.0,2019-11-26,"(666.0, 974.5]",18,26,-8
31238.0,2019-11-26,"(974.5, 1283.0]",8,34,-26
31239.0,2019-11-26,"(358.03, 601.5]",30,31,-1
31239.0,2019-11-26,"(601.5, 844.0]",12,18,-6
31239.0,2019-11-26,"(844.0, 1086.5]",9,27,-18
31239.0,2019-11-26,"(1086.5, 1329.0]",4,13,-9
31240.0,2019-11-26,"(595.287, 774.25]",5,9,-4
31240.0,2019-11-26,"(774.25, 952.5]",11,19,-8
31240.0,2019-11-26,"(952.5, 1130.75]",2,6,-4
31241.0,2019-11-26,"(54.672, 388.0]",2,4,-2
31241.0,2019-11-26,"(388.0, 720.0]",27,52,-25
31241.0,2019-11-26,"(720.0, 1052.0]",16,38,-22
31241.0,2019-11-26,"(1052.0, 1384.0]",16,34,-18
31242.0,2019-11-26,"(405.149, 618.75]",36,38,-2
31242.0,2019-11-26,"(618.75, 831.5]",15,29,-14
31242.0,2019-11-26,"(831.5, 1044.25]",7,24,-17
31243.0,2019-11-26,"(355.023, 600.25]",30,37,-7
31243.0,2019-11-26,"(600.25, 844.5]",3,4,-1
31243.0,2019-11-26,"(844.5, 1088.75]",9,41,-32
31243.0,2019-11-26,"(1088.75, 1333.0]",4,10,-6
31244.0,2019-11-26,"(349.004, 599.0]",14,29,-15
31244.0,2019-11-26,"(599.0, 848.0]",6,11,-5
31244.0,2019-11-26,"(848.0, 1097.0]",18,32,-14
31244.0,2019-11-26,"(1097.0, 1346.0]",5,9,-4
31245.0,2019-11-26,"(171.74, 488.0]",4,9,-5
31245.0,2019-11-26,"(488.0, 803.0]",12,22,-10
31245.0,2019-11-26,"(803.0, 1118.0]",12,20,-8
31245.0,2019-11-26,"(1118.0, 1433.0]",8,19,-11
31246.0,2019-11-26,"(390.5, 739.0]",22,1,21
31246.0,2019-11-26,"(739.0, 1087.5]",20,30,-10
31246.0,2019-11-26,"(1087.5, 1436.0]",4,41,-37
31247.0,2019-11-26,"(394.011, 642.25]",16,35,-19
31247.0,2019-11-26,"(642.25, 889.5]",46,79,-33
31247.0,2019-11-26,"(889.5, 1136.75]",32,70,-38
31247.0,2019-11-26,"(1136.75, 1384.0]",8,15,-7
31248.0,2019-11-26,"(355.986, 610.5]",7,13,-6
31248.0,2019-11-26,"(610.5, 864.0]",14,38,-24
31248.0,2019-11-26,"(864.0, 1117.5]",46,103,-57
31248.0,2019-11-26,"(1117.5, 1371.0]",9,10,-1
31249.0,2019-11-26,"(399.038, 640.5]",6,13,-7
31249.0,2019-11-26,"(640.5, 881.0]",29,54,-25
31249.0,2019-11-26,"(881.0, 1121.5]",8,23,-15
31249.0,2019-11-26,"(1121.5, 1362.0]",3,4,-1
31250.0,2019-11-26,"(418.988, 673.0]",18,22,-4
31250.0,2019-11-26,"(673.0, 926.0]",4,7,-3
31250.0,2019-11-26,"(926.0, 1179.0]",6,28,-22
31251.0,2019-11-26,"(-1.431, 357.75]",2,3,-1
31251.0,2019-11-26,"(357.75, 715.5]",19,35,-16
31251.0,2019-11-26,"(715.5, 1073.25]",19,32,-13
31251.0,2019-11-26,"(1073.25, 1431.0]",13,24,-11
31252.0,2019-11-26,"(331.75, 641.5]",19,1,18
31252.0,2019-11-26,"(641.5, 951.25]",6,21,-15
31252.0,2019-11-26,"(951.25, 1261.0]",3,14,-11
31253.0,2019-11-26,"(399.091, 627.25]",22,25,-3
31253.0,2019-11-26,"(627.25, 854.5]",6,17,-11
31253.0,2019-11-26,"(854.5, 1081.75]",10,24,-14
31253.0,2019-11-26,"(1081.75, 1309.0]",1,11,-10
31254.0,2019-11-26,"(16.623, 362.25]",1,2,-1
31254.0,2019-11-26,"(362.25, 706.5]",16,18,-2
31254.0,2019-11-26,"(706.5, 1050.75]",13,28,-15
31254.0,2019-11-26,"(1050.75, 1395.0]",3,13,-10
31255.0,2019-11-26,"(373.937, 640.75]",12,17,-5
31255.0,2019-11-26,"(640.75, 906.5]",5,15,-10
31255.0,2019-11-26,"(906.5, 1172.25]",11,27,-16
31255.0,2019-11-26,"(1172.25, 1438.0]",2,5,-3
31256.0,2019-11-26,"(332.043, 572.25]",5,6,-1
31256.0,2019-11-26,"(572.25, 811.5]",12,19,-7
31256.0,2019-11-26,"(811.5, 1050.75]",10,21,-11
31256.0,2019-11-26,"(1050.75, 1290.0]",4,16,-12
31257.0,2019-11-26,"(333.015, 580.25]",13,23,-10
31257.0,2019-11-26,"(580.25, 826.5]",13,24,-11
31257.0,2019-11-26,"(826.5, 1072.75]",26,52,-26
31257.0,2019-11-26,"(1072.75, 1319.0]",11,24,-13
31258.0,2019-11-26,"(474.175, 681.25]",5,12,-7
31258.0,2019-11-26,"(681.25, 887.5]",14,27,-13
31258.0,2019-11-26,"(887.5, 1093.75]",31,58,-27
31258.0,2019-11-26,"(1093.75, 1300.0]",26,46,-20
31259.0,2019-11-26,"(451.204, 651.0]",13,13,0
31259.0,2019-11-26,"(651.0, 850.0]",3,6,-3
31259.0,2019-11-26,"(850.0, 1049.0]",3,8,-5
31260.0,2019-11-26,"(403.045, 642.75]",11,15,-4
31260.0,2019-11-26,"(642.75, 881.5]",3,6,-3
31260.0,2019-11-26,"(881.5, 1120.25]",4,26,-22
31260.0,2019-11-26,"(1120.25, 1359.0]",2,2,0
31261.0,2019-11-26,"(495.337, 661.75]",13,15,-2
31261.0,2019-11-26,"(661.75, 827.5]",5,11,-6
31261.0,2019-11-26,"(993.25, 1159.0]",3,3,0
31262.0,2019-11-26,"(447.08, 678.0]",9,10,-1
31262.0,2019-11-26,"(678.0, 908.0]",4,11,-7
31262.0,2019-11-26,"(908.0, 1138.0]",8,14,-6
31263.0,2019-11-26,"(334.926, 604.5]",22,35,-13
31263.0,2019-11-26,"(604.5, 873.0]",14,24,-10
31263.0,2019-11-26,"(873.0, 1141.5]",8,27,-19
31263.0,2019-11-26,"(1141.5, 1410.0]",1,7,-6
31264.0,2019-11-26,"(406.129, 624.75]",19,24,-5
31264.0,2019-11-26,"(624.75, 842.5]",5,8,-3
31264.0,2019-11-26,"(842.5, 1060.25]",6,19,-13
31264.0,2019-11-26,"(1060.25, 1278.0]",2,6,-4
31265.0,2019-11-26,"(293.869, 577.75]",12,31,-19
31265.0,2019-11-26,"(577.75, 860.5]",7,16,-9
31265.0,2019-11-26,"(860.5, 1143.25]",21,37,-16
31265.0,2019-11-26,"(1143.25, 1426.0]",12,18,-6
31266.0,2019-11-26,"(86.756, 399.0]",1,8,-7
31266.0,2019-11-26,"(399.0, 710.0]",12,37,-25
31266.0,2019-11-26,"(710.0, 1021.0]",11,31,-20
31266.0,2019-11-26,"(1021.0, 1332.0]",28,41,-13
31267.0,2019-11-26,"(-0.323, 331.75]",2,4,-2
31267.0,2019-11-26,"(331.75, 662.5]",17,40,-23
31267.0,2019-11-26,"(662.5, 993.25]",16,24,-8
31267.0,2019-11-26,"(993.25, 1324.0]",21,42,-21
31268.0,2019-11-26,"(335.06, 571.0]",10,32,-22
31268.0,2019-11-26,"(571.0, 806.0]",4,12,-8
31268.0,2019-11-26,"(806.0, 1041.0]",9,16,-7
31268.0,2019-11-26,"(1041.0, 1276.0]",22,28,-6
31269.0,2019-11-26,"(388.956, 651.0]",8,18,-10
31269.0,2019-11-26,"(651.0, 912.0]",10,22,-12
31269.0,2019-11-26,"(912.0, 1173.0]",11,23,-12
31269.0,2019-11-26,"(1173.0, 1434.0]",1,2,-1
31270.0,2019-11-26,"(267.859, 554.25]",15,23,-8
31270.0,2019-11-26,"(554.25, 839.5]",6,13,-7
31270.0,2019-11-26,"(839.5, 1124.75]",20,40,-20
31270.0,2019-11-26,"(1124.75, 1410.0]",2,3,-1
31271.0,2019-11-26,"(455.09, 683.5]",24,35,-11
31271.0,2019-11-26,"(683.5, 911.0]",16,34,-18
31271.0,2019-11-26,"(911.0, 1138.5]",10,29,-19
31271.0,2019-11-26,"(1138.5, 1366.0]",8,12,-4
31272.0,2019-11-26,"(7.64, 349.0]",3,4,-1
31272.0,2019-11-26,"(349.0, 689.0]",31,37,-6
31272.0,2019-11-26,"(689.0, 1029.0]",19,54,-35
31272.0,2019-11-26,"(1029.0, 1369.0]",2,9,-7
31273.0,2019-11-26,"(413.361, 573.75]",2,5,-3
31273.0,2019-11-26,"(733.5, 893.25]",3,1,2
31273.0,2019-11-26,"(893.25, 1053.0]",7,7,0
31274.0,2019-11-26,"(397.01, 645.5]",14,15,-1
31274.0,2019-11-26,"(645.5, 893.0]",1,4,-3
31274.0,2019-11-26,"(893.0, 1140.5]",5,17,-12
31274.0,2019-11-26,"(1140.5, 1388.0]",1,7,-6
31275.0,2019-11-26,"(37.664, 373.0]",3,5,-2
31275.0,2019-11-26,"(373.0, 707.0]",21,41,-20
31275.0,2019-11-26,"(707.0, 1041.0]",10,19,-9
31275.0,2019-11-26,"(1041.0, 1375.0]",11,27,-16
31276.0,2019-11-26,"(457.154, 669.5]",25,28,-3
31276.0,2019-11-26,"(669.5, 881.0]",5,14,-9
31276.0,2019-11-26,"(881.0, 1092.5]",7,23,-16
31276.0,2019-11-26,"(1092.5, 1304.0]",3,15,-12
31277.0,2019-11-26,"(277.977, 534.75]",28,31,-3
31277.0,2019-11-26,"(534.75, 790.5]",18,29,-11
31277.0,2019-11-26,"(790.5, 1046.25]",16,40,-24
31277.0,2019-11-26,"(1046.25, 1302.0]",6,26,-20
31278.0,2019-11-26,"(300.964, 561.0]",7,25,-18
31278.0,2019-11-26,"(561.0, 820.0]",6,16,-10
31278.0,2019-11-26,"(820.0, 1079.0]",16,22,-6
31278.0,2019-11-26,"(1079.0, 1338.0]",12,22,-10
31279.0,2019-11-26,"(369.102, 594.5]",20,22,-2
31279.0,2019-11-26,"(594.5, 819.0]",6,18,-12
31279.0,2019-11-26,"(819.0, 1043.5]",8,21,-13
31279.0,2019-11-26,"(1043.5, 1268.0]",6,34,-28
31280.0,2019-11-26,"(359.058, 595.5]",3,21,-18
31280.0,2019-11-26,"(595.5, 831.0]",3,6,-3
31280.0,2019-11-26,"(831.0, 1066.5]",7,10,-3
31280.0,2019-11-26,"(1066.5, 1302.0]",15,24,-9
,,,,1.0,
,,,,1.0,
31001.0,2019-11-27,"(790.635, 882.25]",2,4,-2
31001.0,2019-11-27,"(882.25, 973.5]",2,2,0
31001.0,2019-11-27,"(973.5, 1064.75]",3,4,-1
31001.0,2019-11-27,"(1064.75, 1156.0]",2,2,0
31002.0,2019-11-27,"(558.43, 701.5]",1,3,-2
31002.0,2019-11-27,"(986.5, 1129.0]",1,2,-1
31003.0,2019-11-27,"(547.244, 737.0]",2,2,0
31003.0,2019-11-27,"(737.0, 926.0]",2,4,-2
31003.0,2019-11-27,"(926.0, 1115.0]",2,2,0
31003.0,2019-11-27,"(1115.0, 1304.0]",1,3,-2
31004.0,2019-11-27,"(738.25, 968.5]",4,1,3
31004.0,2019-11-27,"(968.5, 1198.75]",2,5,-3
31004.0,2019-11-27,"(1198.75, 1429.0]",1,3,-2
31005.0,2019-11-27,"(435.01, 683.5]",3,3,0
31005.0,2019-11-27,"(683.5, 931.0]",1,4,-3
31005.0,2019-11-27,"(931.0, 1178.5]",1,4,-3
31006.0,2019-11-27,"(839.25, 977.5]",2,2,0
31006.0,2019-11-27,"(977.5, 1115.75]",1,2,-1
31006.0,2019-11-27,"(1115.75, 1254.0]",1,3,-2
31007.0,2019-11-27,"(433.196, 635.0]",5,12,-7
31007.0,2019-11-27,"(635.0, 836.0]",1,3,-2
31007.0,2019-11-27,"(836.0, 1037.0]",3,9,-6
31007.0,2019-11-27,"(1037.0, 1238.0]",2,6,-4
,,,,1.0,
,,,,2.0,
31010.0,2019-11-27,"(934.75, 1037.0]",1,2,-1
31011.0,2019-11-27,"(413.169, 621.75]",3,3,0
31011.0,2019-11-27,"(829.5, 1037.25]",1,1,0
31011.0,2019-11-27,"(1037.25, 1245.0]",3,3,0
31012.0,2019-11-27,"(883.5, 1048.25]",2,1,1
31012.0,2019-11-27,"(1048.25, 1213.0]",2,2,0
31013.0,2019-11-27,"(581.27, 764.5]",1,3,-2
31013.0,2019-11-27,"(764.5, 947.0]",4,5,-1
31014.0,2019-11-27,"(146.836, 439.0]",4,4,0
31014.0,2019-11-27,"(439.0, 730.0]",13,21,-8
31014.0,2019-11-27,"(730.0, 1021.0]",8,12,-4
31014.0,2019-11-27,"(1021.0, 1312.0]",4,9,-5
31015.0,2019-11-27,"(307.061, 542.75]",7,7,0
31015.0,2019-11-27,"(542.75, 777.5]",2,7,-5
31015.0,2019-11-27,"(777.5, 1012.25]",6,11,-5
31015.0,2019-11-27,"(1012.25, 1247.0]",5,5,0
31016.0,2019-11-27,"(522.185, 726.75]",1,2,-1
31016.0,2019-11-27,"(930.5, 1134.25]",1,5,-4
31017.0,2019-11-27,"(486.275, 668.25]",2,3,-1
31017.0,2019-11-27,"(1030.75, 1212.0]",2,3,-1
31018.0,2019-11-27,"(510.355, 672.25]",1,5,-4
31018.0,2019-11-27,"(994.75, 1156.0]",5,5,0
31019.0,2019-11-27,"(1090.75, 1195.0]",2,1,1
,,,,1.0,
,,,,3.0,
31021.0,2019-11-27,"(525.319, 696.25]",1,3,-2
31021.0,2019-11-27,"(696.25, 866.5]",2,4,-2
31021.0,2019-11-27,"(1036.75, 1207.0]",1,1,0
31022.0,2019-11-27,"(7.612, 356.0]",1,1,0
31022.0,2019-11-27,"(356.0, 703.0]",1,1,0
31022.0,2019-11-27,"(703.0, 1050.0]",4,9,-5
31022.0,2019-11-27,"(1050.0, 1397.0]",1,4,-3
31023.0,2019-11-27,"(407.001, 657.75]",2,4,-2
31023.0,2019-11-27,"(907.5, 1157.25]",1,2,-1
31023.0,2019-11-27,"(1157.25, 1407.0]",2,4,-2
31024.0,2019-11-27,"(549.383, 704.25]",1,2,-1
31024.0,2019-11-27,"(704.25, 858.5]",1,2,-1
31024.0,2019-11-27,"(1012.75, 1167.0]",2,4,-2
31025.0,2019-11-27,"(717.721, 787.75]",3,5,-2
31025.0,2019-11-27,"(927.25, 997.0]",1,1,0
31026.0,2019-11-27,"(665.75, 865.5]",1,1,0
31026.0,2019-11-27,"(1065.25, 1265.0]",1,4,-3
31027.0,2019-11-27,"(853.25, 903.0]",1,1,0
31028.0,2019-11-27,"(484.402, 634.5]",2,2,0
31028.0,2019-11-27,"(784.0, 933.5]",2,1,1
31028.0,2019-11-27,"(933.5, 1083.0]",1,3,-2
31029.0,2019-11-27,"(892.5, 1054.75]",1,2,-1
31029.0,2019-11-27,"(1054.75, 1217.0]",3,2,1
31030.0,2019-11-27,"(962.5, 1188.75]",1,2,-1
31030.0,2019-11-27,"(1188.75, 1415.0]",5,1,4
31031.0,2019-11-27,"(408.031, 651.25]",1,2,-1
31031.0,2019-11-27,"(651.25, 893.5]",1,3,-2
31031.0,2019-11-27,"(893.5, 1135.75]",2,2,0
31032.0,2019-11-27,"(908.25, 983.5]",1,1,0
31032.0,2019-11-27,"(983.5, 1058.75]",2,1,1
31032.0,2019-11-27,"(1058.75, 1134.0]",1,2,-1
31033.0,2019-11-27,"(1026.672, 1109.0]",2,3,-1
31034.0,2019-11-27,"(445.252, 633.0]",2,5,-3
31034.0,2019-11-27,"(633.0, 820.0]",1,2,-1
31034.0,2019-11-27,"(820.0, 1007.0]",1,3,-2
31034.0,2019-11-27,"(1007.0, 1194.0]",1,2,-1
31035.0,2019-11-27,"(26.611, 375.25]",1,1,0
31035.0,2019-11-27,"(375.25, 722.5]",1,4,-3
31035.0,2019-11-27,"(722.5, 1069.75]",4,5,-1
31035.0,2019-11-27,"(1069.75, 1417.0]",2,3,-1
31036.0,2019-11-27,"(779.0, 904.5]",1,1,0
31036.0,2019-11-27,"(904.5, 1030.0]",3,1,2
31037.0,2019-11-27,"(355.75, 691.5]",8,1,7
31037.0,2019-11-27,"(691.5, 1027.25]",5,11,-6
31038.0,2019-11-27,"(450.409, 598.75]",1,2,-1
31038.0,2019-11-27,"(598.75, 746.5]",1,1,0
31038.0,2019-11-27,"(746.5, 894.25]",1,3,-2
31038.0,2019-11-27,"(894.25, 1042.0]",1,2,-1
31039.0,2019-11-27,"(589.332, 757.0]",1,4,-3
31039.0,2019-11-27,"(757.0, 924.0]",2,5,-3
31039.0,2019-11-27,"(924.0, 1091.0]",1,3,-2
31039.0,2019-11-27,"(1091.0, 1258.0]",1,3,-2
31040.0,2019-11-27,"(452.487, 581.25]",2,2,0
31040.0,2019-11-27,"(709.5, 837.75]",2,2,0
31040.0,2019-11-27,"(837.75, 966.0]",1,3,-2
31041.0,2019-11-27,"(486.359, 647.25]",2,6,-4
31041.0,2019-11-27,"(807.5, 967.75]",6,1,5
31041.0,2019-11-27,"(967.75, 1128.0]",1,8,-7
31042.0,2019-11-27,"(492.194, 694.5]",2,2,0
31042.0,2019-11-27,"(694.5, 896.0]",4,6,-2
31042.0,2019-11-27,"(896.0, 1097.5]",4,9,-5
31043.0,2019-11-27,"(410.324, 580.0]",1,2,-1
31043.0,2019-11-27,"(749.0, 918.0]",1,1,0
31043.0,2019-11-27,"(918.0, 1087.0]",1,2,-1
31044.0,2019-11-27,"(648.528, 767.0]",1,1,0
31044.0,2019-11-27,"(767.0, 885.0]",1,1,0
31045.0,2019-11-27,"(298.873, 581.75]",1,3,-2
31045.0,2019-11-27,"(1145.25, 1427.0]",2,1,1
31046.0,2019-11-27,"(390.122, 610.5]",1,4,-3
31046.0,2019-11-27,"(1049.5, 1269.0]",1,1,0
31047.0,2019-11-27,"(295.085, 524.75]",5,9,-4
31047.0,2019-11-27,"(524.75, 753.5]",4,8,-4
31047.0,2019-11-27,"(753.5, 982.25]",4,11,-7
31047.0,2019-11-27,"(982.25, 1211.0]",4,6,-2
31048.0,2019-11-27,"(514.304, 689.0]",1,2,-1
31048.0,2019-11-27,"(1037.0, 1211.0]",1,1,0
31049.0,2019-11-27,"(553.218, 749.5]",1,2,-1
31049.0,2019-11-27,"(749.5, 945.0]",2,3,-1
31049.0,2019-11-27,"(1140.5, 1336.0]",2,1,1
31050.0,2019-11-27,"(757.0, 897.5]",1,1,0
31050.0,2019-11-27,"(897.5, 1038.0]",1,1,0
31051.0,2019-11-27,"(820.0, 992.0]",4,1,3
31052.0,2019-11-27,"(532.172, 740.0]",1,2,-1
31052.0,2019-11-27,"(947.0, 1154.0]",4,2,2
31052.0,2019-11-27,"(1154.0, 1361.0]",1,6,-5
31053.0,2019-11-27,"(697.5, 1046.25]",1,1,0
31053.0,2019-11-27,"(1046.25, 1395.0]",2,1,1
,,,,1.0,
,,,,1.0,
31055.0,2019-11-27,"(965.68, 1046.0]",2,3,-1
31055.0,2019-11-27,"(1046.0, 1126.0]",1,1,0
31055.0,2019-11-27,"(1126.0, 1206.0]",1,1,0
31056.0,2019-11-27,"(1125.75, 1291.0]",2,2,0
31057.0,2019-11-27,"(1020.75, 1361.0]",1,1,0
,,,,1.0,
,,,,1.0,
31059.0,2019-11-27,"(644.75, 860.5]",1,1,0
31059.0,2019-11-27,"(860.5, 1076.25]",1,1,0
31059.0,2019-11-27,"(1076.25, 1292.0]",1,2,-1
31060.0,2019-11-27,"(420.45, 558.5]",1,1,0
31061.0,2019-11-27,"(485.25, 647.0]",1,1,0
31062.0,2019-11-27,"(465.426, 609.5]",1,2,-1
31062.0,2019-11-27,"(753.0, 896.5]",4,5,-1
31062.0,2019-11-27,"(896.5, 1040.0]",4,5,-1
31063.0,2019-11-27,"(755.25, 1007.0]",1,1,0
31064.0,2019-11-27,"(396.193, 598.75]",2,4,-2
31064.0,2019-11-27,"(598.75, 800.5]",1,3,-2
31064.0,2019-11-27,"(800.5, 1002.25]",10,18,-8
31064.0,2019-11-27,"(1002.25, 1204.0]",4,8,-4
31065.0,2019-11-27,"(702.0, 801.0]",1,1,0
31065.0,2019-11-27,"(801.0, 900.0]",1,1,0
31066.0,2019-11-27,"(961.25, 1112.0]",1,1,0
31067.0,2019-11-27,"(744.341, 909.75]",3,4,-1
31067.0,2019-11-27,"(1074.5, 1239.25]",2,3,-1
31067.0,2019-11-27,"(1239.25, 1404.0]",1,1,0
31068.0,2019-11-27,"(680.5, 1020.75]",1,1,0
31068.0,2019-11-27,"(1020.75, 1361.0]",1,1,0
31069.0,2019-11-27,"(817.0, 1030.0]",1,3,-2
31069.0,2019-11-27,"(1030.0, 1243.0]",3,1,2
31070.0,2019-11-27,"(724.0, 788.5]",1,1,0
31070.0,2019-11-27,"(788.5, 853.0]",1,1,0
31071.0,2019-11-27,"(497.181, 702.75]",3,5,-2
31071.0,2019-11-27,"(702.75, 907.5]",3,3,0
31071.0,2019-11-27,"(907.5, 1112.25]",1,7,-6
31071.0,2019-11-27,"(1112.25, 1317.0]",3,4,-1
,,,,2.0,
31073.0,2019-11-27,"(492.221, 687.75]",1,3,-2
31073.0,2019-11-27,"(882.5, 1077.25]",1,2,-1
31073.0,2019-11-27,"(1077.25, 1272.0]",1,2,-1
31074.0,2019-11-27,"(543.323, 713.25]",1,3,-2
31074.0,2019-11-27,"(713.25, 882.5]",1,1,0
31074.0,2019-11-27,"(882.5, 1051.75]",1,1,0
31074.0,2019-11-27,"(1051.75, 1221.0]",4,7,-3
31075.0,2019-11-27,"(875.0, 1075.0]",2,2,0
31075.0,2019-11-27,"(1075.0, 1275.0]",2,2,0
31076.0,2019-11-27,"(313.5, 608.0]",1,1,0
31076.0,2019-11-27,"(608.0, 902.5]",1,1,0
31076.0,2019-11-27,"(902.5, 1197.0]",1,1,0
31077.0,2019-11-27,"(523.574, 630.5]",1,3,-2
31077.0,2019-11-27,"(630.5, 737.0]",2,4,-2
31077.0,2019-11-27,"(737.0, 843.5]",2,2,0
31077.0,2019-11-27,"(843.5, 950.0]",3,3,0
31078.0,2019-11-27,"(503.401, 653.75]",2,3,-1
31078.0,2019-11-27,"(953.25, 1103.0]",1,3,-2
31079.0,2019-11-27,"(537.25, 784.5]",1,3,-2
31079.0,2019-11-27,"(784.5, 1031.75]",4,2,2
31079.0,2019-11-27,"(1031.75, 1279.0]",1,4,-3
31080.0,2019-11-27,"(593.5, 843.0]",1,7,-6
31080.0,2019-11-27,"(843.0, 1092.5]",3,4,-1
31080.0,2019-11-27,"(1092.5, 1342.0]",3,4,-1
31081.0,2019-11-27,"(848.604, 948.0]",1,1,0
31081.0,2019-11-27,"(948.0, 1047.0]",3,6,-3
31081.0,2019-11-27,"(1047.0, 1146.0]",2,5,-3
31081.0,2019-11-27,"(1146.0, 1245.0]",1,2,-1
31082.0,2019-11-27,"(555.0, 740.0]",1,1,0
31083.0,2019-11-27,"(887.811, 935.25]",3,3,0
31083.0,2019-11-27,"(935.25, 982.5]",1,2,-1
31083.0,2019-11-27,"(1029.75, 1077.0]",1,1,0
31084.0,2019-11-27,"(548.261, 733.75]",3,3,0
31085.0,2019-11-27,"(395.376, 552.0]",1,3,-2
31085.0,2019-11-27,"(708.0, 864.0]",1,1,0
31085.0,2019-11-27,"(864.0, 1020.0]",2,2,0
,,,,1.0,
,,,,4.0,
,,,,1.0,
,,,,1.0,
31088.0,2019-11-27,"(939.0, 1142.0]",3,3,0
31088.0,2019-11-27,"(1142.0, 1345.0]",3,3,0
31089.0,2019-11-27,"(356.75, 713.5]",3,1,2
31089.0,2019-11-27,"(713.5, 1070.25]",7,5,2
31089.0,2019-11-27,"(1070.25, 1427.0]",2,20,-18
31090.0,2019-11-27,"(869.5, 1018.0]",1,1,0
31091.0,2019-11-27,"(97.843, 388.25]",2,2,0
31091.0,2019-11-27,"(677.5, 966.75]",1,4,-3
31091.0,2019-11-27,"(966.75, 1256.0]",2,3,-1
31092.0,2019-11-27,"(1098.5, 1331.0]",1,1,0
,,,,1.0,
,,,,3.0,
31094.0,2019-11-27,"(976.591, 1079.25]",1,1,0
31094.0,2019-11-27,"(1079.25, 1181.5]",1,1,0
,,,,2.0,
31096.0,2019-11-27,"(816.5, 877.0]",2,1,1
31097.0,2019-11-27,"(481.046, 720.5]",4,5,-1
31097.0,2019-11-27,"(720.5, 959.0]",2,5,-3
31097.0,2019-11-27,"(1197.5, 1436.0]",2,1,1
31098.0,2019-11-27,"(414.289, 592.75]",4,6,-2
31098.0,2019-11-27,"(770.5, 948.25]",3,9,-6
31098.0,2019-11-27,"(948.25, 1126.0]",2,4,-2
31099.0,2019-11-27,"(672.0, 865.0]",1,1,0
31099.0,2019-11-27,"(865.0, 1058.0]",1,1,0
31100.0,2019-11-27,"(241.866, 526.5]",5,8,-3
31100.0,2019-11-27,"(526.5, 810.0]",10,13,-3
31100.0,2019-11-27,"(810.0, 1093.5]",6,16,-10
31100.0,2019-11-27,"(1093.5, 1377.0]",3,7,-4
31101.0,2019-11-27,"(43.65, 382.5]",2,2,0
31101.0,2019-11-27,"(382.5, 720.0]",14,27,-13
31101.0,2019-11-27,"(720.0, 1057.5]",32,49,-17
31101.0,2019-11-27,"(1057.5, 1395.0]",18,36,-18
31102.0,2019-11-27,"(168.761, 479.75]",1,2,-1
31102.0,2019-11-27,"(479.75, 789.5]",3,12,-9
31102.0,2019-11-27,"(789.5, 1099.25]",3,8,-5
31102.0,2019-11-27,"(1099.25, 1409.0]",3,12,-9
31103.0,2019-11-27,"(576.5, 837.0]",5,19,-14
31103.0,2019-11-27,"(837.0, 1097.5]",9,8,1
31103.0,2019-11-27,"(1097.5, 1358.0]",7,16,-9
31104.0,2019-11-27,"(374.5, 725.0]",6,3,3
31104.0,2019-11-27,"(725.0, 1075.5]",14,27,-13
31104.0,2019-11-27,"(1075.5, 1426.0]",10,28,-18
31105.0,2019-11-27,"(209.92, 481.0]",1,3,-2
31105.0,2019-11-27,"(751.0, 1021.0]",2,3,-1
31105.0,2019-11-27,"(1021.0, 1291.0]",1,6,-5
31106.0,2019-11-27,"(797.0, 962.5]",2,5,-3
31106.0,2019-11-27,"(962.5, 1128.0]",2,2,0
31107.0,2019-11-27,"(334.937, 601.75]",2,22,-20
31107.0,2019-11-27,"(601.75, 867.5]",4,9,-5
31107.0,2019-11-27,"(867.5, 1133.25]",11,21,-10
31107.0,2019-11-27,"(1133.25, 1399.0]",3,8,-5
31108.0,2019-11-27,"(416.065, 650.75]",3,15,-12
31108.0,2019-11-27,"(650.75, 884.5]",12,26,-14
31108.0,2019-11-27,"(884.5, 1118.25]",19,29,-10
31108.0,2019-11-27,"(1118.25, 1352.0]",9,13,-4
31109.0,2019-11-27,"(35.617, 382.75]",1,2,-1
31109.0,2019-11-27,"(382.75, 728.5]",7,18,-11
31109.0,2019-11-27,"(728.5, 1074.25]",13,22,-9
31109.0,2019-11-27,"(1074.25, 1420.0]",6,16,-10
31110.0,2019-11-27,"(8.612, 357.0]",2,4,-2
31110.0,2019-11-27,"(357.0, 704.0]",15,32,-17
31110.0,2019-11-27,"(704.0, 1051.0]",22,35,-13
31110.0,2019-11-27,"(1051.0, 1398.0]",3,10,-7
31111.0,2019-11-27,"(50.639, 392.25]",3,3,0
31111.0,2019-11-27,"(392.25, 732.5]",2,11,-9
31111.0,2019-11-27,"(732.5, 1072.75]",10,17,-7
31111.0,2019-11-27,"(1072.75, 1413.0]",13,20,-7
31112.0,2019-11-27,"(562.234, 754.5]",3,8,-5
31112.0,2019-11-27,"(754.5, 946.0]",1,1,0
31112.0,2019-11-27,"(946.0, 1137.5]",2,3,-1
31112.0,2019-11-27,"(1137.5, 1329.0]",2,2,0
31113.0,2019-11-27,"(252.963, 513.25]",4,10,-6
31113.0,2019-11-27,"(772.5, 1031.75]",4,7,-3
31113.0,2019-11-27,"(1031.75, 1291.0]",3,7,-4
31114.0,2019-11-27,"(29.647, 369.25]",3,4,-1
31114.0,2019-11-27,"(369.25, 707.5]",3,19,-16
31114.0,2019-11-27,"(707.5, 1045.75]",12,24,-12
31114.0,2019-11-27,"(1045.75, 1384.0]",18,37,-19
31115.0,2019-11-27,"(346.911, 620.25]",1,16,-15
31115.0,2019-11-27,"(620.25, 892.5]",3,10,-7
31115.0,2019-11-27,"(892.5, 1164.75]",6,8,-2
31115.0,2019-11-27,"(1164.75, 1437.0]",2,5,-3
31116.0,2019-11-27,"(438.045, 677.75]",3,15,-12
31116.0,2019-11-27,"(677.75, 916.5]",6,18,-12
31116.0,2019-11-27,"(916.5, 1155.25]",13,16,-3
31116.0,2019-11-27,"(1155.25, 1394.0]",7,11,-4
31117.0,2019-11-27,"(16.714, 339.5]",1,1,0
31117.0,2019-11-27,"(339.5, 661.0]",3,13,-10
31117.0,2019-11-27,"(661.0, 982.5]",6,20,-14
31117.0,2019-11-27,"(982.5, 1304.0]",8,18,-10
31118.0,2019-11-27,"(469.199, 670.25]",1,10,-9
31118.0,2019-11-27,"(670.25, 870.5]",3,9,-6
31118.0,2019-11-27,"(870.5, 1070.75]",8,11,-3
31118.0,2019-11-27,"(1070.75, 1271.0]",6,11,-5
31119.0,2019-11-27,"(27.598, 379.5]",4,7,-3
31119.0,2019-11-27,"(379.5, 730.0]",6,18,-12
31119.0,2019-11-27,"(730.0, 1080.5]",8,13,-5
31119.0,2019-11-27,"(1080.5, 1431.0]",7,13,-6
31120.0,2019-11-27,"(24.659, 361.25]",1,1,0
31120.0,2019-11-27,"(361.25, 696.5]",3,9,-6
31120.0,2019-11-27,"(696.5, 1031.75]",8,12,-4
31120.0,2019-11-27,"(1031.75, 1367.0]",6,14,-8
31121.0,2019-11-27,"(36.655, 374.25]",1,3,-2
31121.0,2019-11-27,"(374.25, 710.5]",10,18,-8
31121.0,2019-11-27,"(710.5, 1046.75]",6,16,-10
31121.0,2019-11-27,"(1046.75, 1383.0]",6,10,-4
31122.0,2019-11-27,"(590.5, 864.0]",1,6,-5
31122.0,2019-11-27,"(864.0, 1137.5]",4,5,-1
31122.0,2019-11-27,"(1137.5, 1411.0]",4,9,-5
31123.0,2019-11-27,"(678.25, 919.5]",2,6,-4
31123.0,2019-11-27,"(919.5, 1160.75]",2,7,-5
31123.0,2019-11-27,"(1160.75, 1402.0]",1,5,-4
31124.0,2019-11-27,"(6.595, 359.25]",1,2,-1
31124.0,2019-11-27,"(359.25, 710.5]",16,29,-13
31124.0,2019-11-27,"(710.5, 1061.75]",17,45,-28
31124.0,2019-11-27,"(1061.75, 1413.0]",16,33,-17
31125.0,2019-11-27,"(369.5, 714.0]",8,1,7
31125.0,2019-11-27,"(714.0, 1058.5]",22,29,-7
31125.0,2019-11-27,"(1058.5, 1403.0]",12,32,-20
31126.0,2019-11-27,"(-1.426, 356.5]",1,2,-1
31126.0,2019-11-27,"(356.5, 713.0]",2,23,-21
31126.0,2019-11-27,"(713.0, 1069.5]",7,16,-9
31126.0,2019-11-27,"(1069.5, 1426.0]",10,15,-5
31127.0,2019-11-27,"(64.8, 366.0]",1,1,0
31127.0,2019-11-27,"(366.0, 666.0]",7,7,0
31127.0,2019-11-27,"(666.0, 966.0]",2,7,-5
31127.0,2019-11-27,"(966.0, 1266.0]",2,9,-7
31128.0,2019-11-27,"(339.918, 611.5]",11,18,-7
31128.0,2019-11-27,"(611.5, 882.0]",13,26,-13
31128.0,2019-11-27,"(882.0, 1152.5]",13,25,-12
31128.0,2019-11-27,"(1152.5, 1423.0]",2,5,-3
31129.0,2019-11-27,"(334.0, 663.0]",7,1,6
31129.0,2019-11-27,"(663.0, 992.0]",22,8,14
31129.0,2019-11-27,"(992.0, 1321.0]",4,35,-31
31130.0,2019-11-27,"(26.642, 367.5]",1,3,-2
31130.0,2019-11-27,"(367.5, 707.0]",3,11,-8
31130.0,2019-11-27,"(707.0, 1046.5]",6,12,-6
31130.0,2019-11-27,"(1046.5, 1386.0]",9,13,-4
31131.0,2019-11-27,"(501.094, 728.5]",1,13,-12
31131.0,2019-11-27,"(728.5, 955.0]",1,3,-2
31131.0,2019-11-27,"(955.0, 1181.5]",7,10,-3
31131.0,2019-11-27,"(1181.5, 1408.0]",3,10,-7
31200.0,2019-11-27,"(370.972, 629.0]",21,28,-7
31200.0,2019-11-27,"(629.0, 886.0]",12,22,-10
31200.0,2019-11-27,"(886.0, 1143.0]",16,35,-19
31200.0,2019-11-27,"(1143.0, 1400.0]",7,11,-4
31201.0,2019-11-27,"(293.939, 560.25]",12,24,-12
31201.0,2019-11-27,"(560.25, 825.5]",27,50,-23
31201.0,2019-11-27,"(825.5, 1090.75]",46,77,-31
31201.0,2019-11-27,"(1090.75, 1356.0]",15,31,-16
31202.0,2019-11-27,"(121.728, 441.0]",2,7,-5
31202.0,2019-11-27,"(441.0, 759.0]",17,29,-12
31202.0,2019-11-27,"(759.0, 1077.0]",31,54,-23
31202.0,2019-11-27,"(1077.0, 1395.0]",13,25,-12
31203.0,2019-11-27,"(330.946, 595.5]",3,11,-8
31203.0,2019-11-27,"(595.5, 859.0]",13,23,-10
31203.0,2019-11-27,"(859.0, 1122.5]",23,39,-16
31203.0,2019-11-27,"(1122.5, 1386.0]",7,16,-9
31204.0,2019-11-27,"(3.741, 319.75]",2,3,-1
31204.0,2019-11-27,"(319.75, 634.5]",7,10,-3
31204.0,2019-11-27,"(634.5, 949.25]",4,17,-13
31204.0,2019-11-27,"(949.25, 1264.0]",3,7,-4
31205.0,2019-11-27,"(146.732, 465.0]",1,2,-1
31205.0,2019-11-27,"(465.0, 782.0]",9,11,-2
31205.0,2019-11-27,"(782.0, 1099.0]",12,28,-16
31205.0,2019-11-27,"(1099.0, 1416.0]",4,10,-6
31206.0,2019-11-27,"(431.401, 581.75]",6,6,0
31206.0,2019-11-27,"(581.75, 731.5]",1,2,-1
31206.0,2019-11-27,"(731.5, 881.25]",2,5,-3
31206.0,2019-11-27,"(881.25, 1031.0]",4,11,-7
31207.0,2019-11-27,"(906.5, 1170.75]",3,3,0
31207.0,2019-11-27,"(1170.75, 1435.0]",2,2,0
31208.0,2019-11-27,"(320.908, 595.0]",7,8,-1
31208.0,2019-11-27,"(595.0, 868.0]",5,17,-12
31208.0,2019-11-27,"(868.0, 1141.0]",3,10,-7
31209.0,2019-11-27,"(484.126, 703.5]",2,5,-3
31209.0,2019-11-27,"(703.5, 922.0]",6,9,-3
31209.0,2019-11-27,"(922.0, 1140.5]",8,8,0
31209.0,2019-11-27,"(1140.5, 1359.0]",1,1,0
31211.0,2019-11-27,"(528.381, 683.75]",4,4,0
31211.0,2019-11-27,"(683.75, 838.5]",2,4,-2
31211.0,2019-11-27,"(838.5, 993.25]",1,7,-6
31211.0,2019-11-27,"(993.25, 1148.0]",4,5,-1
31212.0,2019-11-27,"(355.979, 612.25]",18,20,-2
31212.0,2019-11-27,"(612.25, 867.5]",10,19,-9
31212.0,2019-11-27,"(867.5, 1122.75]",6,21,-15
31212.0,2019-11-27,"(1122.75, 1378.0]",3,4,-1
31213.0,2019-11-27,"(459.061, 694.75]",18,34,-16
31213.0,2019-11-27,"(694.75, 929.5]",22,31,-9
31213.0,2019-11-27,"(929.5, 1164.25]",17,32,-15
31213.0,2019-11-27,"(1164.25, 1399.0]",3,3,0
31214.0,2019-11-27,"(350.94, 617.0]",7,20,-13
31214.0,2019-11-27,"(617.0, 882.0]",11,29,-18
31214.0,2019-11-27,"(882.0, 1147.0]",21,31,-10
31214.0,2019-11-27,"(1147.0, 1412.0]",8,12,-4
31215.0,2019-11-27,"(444.062, 679.5]",13,13,0
31215.0,2019-11-27,"(679.5, 914.0]",9,13,-4
31215.0,2019-11-27,"(914.0, 1148.5]",8,18,-10
31216.0,2019-11-27,"(17.651, 356.25]",1,4,-3
31216.0,2019-11-27,"(356.25, 693.5]",13,14,-1
31216.0,2019-11-27,"(693.5, 1030.75]",5,19,-14
31216.0,2019-11-27,"(1030.75, 1368.0]",2,11,-9
31217.0,2019-11-27,"(360.265, 544.75]",7,8,-1
31217.0,2019-11-27,"(544.75, 728.5]",1,3,-2
31217.0,2019-11-27,"(728.5, 912.25]",2,11,-9
31217.0,2019-11-27,"(912.25, 1096.0]",3,7,-4
31218.0,2019-11-27,"(395.352, 558.0]",7,14,-7
31218.0,2019-11-27,"(558.0, 720.0]",3,6,-3
31218.0,2019-11-27,"(720.0, 882.0]",5,8,-3
31218.0,2019-11-27,"(882.0, 1044.0]",7,15,-8
31219.0,2019-11-27,"(392.116, 614.0]",5,6,-1
31219.0,2019-11-27,"(614.0, 835.0]",8,9,-1
31219.0,2019-11-27,"(835.0, 1056.0]",4,16,-12
31219.0,2019-11-27,"(1056.0, 1277.0]",1,4,-3
31220.0,2019-11-27,"(259.193, 461.75]",3,3,0
31220.0,2019-11-27,"(461.75, 663.5]",11,12,-1
31220.0,2019-11-27,"(663.5, 865.25]",1,4,-3
31220.0,2019-11-27,"(865.25, 1067.0]",2,14,-12
31221.0,2019-11-27,"(460.173, 667.75]",14,15,-1
31221.0,2019-11-27,"(667.75, 874.5]",9,19,-10
31221.0,2019-11-27,"(874.5, 1081.25]",9,22,-13
31221.0,2019-11-27,"(1081.25, 1288.0]",6,8,-2
31222.0,2019-11-27,"(381.187, 585.25]",12,12,0
31222.0,2019-11-27,"(585.25, 788.5]",2,7,-5
31222.0,2019-11-27,"(788.5, 991.75]",1,11,-10
31222.0,2019-11-27,"(991.75, 1195.0]",7,7,0
31223.0,2019-11-27,"(48.632, 392.0]",1,2,-1
31223.0,2019-11-27,"(392.0, 734.0]",8,25,-17
31223.0,2019-11-27,"(734.0, 1076.0]",12,23,-11
31223.0,2019-11-27,"(1076.0, 1418.0]",2,8,-6
31224.0,2019-11-27,"(426.019, 672.25]",11,16,-5
31224.0,2019-11-27,"(672.25, 917.5]",6,13,-7
31224.0,2019-11-27,"(917.5, 1162.75]",3,8,-5
31224.0,2019-11-27,"(1162.75, 1408.0]",1,4,-3
31225.0,2019-11-27,"(430.039, 671.25]",5,7,-2
31225.0,2019-11-27,"(671.25, 911.5]",5,10,-5
31225.0,2019-11-27,"(911.5, 1151.75]",4,8,-4
31225.0,2019-11-27,"(1151.75, 1392.0]",4,6,-2
31226.0,2019-11-27,"(19.719, 341.25]",2,2,0
31226.0,2019-11-27,"(661.5, 981.75]",2,4,-2
31226.0,2019-11-27,"(981.75, 1302.0]",5,4,1
31227.0,2019-11-27,"(446.06, 682.0]",27,27,0
31227.0,2019-11-27,"(682.0, 917.0]",5,14,-9
31228.0,2019-11-27,"(113.71, 437.5]",4,5,-1
31228.0,2019-11-27,"(437.5, 760.0]",14,21,-7
31228.0,2019-11-27,"(760.0, 1082.5]",19,42,-23
31228.0,2019-11-27,"(1082.5, 1405.0]",19,37,-18
31229.0,2019-11-27,"(322.899, 599.25]",13,45,-32
31229.0,2019-11-27,"(599.25, 874.5]",15,33,-18
31229.0,2019-11-27,"(874.5, 1149.75]",28,50,-22
31229.0,2019-11-27,"(1149.75, 1425.0]",11,16,-5
31230.0,2019-11-27,"(175.797, 477.75]",6,9,-3
31230.0,2019-11-27,"(477.75, 778.5]",29,38,-9
31230.0,2019-11-27,"(778.5, 1079.25]",21,43,-22
31230.0,2019-11-27,"(1079.25, 1380.0]",3,10,-7
31231.0,2019-11-27,"(490.156, 702.0]",8,12,-4
31231.0,2019-11-27,"(702.0, 913.0]",3,12,-9
31231.0,2019-11-27,"(913.0, 1124.0]",2,8,-6
31231.0,2019-11-27,"(1124.0, 1335.0]",3,3,0
31232.0,2019-11-27,"(86.727, 406.25]",3,6,-3
31232.0,2019-11-27,"(406.25, 724.5]",11,13,-2
31232.0,2019-11-27,"(724.5, 1042.75]",13,24,-11
31232.0,2019-11-27,"(1042.75, 1361.0]",10,24,-14
31233.0,2019-11-27,"(432.003, 682.25]",15,23,-8
31233.0,2019-11-27,"(682.25, 931.5]",5,10,-5
31233.0,2019-11-27,"(931.5, 1180.75]",4,7,-3
31233.0,2019-11-27,"(1180.75, 1430.0]",2,4,-2
31234.0,2019-11-27,"(381.037, 622.75]",7,16,-9
31234.0,2019-11-27,"(622.75, 863.5]",8,12,-4
31234.0,2019-11-27,"(863.5, 1104.25]",10,19,-9
31234.0,2019-11-27,"(1104.25, 1345.0]",7,10,-3
31235.0,2019-11-27,"(555.143, 770.25]",2,5,-3
31235.0,2019-11-27,"(770.25, 984.5]",7,8,-1
31235.0,2019-11-27,"(1198.75, 1413.0]",1,4,-3
31236.0,2019-11-27,"(493.302, 668.5]",11,12,-1
31236.0,2019-11-27,"(668.5, 843.0]",4,9,-5
31236.0,2019-11-27,"(843.0, 1017.5]",4,13,-9
31236.0,2019-11-27,"(1017.5, 1192.0]",5,14,-9
31237.0,2019-11-27,"(150.819, 447.25]",1,1,0
31237.0,2019-11-27,"(447.25, 742.5]",8,25,-17
31237.0,2019-11-27,"(742.5, 1037.75]",18,31,-13
31237.0,2019-11-27,"(1037.75, 1333.0]",9,18,-9
31238.0,2019-11-27,"(55.67, 389.5]",1,2,-1
31238.0,2019-11-27,"(389.5, 722.0]",13,16,-3
31238.0,2019-11-27,"(722.0, 1054.5]",6,22,-16
31238.0,2019-11-27,"(1054.5, 1387.0]",5,8,-3
31239.0,2019-11-27,"(382.024, 627.0]",16,17,-1
31239.0,2019-11-27,"(627.0, 871.0]",8,15,-7
31239.0,2019-11-27,"(871.0, 1115.0]",6,21,-15
31239.0,2019-11-27,"(1115.0, 1359.0]",4,5,-1
31240.0,2019-11-27,"(517.295, 694.25]",1,3,-2
31240.0,2019-11-27,"(694.25, 870.5]",5,8,-3
31240.0,2019-11-27,"(870.5, 1046.75]",2,2,0
31240.0,2019-11-27,"(1046.75, 1223.0]",1,1,0
31241.0,2019-11-27,"(189.801, 490.75]",3,8,-5
31241.0,2019-11-27,"(490.75, 790.5]",9,22,-13
31241.0,2019-11-27,"(790.5, 1090.25]",10,23,-13
31241.0,2019-11-27,"(1090.25, 1390.0]",7,16,-9
31242.0,2019-11-27,"(318.096, 545.0]",8,9,-1
31242.0,2019-11-27,"(545.0, 771.0]",15,18,-3
31242.0,2019-11-27,"(771.0, 997.0]",14,43,-29
31243.0,2019-11-27,"(377.971, 636.25]",12,16,-4
31243.0,2019-11-27,"(636.25, 893.5]",3,15,-12
31243.0,2019-11-27,"(893.5, 1150.75]",11,24,-13
31243.0,2019-11-27,"(1150.75, 1408.0]",3,6,-3
31244.0,2019-11-27,"(375.0, 699.0]",9,1,8
31244.0,2019-11-27,"(699.0, 1023.0]",9,19,-10
31244.0,2019-11-27,"(1023.0, 1347.0]",4,24,-20
31245.0,2019-11-27,"(7.578, 364.5]",1,1,0
31245.0,2019-11-27,"(364.5, 720.0]",10,15,-5
31245.0,2019-11-27,"(720.0, 1075.5]",13,32,-19
31245.0,2019-11-27,"(1075.5, 1431.0]",7,13,-6
31246.0,2019-11-27,"(12.611, 361.25]",1,1,0
31246.0,2019-11-27,"(361.25, 708.5]",10,19,-9
31246.0,2019-11-27,"(708.5, 1055.75]",15,37,-22
31246.0,2019-11-27,"(1055.75, 1403.0]",8,14,-6
31247.0,2019-11-27,"(439.262, 624.5]",8,10,-2
31247.0,2019-11-27,"(624.5, 809.0]",14,21,-7
31247.0,2019-11-27,"(809.0, 993.5]",4,22,-18
31247.0,2019-11-27,"(993.5, 1178.0]",3,12,-9
31248.0,2019-11-27,"(458.137, 674.75]",2,8,-6
31248.0,2019-11-27,"(674.75, 890.5]",18,26,-8
31248.0,2019-11-27,"(890.5, 1106.25]",10,36,-26
31248.0,2019-11-27,"(1106.25, 1322.0]",6,9,-3
31249.0,2019-11-27,"(387.065, 621.75]",7,14,-7
31249.0,2019-11-27,"(621.75, 855.5]",11,21,-10
31249.0,2019-11-27,"(855.5, 1089.25]",10,22,-12
31249.0,2019-11-27,"(1089.25, 1323.0]",7,8,-1
31250.0,2019-11-27,"(458.19, 661.5]",10,11,-1
31250.0,2019-11-27,"(661.5, 864.0]",2,7,-5
31250.0,2019-11-27,"(864.0, 1066.5]",5,12,-7
31250.0,2019-11-27,"(1066.5, 1269.0]",1,4,-3
31251.0,2019-11-27,"(456.052, 694.0]",8,17,-9
31251.0,2019-11-27,"(694.0, 931.0]",7,18,-11
31251.0,2019-11-27,"(931.0, 1168.0]",4,11,-7
31251.0,2019-11-27,"(1168.0, 1405.0]",7,10,-3
31252.0,2019-11-27,"(325.142, 540.5]",5,7,-2
31252.0,2019-11-27,"(540.5, 755.0]",8,9,-1
31252.0,2019-11-27,"(755.0, 969.5]",5,12,-7
31252.0,2019-11-27,"(969.5, 1184.0]",2,8,-6
31253.0,2019-11-27,"(426.087, 655.25]",12,15,-3
31253.0,2019-11-27,"(655.25, 883.5]",6,12,-6
31253.0,2019-11-27,"(883.5, 1111.75]",2,13,-11
31253.0,2019-11-27,"(1111.75, 1340.0]",4,9,-5
31254.0,2019-11-27,"(471.328, 640.0]",6,8,-2
31254.0,2019-11-27,"(640.0, 808.0]",2,2,0
31254.0,2019-11-27,"(808.0, 976.0]",2,11,-9
31254.0,2019-11-27,"(976.0, 1144.0]",3,11,-8
31255.0,2019-11-27,"(428.337, 594.75]",4,7,-3
31255.0,2019-11-27,"(594.75, 760.5]",4,7,-3
31255.0,2019-11-27,"(760.5, 926.25]",1,3,-2
31255.0,2019-11-27,"(926.25, 1092.0]",4,9,-5
31256.0,2019-11-27,"(318.5, 636.0]",10,1,9
31256.0,2019-11-27,"(636.0, 953.5]",9,11,-2
31256.0,2019-11-27,"(953.5, 1271.0]",6,19,-13
31257.0,2019-11-27,"(81.719, 403.25]",2,3,-1
31257.0,2019-11-27,"(403.25, 723.5]",7,13,-6
31257.0,2019-11-27,"(723.5, 1043.75]",16,24,-8
31257.0,2019-11-27,"(1043.75, 1364.0]",9,19,-10
31258.0,2019-11-27,"(68.732, 387.0]",2,4,-2
31258.0,2019-11-27,"(387.0, 704.0]",6,21,-15
31258.0,2019-11-27,"(704.0, 1021.0]",20,35,-15
31258.0,2019-11-27,"(1021.0, 1338.0]",10,26,-16
31259.0,2019-11-27,"(453.252, 641.0]",9,9,0
31259.0,2019-11-27,"(828.0, 1015.0]",1,2,-1
31259.0,2019-11-27,"(1015.0, 1202.0]",1,6,-5
31260.0,2019-11-27,"(382.984, 638.0]",10,13,-3
31260.0,2019-11-27,"(638.0, 892.0]",5,16,-11
31260.0,2019-11-27,"(892.0, 1146.0]",1,6,-5
31260.0,2019-11-27,"(1146.0, 1400.0]",3,3,0
31261.0,2019-11-27,"(378.993, 631.75]",10,10,0
31262.0,2019-11-27,"(524.123, 744.25]",7,7,0
31262.0,2019-11-27,"(744.25, 963.5]",3,8,-5
31262.0,2019-11-27,"(963.5, 1182.75]",7,15,-8
31262.0,2019-11-27,"(1182.75, 1402.0]",3,4,-1
31263.0,2019-11-27,"(360.059, 596.25]",14,20,-6
31263.0,2019-11-27,"(596.25, 831.5]",7,12,-5
31263.0,2019-11-27,"(831.5, 1066.75]",8,19,-11
31263.0,2019-11-27,"(1066.75, 1302.0]",6,15,-9
31264.0,2019-11-27,"(390.242, 580.5]",9,11,-2
31264.0,2019-11-27,"(580.5, 770.0]",5,8,-3
31264.0,2019-11-27,"(770.0, 959.5]",7,20,-13
31264.0,2019-11-27,"(959.5, 1149.0]",2,5,-3
31265.0,2019-11-27,"(4.694, 332.5]",1,1,0
31265.0,2019-11-27,"(332.5, 659.0]",11,24,-13
31265.0,2019-11-27,"(659.0, 985.5]",18,29,-11
31265.0,2019-11-27,"(985.5, 1312.0]",12,26,-14
31266.0,2019-11-27,"(127.732, 446.0]",1,7,-6
31266.0,2019-11-27,"(446.0, 763.0]",9,26,-17
31266.0,2019-11-27,"(763.0, 1080.0]",28,51,-23
31266.0,2019-11-27,"(1080.0, 1397.0]",14,30,-16
31267.0,2019-11-27,"(5.607, 355.25]",1,1,0
31267.0,2019-11-27,"(355.25, 703.5]",8,20,-12
31267.0,2019-11-27,"(703.5, 1051.75]",20,34,-14
31267.0,2019-11-27,"(1051.75, 1400.0]",6,17,-11
31268.0,2019-11-27,"(334.981, 590.75]",10,25,-15
31268.0,2019-11-27,"(590.75, 845.5]",10,16,-6
31268.0,2019-11-27,"(845.5, 1100.25]",13,17,-4
31268.0,2019-11-27,"(1100.25, 1355.0]",3,7,-4
31269.0,2019-11-27,"(336.981, 592.75]",6,10,-4
31269.0,2019-11-27,"(592.75, 847.5]",8,18,-10
31269.0,2019-11-27,"(847.5, 1102.25]",7,11,-4
31269.0,2019-11-27,"(1102.25, 1357.0]",3,6,-3
31270.0,2019-11-27,"(358.137, 574.75]",5,8,-3
31270.0,2019-11-27,"(574.75, 790.5]",6,10,-4
31270.0,2019-11-27,"(790.5, 1006.25]",17,29,-12
31270.0,2019-11-27,"(1006.25, 1222.0]",8,19,-11
31271.0,2019-11-27,"(492.346, 656.5]",16,22,-6
31271.0,2019-11-27,"(656.5, 820.0]",5,16,-11
31271.0,2019-11-27,"(820.0, 983.5]",10,24,-14
31272.0,2019-11-27,"(297.025, 541.75]",10,12,-2
31272.0,2019-11-27,"(541.75, 785.5]",11,16,-5
31272.0,2019-11-27,"(785.5, 1029.25]",10,26,-16
31272.0,2019-11-27,"(1029.25, 1273.0]",3,5,-2
31273.0,2019-11-27,"(467.496, 594.0]",1,3,-2
31273.0,2019-11-27,"(594.0, 720.0]",1,1,0
31273.0,2019-11-27,"(720.0, 846.0]",1,1,0
31273.0,2019-11-27,"(846.0, 972.0]",2,4,-2
31274.0,2019-11-27,"(423.228, 617.0]",4,6,-2
31274.0,2019-11-27,"(617.0, 810.0]",2,5,-3
31274.0,2019-11-27,"(810.0, 1003.0]",2,7,-5
31274.0,2019-11-27,"(1003.0, 1196.0]",4,9,-5
31275.0,2019-11-27,"(18.594, 371.5]",6,8,-2
31275.0,2019-11-27,"(371.5, 723.0]",8,13,-5
31275.0,2019-11-27,"(723.0, 1074.5]",6,20,-14
31275.0,2019-11-27,"(1074.5, 1426.0]",12,17,-5
31276.0,2019-11-27,"(248.811, 547.25]",14,14,0
31276.0,2019-11-27,"(547.25, 844.5]",12,19,-7
31276.0,2019-11-27,"(844.5, 1141.75]",6,14,-8
31276.0,2019-11-27,"(1141.75, 1439.0]",2,4,-2
31277.0,2019-11-27,"(61.651, 400.25]",2,3,-1
31277.0,2019-11-27,"(400.25, 737.5]",27,35,-8
31277.0,2019-11-27,"(737.5, 1074.75]",19,38,-19
31277.0,2019-11-27,"(1074.75, 1412.0]",2,6,-4
31278.0,2019-11-27,"(9.657, 346.75]",2,2,0
31278.0,2019-11-27,"(346.75, 682.5]",5,18,-13
31278.0,2019-11-27,"(682.5, 1018.25]",27,41,-14
31278.0,2019-11-27,"(1018.25, 1354.0]",6,10,-4
31279.0,2019-11-27,"(455.254, 642.5]",18,19,-1
31279.0,2019-11-27,"(642.5, 829.0]",3,8,-5
31279.0,2019-11-27,"(829.0, 1015.5]",2,11,-9
31279.0,2019-11-27,"(1015.5, 1202.0]",2,6,-4
31280.0,2019-11-27,"(334.011, 582.25]",2,9,-7
31280.0,2019-11-27,"(582.25, 829.5]",4,6,-2
31280.0,2019-11-27,"(829.5, 1076.75]",4,12,-8
31280.0,2019-11-27,"(1076.75, 1324.0]",2,3,-1
31000.0,2019-11-28,"(732.75, 977.0]",1,1,0
31001.0,2019-11-28,"(653.323, 823.25]",1,3,-2
31001.0,2019-11-28,"(1161.75, 1331.0]",1,1,0
31002.0,2019-11-28,"(385.5, 514.0]",1,1,0
31003.0,2019-11-28,"(522.75, 541.0]",1,1,0
31004.0,2019-11-28,"(889.898, 915.5]",1,2,-1
31004.0,2019-11-28,"(966.5, 992.0]",1,1,0
31005.0,2019-11-28,"(113.79, 417.5]",1,1,0
31005.0,2019-11-28,"(720.0, 1022.5]",2,1,1
31006.0,2019-11-28,"(607.708, 681.0]",1,2,-1
31006.0,2019-11-28,"(827.0, 900.0]",1,1,0
31007.0,2019-11-28,"(265.968, 525.0]",2,2,0
31007.0,2019-11-28,"(525.0, 783.0]",2,3,-1
31009.0,2019-11-28,"(1237.0, 1300.0]",1,1,0
31010.0,2019-11-28,"(636.75, 871.5]",1,2,-1
31010.0,2019-11-28,"(871.5, 1106.25]",2,2,0
31010.0,2019-11-28,"(1106.25, 1341.0]",1,2,-1
31011.0,2019-11-28,"(431.097, 657.75]",2,3,-1
31011.0,2019-11-28,"(1109.25, 1335.0]",3,2,1
,,,,2.0,
31013.0,2019-11-28,"(511.211, 709.25]",2,3,-1
31013.0,2019-11-28,"(1103.75, 1301.0]",1,1,0
31014.0,2019-11-28,"(317.341, 482.75]",1,1,0
31014.0,2019-11-28,"(482.75, 647.5]",3,4,-1
31014.0,2019-11-28,"(647.5, 812.25]",2,3,-1
31014.0,2019-11-28,"(812.25, 977.0]",1,3,-2
31015.0,2019-11-28,"(5.946, 270.5]",2,2,0
31015.0,2019-11-28,"(270.5, 534.0]",2,2,0
31015.0,2019-11-28,"(534.0, 797.5]",1,1,0
31015.0,2019-11-28,"(797.5, 1061.0]",2,3,-1
31016.0,2019-11-28,"(-0.776, 194.0]",1,2,-1
31016.0,2019-11-28,"(582.0, 776.0]",1,1,0
,,,,1.0,
,,,,1.0,
,,,,1.0,
,,,,2.0,
31019.0,2019-11-28,"(658.25, 839.0]",1,1,0
31020.0,2019-11-28,"(540.75, 721.0]",1,1,0
31021.0,2019-11-28,"(27.308, 201.0]",1,3,-2
31021.0,2019-11-28,"(547.0, 720.0]",1,2,-1
31022.0,2019-11-28,"(393.75, 718.5]",2,1,1
31022.0,2019-11-28,"(1043.25, 1368.0]",2,3,-1
31023.0,2019-11-28,"(413.5, 593.25]",1,2,-1
31023.0,2019-11-28,"(593.25, 773.0]",3,1,2
31024.0,2019-11-28,"(440.384, 595.0]",1,3,-2
31024.0,2019-11-28,"(595.0, 749.0]",2,3,-1
31024.0,2019-11-28,"(749.0, 903.0]",2,3,-1
31024.0,2019-11-28,"(903.0, 1057.0]",1,2,-1
31025.0,2019-11-28,"(412.5, 550.0]",1,1,0
31026.0,2019-11-28,"(575.5, 832.75]",1,1,0
31026.0,2019-11-28,"(832.75, 1090.0]",1,3,-2
31027.0,2019-11-28,"(509.0, 763.5]",1,1,0
31027.0,2019-11-28,"(763.5, 1018.0]",1,1,0
,,,,2.0,
31029.0,2019-11-28,"(562.497, 688.75]",1,6,-5
31029.0,2019-11-28,"(940.25, 1066.0]",2,1,1
31030.0,2019-11-28,"(557.25, 803.5]",1,1,0
31030.0,2019-11-28,"(803.5, 1049.75]",1,3,-2
31030.0,2019-11-28,"(1049.75, 1296.0]",1,2,-1
31031.0,2019-11-28,"(70.074, 302.5]",2,2,0
31031.0,2019-11-28,"(534.0, 765.5]",1,2,-1
31032.0,2019-11-28,"(446.567, 555.25]",2,4,-2
,,,,2.0,
31034.0,2019-11-28,"(44.25, 67.5]",1,1,0
31034.0,2019-11-28,"(90.75, 114.0]",2,1,1
31035.0,2019-11-28,"(383.3, 559.0]",1,3,-2
31035.0,2019-11-28,"(734.0, 909.0]",1,2,-1
31035.0,2019-11-28,"(909.0, 1084.0]",2,2,0
,,,,2.0,
31037.0,2019-11-28,"(772.25, 875.5]",1,1,0
,,,,1.0,
,,,,1.0,
31039.0,2019-11-28,"(781.5, 827.0]",1,1,0
31040.0,2019-11-28,"(794.25, 1059.0]",1,1,0
31041.0,2019-11-28,"(824.5, 834.0]",1,1,0
31042.0,2019-11-28,"(574.476, 706.0]",1,1,0
31042.0,2019-11-28,"(837.0, 968.0]",2,4,-2
31042.0,2019-11-28,"(968.0, 1099.0]",3,3,0
,,,,2.0,
,,,,1.0,
,,,,1.0,
31045.0,2019-11-28,"(1258.75, 1347.0]",1,1,0
31046.0,2019-11-28,"(492.0, 656.0]",1,1,0
31047.0,2019-11-28,"(537.939, 553.25]",2,2,0
31048.0,2019-11-28,"(1041.698, 1117.5]",1,1,0
,,,,2.0,
31050.0,2019-11-28,"(398.666, 482.5]",1,1,0
31050.0,2019-11-28,"(649.5, 733.0]",1,2,-1
31051.0,2019-11-28,"(438.475, 570.25]",1,3,-2
31052.0,2019-11-28,"(353.75, 360.0]",1,1,0
31053.0,2019-11-28,"(556.0, 812.0]",1,1,0
31053.0,2019-11-28,"(812.0, 1068.0]",1,1,0
,,,,2.0,
,,,,2.0,
31056.0,2019-11-28,"(531.75, 709.0]",1,1,0
31057.0,2019-11-28,"(-0.876, 219.0]",1,2,-1
31057.0,2019-11-28,"(657.0, 876.0]",1,1,0
31058.0,2019-11-28,"(669.75, 893.0]",1,1,0
,,,,2.0,
31060.0,2019-11-28,"(468.0, 624.0]",1,1,0
,,,,2.0,
31062.0,2019-11-28,"(638.604, 738.0]",3,5,-2
31062.0,2019-11-28,"(837.0, 936.0]",1,1,0
31062.0,2019-11-28,"(936.0, 1035.0]",2,1,1
,,,,2.0,
31064.0,2019-11-28,"(505.554, 617.5]",4,7,-3
31064.0,2019-11-28,"(617.5, 729.0]",1,2,-1
31064.0,2019-11-28,"(729.0, 840.5]",2,4,-2
31064.0,2019-11-28,"(840.5, 952.0]",6,10,-4
,,,,1.0,
,,,,1.0,
,,,,1.0,
,,,,1.0,
,,,,2.0,
31068.0,2019-11-28,"(527.583, 632.25]",1,2,-1
31068.0,2019-11-28,"(840.75, 945.0]",2,4,-2
,,,,1.0,
,,,,1.0,
31070.0,2019-11-28,"(1096.25, 1381.0]",2,1,1
31071.0,2019-11-28,"(425.115, 647.25]",2,5,-3
31071.0,2019-11-28,"(647.25, 868.5]",1,1,0
31071.0,2019-11-28,"(1089.75, 1311.0]",1,1,0
,,,,2.0,
31073.0,2019-11-28,"(666.75, 889.0]",1,1,0
,,,,2.0,
,,,,1.0,
,,,,1.0,
31076.0,2019-11-28,"(826.75, 869.0]",1,1,0
31077.0,2019-11-28,"(255.118, 476.5]",1,2,-1
31077.0,2019-11-28,"(476.5, 697.0]",1,1,0
31077.0,2019-11-28,"(697.0, 917.5]",8,10,-2
31077.0,2019-11-28,"(917.5, 1138.0]",2,3,-1
,,,,2.0,
31079.0,2019-11-28,"(66.787, 371.25]",1,1,0
31080.0,2019-11-28,"(799.0, 1006.0]",1,2,-1
31080.0,2019-11-28,"(1006.0, 1213.0]",2,2,0
31080.0,2019-11-28,"(1213.0, 1420.0]",1,2,-1
31081.0,2019-11-28,"(647.97, 655.5]",1,1,0
31082.0,2019-11-28,"(1043.5, 1054.0]",4,4,0
31083.0,2019-11-28,"(110.508, 234.0]",2,4,-2
31083.0,2019-11-28,"(480.0, 603.0]",1,1,0
31084.0,2019-11-28,"(665.0, 790.0]",1,2,-1
31084.0,2019-11-28,"(915.0, 1040.0]",1,1,0
31085.0,2019-11-28,"(1179.5, 1371.0]",1,2,-1
31086.0,2019-11-28,"(320.0, 480.0]",1,1,0
31086.0,2019-11-28,"(480.0, 640.0]",1,1,0
,,,,2.0,
31088.0,2019-11-28,"(660.0, 880.0]",1,1,0
31089.0,2019-11-28,"(332.0, 584.0]",1,1,0
31089.0,2019-11-28,"(584.0, 836.0]",1,1,0
31089.0,2019-11-28,"(836.0, 1088.0]",2,1,1
31090.0,2019-11-28,"(672.915, 694.25]",1,1,0
31091.0,2019-11-28,"(523.25, 784.5]",1,1,0
31091.0,2019-11-28,"(1045.75, 1307.0]",1,3,-2
31092.0,2019-11-28,"(612.875, 644.25]",1,1,0
31093.0,2019-11-28,"(899.5, 976.0]",1,1,0
31094.0,2019-11-28,"(739.457, 875.75]",1,2,-1
31094.0,2019-11-28,"(1147.25, 1283.0]",1,1,0
,,,,2.0,
,,,,1.0,
,,,,1.0,
,,,,1.0,
,,,,1.0,
31098.0,2019-11-28,"(1185.5, 1364.0]",1,1,0
31099.0,2019-11-28,"(754.5, 1006.0]",1,1,0
31100.0,2019-11-28,"(553.5, 753.25]",1,2,-1
31100.0,2019-11-28,"(753.25, 953.0]",2,1,1
31101.0,2019-11-28,"(20.643, 361.25]",4,5,-1
31101.0,2019-11-28,"(361.25, 700.5]",7,11,-4
31101.0,2019-11-28,"(700.5, 1039.75]",10,18,-8
31102.0,2019-11-28,"(413.977, 670.75]",1,3,-2
31102.0,2019-11-28,"(670.75, 926.5]",2,6,-4
31102.0,2019-11-28,"(926.5, 1182.25]",1,3,-2
31102.0,2019-11-28,"(1182.25, 1438.0]",1,2,-1
31103.0,2019-11-28,"(577.75, 836.5]",1,7,-6
31103.0,2019-11-28,"(836.5, 1095.25]",1,2,-1
31103.0,2019-11-28,"(1095.25, 1354.0]",3,4,-1
31104.0,2019-11-28,"(471.75, 787.5]",7,3,4
31104.0,2019-11-28,"(787.5, 1103.25]",3,15,-12
31104.0,2019-11-28,"(1103.25, 1419.0]",2,8,-6
31105.0,2019-11-28,"(639.5, 958.75]",1,2,-1
31105.0,2019-11-28,"(958.75, 1278.0]",3,1,2
31106.0,2019-11-28,"(1165.25, 1343.0]",2,3,-1
31107.0,2019-11-28,"(171.811, 470.25]",1,2,-1
31107.0,2019-11-28,"(470.25, 767.5]",3,8,-5
31107.0,2019-11-28,"(767.5, 1064.75]",3,9,-6
31107.0,2019-11-28,"(1064.75, 1362.0]",2,7,-5
31108.0,2019-11-28,"(535.254, 722.5]",2,12,-10
31108.0,2019-11-28,"(722.5, 909.0]",5,11,-6
31108.0,2019-11-28,"(909.0, 1095.5]",2,5,-3
31108.0,2019-11-28,"(1095.5, 1282.0]",4,5,-1
31109.0,2019-11-28,"(21.659, 358.25]",1,6,-5
31109.0,2019-11-28,"(358.25, 693.5]",4,7,-3
31109.0,2019-11-28,"(693.5, 1028.75]",2,6,-4
31109.0,2019-11-28,"(1028.75, 1364.0]",4,5,-1
31110.0,2019-11-28,"(327.75, 652.5]",11,1,10
31110.0,2019-11-28,"(652.5, 977.25]",5,22,-17
31110.0,2019-11-28,"(977.25, 1302.0]",3,11,-8
31111.0,2019-11-28,"(6.596, 359.0]",4,9,-5
31111.0,2019-11-28,"(359.0, 710.0]",3,9,-6
31111.0,2019-11-28,"(710.0, 1061.0]",4,7,-3
31111.0,2019-11-28,"(1061.0, 1412.0]",5,10,-5
31112.0,2019-11-28,"(497.6, 598.0]",1,1,0
31112.0,2019-11-28,"(598.0, 698.0]",1,2,-1
31112.0,2019-11-28,"(798.0, 898.0]",1,2,-1
31113.0,2019-11-28,"(681.5, 882.0]",4,4,0
31113.0,2019-11-28,"(882.0, 1082.5]",1,8,-7
31114.0,2019-11-28,"(702.25, 938.5]",4,3,1
31114.0,2019-11-28,"(938.5, 1174.75]",1,6,-5
31114.0,2019-11-28,"(1174.75, 1411.0]",5,4,1
31115.0,2019-11-28,"(402.169, 610.75]",1,7,-6
31115.0,2019-11-28,"(610.75, 818.5]",3,6,-3
31115.0,2019-11-28,"(1026.25, 1234.0]",1,6,-5
31116.0,2019-11-28,"(177.742, 493.5]",2,4,-2
31116.0,2019-11-28,"(493.5, 808.0]",4,10,-6
31116.0,2019-11-28,"(808.0, 1122.5]",3,5,-2
31116.0,2019-11-28,"(1122.5, 1437.0]",2,3,-1
31117.0,2019-11-28,"(159.862, 445.5]",1,2,-1
31117.0,2019-11-28,"(445.5, 730.0]",1,8,-7
31117.0,2019-11-28,"(1014.5, 1299.0]",1,4,-3
31118.0,2019-11-28,"(170.811, 469.25]",1,2,-1
31118.0,2019-11-28,"(469.25, 766.5]",1,2,-1
31118.0,2019-11-28,"(766.5, 1063.75]",3,7,-4
31118.0,2019-11-28,"(1063.75, 1361.0]",3,5,-2
31119.0,2019-11-28,"(55.632, 399.0]",1,2,-1
31119.0,2019-11-28,"(399.0, 741.0]",2,5,-3
31119.0,2019-11-28,"(741.0, 1083.0]",3,6,-3
31119.0,2019-11-28,"(1083.0, 1425.0]",3,8,-5
31120.0,2019-11-28,"(284.75, 567.5]",1,1,0
31120.0,2019-11-28,"(567.5, 850.25]",5,1,4
31120.0,2019-11-28,"(850.25, 1133.0]",2,7,-5
31121.0,2019-11-28,"(35.616, 383.0]",1,1,0
31121.0,2019-11-28,"(383.0, 729.0]",5,7,-2
31121.0,2019-11-28,"(729.0, 1075.0]",2,8,-6
31121.0,2019-11-28,"(1075.0, 1421.0]",2,3,-1
31122.0,2019-11-28,"(76.979, 333.25]",1,2,-1
31122.0,2019-11-28,"(843.75, 1099.0]",5,4,1
31123.0,2019-11-28,"(-0.039, 260.75]",2,2,0
31123.0,2019-11-28,"(780.25, 1040.0]",1,1,0
31124.0,2019-11-28,"(0.583, 356.25]",1,3,-2
31124.0,2019-11-28,"(356.25, 710.5]",9,17,-8
31124.0,2019-11-28,"(710.5, 1064.75]",16,29,-13
31124.0,2019-11-28,"(1064.75, 1419.0]",5,14,-9
31125.0,2019-11-28,"(12.932, 281.0]",1,1,0
31125.0,2019-11-28,"(281.0, 548.0]",1,4,-3
31125.0,2019-11-28,"(548.0, 815.0]",12,16,-4
31125.0,2019-11-28,"(815.0, 1082.0]",2,5,-3
31126.0,2019-11-28,"(0.667, 335.25]",2,3,-1
31126.0,2019-11-28,"(335.25, 668.5]",1,15,-14
31126.0,2019-11-28,"(668.5, 1001.75]",6,10,-4
31126.0,2019-11-28,"(1001.75, 1335.0]",4,7,-3
31127.0,2019-11-28,"(732.445, 871.75]",2,2,0
31127.0,2019-11-28,"(871.75, 1010.5]",5,5,0
31128.0,2019-11-28,"(-1.434, 358.5]",1,3,-2
31128.0,2019-11-28,"(358.5, 717.0]",4,5,-1
31128.0,2019-11-28,"(717.0, 1075.5]",1,3,-2
31128.0,2019-11-28,"(1075.5, 1434.0]",4,10,-6
31129.0,2019-11-28,"(330.913, 603.75]",8,10,-2
31129.0,2019-11-28,"(603.75, 875.5]",11,20,-9
31129.0,2019-11-28,"(875.5, 1147.25]",6,8,-2
31129.0,2019-11-28,"(1147.25, 1419.0]",3,4,-1
31130.0,2019-11-28,"(327.255, 514.25]",1,1,0
31130.0,2019-11-28,"(514.25, 700.5]",1,5,-4
31130.0,2019-11-28,"(886.75, 1073.0]",1,1,0
31131.0,2019-11-28,"(1.732, 320.0]",1,1,0
31131.0,2019-11-28,"(320.0, 637.0]",1,3,-2
31131.0,2019-11-28,"(637.0, 954.0]",1,2,-1
31200.0,2019-11-28,"(39.745, 354.75]",1,2,-1
31200.0,2019-11-28,"(354.75, 668.5]",9,10,-1
31200.0,2019-11-28,"(668.5, 982.25]",7,15,-8
31200.0,2019-11-28,"(982.25, 1296.0]",1,1,0
31201.0,2019-11-28,"(7.569, 366.75]",1,7,-6
31201.0,2019-11-28,"(366.75, 724.5]",16,25,-9
31201.0,2019-11-28,"(724.5, 1082.25]",21,28,-7
31201.0,2019-11-28,"(1082.25, 1440.0]",4,8,-4
31202.0,2019-11-28,"(418.75, 719.5]",6,1,5
31202.0,2019-11-28,"(719.5, 1020.25]",4,11,-7
31202.0,2019-11-28,"(1020.25, 1321.0]",3,13,-10
31203.0,2019-11-28,"(409.75, 752.5]",4,3,1
31203.0,2019-11-28,"(752.5, 1095.25]",4,7,-3
31203.0,2019-11-28,"(1095.25, 1438.0]",8,7,1
31204.0,2019-11-28,"(84.666, 419.5]",1,1,0
31204.0,2019-11-28,"(753.0, 1086.5]",3,1,2
31204.0,2019-11-28,"(1086.5, 1420.0]",3,6,-3
31205.0,2019-11-28,"(388.5, 686.0]",2,1,1
31205.0,2019-11-28,"(686.0, 983.5]",4,2,2
,,,,2.0,
31207.0,2019-11-28,"(747.5, 1077.25]",1,1,0
31208.0,2019-11-28,"(761.0, 901.0]",1,1,0
31208.0,2019-11-28,"(1041.0, 1181.0]",1,1,0
,,,,2.0,
31211.0,2019-11-28,"(652.253, 839.75]",2,4,-2
31211.0,2019-11-28,"(839.75, 1026.5]",4,4,0
31211.0,2019-11-28,"(1026.5, 1213.25]",2,3,-1
31212.0,2019-11-28,"(405.009, 653.75]",4,9,-5
31212.0,2019-11-28,"(653.75, 901.5]",9,14,-5
31212.0,2019-11-28,"(901.5, 1149.25]",3,9,-6
31212.0,2019-11-28,"(1149.25, 1397.0]",2,3,-1
31213.0,2019-11-28,"(571.278, 752.5]",10,15,-5
31213.0,2019-11-28,"(752.5, 933.0]",1,1,0
31213.0,2019-11-28,"(933.0, 1113.5]",1,3,-2
31214.0,2019-11-28,"(396.5, 714.0]",6,2,4
31214.0,2019-11-28,"(714.0, 1031.5]",11,11,0
31214.0,2019-11-28,"(1031.5, 1349.0]",6,24,-18
31215.0,2019-11-28,"(450.08, 681.0]",6,6,0
31215.0,2019-11-28,"(681.0, 911.0]",3,3,0
31215.0,2019-11-28,"(911.0, 1141.0]",11,12,-1
31215.0,2019-11-28,"(1141.0, 1371.0]",2,3,-1
31216.0,2019-11-28,"(417.339, 583.25]",2,3,-1
31216.0,2019-11-28,"(748.5, 913.75]",2,4,-2
31217.0,2019-11-28,"(1041.25, 1200.0]",1,2,-1
31218.0,2019-11-28,"(143.178, 349.5]",1,1,0
31218.0,2019-11-28,"(760.5, 966.0]",6,12,-6
31219.0,2019-11-28,"(509.494, 636.5]",5,6,-1
31219.0,2019-11-28,"(763.0, 889.5]",6,1,5
31220.0,2019-11-28,"(1028.5, 1214.0]",1,2,-1
31221.0,2019-11-28,"(516.5, 755.25]",1,4,-3
31221.0,2019-11-28,"(755.25, 994.0]",1,1,0
31222.0,2019-11-28,"(407.093, 634.75]",6,7,-1
31222.0,2019-11-28,"(861.5, 1088.25]",2,6,-4
31223.0,2019-11-28,"(25.633, 368.75]",1,2,-1
31223.0,2019-11-28,"(368.75, 710.5]",3,6,-3
31223.0,2019-11-28,"(710.5, 1052.25]",2,9,-7
31223.0,2019-11-28,"(1052.25, 1394.0]",2,3,-1
,,,,1.0,
,,,,5.0,
31225.0,2019-11-28,"(444.644, 534.0]",2,2,0
31225.0,2019-11-28,"(534.0, 623.0]",1,1,0
31225.0,2019-11-28,"(712.0, 801.0]",4,1,3
31226.0,2019-11-28,"(754.713, 826.75]",2,2,0
31226.0,2019-11-28,"(898.5, 970.25]",4,2,2
31227.0,2019-11-28,"(40.716, 363.0]",1,1,0
31227.0,2019-11-28,"(684.0, 1005.0]",1,2,-1
31227.0,2019-11-28,"(1005.0, 1326.0]",1,1,0
31228.0,2019-11-28,"(63.651, 402.25]",1,1,0
31228.0,2019-11-28,"(402.25, 739.5]",6,9,-3
31228.0,2019-11-28,"(739.5, 1076.75]",5,14,-9
31228.0,2019-11-28,"(1076.75, 1414.0]",6,11,-5
31229.0,2019-11-28,"(10.689, 339.75]",3,6,-3
31229.0,2019-11-28,"(339.75, 667.5]",8,19,-11
31229.0,2019-11-28,"(667.5, 995.25]",7,21,-14
31229.0,2019-11-28,"(995.25, 1323.0]",4,5,-1
31230.0,2019-11-28,"(493.119, 714.25]",9,13,-4
31230.0,2019-11-28,"(714.25, 934.5]",5,8,-3
31230.0,2019-11-28,"(934.5, 1154.75]",5,8,-3
31231.0,2019-11-28,"(488.082, 718.5]",6,10,-4
31231.0,2019-11-28,"(718.5, 948.0]",1,3,-2
31231.0,2019-11-28,"(948.0, 1177.5]",1,1,0
31232.0,2019-11-28,"(170.005, 419.75]",1,2,-1
31232.0,2019-11-28,"(668.5, 917.25]",3,2,1
31232.0,2019-11-28,"(917.25, 1166.0]",10,6,4
31233.0,2019-11-28,"(336.974, 594.5]",3,5,-2
31233.0,2019-11-28,"(594.5, 851.0]",2,5,-3
31233.0,2019-11-28,"(1107.5, 1364.0]",3,3,0
31234.0,2019-11-28,"(718.25, 843.5]",2,3,-1
31234.0,2019-11-28,"(968.75, 1094.0]",1,3,-2
31235.0,2019-11-28,"(747.931, 765.25]",2,3,-1
31235.0,2019-11-28,"(799.75, 817.0]",3,3,0
31236.0,2019-11-28,"(413.011, 661.25]",1,2,-1
31236.0,2019-11-28,"(661.25, 908.5]",2,4,-2
31236.0,2019-11-28,"(908.5, 1155.75]",1,5,-4
31236.0,2019-11-28,"(1155.75, 1403.0]",1,4,-3
31237.0,2019-11-28,"(93.673, 426.75]",1,2,-1
31237.0,2019-11-28,"(426.75, 758.5]",2,8,-6
31237.0,2019-11-28,"(758.5, 1090.25]",6,11,-5
31237.0,2019-11-28,"(1090.25, 1422.0]",4,6,-2
31238.0,2019-11-28,"(23.253, 210.75]",1,2,-1
31238.0,2019-11-28,"(397.5, 584.25]",7,1,6
31238.0,2019-11-28,"(584.25, 771.0]",3,7,-4
31239.0,2019-11-28,"(11.128, 230.0]",1,3,-2
31239.0,2019-11-28,"(448.0, 666.0]",2,1,1
31240.0,2019-11-28,"(601.862, 636.5]",2,4,-2
31240.0,2019-11-28,"(705.5, 740.0]",1,1,0
31241.0,2019-11-28,"(46.611, 395.25]",3,4,-1
31241.0,2019-11-28,"(395.25, 742.5]",6,10,-4
31241.0,2019-11-28,"(742.5, 1089.75]",3,5,-2
31241.0,2019-11-28,"(1089.75, 1437.0]",3,11,-8
31242.0,2019-11-28,"(708.0, 854.0]",3,3,0
31242.0,2019-11-28,"(854.0, 1000.0]",3,5,-2
31242.0,2019-11-28,"(1000.0, 1146.0]",1,3,-2
31243.0,2019-11-28,"(284.23, 477.5]",2,2,0
31243.0,2019-11-28,"(477.5, 670.0]",1,2,-1
31243.0,2019-11-28,"(670.0, 862.5]",5,7,-2
31243.0,2019-11-28,"(862.5, 1055.0]",1,9,-8
31244.0,2019-11-28,"(313.022, 558.5]",1,3,-2
31244.0,2019-11-28,"(558.5, 803.0]",1,2,-1
31244.0,2019-11-28,"(1047.5, 1292.0]",2,2,0
31245.0,2019-11-28,"(502.133, 719.75]",5,6,-1
31245.0,2019-11-28,"(719.75, 936.5]",5,6,-1
31245.0,2019-11-28,"(936.5, 1153.25]",1,2,-1
31245.0,2019-11-28,"(1153.25, 1370.0]",1,2,-1
31246.0,2019-11-28,"(967.0, 1189.0]",1,5,-4
31246.0,2019-11-28,"(1189.0, 1411.0]",3,1,2
31247.0,2019-11-28,"(477.401, 627.75]",4,5,-1
31247.0,2019-11-28,"(627.75, 777.5]",16,29,-13
31247.0,2019-11-28,"(777.5, 927.25]",4,10,-6
31247.0,2019-11-28,"(927.25, 1077.0]",5,12,-7
31248.0,2019-11-28,"(577.401, 727.75]",7,14,-7
31248.0,2019-11-28,"(727.75, 877.5]",12,19,-7
31248.0,2019-11-28,"(877.5, 1027.25]",7,9,-2
31248.0,2019-11-28,"(1027.25, 1177.0]",3,10,-7
31249.0,2019-11-28,"(581.326, 750.5]",4,7,-3
31249.0,2019-11-28,"(750.5, 919.0]",3,5,-2
31249.0,2019-11-28,"(919.0, 1087.5]",4,5,-1
31249.0,2019-11-28,"(1087.5, 1256.0]",1,2,-1
31250.0,2019-11-28,"(442.388, 596.0]",1,2,-1
31250.0,2019-11-28,"(596.0, 749.0]",1,1,0
31250.0,2019-11-28,"(902.0, 1055.0]",1,3,-2
31251.0,2019-11-28,"(459.04, 700.0]",3,6,-3
31251.0,2019-11-28,"(700.0, 940.0]",4,11,-7
31251.0,2019-11-28,"(940.0, 1180.0]",5,6,-1
31251.0,2019-11-28,"(1180.0, 1420.0]",2,3,-1
31252.0,2019-11-28,"(504.251, 692.25]",2,2,0
31252.0,2019-11-28,"(692.25, 879.5]",1,1,0
31252.0,2019-11-28,"(879.5, 1066.75]",2,2,0
31253.0,2019-11-28,"(735.5, 978.0]",1,1,0
31254.0,2019-11-28,"(442.0, 727.0]",2,1,1
31254.0,2019-11-28,"(1012.0, 1297.0]",1,3,-2
31255.0,2019-11-28,"(756.5, 906.75]",1,1,0
31255.0,2019-11-28,"(906.75, 1057.0]",1,1,0
31256.0,2019-11-28,"(239.865, 524.75]",8,8,0
31256.0,2019-11-28,"(524.75, 808.5]",3,9,-6
31256.0,2019-11-28,"(808.5, 1092.25]",3,8,-5
31256.0,2019-11-28,"(1092.25, 1376.0]",1,4,-3
31257.0,2019-11-28,"(398.75, 721.5]",6,1,5
31257.0,2019-11-28,"(721.5, 1044.25]",6,10,-4
31258.0,2019-11-28,"(466.031, 709.25]",12,25,-13
31258.0,2019-11-28,"(709.25, 951.5]",10,13,-3
31258.0,2019-11-28,"(951.5, 1193.75]",3,13,-10
31258.0,2019-11-28,"(1193.75, 1436.0]",7,10,-3
31259.0,2019-11-28,"(663.663, 748.25]",1,1,0
31259.0,2019-11-28,"(916.75, 1001.0]",1,2,-1
31260.0,2019-11-28,"(1253.5, 1319.0]",4,1,3
,,,,1.0,
,,,,2.0,
31262.0,2019-11-28,"(538.18, 744.0]",1,2,-1
31262.0,2019-11-28,"(744.0, 949.0]",5,5,0
31262.0,2019-11-28,"(1154.0, 1359.0]",1,1,0
31263.0,2019-11-28,"(361.5, 702.0]",5,2,3
31263.0,2019-11-28,"(702.0, 1042.5]",8,15,-7
31263.0,2019-11-28,"(1042.5, 1383.0]",1,9,-8
31264.0,2019-11-28,"(431.044, 671.0]",4,4,0
31264.0,2019-11-28,"(671.0, 910.0]",1,5,-4
31264.0,2019-11-28,"(1149.0, 1388.0]",1,2,-1
31265.0,2019-11-28,"(372.75, 691.5]",3,1,2
31265.0,2019-11-28,"(691.5, 1010.25]",4,7,-3
31265.0,2019-11-28,"(1010.25, 1329.0]",2,7,-5
31266.0,2019-11-28,"(50.633, 393.75]",1,3,-2
31266.0,2019-11-28,"(393.75, 735.5]",1,8,-7
31266.0,2019-11-28,"(735.5, 1077.25]",4,7,-3
31266.0,2019-11-28,"(1077.25, 1419.0]",5,8,-3
31267.0,2019-11-28,"(8.709, 332.75]",1,1,0
31267.0,2019-11-28,"(332.75, 655.5]",1,4,-3
31267.0,2019-11-28,"(655.5, 978.25]",3,11,-8
31267.0,2019-11-28,"(978.25, 1301.0]",7,12,-5
31268.0,2019-11-28,"(58.788, 363.0]",2,4,-2
31268.0,2019-11-28,"(363.0, 666.0]",10,12,-2
31268.0,2019-11-28,"(666.0, 969.0]",3,5,-2
31268.0,2019-11-28,"(969.0, 1272.0]",3,6,-3
31269.0,2019-11-28,"(468.435, 610.25]",1,3,-2
31269.0,2019-11-28,"(610.25, 751.5]",1,3,-2
31269.0,2019-11-28,"(751.5, 892.75]",2,3,-1
31270.0,2019-11-28,"(171.038, 412.5]",1,2,-1
31270.0,2019-11-28,"(412.5, 653.0]",6,6,0
31270.0,2019-11-28,"(653.0, 893.5]",2,3,-1
31270.0,2019-11-28,"(893.5, 1134.0]",3,5,-2
31271.0,2019-11-28,"(536.463, 671.25]",4,9,-5
31271.0,2019-11-28,"(671.25, 805.5]",6,10,-4
31271.0,2019-11-28,"(939.75, 1074.0]",6,6,0
31272.0,2019-11-28,"(438.407, 587.25]",3,5,-2
31272.0,2019-11-28,"(587.25, 735.5]",4,5,-1
31272.0,2019-11-28,"(735.5, 883.75]",9,16,-7
31272.0,2019-11-28,"(883.75, 1032.0]",5,8,-3
31273.0,2019-11-28,"(628.687, 707.25]",1,2,-1
31273.0,2019-11-28,"(707.25, 785.5]",2,4,-2
31273.0,2019-11-28,"(863.75, 942.0]",1,2,-1
31274.0,2019-11-28,"(111.833, 404.75]",1,2,-1
31274.0,2019-11-28,"(404.75, 696.5]",3,4,-1
31274.0,2019-11-28,"(696.5, 988.25]",1,1,0
31274.0,2019-11-28,"(988.25, 1280.0]",1,3,-2
31275.0,2019-11-28,"(62.688, 392.0]",3,4,-1
31275.0,2019-11-28,"(392.0, 720.0]",1,6,-5
31275.0,2019-11-28,"(720.0, 1048.0]",6,10,-4
31275.0,2019-11-28,"(1048.0, 1376.0]",4,5,-1
31276.0,2019-11-28,"(746.0, 954.0]",2,2,0
31277.0,2019-11-28,"(343.156, 555.0]",2,2,0
31277.0,2019-11-28,"(555.0, 766.0]",6,11,-5
31277.0,2019-11-28,"(766.0, 977.0]",3,5,-2
31277.0,2019-11-28,"(977.0, 1188.0]",2,4,-2
31278.0,2019-11-28,"(50.701, 376.75]",1,1,0
31278.0,2019-11-28,"(376.75, 701.5]",6,11,-5
31278.0,2019-11-28,"(701.5, 1026.25]",2,6,-4
31278.0,2019-11-28,"(1026.25, 1351.0]",3,3,0
31279.0,2019-11-28,"(721.538, 837.5]",1,1,0
31279.0,2019-11-28,"(1068.5, 1184.0]",1,1,0
31280.0,2019-11-28,"(457.157, 668.75]",4,10,-6
,,,,1.0,
,,,,1.0,
,,,,1.0,
,,,,1.0,
,,,,1.0,
,,,,1.0,
31002.0,2019-11-29,"(538.656, 625.0]",1,1,0
31003.0,2019-11-29,"(499.282, 679.5]",2,3,-1
31003.0,2019-11-29,"(859.0, 1038.5]",1,2,-1
31003.0,2019-11-29,"(1038.5, 1218.0]",2,4,-2
31004.0,2019-11-29,"(667.5, 825.0]",1,2,-1
31004.0,2019-11-29,"(982.5, 1140.0]",2,1,1
31005.0,2019-11-29,"(389.108, 613.0]",3,3,0
31005.0,2019-11-29,"(836.0, 1059.0]",1,4,-3
31005.0,2019-11-29,"(1059.0, 1282.0]",3,2,1
31006.0,2019-11-29,"(553.293, 730.75]",1,2,-1
31006.0,2019-11-29,"(730.75, 907.5]",3,4,-1
31006.0,2019-11-29,"(907.5, 1084.25]",2,2,0
31006.0,2019-11-29,"(1084.25, 1261.0]",2,4,-2
31007.0,2019-11-29,"(572.156, 784.0]",2,3,-1
31007.0,2019-11-29,"(784.0, 995.0]",1,4,-3
31007.0,2019-11-29,"(995.0, 1206.0]",1,4,-3
31009.0,2019-11-29,"(1135.75, 1228.0]",2,1,1
31010.0,2019-11-29,"(40.992, 294.0]",1,2,-1
31010.0,2019-11-29,"(546.0, 798.0]",1,1,0
31010.0,2019-11-29,"(798.0, 1050.0]",4,1,3
31011.0,2019-11-29,"(429.412, 577.0]",1,1,0
31011.0,2019-11-29,"(724.0, 871.0]",1,4,-3
31012.0,2019-11-29,"(1062.985, 1066.75]",1,1,0
31013.0,2019-11-29,"(578.32, 749.0]",2,5,-3
31013.0,2019-11-29,"(919.0, 1089.0]",3,4,-1
31013.0,2019-11-29,"(1089.0, 1259.0]",2,3,-1
31014.0,2019-11-29,"(295.089, 523.75]",4,6,-2
31014.0,2019-11-29,"(523.75, 751.5]",2,5,-3
31014.0,2019-11-29,"(751.5, 979.25]",4,6,-2
31014.0,2019-11-29,"(979.25, 1207.0]",2,4,-2
31015.0,2019-11-29,"(506.445, 645.75]",2,3,-1
31015.0,2019-11-29,"(645.75, 784.5]",1,1,0
31015.0,2019-11-29,"(784.5, 923.25]",1,2,-1
31015.0,2019-11-29,"(923.25, 1062.0]",5,8,-3
,,,,1.0,
,,,,1.0,
,,,,2.0,
31017.0,2019-11-29,"(622.232, 815.0]",2,4,-2
31017.0,2019-11-29,"(815.0, 1007.0]",2,2,0
31017.0,2019-11-29,"(1199.0, 1391.0]",1,2,-1
31018.0,2019-11-29,"(963.0, 1152.0]",1,1,0
31019.0,2019-11-29,"(715.334, 882.5]",1,1,0
31019.0,2019-11-29,"(882.5, 1049.0]",1,1,0
31019.0,2019-11-29,"(1049.0, 1215.5]",2,2,0
31020.0,2019-11-29,"(628.62, 724.0]",1,2,-1
31020.0,2019-11-29,"(914.0, 1009.0]",1,1,0
31021.0,2019-11-29,"(480.5, 720.75]",2,1,1
31021.0,2019-11-29,"(720.75, 961.0]",2,2,0
31022.0,2019-11-29,"(387.5, 659.0]",1,1,0
31022.0,2019-11-29,"(659.0, 930.5]",2,1,1
31023.0,2019-11-29,"(761.328, 930.0]",5,5,0
31024.0,2019-11-29,"(531.468, 665.0]",1,3,-2
31024.0,2019-11-29,"(665.0, 798.0]",1,2,-1
31024.0,2019-11-29,"(931.0, 1064.0]",1,1,0
31025.0,2019-11-29,"(878.984, 883.0]",1,2,-1
31025.0,2019-11-29,"(891.0, 895.0]",2,2,0
31026.0,2019-11-29,"(537.198, 738.5]",2,2,0
31026.0,2019-11-29,"(939.0, 1139.5]",1,2,-1
,,,,2.0,
,,,,1.0,
,,,,2.0,
31029.0,2019-11-29,"(759.742, 824.5]",1,2,-1
31030.0,2019-11-29,"(602.356, 764.0]",1,2,-1
31030.0,2019-11-29,"(764.0, 925.0]",1,1,0
31030.0,2019-11-29,"(1086.0, 1247.0]",1,3,-2
31031.0,2019-11-29,"(119.233, 311.75]",1,1,0
31031.0,2019-11-29,"(695.25, 887.0]",1,1,0
,,,,1.0,
,,,,1.0,
,,,,1.0,
31033.0,2019-11-29,"(699.0, 932.0]",3,1,2
31034.0,2019-11-29,"(840.75, 928.0]",1,1,0
31035.0,2019-11-29,"(605.25, 716.5]",1,2,-1
31035.0,2019-11-29,"(827.75, 939.0]",1,1,0
,,,,1.0,
,,,,1.0,
31037.0,2019-11-29,"(472.291, 650.25]",4,4,0
31037.0,2019-11-29,"(650.25, 827.5]",1,1,0
,,,,1.0,
,,,,1.0,
31039.0,2019-11-29,"(489.564, 599.0]",1,2,-1
,,,,2.0,
31041.0,2019-11-29,"(733.504, 858.0]",2,3,-1
31041.0,2019-11-29,"(858.0, 982.0]",1,3,-2
31042.0,2019-11-29,"(729.25, 888.5]",5,1,4
31042.0,2019-11-29,"(888.5, 1047.75]",1,8,-7
31043.0,2019-11-29,"(856.694, 933.5]",1,1,0
31043.0,2019-11-29,"(1086.5, 1163.0]",1,2,-1
31044.0,2019-11-29,"(730.5, 974.0]",2,1,1
31045.0,2019-11-29,"(528.377, 684.75]",1,3,-2
31045.0,2019-11-29,"(840.5, 996.25]",1,2,-1
31045.0,2019-11-29,"(996.25, 1152.0]",3,5,-2
31046.0,2019-11-29,"(1084.5, 1167.0]",1,1,0
31047.0,2019-11-29,"(727.25, 950.5]",1,2,-1
31047.0,2019-11-29,"(1173.75, 1397.0]",1,2,-1
31048.0,2019-11-29,"(715.75, 844.5]",1,1,0
,,,,1.0,
,,,,2.0,
,,,,2.0,
31051.0,2019-11-29,"(789.415, 936.25]",1,2,-1
31051.0,2019-11-29,"(936.25, 1082.5]",1,2,-1
31051.0,2019-11-29,"(1228.75, 1375.0]",1,1,0
31052.0,2019-11-29,"(978.25, 1028.5]",1,1,0
31052.0,2019-11-29,"(1078.75, 1129.0]",1,1,0
31053.0,2019-11-29,"(932.25, 1203.0]",1,1,0
31054.0,2019-11-29,"(124.917, 396.75]",1,1,0
31054.0,2019-11-29,"(938.25, 1209.0]",1,1,0
31055.0,2019-11-29,"(736.307, 910.25]",1,2,-1
31055.0,2019-11-29,"(1083.5, 1256.75]",1,1,0
31055.0,2019-11-29,"(1256.75, 1430.0]",1,1,0
31056.0,2019-11-29,"(610.448, 749.0]",1,2,-1
31056.0,2019-11-29,"(1025.0, 1163.0]",1,2,-1
,,,,1.0,
,,,,2.0,
,,,,1.0,
,,,,1.0,
,,,,1.0,
,,,,1.0,
31060.0,2019-11-29,"(918.25, 981.0]",4,1,3
,,,,1.0,
,,,,2.0,
31062.0,2019-11-29,"(674.636, 766.0]",2,7,-5
31062.0,2019-11-29,"(857.0, 948.0]",1,1,0
31062.0,2019-11-29,"(948.0, 1039.0]",2,1,1
,,,,2.0,
31064.0,2019-11-29,"(653.514, 775.5]",3,7,-4
31064.0,2019-11-29,"(775.5, 897.0]",5,10,-5
31064.0,2019-11-29,"(897.0, 1018.5]",12,24,-12
31064.0,2019-11-29,"(1018.5, 1140.0]",2,5,-3
31065.0,2019-11-29,"(475.456, 612.0]",1,2,-1
31065.0,2019-11-29,"(748.0, 884.0]",1,1,0
31065.0,2019-11-29,"(884.0, 1020.0]",1,1,0
,,,,2.0,
,,,,1.0,
,,,,1.0,
31068.0,2019-11-29,"(684.0, 912.0]",3,1,2
31069.0,2019-11-29,"(764.5, 887.0]",1,1,0
31070.0,2019-11-29,"(780.75, 864.0]",1,1,0
31071.0,2019-11-29,"(386.132, 604.0]",3,4,-1
31071.0,2019-11-29,"(604.0, 821.0]",2,4,-2
31071.0,2019-11-29,"(821.0, 1038.0]",3,6,-3
31071.0,2019-11-29,"(1038.0, 1255.0]",2,5,-3
,,,,2.0,
31073.0,2019-11-29,"(749.0, 800.0]",1,1,0
31074.0,2019-11-29,"(515.37, 673.5]",1,3,-2
31074.0,2019-11-29,"(988.5, 1146.0]",2,3,-1
,,,,1.0,
,,,,1.0,
,,,,2.0,
31077.0,2019-11-29,"(608.0, 751.0]",2,1,1
31077.0,2019-11-29,"(751.0, 894.0]",2,5,-3
31077.0,2019-11-29,"(894.0, 1037.0]",1,4,-3
31078.0,2019-11-29,"(498.601, 598.75]",1,1,0
31079.0,2019-11-29,"(563.25, 837.5]",1,2,-1
31079.0,2019-11-29,"(837.5, 1111.75]",2,2,0
31079.0,2019-11-29,"(1111.75, 1386.0]",5,6,-1
31080.0,2019-11-29,"(670.0, 912.0]",1,1,0
31080.0,2019-11-29,"(912.0, 1154.0]",4,3,1
31080.0,2019-11-29,"(1154.0, 1396.0]",1,6,-5
31081.0,2019-11-29,"(761.633, 853.75]",1,2,-1
31081.0,2019-11-29,"(1037.25, 1129.0]",1,1,0
31082.0,2019-11-29,"(670.652, 758.0]",1,2,-1
31082.0,2019-11-29,"(932.0, 1019.0]",1,2,-1
31083.0,2019-11-29,"(736.335, 903.25]",2,4,-2
31083.0,2019-11-29,"(1235.75, 1402.0]",1,1,0
31084.0,2019-11-29,"(533.418, 679.5]",2,3,-1
31084.0,2019-11-29,"(679.5, 825.0]",2,4,-2
31084.0,2019-11-29,"(970.5, 1116.0]",1,2,-1
31085.0,2019-11-29,"(555.337, 721.75]",1,2,-1
31085.0,2019-11-29,"(1053.25, 1219.0]",1,1,0
31086.0,2019-11-29,"(747.397, 898.75]",1,2,-1
31086.0,2019-11-29,"(1200.25, 1351.0]",1,1,0
31087.0,2019-11-29,"(627.398, 778.5]",1,1,0
31087.0,2019-11-29,"(929.0, 1079.5]",1,2,-1
,,,,1.0,
,,,,2.0,
31089.0,2019-11-29,"(410.039, 651.25]",2,4,-2
31089.0,2019-11-29,"(891.5, 1131.75]",2,2,0
31090.0,2019-11-29,"(686.913, 708.75]",1,1,0
31091.0,2019-11-29,"(432.153, 644.75]",1,3,-2
31091.0,2019-11-29,"(856.5, 1068.25]",1,1,0
31091.0,2019-11-29,"(1068.25, 1280.0]",1,2,-1
,,,,2.0,
31093.0,2019-11-29,"(827.5, 964.0]",1,1,0
,,,,2.0,
31095.0,2019-11-29,"(1101.998, 1102.5]",1,1,0
31096.0,2019-11-29,"(849.5, 854.0]",1,1,0
31097.0,2019-11-29,"(823.694, 900.5]",4,5,-1
31097.0,2019-11-29,"(900.5, 977.0]",3,6,-3
31097.0,2019-11-29,"(1053.5, 1130.0]",2,2,0
31098.0,2019-11-29,"(576.336, 743.0]",3,3,0
31098.0,2019-11-29,"(743.0, 909.0]",2,2,0
31098.0,2019-11-29,"(909.0, 1075.0]",3,5,-2
31098.0,2019-11-29,"(1075.0, 1241.0]",2,2,0
,,,,2.0,
31100.0,2019-11-29,"(377.75, 698.5]",2,2,0
31100.0,2019-11-29,"(698.5, 1019.25]",2,4,-2
31100.0,2019-11-29,"(1019.25, 1340.0]",9,4,5
31101.0,2019-11-29,"(1.567, 361.25]",2,3,-1
31101.0,2019-11-29,"(361.25, 719.5]",15,30,-15
31101.0,2019-11-29,"(719.5, 1077.75]",23,34,-11
31101.0,2019-11-29,"(1077.75, 1436.0]",9,17,-8
31102.0,2019-11-29,"(408.011, 656.25]",3,5,-2
31102.0,2019-11-29,"(903.5, 1150.75]",1,2,-1
31102.0,2019-11-29,"(1150.75, 1398.0]",2,8,-6
31103.0,2019-11-29,"(447.185, 651.75]",2,8,-6
31103.0,2019-11-29,"(651.75, 855.5]",2,10,-8
31103.0,2019-11-29,"(855.5, 1059.25]",4,11,-7
31103.0,2019-11-29,"(1059.25, 1263.0]",2,7,-5
31104.0,2019-11-29,"(401.021, 646.75]",3,9,-6
31104.0,2019-11-29,"(646.75, 891.5]",7,12,-5
31104.0,2019-11-29,"(891.5, 1136.25]",9,12,-3
31104.0,2019-11-29,"(1136.25, 1381.0]",6,12,-6
31105.0,2019-11-29,"(1075.75, 1227.0]",1,2,-1
31106.0,2019-11-29,"(518.345, 682.75]",1,3,-2
31107.0,2019-11-29,"(6.689, 335.75]",1,2,-1
31107.0,2019-11-29,"(335.75, 663.5]",1,10,-9
31107.0,2019-11-29,"(663.5, 991.25]",4,14,-10
31107.0,2019-11-29,"(991.25, 1319.0]",8,11,-3
31108.0,2019-11-29,"(16.599, 368.25]",1,2,-1
31108.0,2019-11-29,"(368.25, 718.5]",2,17,-15
31108.0,2019-11-29,"(718.5, 1068.75]",13,27,-14
31108.0,2019-11-29,"(1068.75, 1419.0]",11,18,-7
31109.0,2019-11-29,"(543.111, 766.25]",7,13,-6
31109.0,2019-11-29,"(766.25, 988.5]",6,12,-6
31109.0,2019-11-29,"(988.5, 1210.75]",6,7,-1
31109.0,2019-11-29,"(1210.75, 1433.0]",3,11,-8
31110.0,2019-11-29,"(404.968, 664.0]",2,4,-2
31110.0,2019-11-29,"(664.0, 922.0]",5,9,-4
31110.0,2019-11-29,"(922.0, 1180.0]",7,12,-5
31110.0,2019-11-29,"(1180.0, 1438.0]",2,3,-1
31111.0,2019-11-29,"(508.09, 736.5]",1,4,-3
31111.0,2019-11-29,"(736.5, 964.0]",5,8,-3
31111.0,2019-11-29,"(964.0, 1191.5]",4,7,-3
31111.0,2019-11-29,"(1191.5, 1419.0]",8,11,-3
31112.0,2019-11-29,"(767.75, 958.5]",3,2,1
31112.0,2019-11-29,"(958.5, 1149.25]",1,5,-4
31112.0,2019-11-29,"(1149.25, 1340.0]",3,3,0
31113.0,2019-11-29,"(864.0, 1067.0]",8,4,4
31113.0,2019-11-29,"(1067.0, 1270.0]",1,9,-8
31114.0,2019-11-29,"(345.0, 690.0]",1,3,-2
31114.0,2019-11-29,"(690.0, 1035.0]",10,5,5
31114.0,2019-11-29,"(1035.0, 1380.0]",9,20,-11
31115.0,2019-11-29,"(17.584, 373.0]",3,5,-2
31115.0,2019-11-29,"(373.0, 727.0]",1,8,-7
31115.0,2019-11-29,"(727.0, 1081.0]",3,7,-4
31115.0,2019-11-29,"(1081.0, 1435.0]",4,7,-3
31116.0,2019-11-29,"(363.25, 698.5]",5,1,4
31116.0,2019-11-29,"(698.5, 1033.75]",15,6,9
31116.0,2019-11-29,"(1033.75, 1369.0]",4,27,-23
31117.0,2019-11-29,"(678.0, 1000.5]",7,1,6
31117.0,2019-11-29,"(1000.5, 1323.0]",3,7,-4
31118.0,2019-11-29,"(670.5, 869.0]",6,4,2
31118.0,2019-11-29,"(869.0, 1067.5]",4,10,-6
31118.0,2019-11-29,"(1067.5, 1266.0]",2,5,-3
31119.0,2019-11-29,"(32.656, 370.0]",2,2,0
31119.0,2019-11-29,"(370.0, 706.0]",2,7,-5
31119.0,2019-11-29,"(706.0, 1042.0]",3,7,-4
31119.0,2019-11-29,"(1042.0, 1378.0]",4,6,-2
31120.0,2019-11-29,"(516.143, 731.25]",1,3,-2
31120.0,2019-11-29,"(945.5, 1159.75]",4,2,2
31120.0,2019-11-29,"(1159.75, 1374.0]",2,7,-5
31121.0,2019-11-29,"(441.154, 653.5]",6,9,-3
31121.0,2019-11-29,"(653.5, 865.0]",1,2,-1
31121.0,2019-11-29,"(865.0, 1076.5]",3,6,-3
31121.0,2019-11-29,"(1076.5, 1288.0]",1,6,-5
31122.0,2019-11-29,"(679.75, 923.5]",3,5,-2
31122.0,2019-11-29,"(1167.25, 1411.0]",2,7,-5
31123.0,2019-11-29,"(904.0, 1093.0]",1,5,-4
31123.0,2019-11-29,"(1093.0, 1282.0]",3,3,0
31124.0,2019-11-29,"(11.579, 368.25]",2,3,-1
31124.0,2019-11-29,"(368.25, 723.5]",7,17,-10
31124.0,2019-11-29,"(723.5, 1078.75]",13,31,-18
31124.0,2019-11-29,"(1078.75, 1434.0]",11,23,-12
31125.0,2019-11-29,"(461.0, 771.0]",5,2,3
31125.0,2019-11-29,"(771.0, 1081.0]",11,11,0
31125.0,2019-11-29,"(1081.0, 1391.0]",11,20,-9
31126.0,2019-11-29,"(613.0, 851.0]",5,3,2
31126.0,2019-11-29,"(851.0, 1089.0]",5,13,-8
31126.0,2019-11-29,"(1089.0, 1327.0]",2,12,-10
31127.0,2019-11-29,"(557.527, 676.25]",1,1,0
31128.0,2019-11-29,"(38.628, 383.0]",2,2,0
31128.0,2019-11-29,"(383.0, 726.0]",9,19,-10
31128.0,2019-11-29,"(726.0, 1069.0]",15,23,-8
31128.0,2019-11-29,"(1069.0, 1412.0]",7,11,-4
31129.0,2019-11-29,"(584.302, 759.5]",7,7,0
31129.0,2019-11-29,"(759.5, 934.0]",3,6,-3
31129.0,2019-11-29,"(934.0, 1108.5]",9,15,-6
31129.0,2019-11-29,"(1108.5, 1283.0]",4,4,0
31130.0,2019-11-29,"(428.177, 634.75]",1,2,-1
31130.0,2019-11-29,"(634.75, 840.5]",1,8,-7
31130.0,2019-11-29,"(840.5, 1046.25]",1,1,0
31130.0,2019-11-29,"(1046.25, 1252.0]",3,3,0
31131.0,2019-11-29,"(714.0, 1024.5]",6,1,5
31131.0,2019-11-29,"(1024.5, 1335.0]",2,4,-2
31200.0,2019-11-29,"(465.073, 697.75]",8,10,-2
31200.0,2019-11-29,"(697.75, 929.5]",14,25,-11
31200.0,2019-11-29,"(929.5, 1161.25]",11,20,-9
31200.0,2019-11-29,"(1161.25, 1393.0]",4,9,-5
31201.0,2019-11-29,"(-1.428, 357.0]",2,4,-2
31201.0,2019-11-29,"(357.0, 714.0]",10,14,-4
31201.0,2019-11-29,"(714.0, 1071.0]",29,56,-27
31201.0,2019-11-29,"(1071.0, 1428.0]",11,23,-12
31202.0,2019-11-29,"(402.977, 659.75]",6,10,-4
31202.0,2019-11-29,"(659.75, 915.5]",18,32,-14
31202.0,2019-11-29,"(915.5, 1171.25]",11,20,-9
31202.0,2019-11-29,"(1171.25, 1427.0]",2,9,-7
31203.0,2019-11-29,"(419.982, 675.5]",9,15,-6
31203.0,2019-11-29,"(675.5, 930.0]",10,15,-5
31203.0,2019-11-29,"(930.0, 1184.5]",11,19,-8
31203.0,2019-11-29,"(1184.5, 1439.0]",12,24,-12
31204.0,2019-11-29,"(355.003, 605.25]",2,5,-3
31204.0,2019-11-29,"(605.25, 854.5]",4,10,-6
31204.0,2019-11-29,"(854.5, 1103.75]",5,9,-4
31204.0,2019-11-29,"(1103.75, 1353.0]",5,6,-1
31205.0,2019-11-29,"(503.327, 672.25]",2,2,0
31205.0,2019-11-29,"(672.25, 840.5]",3,3,0
31205.0,2019-11-29,"(840.5, 1008.75]",9,14,-5
31205.0,2019-11-29,"(1008.75, 1177.0]",5,8,-3
31206.0,2019-11-29,"(506.543, 621.25]",2,2,0
31206.0,2019-11-29,"(849.75, 964.0]",4,1,3
31207.0,2019-11-29,"(876.0, 1070.0]",1,1,0
31207.0,2019-11-29,"(1070.0, 1264.0]",1,1,0
31208.0,2019-11-29,"(440.023, 685.25]",4,6,-2
31208.0,2019-11-29,"(685.25, 929.5]",5,13,-8
31208.0,2019-11-29,"(929.5, 1173.75]",3,5,-2
31208.0,2019-11-29,"(1173.75, 1418.0]",1,2,-1
31209.0,2019-11-29,"(508.223, 703.25]",1,3,-2
31209.0,2019-11-29,"(897.5, 1091.75]",4,1,3
31209.0,2019-11-29,"(1091.75, 1286.0]",5,10,-5
31211.0,2019-11-29,"(633.331, 801.25]",2,2,0
31211.0,2019-11-29,"(801.25, 968.5]",1,1,0
31211.0,2019-11-29,"(968.5, 1135.75]",4,7,-3
31211.0,2019-11-29,"(1135.75, 1303.0]",2,3,-1
31212.0,2019-11-29,"(542.305, 716.75]",4,7,-3
31212.0,2019-11-29,"(716.75, 890.5]",2,4,-2
31212.0,2019-11-29,"(890.5, 1064.25]",4,8,-4
31212.0,2019-11-29,"(1064.25, 1238.0]",3,4,-1
31213.0,2019-11-29,"(498.75, 739.5]",3,1,2
31213.0,2019-11-29,"(739.5, 980.25]",6,6,0
31213.0,2019-11-29,"(980.25, 1221.0]",1,10,-9
31214.0,2019-11-29,"(-1.402, 350.5]",1,1,0
31214.0,2019-11-29,"(350.5, 701.0]",6,12,-6
31214.0,2019-11-29,"(701.0, 1051.5]",11,28,-17
31214.0,2019-11-29,"(1051.5, 1402.0]",13,24,-11
31215.0,2019-11-29,"(558.183, 763.25]",9,16,-7
31215.0,2019-11-29,"(763.25, 967.5]",18,23,-5
31215.0,2019-11-29,"(967.5, 1171.75]",2,5,-3
31215.0,2019-11-29,"(1171.75, 1376.0]",1,3,-2
31216.0,2019-11-29,"(696.469, 829.75]",3,4,-1
31216.0,2019-11-29,"(962.5, 1095.25]",9,10,-1
31216.0,2019-11-29,"(1095.25, 1228.0]",2,10,-8
31217.0,2019-11-29,"(433.148, 647.0]",3,5,-2
31217.0,2019-11-29,"(647.0, 860.0]",2,4,-2
31217.0,2019-11-29,"(860.0, 1073.0]",2,5,-3
31217.0,2019-11-29,"(1073.0, 1286.0]",4,4,0
31218.0,2019-11-29,"(360.299, 536.25]",2,4,-2
31218.0,2019-11-29,"(711.5, 886.75]",4,5,-1
31218.0,2019-11-29,"(886.75, 1062.0]",13,4,9
31219.0,2019-11-29,"(429.211, 627.25]",5,5,0
31219.0,2019-11-29,"(627.25, 824.5]",7,15,-8
31219.0,2019-11-29,"(824.5, 1021.75]",9,23,-14
31219.0,2019-11-29,"(1021.75, 1219.0]",2,3,-1
31220.0,2019-11-29,"(434.457, 570.75]",6,7,-1
31221.0,2019-11-29,"(492.108, 716.0]",5,5,0
31221.0,2019-11-29,"(716.0, 939.0]",3,4,-1
31221.0,2019-11-29,"(939.0, 1162.0]",4,9,-5
31221.0,2019-11-29,"(1162.0, 1385.0]",2,5,-3
31222.0,2019-11-29,"(330.264, 515.0]",1,1,0
31222.0,2019-11-29,"(515.0, 699.0]",2,3,-1
31222.0,2019-11-29,"(699.0, 883.0]",1,1,0
31222.0,2019-11-29,"(883.0, 1067.0]",13,19,-6
31223.0,2019-11-29,"(64.657, 401.75]",2,3,-1
31223.0,2019-11-29,"(401.75, 737.5]",4,7,-3
31223.0,2019-11-29,"(737.5, 1073.25]",6,14,-8
31223.0,2019-11-29,"(1073.25, 1409.0]",11,20,-9
31224.0,2019-11-29,"(531.299, 707.25]",3,10,-7
31224.0,2019-11-29,"(707.25, 882.5]",2,4,-2
31224.0,2019-11-29,"(1057.75, 1233.0]",5,8,-3
31225.0,2019-11-29,"(416.002, 666.5]",2,5,-3
31225.0,2019-11-29,"(666.5, 916.0]",16,25,-9
31225.0,2019-11-29,"(916.0, 1165.5]",11,25,-14
31226.0,2019-11-29,"(267.01, 515.5]",1,1,0
31226.0,2019-11-29,"(763.0, 1010.5]",1,2,-1
31226.0,2019-11-29,"(1010.5, 1258.0]",1,2,-1
31227.0,2019-11-29,"(515.427, 659.25]",3,3,0
31227.0,2019-11-29,"(659.25, 802.5]",3,3,0
31227.0,2019-11-29,"(802.5, 945.75]",1,5,-4
31227.0,2019-11-29,"(945.75, 1089.0]",3,5,-2
31228.0,2019-11-29,"(370.937, 637.75]",5,9,-4
31228.0,2019-11-29,"(637.75, 903.5]",18,29,-11
31228.0,2019-11-29,"(903.5, 1169.25]",31,47,-16
31228.0,2019-11-29,"(1169.25, 1435.0]",3,16,-13
31229.0,2019-11-29,"(7.577, 364.75]",2,3,-1
31229.0,2019-11-29,"(364.75, 720.5]",7,18,-11
31229.0,2019-11-29,"(720.5, 1076.25]",24,53,-29
31229.0,2019-11-29,"(1076.25, 1432.0]",12,18,-6
31230.0,2019-11-29,"(410.073, 642.75]",3,6,-3
31230.0,2019-11-29,"(642.75, 874.5]",7,12,-5
31230.0,2019-11-29,"(874.5, 1106.25]",12,27,-15
31230.0,2019-11-29,"(1106.25, 1338.0]",11,22,-11
31231.0,2019-11-29,"(515.098, 741.5]",4,5,-1
31231.0,2019-11-29,"(741.5, 967.0]",16,19,-3
31231.0,2019-11-29,"(967.0, 1192.5]",4,9,-5
31232.0,2019-11-29,"(483.071, 716.25]",7,8,-1
31232.0,2019-11-29,"(716.25, 948.5]",11,26,-15
31232.0,2019-11-29,"(948.5, 1180.75]",18,24,-6
31232.0,2019-11-29,"(1180.75, 1413.0]",5,8,-3
31233.0,2019-11-29,"(423.0, 755.0]",3,2,1
31233.0,2019-11-29,"(755.0, 1087.0]",8,4,4
31233.0,2019-11-29,"(1087.0, 1419.0]",1,17,-16
31234.0,2019-11-29,"(363.25, 713.5]",1,1,0
31234.0,2019-11-29,"(713.5, 1063.75]",12,3,9
31234.0,2019-11-29,"(1063.75, 1414.0]",3,24,-21
31235.0,2019-11-29,"(494.409, 642.75]",1,1,0
31235.0,2019-11-29,"(642.75, 790.5]",2,3,-1
31235.0,2019-11-29,"(790.5, 938.25]",2,6,-4
31236.0,2019-11-29,"(310.994, 563.5]",2,2,0
31236.0,2019-11-29,"(563.5, 815.0]",2,8,-6
31236.0,2019-11-29,"(815.0, 1066.5]",3,7,-4
31236.0,2019-11-29,"(1066.5, 1318.0]",1,5,-4
31237.0,2019-11-29,"(36.66, 373.0]",2,2,0
31237.0,2019-11-29,"(708.0, 1043.0]",13,8,5
31237.0,2019-11-29,"(1043.0, 1378.0]",11,20,-9
31238.0,2019-11-29,"(71.785, 376.75]",1,2,-1
31238.0,2019-11-29,"(376.75, 680.5]",5,7,-2
31238.0,2019-11-29,"(680.5, 984.25]",4,12,-8
31238.0,2019-11-29,"(984.25, 1288.0]",15,26,-11
31239.0,2019-11-29,"(471.401, 621.75]",3,4,-1
31239.0,2019-11-29,"(621.75, 771.5]",2,3,-1
31239.0,2019-11-29,"(771.5, 921.25]",1,4,-3
31239.0,2019-11-29,"(921.25, 1071.0]",5,6,-1
31240.0,2019-11-29,"(677.479, 808.25]",6,13,-7
31240.0,2019-11-29,"(808.25, 938.5]",18,34,-16
31240.0,2019-11-29,"(938.5, 1068.75]",13,17,-4
31240.0,2019-11-29,"(1068.75, 1199.0]",5,8,-3
31241.0,2019-11-29,"(425.064, 660.0]",2,11,-9
31241.0,2019-11-29,"(660.0, 894.0]",4,10,-6
31241.0,2019-11-29,"(894.0, 1128.0]",9,10,-1
31241.0,2019-11-29,"(1128.0, 1362.0]",4,9,-5
31242.0,2019-11-29,"(17.68, 349.0]",1,1,0
31242.0,2019-11-29,"(679.0, 1009.0]",7,16,-9
31242.0,2019-11-29,"(1009.0, 1339.0]",2,2,0
31243.0,2019-11-29,"(413.018, 659.5]",10,12,-2
31243.0,2019-11-29,"(659.5, 905.0]",8,17,-9
31243.0,2019-11-29,"(905.0, 1150.5]",5,17,-12
31243.0,2019-11-29,"(1150.5, 1396.0]",1,3,-2
31244.0,2019-11-29,"(313.917, 585.75]",1,4,-3
31244.0,2019-11-29,"(585.75, 856.5]",5,7,-2
31244.0,2019-11-29,"(856.5, 1127.25]",3,10,-7
31244.0,2019-11-29,"(1127.25, 1398.0]",5,9,-4
31245.0,2019-11-29,"(0.588, 355.0]",1,1,0
31245.0,2019-11-29,"(355.0, 708.0]",3,6,-3
31245.0,2019-11-29,"(708.0, 1061.0]",5,14,-9
31245.0,2019-11-29,"(1061.0, 1414.0]",2,4,-2
31246.0,2019-11-29,"(419.009, 667.75]",5,8,-3
31246.0,2019-11-29,"(667.75, 915.5]",19,26,-7
31246.0,2019-11-29,"(915.5, 1163.25]",14,24,-10
31246.0,2019-11-29,"(1163.25, 1411.0]",6,9,-3
31247.0,2019-11-29,"(466.286, 645.5]",14,17,-3
31247.0,2019-11-29,"(645.5, 824.0]",23,42,-19
31247.0,2019-11-29,"(824.0, 1002.5]",29,54,-25
31247.0,2019-11-29,"(1002.5, 1181.0]",7,19,-12
31248.0,2019-11-29,"(482.15, 695.5]",7,16,-9
31248.0,2019-11-29,"(695.5, 908.0]",36,74,-38
31248.0,2019-11-29,"(908.0, 1120.5]",30,56,-26
31248.0,2019-11-29,"(1120.5, 1333.0]",6,14,-8
31249.0,2019-11-29,"(649.436, 791.0]",17,33,-16
31249.0,2019-11-29,"(791.0, 932.0]",9,25,-16
31249.0,2019-11-29,"(932.0, 1073.0]",24,44,-20
31249.0,2019-11-29,"(1073.0, 1214.0]",9,17,-8
31250.0,2019-11-29,"(686.0, 905.0]",3,1,2
31251.0,2019-11-29,"(413.031, 656.25]",3,3,0
31251.0,2019-11-29,"(656.25, 898.5]",3,8,-5
31251.0,2019-11-29,"(898.5, 1140.75]",5,17,-12
31251.0,2019-11-29,"(1140.75, 1383.0]",5,6,-1
31252.0,2019-11-29,"(538.133, 755.75]",5,6,-1
31252.0,2019-11-29,"(755.75, 972.5]",1,2,-1
31252.0,2019-11-29,"(972.5, 1189.25]",1,4,-3
31253.0,2019-11-29,"(304.25, 548.5]",1,1,0
31253.0,2019-11-29,"(548.5, 792.75]",1,2,-1
31253.0,2019-11-29,"(792.75, 1037.0]",1,1,0
31254.0,2019-11-29,"(524.152, 737.0]",5,8,-3
31254.0,2019-11-29,"(949.0, 1161.0]",4,2,2
31254.0,2019-11-29,"(1161.0, 1373.0]",2,11,-9
31255.0,2019-11-29,"(565.267, 749.25]",2,7,-5
31255.0,2019-11-29,"(749.25, 932.5]",1,1,0
31255.0,2019-11-29,"(932.5, 1115.75]",3,6,-3
31255.0,2019-11-29,"(1115.75, 1299.0]",2,4,-2
31256.0,2019-11-29,"(558.133, 775.75]",7,9,-2
31256.0,2019-11-29,"(775.75, 992.5]",5,10,-5
31256.0,2019-11-29,"(992.5, 1209.25]",4,6,-2
31256.0,2019-11-29,"(1209.25, 1426.0]",2,4,-2
31257.0,2019-11-29,"(385.993, 638.75]",3,8,-5
31257.0,2019-11-29,"(638.75, 890.5]",6,15,-9
31257.0,2019-11-29,"(890.5, 1142.25]",8,13,-5
31257.0,2019-11-29,"(1142.25, 1394.0]",4,12,-8
31258.0,2019-11-29,"(452.053, 689.75]",10,19,-9
31258.0,2019-11-29,"(689.75, 926.5]",28,58,-30
31258.0,2019-11-29,"(926.5, 1163.25]",31,63,-32
31258.0,2019-11-29,"(1163.25, 1400.0]",4,7,-3
31259.0,2019-11-29,"(529.402, 679.5]",2,2,0
31259.0,2019-11-29,"(679.5, 829.0]",1,1,0
31260.0,2019-11-29,"(437.278, 618.5]",1,4,-3
31260.0,2019-11-29,"(618.5, 799.0]",1,1,0
31260.0,2019-11-29,"(979.5, 1160.0]",3,3,0
31261.0,2019-11-29,"(401.187, 605.25]",4,4,0
31261.0,2019-11-29,"(605.25, 808.5]",1,3,-2
31261.0,2019-11-29,"(1011.75, 1215.0]",6,4,2
31262.0,2019-11-29,"(496.171, 704.25]",4,5,-1
31262.0,2019-11-29,"(704.25, 911.5]",1,4,-3
31262.0,2019-11-29,"(911.5, 1118.75]",5,9,-4
31262.0,2019-11-29,"(1118.75, 1326.0]",4,5,-1
31263.0,2019-11-29,"(508.12, 729.0]",6,11,-5
31263.0,2019-11-29,"(729.0, 949.0]",8,15,-7
31263.0,2019-11-29,"(949.0, 1169.0]",5,7,-2
31263.0,2019-11-29,"(1169.0, 1389.0]",1,4,-3
31264.0,2019-11-29,"(481.094, 708.5]",2,2,0
31264.0,2019-11-29,"(708.5, 935.0]",16,18,-2
31264.0,2019-11-29,"(935.0, 1161.5]",1,3,-2
31265.0,2019-11-29,"(148.716, 471.0]",3,4,-1
31265.0,2019-11-29,"(471.0, 792.0]",4,6,-2
31265.0,2019-11-29,"(792.0, 1113.0]",11,23,-12
31265.0,2019-11-29,"(1113.0, 1434.0]",9,11,-2
31266.0,2019-11-29,"(283.892, 562.0]",2,7,-5
31266.0,2019-11-29,"(562.0, 839.0]",6,13,-7
31266.0,2019-11-29,"(839.0, 1116.0]",14,22,-8
31266.0,2019-11-29,"(1116.0, 1393.0]",2,7,-5
31267.0,2019-11-29,"(399.13, 617.5]",2,5,-3
31267.0,2019-11-29,"(617.5, 835.0]",4,7,-3
31267.0,2019-11-29,"(835.0, 1052.5]",6,11,-5
31267.0,2019-11-29,"(1052.5, 1270.0]",4,6,-2
31268.0,2019-11-29,"(479.105, 703.75]",2,8,-6
31268.0,2019-11-29,"(703.75, 927.5]",3,8,-5
31268.0,2019-11-29,"(927.5, 1151.25]",3,8,-5
31268.0,2019-11-29,"(1151.25, 1375.0]",1,3,-2
31269.0,2019-11-29,"(374.038, 615.5]",3,5,-2
31269.0,2019-11-29,"(615.5, 856.0]",14,29,-15
31269.0,2019-11-29,"(856.0, 1096.5]",6,17,-11
31269.0,2019-11-29,"(1096.5, 1337.0]",1,2,-1
31270.0,2019-11-29,"(270.897, 547.75]",5,7,-2
31270.0,2019-11-29,"(547.75, 823.5]",6,13,-7
31270.0,2019-11-29,"(823.5, 1099.25]",20,31,-11
31270.0,2019-11-29,"(1099.25, 1375.0]",1,3,-2
31271.0,2019-11-29,"(506.255, 693.25]",6,12,-6
31271.0,2019-11-29,"(693.25, 879.5]",17,35,-18
31271.0,2019-11-29,"(879.5, 1065.75]",16,42,-26
31271.0,2019-11-29,"(1065.75, 1252.0]",13,17,-4
31272.0,2019-11-29,"(330.028, 574.0]",2,3,-1
31272.0,2019-11-29,"(574.0, 817.0]",18,28,-10
31272.0,2019-11-29,"(817.0, 1060.0]",13,33,-20
31272.0,2019-11-29,"(1060.0, 1303.0]",2,3,-1
31273.0,2019-11-29,"(399.463, 534.25]",2,2,0
31273.0,2019-11-29,"(668.5, 802.75]",2,4,-2
31273.0,2019-11-29,"(802.75, 937.0]",6,12,-6
31274.0,2019-11-29,"(426.097, 652.75]",1,3,-2
31274.0,2019-11-29,"(652.75, 878.5]",3,5,-2
31274.0,2019-11-29,"(878.5, 1104.25]",6,12,-6
31274.0,2019-11-29,"(1104.25, 1330.0]",5,5,0
31275.0,2019-11-29,"(292.867, 577.25]",2,5,-3
31275.0,2019-11-29,"(577.25, 860.5]",3,13,-10
31275.0,2019-11-29,"(860.5, 1143.75]",4,11,-7
31275.0,2019-11-29,"(1143.75, 1427.0]",2,3,-1
31276.0,2019-11-29,"(776.503, 901.25]",3,3,0
31276.0,2019-11-29,"(1025.5, 1149.75]",4,3,1
31277.0,2019-11-29,"(282.083, 512.25]",5,5,0
31277.0,2019-11-29,"(512.25, 741.5]",11,17,-6
31277.0,2019-11-29,"(741.5, 970.75]",18,25,-7
31277.0,2019-11-29,"(970.75, 1200.0]",9,20,-11
31278.0,2019-11-29,"(44.682, 375.5]",1,2,-1
31278.0,2019-11-29,"(375.5, 705.0]",2,8,-6
31278.0,2019-11-29,"(705.0, 1034.5]",13,21,-8
31278.0,2019-11-29,"(1034.5, 1364.0]",5,8,-3
31279.0,2019-11-29,"(519.263, 704.25]",3,8,-5
31279.0,2019-11-29,"(704.25, 888.5]",1,3,-2
31279.0,2019-11-29,"(1072.75, 1257.0]",1,1,0
31280.0,2019-11-29,"(466.161, 676.75]",1,6,-5
31280.0,2019-11-29,"(676.75, 886.5]",2,7,-5
31280.0,2019-11-29,"(886.5, 1096.25]",2,6,-4
31280.0,2019-11-29,"(1096.25, 1306.0]",3,4,-1
,,,,1.0,
,,,,5.0,
31001.0,2019-11-30,"(750.25, 886.5]",1,2,-1
31001.0,2019-11-30,"(886.5, 1022.75]",2,1,1
31001.0,2019-11-30,"(1022.75, 1159.0]",1,2,-1
31002.0,2019-11-30,"(399.58, 505.0]",2,3,-1
31003.0,2019-11-30,"(505.528, 624.0]",1,1,0
31003.0,2019-11-30,"(742.0, 860.0]",1,2,-1
31003.0,2019-11-30,"(860.0, 978.0]",2,4,-2
,,,,2.0,
31005.0,2019-11-30,"(564.411, 712.25]",3,3,0
31005.0,2019-11-30,"(712.25, 859.5]",2,4,-2
31005.0,2019-11-30,"(859.5, 1006.75]",2,4,-2
31006.0,2019-11-30,"(618.573, 725.75]",1,1,0
31006.0,2019-11-30,"(832.5, 939.25]",1,1,0
31006.0,2019-11-30,"(939.25, 1046.0]",4,6,-2
31007.0,2019-11-30,"(869.75, 1034.5]",3,2,1
,,,,2.0,
31010.0,2019-11-30,"(626.25, 755.5]",1,1,0
31010.0,2019-11-30,"(755.5, 884.75]",3,1,2
31010.0,2019-11-30,"(884.75, 1014.0]",2,6,-4
31011.0,2019-11-30,"(721.864, 756.0]",1,1,0
31012.0,2019-11-30,"(302.25, 403.0]",1,1,0
31013.0,2019-11-30,"(992.5, 1178.75]",1,1,0
31013.0,2019-11-30,"(1178.75, 1365.0]",1,3,-2
31014.0,2019-11-30,"(320.943, 586.25]",1,2,-1
31014.0,2019-11-30,"(586.25, 850.5]",3,7,-4
31014.0,2019-11-30,"(850.5, 1114.75]",3,4,-1
31014.0,2019-11-30,"(1114.75, 1379.0]",4,5,-1
31015.0,2019-11-30,"(636.508, 760.0]",1,4,-3
31015.0,2019-11-30,"(760.0, 883.0]",3,5,-2
31015.0,2019-11-30,"(883.0, 1006.0]",1,2,-1
31015.0,2019-11-30,"(1006.0, 1129.0]",5,6,-1
31016.0,2019-11-30,"(719.302, 894.5]",3,3,0
31016.0,2019-11-30,"(894.5, 1069.0]",2,2,0
31016.0,2019-11-30,"(1243.5, 1418.0]",1,1,0
31017.0,2019-11-30,"(1243.5, 1416.0]",1,1,0
31018.0,2019-11-30,"(735.676, 817.0]",1,2,-1
31018.0,2019-11-30,"(979.0, 1060.0]",1,3,-2
31019.0,2019-11-30,"(747.355, 909.25]",2,2,0
31019.0,2019-11-30,"(909.25, 1070.5]",1,2,-1
31019.0,2019-11-30,"(1231.75, 1393.0]",2,6,-4
31020.0,2019-11-30,"(360.75, 720.5]",1,3,-2
31020.0,2019-11-30,"(720.5, 1080.25]",2,1,1
31020.0,2019-11-30,"(1080.25, 1440.0]",1,2,-1
31021.0,2019-11-30,"(447.232, 640.0]",1,1,0
31021.0,2019-11-30,"(640.0, 832.0]",3,5,-2
31022.0,2019-11-30,"(717.375, 874.25]",4,5,-1
31022.0,2019-11-30,"(874.25, 1030.5]",2,4,-2
31022.0,2019-11-30,"(1030.5, 1186.75]",1,2,-1
31023.0,2019-11-30,"(617.215, 814.25]",1,1,0
31023.0,2019-11-30,"(814.25, 1010.5]",2,3,-1
31023.0,2019-11-30,"(1010.5, 1206.75]",1,3,-2
31024.0,2019-11-30,"(637.271, 820.25]",1,4,-3
31024.0,2019-11-30,"(820.25, 1002.5]",1,1,0
,,,,1.0,
,,,,1.0,
31026.0,2019-11-30,"(549.75, 733.0]",1,1,0
31027.0,2019-11-30,"(131.091, 359.25]",1,1,0
31028.0,2019-11-30,"(1.609, 350.75]",2,2,0
31028.0,2019-11-30,"(698.5, 1046.25]",1,6,-5
31029.0,2019-11-30,"(547.152, 760.0]",1,3,-2
31029.0,2019-11-30,"(1184.0, 1396.0]",1,1,0
31030.0,2019-11-30,"(856.0, 974.0]",2,2,0
31030.0,2019-11-30,"(974.0, 1092.0]",2,1,1
31031.0,2019-11-30,"(477.74, 543.0]",1,1,0
31032.0,2019-11-30,"(762.75, 1017.0]",2,1,1
31033.0,2019-11-30,"(825.814, 872.5]",1,1,0
31033.0,2019-11-30,"(965.5, 1012.0]",1,2,-1
31034.0,2019-11-30,"(1009.5, 1210.75]",1,1,0
31034.0,2019-11-30,"(1210.75, 1412.0]",1,2,-1
31035.0,2019-11-30,"(1.642, 342.5]",1,1,0
31035.0,2019-11-30,"(342.5, 682.0]",1,1,0
31035.0,2019-11-30,"(1021.5, 1361.0]",1,2,-1
,,,,1.0,
,,,,1.0,
,,,,1.0,
31037.0,2019-11-30,"(419.172, 627.0]",2,3,-1
31037.0,2019-11-30,"(627.0, 834.0]",2,4,-2
31038.0,2019-11-30,"(573.0, 746.0]",2,1,1
31038.0,2019-11-30,"(919.0, 1092.0]",1,3,-2
31039.0,2019-11-30,"(530.35, 693.5]",2,4,-2
31039.0,2019-11-30,"(1018.5, 1181.0]",1,1,0
31040.0,2019-11-30,"(407.057, 643.75]",1,2,-1
31040.0,2019-11-30,"(643.75, 879.5]",2,3,-1
31040.0,2019-11-30,"(879.5, 1115.25]",1,1,0
31040.0,2019-11-30,"(1115.25, 1351.0]",1,4,-3
31041.0,2019-11-30,"(595.75, 698.5]",3,1,2
31041.0,2019-11-30,"(698.5, 801.25]",1,3,-2
31041.0,2019-11-30,"(801.25, 904.0]",4,1,3
31042.0,2019-11-30,"(569.574, 676.5]",1,1,0
31042.0,2019-11-30,"(676.5, 783.0]",2,3,-1
31042.0,2019-11-30,"(783.0, 889.5]",6,6,0
31042.0,2019-11-30,"(889.5, 996.0]",2,4,-2
31043.0,2019-11-30,"(481.235, 673.25]",1,1,0
31043.0,2019-11-30,"(1055.75, 1247.0]",2,1,1
31044.0,2019-11-30,"(761.25, 1015.0]",2,1,1
31045.0,2019-11-30,"(685.439, 826.25]",3,5,-2
31045.0,2019-11-30,"(966.5, 1106.75]",1,1,0
31045.0,2019-11-30,"(1106.75, 1247.0]",1,1,0
31046.0,2019-11-30,"(1192.5, 1291.0]",1,1,0
31047.0,2019-11-30,"(751.609, 849.75]",3,3,0
31047.0,2019-11-30,"(849.75, 947.5]",1,1,0
31047.0,2019-11-30,"(947.5, 1045.25]",1,2,-1
,,,,1.0,
,,,,1.0,
31049.0,2019-11-30,"(724.5, 866.25]",2,1,1
31049.0,2019-11-30,"(866.25, 1008.0]",1,2,-1
31050.0,2019-11-30,"(1280.5, 1347.0]",1,1,0
31051.0,2019-11-30,"(808.0, 1015.5]",2,1,1
31051.0,2019-11-30,"(1015.5, 1223.0]",1,3,-2
31052.0,2019-11-30,"(486.845, 525.75]",1,2,-1
,,,,1.0,
,,,,1.0,
,,,,1.0,
,,,,2.0,
,,,,2.0,
,,,,2.0,
31057.0,2019-11-30,"(766.764, 826.0]",1,1,0
31057.0,2019-11-30,"(944.0, 1003.0]",1,2,-1
,,,,2.0,
31059.0,2019-11-30,"(504.765, 563.75]",1,1,0
31059.0,2019-11-30,"(681.25, 740.0]",1,2,-1
31060.0,2019-11-30,"(955.25, 1029.0]",2,1,1
31061.0,2019-11-30,"(564.617, 660.75]",1,1,0
31061.0,2019-11-30,"(852.25, 948.0]",1,1,0
31062.0,2019-11-30,"(503.515, 625.25]",1,1,0
31062.0,2019-11-30,"(625.25, 746.5]",4,7,-3
31062.0,2019-11-30,"(746.5, 867.75]",6,15,-9
31062.0,2019-11-30,"(867.75, 989.0]",4,10,-6
31063.0,2019-11-30,"(1291.0, 1352.0]",1,1,0
31064.0,2019-11-30,"(389.286, 568.5]",1,2,-1
31064.0,2019-11-30,"(568.5, 747.0]",2,4,-2
31064.0,2019-11-30,"(747.0, 925.5]",17,37,-20
31064.0,2019-11-30,"(925.5, 1104.0]",6,8,-2
,,,,1.0,
,,,,1.0,
31066.0,2019-11-30,"(704.622, 799.5]",1,1,0
31066.0,2019-11-30,"(988.5, 1083.0]",2,4,-2
31067.0,2019-11-30,"(825.654, 912.5]",1,1,0
31067.0,2019-11-30,"(1085.5, 1172.0]",1,2,-1
31068.0,2019-11-30,"(618.271, 801.25]",1,2,-1
31068.0,2019-11-30,"(801.25, 983.5]",1,1,0
31068.0,2019-11-30,"(983.5, 1165.75]",1,1,0
31069.0,2019-11-30,"(594.5, 792.0]",1,2,-1
31069.0,2019-11-30,"(989.5, 1187.0]",1,1,0
31070.0,2019-11-30,"(1173.25, 1180.0]",1,1,0
31071.0,2019-11-30,"(724.0, 887.5]",1,1,0
31071.0,2019-11-30,"(887.5, 1051.0]",3,2,1
,,,,2.0,
,,,,2.0,
31074.0,2019-11-30,"(1063.0, 1086.0]",1,1,0
31075.0,2019-11-30,"(514.86, 550.0]",1,1,0
31076.0,2019-11-30,"(658.762, 718.5]",1,1,0
31076.0,2019-11-30,"(718.5, 778.0]",1,1,0
31077.0,2019-11-30,"(510.444, 650.0]",1,6,-5
31077.0,2019-11-30,"(650.0, 789.0]",3,5,-2
31077.0,2019-11-30,"(789.0, 928.0]",2,4,-2
31077.0,2019-11-30,"(928.0, 1067.0]",5,10,-5
31078.0,2019-11-30,"(817.5, 1090.0]",1,1,0
31079.0,2019-11-30,"(694.315, 866.25]",1,4,-3
31079.0,2019-11-30,"(1208.75, 1380.0]",1,2,-1
31080.0,2019-11-30,"(1112.25, 1273.0]",2,1,1
31081.0,2019-11-30,"(704.461, 839.75]",1,3,-2
31081.0,2019-11-30,"(974.5, 1109.25]",1,1,0
31081.0,2019-11-30,"(1109.25, 1244.0]",1,2,-1
31082.0,2019-11-30,"(766.25, 836.0]",1,1,0
31083.0,2019-11-30,"(853.993, 855.75]",1,2,-1
31083.0,2019-11-30,"(855.75, 857.5]",1,1,0
31084.0,2019-11-30,"(695.471, 828.25]",2,2,0
31085.0,2019-11-30,"(847.0, 1021.0]",2,1,1
31085.0,2019-11-30,"(1195.0, 1369.0]",1,4,-3
31086.0,2019-11-30,"(571.631, 664.25]",1,1,0
31086.0,2019-11-30,"(664.25, 756.5]",1,2,-1
31086.0,2019-11-30,"(848.75, 941.0]",2,1,1
31087.0,2019-11-30,"(701.25, 935.0]",6,1,5
31088.0,2019-11-30,"(591.0, 788.0]",1,1,0
31089.0,2019-11-30,"(408.147, 622.25]",1,1,0
31089.0,2019-11-30,"(622.25, 835.5]",1,4,-3
31089.0,2019-11-30,"(835.5, 1048.75]",2,7,-5
31089.0,2019-11-30,"(1048.75, 1262.0]",4,7,-3
,,,,2.0,
31091.0,2019-11-30,"(970.5, 975.0]",1,1,0
,,,,1.0,
,,,,1.0,
31093.0,2019-11-30,"(783.0, 1044.0]",1,1,0
31094.0,2019-11-30,"(490.5, 654.0]",1,1,0
,,,,2.0,
31096.0,2019-11-30,"(497.25, 663.0]",1,1,0
31097.0,2019-11-30,"(704.75, 898.5]",1,1,0
31097.0,2019-11-30,"(898.5, 1092.25]",2,3,-1
31097.0,2019-11-30,"(1092.25, 1286.0]",1,5,-4
31098.0,2019-11-30,"(1181.5, 1268.0]",1,4,-3
31099.0,2019-11-30,"(757.833, 799.75]",4,4,0
31099.0,2019-11-30,"(883.25, 925.0]",1,1,0
31100.0,2019-11-30,"(302.5, 585.0]",1,1,0
31100.0,2019-11-30,"(585.0, 867.5]",1,1,0
31100.0,2019-11-30,"(867.5, 1150.0]",2,1,1
31101.0,2019-11-30,"(0.583, 356.25]",2,11,-9
31101.0,2019-11-30,"(356.25, 710.5]",11,16,-5
31101.0,2019-11-30,"(710.5, 1064.75]",35,57,-22
31101.0,2019-11-30,"(1064.75, 1419.0]",15,29,-14
31102.0,2019-11-30,"(11.649, 350.75]",2,4,-2
31102.0,2019-11-30,"(350.75, 688.5]",2,6,-4
31102.0,2019-11-30,"(688.5, 1026.25]",2,13,-11
31102.0,2019-11-30,"(1026.25, 1364.0]",5,10,-5
31103.0,2019-11-30,"(6.726, 326.5]",2,3,-1
31103.0,2019-11-30,"(326.5, 645.0]",1,7,-6
31103.0,2019-11-30,"(645.0, 963.5]",2,20,-18
31103.0,2019-11-30,"(963.5, 1282.0]",6,16,-10
31104.0,2019-11-30,"(35.65, 374.5]",3,7,-4
31104.0,2019-11-30,"(374.5, 712.0]",6,18,-12
31104.0,2019-11-30,"(712.0, 1049.5]",18,28,-10
31104.0,2019-11-30,"(1049.5, 1387.0]",9,18,-9
31105.0,2019-11-30,"(695.5, 901.0]",1,2,-1
31105.0,2019-11-30,"(901.0, 1106.5]",1,3,-2
31106.0,2019-11-30,"(630.75, 819.5]",2,4,-2
31106.0,2019-11-30,"(819.5, 1008.25]",1,4,-3
31106.0,2019-11-30,"(1008.25, 1197.0]",2,4,-2
31107.0,2019-11-30,"(-0.432, 359.0]",5,7,-2
31107.0,2019-11-30,"(359.0, 717.0]",6,14,-8
31107.0,2019-11-30,"(717.0, 1075.0]",4,13,-9
31107.0,2019-11-30,"(1075.0, 1433.0]",5,11,-6
31108.0,2019-11-30,"(189.754, 502.5]",1,2,-1
31108.0,2019-11-30,"(502.5, 814.0]",7,15,-8
31108.0,2019-11-30,"(814.0, 1125.5]",9,22,-13
31108.0,2019-11-30,"(1125.5, 1437.0]",11,16,-5
31109.0,2019-11-30,"(361.75, 717.5]",4,2,2
31109.0,2019-11-30,"(717.5, 1073.25]",8,6,2
31109.0,2019-11-30,"(1073.25, 1429.0]",6,18,-12
31110.0,2019-11-30,"(130.756, 443.0]",3,3,0
31110.0,2019-11-30,"(443.0, 754.0]",7,15,-8
31110.0,2019-11-30,"(754.0, 1065.0]",9,18,-9
31110.0,2019-11-30,"(1065.0, 1376.0]",5,14,-9
31111.0,2019-11-30,"(24.72, 346.0]",3,7,-4
31111.0,2019-11-30,"(346.0, 666.0]",2,8,-6
31111.0,2019-11-30,"(666.0, 986.0]",14,23,-9
31111.0,2019-11-30,"(986.0, 1306.0]",7,10,-3
31112.0,2019-11-30,"(661.426, 805.5]",3,9,-6
31112.0,2019-11-30,"(805.5, 949.0]",3,6,-3
31112.0,2019-11-30,"(949.0, 1092.5]",4,4,0
31112.0,2019-11-30,"(1092.5, 1236.0]",1,8,-7
31113.0,2019-11-30,"(691.75, 921.5]",6,4,2
31113.0,2019-11-30,"(921.5, 1151.25]",2,12,-10
31113.0,2019-11-30,"(1151.25, 1381.0]",2,6,-4
31114.0,2019-11-30,"(587.178, 793.5]",3,12,-9
31114.0,2019-11-30,"(793.5, 999.0]",10,17,-7
31114.0,2019-11-30,"(999.0, 1204.5]",9,12,-3
31114.0,2019-11-30,"(1204.5, 1410.0]",4,6,-2
31115.0,2019-11-30,"(853.5, 1095.25]",4,5,-1
31115.0,2019-11-30,"(1095.25, 1337.0]",6,3,3
31116.0,2019-11-30,"(11.603, 362.25]",4,6,-2
31116.0,2019-11-30,"(362.25, 711.5]",8,13,-5
31116.0,2019-11-30,"(711.5, 1060.75]",11,16,-5
31116.0,2019-11-30,"(1060.75, 1410.0]",7,17,-10
31117.0,2019-11-30,"(3.652, 342.0]",2,3,-1
31117.0,2019-11-30,"(679.0, 1016.0]",3,8,-5
31117.0,2019-11-30,"(1016.0, 1353.0]",5,8,-3
31118.0,2019-11-30,"(129.698, 456.5]",1,1,0
31118.0,2019-11-30,"(456.5, 782.0]",3,9,-6
31118.0,2019-11-30,"(782.0, 1107.5]",4,9,-5
31118.0,2019-11-30,"(1107.5, 1433.0]",3,6,-3
31119.0,2019-11-30,"(11.672, 345.0]",5,5,0
31119.0,2019-11-30,"(345.0, 677.0]",1,4,-3
31119.0,2019-11-30,"(677.0, 1009.0]",10,22,-12
31119.0,2019-11-30,"(1009.0, 1341.0]",5,8,-3
31120.0,2019-11-30,"(179.885, 459.75]",2,3,-1
31120.0,2019-11-30,"(459.75, 738.5]",5,6,-1
31120.0,2019-11-30,"(738.5, 1017.25]",4,10,-6
31120.0,2019-11-30,"(1017.25, 1296.0]",3,6,-3
31121.0,2019-11-30,"(25.643, 366.25]",3,5,-2
31121.0,2019-11-30,"(366.25, 705.5]",3,5,-2
31121.0,2019-11-30,"(705.5, 1044.75]",3,9,-6
31121.0,2019-11-30,"(1044.75, 1384.0]",7,10,-3
31122.0,2019-11-30,"(40.799, 342.25]",1,2,-1
31122.0,2019-11-30,"(342.25, 642.5]",1,2,-1
31122.0,2019-11-30,"(642.5, 942.75]",1,5,-4
31122.0,2019-11-30,"(942.75, 1243.0]",3,6,-3
31123.0,2019-11-30,"(637.75, 904.5]",3,4,-1
31123.0,2019-11-30,"(904.5, 1171.25]",7,6,1
31123.0,2019-11-30,"(1171.25, 1438.0]",1,16,-15
31124.0,2019-11-30,"(357.0, 709.0]",8,3,5
31124.0,2019-11-30,"(709.0, 1061.0]",18,19,-1
31124.0,2019-11-30,"(1061.0, 1413.0]",11,43,-32
31125.0,2019-11-30,"(109.77, 418.5]",1,4,-3
31125.0,2019-11-30,"(418.5, 726.0]",5,13,-8
31125.0,2019-11-30,"(726.0, 1033.5]",15,29,-14
31125.0,2019-11-30,"(1033.5, 1341.0]",10,16,-6
31126.0,2019-11-30,"(194.873, 477.75]",2,3,-1
31126.0,2019-11-30,"(477.75, 759.5]",2,12,-10
31126.0,2019-11-30,"(759.5, 1041.25]",1,8,-7
31126.0,2019-11-30,"(1041.25, 1323.0]",6,10,-4
31127.0,2019-11-30,"(732.294, 909.5]",2,2,0
31127.0,2019-11-30,"(1262.5, 1439.0]",2,1,1
31128.0,2019-11-30,"(340.096, 567.0]",2,3,-1
31128.0,2019-11-30,"(567.0, 793.0]",6,12,-6
31128.0,2019-11-30,"(793.0, 1019.0]",10,23,-13
31128.0,2019-11-30,"(1019.0, 1245.0]",11,16,-5
31129.0,2019-11-30,"(499.156, 711.0]",4,6,-2
31129.0,2019-11-30,"(711.0, 922.0]",16,23,-7
31129.0,2019-11-30,"(922.0, 1133.0]",7,13,-6
31129.0,2019-11-30,"(1133.0, 1344.0]",2,2,0
31130.0,2019-11-30,"(910.5, 1090.75]",2,3,-1
31130.0,2019-11-30,"(1090.75, 1271.0]",5,2,3
31131.0,2019-11-30,"(681.0, 895.0]",2,1,1
31131.0,2019-11-30,"(895.0, 1109.0]",3,1,2
31200.0,2019-11-30,"(145.72, 467.0]",1,2,-1
31200.0,2019-11-30,"(467.0, 787.0]",19,27,-8
31200.0,2019-11-30,"(787.0, 1107.0]",9,15,-6
31200.0,2019-11-30,"(1107.0, 1427.0]",4,9,-5
31201.0,2019-11-30,"(84.67, 418.5]",2,9,-7
31201.0,2019-11-30,"(418.5, 751.0]",19,28,-9
31201.0,2019-11-30,"(751.0, 1083.5]",26,52,-26
31201.0,2019-11-30,"(1083.5, 1416.0]",12,21,-9
31202.0,2019-11-30,"(360.25, 705.5]",16,2,14
31202.0,2019-11-30,"(705.5, 1050.75]",21,18,3
31202.0,2019-11-30,"(1050.75, 1396.0]",12,41,-29
31203.0,2019-11-30,"(17.654, 355.5]",2,6,-4
31203.0,2019-11-30,"(355.5, 692.0]",5,9,-4
31203.0,2019-11-30,"(692.0, 1028.5]",18,35,-17
31203.0,2019-11-30,"(1028.5, 1365.0]",23,34,-11
31204.0,2019-11-30,"(229.814, 527.5]",1,2,-1
31204.0,2019-11-30,"(527.5, 824.0]",3,6,-3
31204.0,2019-11-30,"(824.0, 1120.5]",1,3,-2
31205.0,2019-11-30,"(409.988, 664.0]",2,2,0
31205.0,2019-11-30,"(664.0, 917.0]",9,14,-5
31205.0,2019-11-30,"(917.0, 1170.0]",1,3,-2
31205.0,2019-11-30,"(1170.0, 1423.0]",2,7,-5
,,,,1.0,
,,,,1.0,
,,,,1.0,
,,,,1.0,
,,,,3.0,
31208.0,2019-11-30,"(573.226, 767.5]",1,3,-2
31208.0,2019-11-30,"(767.5, 961.0]",4,7,-3
31208.0,2019-11-30,"(961.0, 1154.5]",3,3,0
31209.0,2019-11-30,"(419.75, 746.5]",2,1,1
31209.0,2019-11-30,"(1073.25, 1400.0]",1,2,-1
31211.0,2019-11-30,"(560.185, 764.75]",1,1,0
31211.0,2019-11-30,"(968.5, 1172.25]",2,1,1
31211.0,2019-11-30,"(1172.25, 1376.0]",3,5,-2
31212.0,2019-11-30,"(407.007, 656.25]",1,3,-2
31212.0,2019-11-30,"(656.25, 904.5]",2,6,-4
31212.0,2019-11-30,"(904.5, 1152.75]",12,15,-3
31212.0,2019-11-30,"(1152.75, 1401.0]",2,3,-1
31213.0,2019-11-30,"(583.448, 722.0]",5,7,-2
31213.0,2019-11-30,"(860.0, 998.0]",3,5,-2
31213.0,2019-11-30,"(998.0, 1136.0]",8,8,0
31214.0,2019-11-30,"(73.661, 409.75]",1,1,0
31214.0,2019-11-30,"(409.75, 744.5]",17,31,-14
31214.0,2019-11-30,"(744.5, 1079.25]",17,25,-8
31214.0,2019-11-30,"(1079.25, 1414.0]",9,14,-5
31215.0,2019-11-30,"(689.252, 877.0]",17,19,-2
31215.0,2019-11-30,"(877.0, 1064.0]",6,6,0
31216.0,2019-11-30,"(830.5, 997.0]",1,2,-1
31216.0,2019-11-30,"(1163.5, 1330.0]",1,2,-1
31217.0,2019-11-30,"(730.0, 908.0]",2,1,1
31217.0,2019-11-30,"(908.0, 1086.0]",3,5,-2
31217.0,2019-11-30,"(1086.0, 1264.0]",5,10,-5
31218.0,2019-11-30,"(601.59, 704.5]",3,3,0
31218.0,2019-11-30,"(704.5, 807.0]",1,3,-2
31218.0,2019-11-30,"(807.0, 909.5]",2,3,-1
31219.0,2019-11-30,"(569.437, 710.75]",6,12,-6
31219.0,2019-11-30,"(851.5, 992.25]",3,1,2
31219.0,2019-11-30,"(992.25, 1133.0]",3,5,-2
31220.0,2019-11-30,"(735.361, 895.75]",1,2,-1
31220.0,2019-11-30,"(895.75, 1055.5]",1,2,-1
31220.0,2019-11-30,"(1215.25, 1375.0]",1,1,0
31221.0,2019-11-30,"(346.006, 595.5]",2,6,-4
31221.0,2019-11-30,"(595.5, 844.0]",9,14,-5
31221.0,2019-11-30,"(844.0, 1092.5]",4,10,-6
31222.0,2019-11-30,"(791.717, 862.75]",2,4,-2
31222.0,2019-11-30,"(862.75, 933.5]",1,6,-5
31222.0,2019-11-30,"(933.5, 1004.25]",4,8,-4
31222.0,2019-11-30,"(1004.25, 1075.0]",2,3,-1
31223.0,2019-11-30,"(7.724, 328.0]",3,5,-2
31223.0,2019-11-30,"(328.0, 647.0]",5,8,-3
31223.0,2019-11-30,"(647.0, 966.0]",6,12,-6
31223.0,2019-11-30,"(966.0, 1285.0]",1,10,-9
31224.0,2019-11-30,"(603.42, 749.0]",3,9,-6
31224.0,2019-11-30,"(749.0, 894.0]",1,1,0
31224.0,2019-11-30,"(1039.0, 1184.0]",4,5,-1
31225.0,2019-11-30,"(520.193, 722.75]",5,7,-2
31225.0,2019-11-30,"(722.75, 924.5]",8,11,-3
31225.0,2019-11-30,"(924.5, 1126.25]",8,13,-5
31225.0,2019-11-30,"(1126.25, 1328.0]",5,6,-1
31226.0,2019-11-30,"(452.14, 668.0]",3,5,-2
31226.0,2019-11-30,"(668.0, 883.0]",2,4,-2
31226.0,2019-11-30,"(883.0, 1098.0]",5,11,-6
31226.0,2019-11-30,"(1098.0, 1313.0]",3,5,-2
31227.0,2019-11-30,"(307.25, 613.5]",1,1,0
31227.0,2019-11-30,"(613.5, 919.75]",3,1,2
31227.0,2019-11-30,"(919.75, 1226.0]",1,9,-8
31228.0,2019-11-30,"(76.641, 417.75]",1,2,-1
31228.0,2019-11-30,"(417.75, 757.5]",6,9,-3
31228.0,2019-11-30,"(757.5, 1097.25]",18,25,-7
31228.0,2019-11-30,"(1097.25, 1437.0]",14,19,-5
31229.0,2019-11-30,"(33.649, 372.75]",2,3,-1
31229.0,2019-11-30,"(372.75, 710.5]",8,22,-14
31229.0,2019-11-30,"(710.5, 1048.25]",19,37,-18
31229.0,2019-11-30,"(1048.25, 1386.0]",6,16,-10
31230.0,2019-11-30,"(405.75, 740.5]",5,2,3
31230.0,2019-11-30,"(740.5, 1075.25]",16,6,10
31230.0,2019-11-30,"(1075.25, 1410.0]",8,26,-18
31231.0,2019-11-30,"(779.5, 925.0]",2,5,-3
31231.0,2019-11-30,"(925.0, 1070.5]",2,2,0
31231.0,2019-11-30,"(1070.5, 1216.0]",5,2,3
31232.0,2019-11-30,"(350.927, 620.25]",3,8,-5
31232.0,2019-11-30,"(620.25, 888.5]",20,28,-8
31232.0,2019-11-30,"(888.5, 1156.75]",11,19,-8
31232.0,2019-11-30,"(1156.75, 1425.0]",9,13,-4
31233.0,2019-11-30,"(26.735, 344.25]",1,1,0
31233.0,2019-11-30,"(344.25, 660.5]",1,2,-1
31233.0,2019-11-30,"(660.5, 976.75]",4,5,-1
31233.0,2019-11-30,"(976.75, 1293.0]",1,3,-2
31234.0,2019-11-30,"(171.784, 477.0]",2,3,-1
31234.0,2019-11-30,"(477.0, 781.0]",2,5,-3
31234.0,2019-11-30,"(781.0, 1085.0]",7,16,-9
31234.0,2019-11-30,"(1085.0, 1389.0]",6,13,-7
31235.0,2019-11-30,"(654.46, 790.0]",7,9,-2
31235.0,2019-11-30,"(790.0, 925.0]",4,4,0
31235.0,2019-11-30,"(925.0, 1060.0]",7,10,-3
31235.0,2019-11-30,"(1060.0, 1195.0]",1,4,-3
31236.0,2019-11-30,"(524.199, 725.25]",5,6,-1
31236.0,2019-11-30,"(725.25, 925.5]",6,13,-7
31236.0,2019-11-30,"(925.5, 1125.75]",7,15,-8
31236.0,2019-11-30,"(1125.75, 1326.0]",3,6,-3
31237.0,2019-11-30,"(11.652, 350.0]",1,1,0
31237.0,2019-11-30,"(350.0, 687.0]",2,9,-7
31237.0,2019-11-30,"(687.0, 1024.0]",7,13,-6
31237.0,2019-11-30,"(1024.0, 1361.0]",5,8,-3
31238.0,2019-11-30,"(10.761, 321.75]",2,3,-1
31238.0,2019-11-30,"(321.75, 631.5]",3,4,-1
31238.0,2019-11-30,"(631.5, 941.25]",3,6,-3
31238.0,2019-11-30,"(941.25, 1251.0]",7,11,-4
31239.0,2019-11-30,"(426.0, 741.0]",6,1,5
31239.0,2019-11-30,"(741.0, 1056.0]",5,8,-3
31239.0,2019-11-30,"(1056.0, 1371.0]",2,10,-8
31240.0,2019-11-30,"(641.22, 837.0]",14,28,-14
31240.0,2019-11-30,"(837.0, 1032.0]",12,25,-13
31240.0,2019-11-30,"(1032.0, 1227.0]",5,9,-4
31240.0,2019-11-30,"(1227.0, 1422.0]",7,16,-9
31241.0,2019-11-30,"(143.784, 449.0]",1,4,-3
31241.0,2019-11-30,"(449.0, 753.0]",3,8,-5
31241.0,2019-11-30,"(753.0, 1057.0]",5,20,-15
31241.0,2019-11-30,"(1057.0, 1361.0]",6,12,-6
31242.0,2019-11-30,"(609.286, 788.5]",3,6,-3
31242.0,2019-11-30,"(788.5, 967.0]",4,10,-6
31242.0,2019-11-30,"(967.0, 1145.5]",2,2,0
31243.0,2019-11-30,"(530.111, 753.25]",5,6,-1
31243.0,2019-11-30,"(753.25, 975.5]",5,7,-2
31243.0,2019-11-30,"(975.5, 1197.75]",5,17,-12
31243.0,2019-11-30,"(1197.75, 1420.0]",3,7,-4
31244.0,2019-11-30,"(634.431, 777.25]",1,4,-3
31244.0,2019-11-30,"(1061.75, 1204.0]",6,2,4
31245.0,2019-11-30,"(8.587, 363.25]",2,5,-3
31245.0,2019-11-30,"(363.25, 716.5]",7,11,-4
31245.0,2019-11-30,"(716.5, 1069.75]",7,12,-5
31245.0,2019-11-30,"(1069.75, 1423.0]",2,5,-3
31246.0,2019-11-30,"(511.155, 723.25]",8,10,-2
31246.0,2019-11-30,"(723.25, 934.5]",7,8,-1
31246.0,2019-11-30,"(934.5, 1145.75]",3,6,-3
31247.0,2019-11-30,"(465.154, 677.5]",5,10,-5
31247.0,2019-11-30,"(677.5, 889.0]",25,46,-21
31247.0,2019-11-30,"(889.0, 1100.5]",24,49,-25
31247.0,2019-11-30,"(1100.5, 1312.0]",9,16,-7
31248.0,2019-11-30,"(515.086, 744.5]",3,8,-5
31248.0,2019-11-30,"(744.5, 973.0]",21,43,-22
31248.0,2019-11-30,"(973.0, 1201.5]",15,28,-13
31248.0,2019-11-30,"(1201.5, 1430.0]",3,4,-1
31249.0,2019-11-30,"(463.046, 702.5]",2,6,-4
31249.0,2019-11-30,"(702.5, 941.0]",13,24,-11
31249.0,2019-11-30,"(941.0, 1179.5]",12,24,-12
31249.0,2019-11-30,"(1179.5, 1418.0]",5,5,0
31250.0,2019-11-30,"(83.716, 406.0]",2,2,0
31250.0,2019-11-30,"(406.0, 727.0]",1,1,0
31250.0,2019-11-30,"(727.0, 1048.0]",3,4,-1
31251.0,2019-11-30,"(519.112, 742.0]",4,7,-3
31251.0,2019-11-30,"(742.0, 964.0]",2,6,-4
31251.0,2019-11-30,"(964.0, 1186.0]",3,7,-4
31251.0,2019-11-30,"(1186.0, 1408.0]",3,5,-2
31252.0,2019-11-30,"(714.616, 811.0]",1,1,0
31252.0,2019-11-30,"(811.0, 907.0]",1,4,-3
31252.0,2019-11-30,"(1003.0, 1099.0]",1,1,0
31253.0,2019-11-30,"(757.824, 802.0]",2,4,-2
31253.0,2019-11-30,"(890.0, 934.0]",3,3,0
31254.0,2019-11-30,"(525.127, 744.25]",3,6,-3
31254.0,2019-11-30,"(962.5, 1180.75]",4,6,-2
31254.0,2019-11-30,"(1180.75, 1399.0]",1,2,-1
31255.0,2019-11-30,"(533.663, 618.25]",3,6,-3
31255.0,2019-11-30,"(618.25, 702.5]",2,3,-1
31255.0,2019-11-30,"(702.5, 786.75]",2,3,-1
31255.0,2019-11-30,"(786.75, 871.0]",3,5,-2
31256.0,2019-11-30,"(494.0, 762.0]",1,2,-1
31256.0,2019-11-30,"(762.0, 1030.0]",14,1,13
31256.0,2019-11-30,"(1030.0, 1298.0]",7,17,-10
31257.0,2019-11-30,"(389.085, 618.75]",3,4,-1
31257.0,2019-11-30,"(618.75, 847.5]",4,7,-3
31257.0,2019-11-30,"(847.5, 1076.25]",9,11,-2
31257.0,2019-11-30,"(1076.25, 1305.0]",2,5,-3
31258.0,2019-11-30,"(489.085, 718.75]",14,19,-5
31258.0,2019-11-30,"(718.75, 947.5]",37,87,-50
31258.0,2019-11-30,"(947.5, 1176.25]",23,55,-32
31258.0,2019-11-30,"(1176.25, 1405.0]",6,14,-8
,,,,2.0,
31260.0,2019-11-30,"(220.941, 486.75]",1,2,-1
31260.0,2019-11-30,"(751.5, 1016.25]",1,4,-3
31260.0,2019-11-30,"(1016.25, 1281.0]",5,10,-5
31261.0,2019-11-30,"(692.606, 791.5]",2,4,-2
31262.0,2019-11-30,"(709.384, 864.0]",6,8,-2
31262.0,2019-11-30,"(864.0, 1018.0]",4,4,0
31262.0,2019-11-30,"(1018.0, 1172.0]",2,3,-1
31262.0,2019-11-30,"(1172.0, 1326.0]",2,3,-1
31263.0,2019-11-30,"(468.133, 685.75]",3,4,-1
31263.0,2019-11-30,"(685.75, 902.5]",2,2,0
31263.0,2019-11-30,"(902.5, 1119.25]",2,4,-2
31263.0,2019-11-30,"(1119.25, 1336.0]",2,6,-4
31264.0,2019-11-30,"(196.763, 507.25]",1,2,-1
31264.0,2019-11-30,"(507.25, 816.5]",12,16,-4
31264.0,2019-11-30,"(816.5, 1125.75]",4,10,-6
31264.0,2019-11-30,"(1125.75, 1435.0]",6,8,-2
31265.0,2019-11-30,"(7.577, 364.75]",1,3,-2
31265.0,2019-11-30,"(364.75, 720.5]",4,12,-8
31265.0,2019-11-30,"(720.5, 1076.25]",14,24,-10
31265.0,2019-11-30,"(1076.25, 1432.0]",5,9,-4
31266.0,2019-11-30,"(72.694, 400.5]",1,3,-2
31266.0,2019-11-30,"(400.5, 727.0]",2,10,-8
31266.0,2019-11-30,"(727.0, 1053.5]",13,32,-19
31266.0,2019-11-30,"(1053.5, 1380.0]",13,24,-11
31267.0,2019-11-30,"(102.75, 416.5]",3,4,-1
31267.0,2019-11-30,"(416.5, 729.0]",2,6,-4
31267.0,2019-11-30,"(729.0, 1041.5]",5,10,-5
31267.0,2019-11-30,"(1041.5, 1354.0]",6,10,-4
31268.0,2019-11-30,"(20.629, 364.75]",1,2,-1
31268.0,2019-11-30,"(364.75, 707.5]",8,14,-6
31268.0,2019-11-30,"(707.5, 1050.25]",4,8,-4
31268.0,2019-11-30,"(1050.25, 1393.0]",4,9,-5
31269.0,2019-11-30,"(-0.393, 349.25]",1,1,0
31269.0,2019-11-30,"(349.25, 697.5]",6,15,-9
31269.0,2019-11-30,"(697.5, 1045.75]",13,23,-10
31269.0,2019-11-30,"(1045.75, 1394.0]",6,14,-8
31270.0,2019-11-30,"(0.575, 358.25]",2,3,-1
31270.0,2019-11-30,"(358.25, 714.5]",2,2,0
31270.0,2019-11-30,"(714.5, 1070.75]",8,19,-11
31270.0,2019-11-30,"(1070.75, 1427.0]",1,5,-4
31271.0,2019-11-30,"(593.392, 746.0]",6,7,-1
31271.0,2019-11-30,"(746.0, 898.0]",9,15,-6
31271.0,2019-11-30,"(898.0, 1050.0]",5,12,-7
31272.0,2019-11-30,"(613.561, 723.75]",2,3,-1
31272.0,2019-11-30,"(833.5, 943.25]",7,1,6
31272.0,2019-11-30,"(943.25, 1053.0]",7,19,-12
31273.0,2019-11-30,"(463.532, 581.0]",1,1,0
31273.0,2019-11-30,"(581.0, 698.0]",1,3,-2
31273.0,2019-11-30,"(698.0, 815.0]",5,8,-3
31273.0,2019-11-30,"(815.0, 932.0]",3,6,-3
31274.0,2019-11-30,"(335.5, 642.0]",1,1,0
31274.0,2019-11-30,"(642.0, 948.5]",1,1,0
31274.0,2019-11-30,"(948.5, 1255.0]",5,4,1
31275.0,2019-11-30,"(25.609, 374.75]",2,3,-1
31275.0,2019-11-30,"(374.75, 722.5]",1,5,-4
31275.0,2019-11-30,"(722.5, 1070.25]",7,13,-6
31275.0,2019-11-30,"(1070.25, 1418.0]",5,11,-6
31276.0,2019-11-30,"(717.5, 861.0]",2,4,-2
31276.0,2019-11-30,"(861.0, 1004.5]",2,3,-1
31276.0,2019-11-30,"(1004.5, 1148.0]",1,2,-1
31277.0,2019-11-30,"(68.878, 350.5]",3,5,-2
31277.0,2019-11-30,"(350.5, 631.0]",6,9,-3
31277.0,2019-11-30,"(631.0, 911.5]",4,14,-10
31277.0,2019-11-30,"(911.5, 1192.0]",19,24,-5
31278.0,2019-11-30,"(88.69, 417.5]",2,2,0
31278.0,2019-11-30,"(417.5, 745.0]",6,12,-6
31278.0,2019-11-30,"(745.0, 1072.5]",9,21,-12
31278.0,2019-11-30,"(1072.5, 1400.0]",10,22,-12
31279.0,2019-11-30,"(489.163, 699.25]",1,2,-1
31279.0,2019-11-30,"(1117.75, 1327.0]",1,3,-2
31280.0,2019-11-30,"(445.037, 686.75]",4,8,-4
31280.0,2019-11-30,"(686.75, 927.5]",6,13,-7
31280.0,2019-11-30,"(927.5, 1168.25]",4,7,-3
31280.0,2019-11-30,"(1168.25, 1409.0]",2,3,-1
,,,,2.0,
31001.0,2019-12-01,"(1036.25, 1369.0]",3,1,2
31002.0,2019-12-01,"(820.475, 952.25]",1,2,-1
31002.0,2019-12-01,"(1083.5, 1214.75]",1,2,-1
31002.0,2019-12-01,"(1214.75, 1346.0]",1,2,-1
,,,,2.0,
31004.0,2019-12-01,"(1038.75, 1041.0]",1,1,0
31005.0,2019-12-01,"(563.243, 753.25]",1,1,0
31005.0,2019-12-01,"(1131.75, 1321.0]",1,4,-3
31006.0,2019-12-01,"(623.75, 661.0]",1,1,0
,,,,2.0,
,,,,2.0,
,,,,2.0,
31011.0,2019-12-01,"(1131.0, 1357.0]",1,1,0
,,,,2.0,
31013.0,2019-12-01,"(392.25, 523.0]",1,1,0
31014.0,2019-12-01,"(118.773, 426.75]",1,3,-2
31014.0,2019-12-01,"(1040.25, 1347.0]",4,1,3
31015.0,2019-12-01,"(130.818, 427.5]",1,2,-1
31015.0,2019-12-01,"(427.5, 723.0]",1,2,-1
31015.0,2019-12-01,"(723.0, 1018.5]",1,3,-2
31015.0,2019-12-01,"(1018.5, 1314.0]",3,5,-2
,,,,1.0,
,,,,1.0,
,,,,1.0,
,,,,2.0,
31018.0,2019-12-01,"(1097.884, 1127.0]",1,1,0
31019.0,2019-12-01,"(1190.404, 1191.0]",1,2,-1
,,,,2.0,
31021.0,2019-12-01,"(489.314, 661.5]",1,2,-1
31021.0,2019-12-01,"(1004.5, 1176.0]",3,1,2
31022.0,2019-12-01,"(911.25, 1054.5]",1,1,0
31022.0,2019-12-01,"(1054.5, 1197.75]",2,2,0
31023.0,2019-12-01,"(730.385, 884.75]",1,1,0
31024.0,2019-12-01,"(979.75, 1261.0]",1,1,0
31025.0,2019-12-01,"(1008.749, 1071.75]",1,1,0
31026.0,2019-12-01,"(312.75, 417.0]",1,1,0
,,,,1.0,
,,,,1.0,
31028.0,2019-12-01,"(1077.823, 1122.25]",1,1,0
,,,,2.0,
31030.0,2019-12-01,"(0.635, 343.25]",2,2,0
31030.0,2019-12-01,"(343.25, 684.5]",1,2,-1
31030.0,2019-12-01,"(1025.75, 1367.0]",2,3,-1
31031.0,2019-12-01,"(793.5, 1058.0]",1,1,0
,,,,1.0,
,,,,1.0,
31033.0,2019-12-01,"(458.143, 673.25]",1,1,0
31033.0,2019-12-01,"(1101.75, 1316.0]",1,1,0
,,,,1.0,
,,,,1.0,
,,,,2.0,
31035.0,2019-12-01,"(220.813, 267.75]",1,1,0
,,,,2.0,
31037.0,2019-12-01,"(427.184, 632.0]",1,2,-1
31037.0,2019-12-01,"(632.0, 836.0]",1,2,-1
31037.0,2019-12-01,"(1040.0, 1244.0]",3,2,1
31038.0,2019-12-01,"(523.5, 785.25]",2,1,1
31038.0,2019-12-01,"(785.25, 1047.0]",1,2,-1
,,,,2.0,
31040.0,2019-12-01,"(422.262, 607.5]",1,2,-1
31040.0,2019-12-01,"(976.5, 1161.0]",2,4,-2
,,,,2.0,
,,,,2.0,
,,,,2.0,
,,,,1.0,
,,,,1.0,
,,,,2.0,
31046.0,2019-12-01,"(808.82, 854.0]",1,1,0
,,,,2.0,
31048.0,2019-12-01,"(849.609, 947.75]",3,3,0
31049.0,2019-12-01,"(925.5, 1234.0]",1,1,0
,,,,2.0,
31051.0,2019-12-01,"(715.5, 954.0]",1,1,0
31052.0,2019-12-01,"(1060.863, 1095.25]",2,2,0
,,,,2.0,
,,,,2.0,
,,,,2.0,
31056.0,2019-12-01,"(43.5, 58.0]",1,1,0
,,,,2.0,
,,,,1.0,
,,,,1.0,
,,,,2.0,
31060.0,2019-12-01,"(1020.715, 1092.25]",1,1,0
31061.0,2019-12-01,"(389.25, 519.0]",1,1,0
31062.0,2019-12-01,"(839.58, 840.0]",1,2,-1
,,,,2.0,
31064.0,2019-12-01,"(1134.432, 1135.0]",1,2,-1
31065.0,2019-12-01,"(406.661, 491.75]",1,2,-1
31065.0,2019-12-01,"(661.25, 746.0]",1,1,0
,,,,2.0,
31067.0,2019-12-01,"(588.0, 784.0]",1,1,0
31068.0,2019-12-01,"(1023.0, 1364.0]",1,1,0
,,,,2.0,
31070.0,2019-12-01,"(1052.937, 1068.75]",1,2,-1
31070.0,2019-12-01,"(1100.25, 1116.0]",1,1,0
31071.0,2019-12-01,"(139.871, 423.25]",1,1,0
31071.0,2019-12-01,"(423.25, 705.5]",1,3,-2
31071.0,2019-12-01,"(987.75, 1270.0]",1,2,-1
,,,,2.0,
31073.0,2019-12-01,"(851.5, 919.0]",1,1,0
,,,,2.0,
,,,,2.0,
31076.0,2019-12-01,"(21.575, 128.25]",1,2,-1
,,,,1.0,
,,,,1.0,
,,,,2.0,
31079.0,2019-12-01,"(1172.25, 1347.0]",3,1,2
31080.0,2019-12-01,"(126.851, 415.25]",1,1,0
31080.0,2019-12-01,"(989.75, 1277.0]",1,1,0
,,,,2.0,
,,,,2.0,
,,,,2.0,
31084.0,2019-12-01,"(1167.75, 1246.0]",1,1,0
31085.0,2019-12-01,"(1078.25, 1085.0]",1,1,0
,,,,2.0,
,,,,2.0,
31088.0,2019-12-01,"(105.75, 141.0]",1,1,0
31089.0,2019-12-01,"(412.75, 690.5]",1,2,-1
31089.0,2019-12-01,"(968.25, 1246.0]",2,1,1
,,,,2.0,
31091.0,2019-12-01,"(882.0, 1176.0]",1,1,0
31092.0,2019-12-01,"(904.5, 1206.0]",2,1,1
,,,,1.0,
,,,,1.0,
31094.0,2019-12-01,"(641.75, 650.0]",1,1,0
,,,,2.0,
,,,,2.0,
31097.0,2019-12-01,"(745.5, 994.0]",1,1,0
31098.0,2019-12-01,"(1064.896, 1091.0]",1,2,-1
31098.0,2019-12-01,"(1143.0, 1169.0]",1,1,0
,,,,2.0,
31100.0,2019-12-01,"(677.743, 742.25]",1,2,-1
31100.0,2019-12-01,"(870.75, 935.0]",2,2,0
31101.0,2019-12-01,"(390.5, 736.0]",8,3,5
31101.0,2019-12-01,"(736.0, 1081.5]",14,11,3
31101.0,2019-12-01,"(1081.5, 1427.0]",11,20,-9
31102.0,2019-12-01,"(450.25, 776.5]",3,2,1
31102.0,2019-12-01,"(776.5, 1102.75]",2,5,-3
31102.0,2019-12-01,"(1102.75, 1429.0]",1,6,-5
31103.0,2019-12-01,"(503.132, 721.0]",1,6,-5
31103.0,2019-12-01,"(721.0, 938.0]",1,5,-4
31103.0,2019-12-01,"(938.0, 1155.0]",2,10,-8
31103.0,2019-12-01,"(1155.0, 1372.0]",3,6,-3
31104.0,2019-12-01,"(0.686, 330.5]",3,7,-4
31104.0,2019-12-01,"(330.5, 659.0]",1,4,-3
31104.0,2019-12-01,"(659.0, 987.5]",1,3,-2
31104.0,2019-12-01,"(987.5, 1316.0]",9,19,-10
31105.0,2019-12-01,"(998.75, 1300.0]",2,1,1
,,,,3.0,
,,,,1.0,
31107.0,2019-12-01,"(37.615, 385.25]",3,5,-2
31107.0,2019-12-01,"(731.5, 1077.75]",2,3,-1
31107.0,2019-12-01,"(1077.75, 1424.0]",6,5,1
31108.0,2019-12-01,"(195.033, 437.75]",1,2,-1
31108.0,2019-12-01,"(679.5, 921.25]",1,4,-3
31108.0,2019-12-01,"(921.25, 1163.0]",3,1,2
31109.0,2019-12-01,"(409.5, 719.0]",2,4,-2
31109.0,2019-12-01,"(719.0, 1028.5]",1,3,-2
31109.0,2019-12-01,"(1028.5, 1338.0]",6,4,2
31110.0,2019-12-01,"(108.679, 440.25]",1,2,-1
31110.0,2019-12-01,"(440.25, 770.5]",8,14,-6
31110.0,2019-12-01,"(770.5, 1100.75]",3,5,-2
31110.0,2019-12-01,"(1100.75, 1431.0]",5,8,-3
31111.0,2019-12-01,"(49.739, 366.25]",1,3,-2
31111.0,2019-12-01,"(366.25, 681.5]",1,1,0
31111.0,2019-12-01,"(681.5, 996.75]",2,3,-1
31111.0,2019-12-01,"(996.75, 1312.0]",5,10,-5
,,,,2.0,
31113.0,2019-12-01,"(697.368, 856.0]",1,3,-2
31113.0,2019-12-01,"(1014.0, 1172.0]",1,3,-2
31113.0,2019-12-01,"(1172.0, 1330.0]",2,2,0
31114.0,2019-12-01,"(730.5, 1081.25]",8,5,3
31114.0,2019-12-01,"(1081.25, 1432.0]",5,2,3
31115.0,2019-12-01,"(85.894, 363.5]",1,1,0
31115.0,2019-12-01,"(363.5, 640.0]",1,3,-2
31115.0,2019-12-01,"(640.0, 916.5]",1,3,-2
31115.0,2019-12-01,"(916.5, 1193.0]",3,6,-3
31116.0,2019-12-01,"(428.152, 641.0]",1,1,0
31116.0,2019-12-01,"(641.0, 853.0]",3,5,-2
31116.0,2019-12-01,"(1065.0, 1277.0]",3,1,2
31117.0,2019-12-01,"(171.963, 432.25]",1,1,0
31117.0,2019-12-01,"(691.5, 950.75]",2,6,-4
31117.0,2019-12-01,"(950.75, 1210.0]",2,3,-1
31118.0,2019-12-01,"(67.872, 351.0]",2,2,0
31118.0,2019-12-01,"(351.0, 633.0]",1,3,-2
31118.0,2019-12-01,"(633.0, 915.0]",1,2,-1
31118.0,2019-12-01,"(915.0, 1197.0]",4,6,-2
31119.0,2019-12-01,"(157.755, 470.25]",1,3,-2
31119.0,2019-12-01,"(470.25, 781.5]",4,10,-6
31119.0,2019-12-01,"(781.5, 1092.75]",6,7,-1
31119.0,2019-12-01,"(1092.75, 1404.0]",5,8,-3
31120.0,2019-12-01,"(154.813, 452.75]",1,1,0
31120.0,2019-12-01,"(749.5, 1046.25]",4,6,-2
31120.0,2019-12-01,"(1046.25, 1343.0]",3,6,-3
31121.0,2019-12-01,"(36.697, 363.75]",1,2,-1
31121.0,2019-12-01,"(363.75, 689.5]",1,4,-3
31121.0,2019-12-01,"(1015.25, 1341.0]",6,9,-3
31122.0,2019-12-01,"(9.636, 352.0]",1,1,0
31122.0,2019-12-01,"(352.0, 693.0]",2,3,-1
31123.0,2019-12-01,"(174.785, 479.75]",1,2,-1
31123.0,2019-12-01,"(479.75, 783.5]",1,1,0
31123.0,2019-12-01,"(783.5, 1087.25]",1,5,-4
31123.0,2019-12-01,"(1087.25, 1391.0]",1,4,-3
31124.0,2019-12-01,"(18.732, 337.0]",1,1,0
31124.0,2019-12-01,"(337.0, 654.0]",2,5,-3
31124.0,2019-12-01,"(654.0, 971.0]",3,8,-5
31124.0,2019-12-01,"(971.0, 1288.0]",7,21,-14
31125.0,2019-12-01,"(636.5, 949.75]",2,1,1
31125.0,2019-12-01,"(949.75, 1263.0]",6,1,5
31126.0,2019-12-01,"(97.673, 430.75]",1,1,0
31126.0,2019-12-01,"(430.75, 762.5]",2,7,-5
31126.0,2019-12-01,"(762.5, 1094.25]",4,10,-6
31126.0,2019-12-01,"(1094.25, 1426.0]",7,11,-4
,,,,2.0,
31128.0,2019-12-01,"(60.633, 403.75]",2,4,-2
31128.0,2019-12-01,"(403.75, 745.5]",1,5,-4
31128.0,2019-12-01,"(745.5, 1087.25]",5,6,-1
31128.0,2019-12-01,"(1087.25, 1429.0]",1,3,-2
31129.0,2019-12-01,"(431.75, 755.5]",1,1,0
31129.0,2019-12-01,"(755.5, 1079.25]",1,1,0
31129.0,2019-12-01,"(1079.25, 1403.0]",5,1,4
31130.0,2019-12-01,"(77.753, 390.75]",1,3,-2
31130.0,2019-12-01,"(390.75, 702.5]",1,1,0
31130.0,2019-12-01,"(702.5, 1014.25]",1,2,-1
31130.0,2019-12-01,"(1014.25, 1326.0]",1,1,0
31131.0,2019-12-01,"(309.75, 570.5]",1,1,0
31131.0,2019-12-01,"(831.25, 1092.0]",2,2,0
31200.0,2019-12-01,"(410.75, 735.5]",9,1,8
31200.0,2019-12-01,"(735.5, 1060.25]",11,13,-2
31200.0,2019-12-01,"(1060.25, 1385.0]",7,19,-12
31201.0,2019-12-01,"(445.0, 764.0]",8,2,6
31201.0,2019-12-01,"(764.0, 1083.0]",7,14,-7
31201.0,2019-12-01,"(1083.0, 1402.0]",8,12,-4
31202.0,2019-12-01,"(32.675, 365.25]",3,8,-5
31202.0,2019-12-01,"(365.25, 696.5]",3,4,-1
31202.0,2019-12-01,"(696.5, 1027.75]",7,15,-8
31202.0,2019-12-01,"(1027.75, 1359.0]",7,13,-6
31203.0,2019-12-01,"(19.591, 373.25]",1,3,-2
31203.0,2019-12-01,"(373.25, 725.5]",2,3,-1
31203.0,2019-12-01,"(725.5, 1077.75]",4,5,-1
31203.0,2019-12-01,"(1077.75, 1430.0]",13,20,-7
31204.0,2019-12-01,"(52.695, 380.25]",1,1,0
31204.0,2019-12-01,"(1032.75, 1359.0]",2,2,0
31205.0,2019-12-01,"(839.437, 980.75]",1,2,-1
31205.0,2019-12-01,"(980.75, 1121.5]",2,2,0
31205.0,2019-12-01,"(1121.5, 1262.25]",1,4,-3
31205.0,2019-12-01,"(1262.25, 1403.0]",4,5,-1
,,,,2.0,
31207.0,2019-12-01,"(760.42, 906.0]",2,4,-2
31207.0,2019-12-01,"(1051.0, 1196.0]",1,1,0
31207.0,2019-12-01,"(1196.0, 1341.0]",1,2,-1
31208.0,2019-12-01,"(579.238, 770.5]",1,1,0
31208.0,2019-12-01,"(770.5, 961.0]",1,1,0
31208.0,2019-12-01,"(961.0, 1151.5]",3,3,0
31208.0,2019-12-01,"(1151.5, 1342.0]",2,4,-2
31209.0,2019-12-01,"(1187.0, 1388.0]",1,1,0
31211.0,2019-12-01,"(548.287, 727.25]",2,5,-3
31211.0,2019-12-01,"(905.5, 1083.75]",1,1,0
31212.0,2019-12-01,"(291.949, 555.75]",3,4,-1
31212.0,2019-12-01,"(555.75, 818.5]",2,3,-1
31212.0,2019-12-01,"(818.5, 1081.25]",1,4,-3
31212.0,2019-12-01,"(1081.25, 1344.0]",2,5,-3
31213.0,2019-12-01,"(686.596, 788.0]",2,2,0
31214.0,2019-12-01,"(128.768, 438.0]",1,1,0
31214.0,2019-12-01,"(438.0, 746.0]",9,19,-10
31214.0,2019-12-01,"(746.0, 1054.0]",7,13,-6
31214.0,2019-12-01,"(1054.0, 1362.0]",9,17,-8
31215.0,2019-12-01,"(575.25, 767.0]",1,1,0
31216.0,2019-12-01,"(710.631, 803.25]",1,3,-2
31216.0,2019-12-01,"(987.75, 1080.0]",1,3,-2
31217.0,2019-12-01,"(833.724, 903.0]",2,2,0
31217.0,2019-12-01,"(1041.0, 1110.0]",1,2,-1
31218.0,2019-12-01,"(0.809, 299.75]",2,2,0
31218.0,2019-12-01,"(895.25, 1193.0]",3,4,-1
31219.0,2019-12-01,"(783.762, 843.5]",3,4,-1
31219.0,2019-12-01,"(903.0, 962.5]",1,1,0
,,,,2.0,
31221.0,2019-12-01,"(767.36, 928.0]",2,2,0
31221.0,2019-12-01,"(928.0, 1088.0]",1,3,-2
31221.0,2019-12-01,"(1088.0, 1248.0]",2,3,-1
,,,,1.0,
,,,,2.0,
31223.0,2019-12-01,"(48.696, 376.0]",5,11,-6
31223.0,2019-12-01,"(376.0, 702.0]",2,4,-2
31223.0,2019-12-01,"(702.0, 1028.0]",2,4,-2
31223.0,2019-12-01,"(1028.0, 1354.0]",7,11,-4
31224.0,2019-12-01,"(203.886, 483.5]",3,5,-2
31224.0,2019-12-01,"(1040.5, 1319.0]",1,1,0
31225.0,2019-12-01,"(20.633, 363.75]",2,2,0
31225.0,2019-12-01,"(363.75, 705.5]",8,13,-5
31225.0,2019-12-01,"(705.5, 1047.25]",3,5,-2
31225.0,2019-12-01,"(1047.25, 1389.0]",3,10,-7
31226.0,2019-12-01,"(500.313, 672.75]",3,6,-3
31226.0,2019-12-01,"(672.75, 844.5]",2,3,-1
31226.0,2019-12-01,"(1016.25, 1188.0]",2,3,-1
31227.0,2019-12-01,"(813.869, 846.75]",1,1,0
31227.0,2019-12-01,"(846.75, 879.5]",2,3,-1
31228.0,2019-12-01,"(37.624, 383.0]",1,3,-2
31228.0,2019-12-01,"(727.0, 1071.0]",1,1,0
31228.0,2019-12-01,"(1071.0, 1415.0]",4,4,0
31229.0,2019-12-01,"(39.612, 388.0]",3,6,-3
31229.0,2019-12-01,"(388.0, 735.0]",5,13,-8
31229.0,2019-12-01,"(735.0, 1082.0]",5,11,-6
31229.0,2019-12-01,"(1082.0, 1429.0]",6,14,-8
31230.0,2019-12-01,"(503.175, 710.25]",1,1,0
31230.0,2019-12-01,"(1122.75, 1329.0]",1,3,-2
,,,,2.0,
31232.0,2019-12-01,"(519.16, 730.0]",1,3,-2
31232.0,2019-12-01,"(730.0, 940.0]",2,2,0
31232.0,2019-12-01,"(940.0, 1150.0]",1,2,-1
31232.0,2019-12-01,"(1150.0, 1360.0]",1,1,0
,,,,2.0,
31234.0,2019-12-01,"(647.75, 906.5]",4,1,3
31234.0,2019-12-01,"(906.5, 1165.25]",3,6,-3
31234.0,2019-12-01,"(1165.25, 1424.0]",3,5,-2
,,,,2.0,
31236.0,2019-12-01,"(580.245, 769.75]",2,2,0
31236.0,2019-12-01,"(958.5, 1147.25]",4,9,-5
31237.0,2019-12-01,"(39.744, 355.0]",1,1,0
31237.0,2019-12-01,"(355.0, 669.0]",3,4,-1
31237.0,2019-12-01,"(669.0, 983.0]",3,8,-5
31237.0,2019-12-01,"(983.0, 1297.0]",8,13,-5
31238.0,2019-12-01,"(45.286, 224.5]",1,2,-1
31238.0,2019-12-01,"(581.5, 760.0]",1,1,0
31239.0,2019-12-01,"(172.864, 458.0]",1,2,-1
31239.0,2019-12-01,"(458.0, 742.0]",1,1,0
31239.0,2019-12-01,"(742.0, 1026.0]",2,4,-2
31239.0,2019-12-01,"(1026.0, 1310.0]",4,9,-5
,,,,1.0,
,,,,1.0,
31241.0,2019-12-01,"(68.763, 379.25]",3,3,0
31241.0,2019-12-01,"(688.5, 997.75]",2,3,-1
31241.0,2019-12-01,"(997.75, 1307.0]",8,3,5
31242.0,2019-12-01,"(566.252, 754.0]",1,1,0
31242.0,2019-12-01,"(1128.0, 1315.0]",1,2,-1
31243.0,2019-12-01,"(13.652, 352.0]",3,4,-1
31243.0,2019-12-01,"(1026.0, 1363.0]",2,4,-2
31244.0,2019-12-01,"(189.87, 473.5]",1,2,-1
31244.0,2019-12-01,"(473.5, 756.0]",3,4,-1
31244.0,2019-12-01,"(1038.5, 1321.0]",4,2,2
31245.0,2019-12-01,"(27.705, 352.75]",1,3,-2
31245.0,2019-12-01,"(676.5, 1000.25]",4,9,-5
31245.0,2019-12-01,"(1000.25, 1324.0]",2,6,-4
31246.0,2019-12-01,"(468.067, 702.25]",4,5,-1
31246.0,2019-12-01,"(702.25, 935.5]",2,3,-1
31246.0,2019-12-01,"(935.5, 1168.75]",5,8,-3
31246.0,2019-12-01,"(1168.75, 1402.0]",3,7,-4
31247.0,2019-12-01,"(873.0, 1017.0]",3,3,0
31247.0,2019-12-01,"(1161.0, 1305.0]",4,4,0
31248.0,2019-12-01,"(720.378, 876.5]",2,2,0
31248.0,2019-12-01,"(876.5, 1032.0]",2,5,-3
31248.0,2019-12-01,"(1187.5, 1343.0]",1,1,0
31249.0,2019-12-01,"(475.178, 681.5]",1,1,0
31249.0,2019-12-01,"(1092.5, 1298.0]",4,10,-6
,,,,2.0,
31251.0,2019-12-01,"(45.727, 365.25]",1,1,0
31251.0,2019-12-01,"(1001.75, 1320.0]",3,2,1
31252.0,2019-12-01,"(628.479, 759.25]",1,2,-1
31252.0,2019-12-01,"(759.25, 889.5]",1,1,0
31252.0,2019-12-01,"(1019.75, 1150.0]",1,2,-1
31253.0,2019-12-01,"(480.75, 641.0]",1,1,0
,,,,2.0,
,,,,1.0,
,,,,1.0,
31255.0,2019-12-01,"(389.0, 715.0]",1,1,0
31256.0,2019-12-01,"(1176.779, 1232.25]",2,2,0
31257.0,2019-12-01,"(703.75, 919.5]",1,1,0
31257.0,2019-12-01,"(919.5, 1135.25]",3,1,2
31257.0,2019-12-01,"(1135.25, 1351.0]",1,3,-2
31258.0,2019-12-01,"(648.528, 767.0]",4,7,-3
31258.0,2019-12-01,"(1003.0, 1121.0]",5,1,4
,,,,2.0,
31260.0,2019-12-01,"(1256.75, 1416.0]",2,1,1
,,,,2.0,
,,,,1.0,
,,,,1.0,
,,,,2.0,
31263.0,2019-12-01,"(1150.5, 1212.75]",2,1,1
31264.0,2019-12-01,"(661.272, 844.0]",1,2,-1
31264.0,2019-12-01,"(844.0, 1026.0]",2,2,0
31264.0,2019-12-01,"(1026.0, 1208.0]",1,1,0
31265.0,2019-12-01,"(4.602, 355.5]",1,3,-2
31265.0,2019-12-01,"(355.5, 705.0]",1,2,-1
31265.0,2019-12-01,"(705.0, 1054.5]",2,6,-4
31265.0,2019-12-01,"(1054.5, 1404.0]",3,7,-4
31266.0,2019-12-01,"(118.697, 445.75]",1,4,-3
31266.0,2019-12-01,"(445.75, 771.5]",3,6,-3
31266.0,2019-12-01,"(771.5, 1097.25]",5,10,-5
31266.0,2019-12-01,"(1097.25, 1423.0]",8,14,-6
31267.0,2019-12-01,"(618.318, 789.5]",2,3,-1
31267.0,2019-12-01,"(789.5, 960.0]",1,1,0
31267.0,2019-12-01,"(960.0, 1130.5]",1,3,-2
31268.0,2019-12-01,"(55.623, 401.25]",3,6,-3
31268.0,2019-12-01,"(401.25, 745.5]",4,5,-1
31268.0,2019-12-01,"(745.5, 1089.75]",5,8,-3
31268.0,2019-12-01,"(1089.75, 1434.0]",3,5,-2
31269.0,2019-12-01,"(586.371, 744.25]",1,2,-1
31269.0,2019-12-01,"(901.5, 1058.75]",2,2,0
31269.0,2019-12-01,"(1058.75, 1216.0]",1,1,0
31270.0,2019-12-01,"(268.993, 521.75]",1,4,-3
31270.0,2019-12-01,"(773.5, 1025.25]",1,1,0
31270.0,2019-12-01,"(1025.25, 1277.0]",3,3,0
31271.0,2019-12-01,"(735.674, 817.5]",1,1,0
31272.0,2019-12-01,"(825.75, 1094.0]",3,1,2
31273.0,2019-12-01,"(484.489, 612.75]",1,2,-1
31274.0,2019-12-01,"(564.397, 715.75]",2,2,0
31274.0,2019-12-01,"(1017.25, 1168.0]",1,1,0
31275.0,2019-12-01,"(235.865, 520.75]",1,3,-2
31275.0,2019-12-01,"(520.75, 804.5]",3,4,-1
31275.0,2019-12-01,"(804.5, 1088.25]",2,6,-4
31275.0,2019-12-01,"(1088.25, 1372.0]",2,5,-3
31276.0,2019-12-01,"(813.5, 1123.25]",1,1,0
31276.0,2019-12-01,"(1123.25, 1433.0]",2,2,0
31277.0,2019-12-01,"(280.046, 519.5]",3,3,0
31277.0,2019-12-01,"(519.5, 758.0]",1,1,0
31277.0,2019-12-01,"(758.0, 996.5]",1,1,0
31277.0,2019-12-01,"(996.5, 1235.0]",3,7,-4
31278.0,2019-12-01,"(9.6, 361.0]",2,2,0
31278.0,2019-12-01,"(361.0, 711.0]",1,2,-1
31278.0,2019-12-01,"(711.0, 1061.0]",5,8,-3
31278.0,2019-12-01,"(1061.0, 1411.0]",7,11,-4
,,,,1.0,
,,,,2.0,
,,,,1.0,
31280.0,2019-12-01,"(480.365, 639.75]",1,2,-1
31280.0,2019-12-01,"(639.75, 798.5]",2,2,0
31280.0,2019-12-01,"(957.25, 1116.0]",2,2,0
,,,,2.0,
31001.0,2019-12-02,"(996.5, 1138.0]",1,2,-1
31001.0,2019-12-02,"(1138.0, 1279.5]",1,2,-1
31001.0,2019-12-02,"(1279.5, 1421.0]",1,1,0
31002.0,2019-12-02,"(502.421, 647.75]",4,7,-3
31002.0,2019-12-02,"(937.25, 1082.0]",1,4,-3
31003.0,2019-12-02,"(378.266, 562.5]",1,5,-4
31003.0,2019-12-02,"(562.5, 746.0]",3,4,-1
31003.0,2019-12-02,"(929.5, 1113.0]",3,1,2
31004.0,2019-12-02,"(875.5, 1085.75]",1,3,-2
31004.0,2019-12-02,"(1085.75, 1296.0]",3,1,2
31005.0,2019-12-02,"(432.134, 649.5]",3,3,0
31005.0,2019-12-02,"(649.5, 866.0]",1,1,0
31005.0,2019-12-02,"(1082.5, 1299.0]",3,3,0
31006.0,2019-12-02,"(448.034, 690.5]",1,3,-2
31006.0,2019-12-02,"(690.5, 932.0]",1,1,0
31007.0,2019-12-02,"(354.148, 568.0]",6,16,-10
31007.0,2019-12-02,"(568.0, 781.0]",5,9,-4
31007.0,2019-12-02,"(994.0, 1207.0]",4,4,0
31009.0,2019-12-02,"(436.306, 610.5]",6,6,0
31009.0,2019-12-02,"(784.0, 957.5]",1,1,0
31009.0,2019-12-02,"(957.5, 1131.0]",1,2,-1
31010.0,2019-12-02,"(421.0, 620.5]",1,1,0
31010.0,2019-12-02,"(620.5, 820.0]",1,1,0
31011.0,2019-12-02,"(27.743, 343.25]",1,1,0
31011.0,2019-12-02,"(343.25, 657.5]",6,7,-1
31011.0,2019-12-02,"(657.5, 971.75]",2,3,-1
31011.0,2019-12-02,"(971.75, 1286.0]",2,8,-6
31012.0,2019-12-02,"(358.296, 535.0]",4,4,0
31012.0,2019-12-02,"(535.0, 711.0]",1,1,0
31013.0,2019-12-02,"(605.75, 773.5]",1,2,-1
31013.0,2019-12-02,"(941.25, 1109.0]",1,2,-1
31014.0,2019-12-02,"(311.993, 564.75]",19,28,-9
31014.0,2019-12-02,"(564.75, 816.5]",7,9,-2
31014.0,2019-12-02,"(816.5, 1068.25]",7,11,-4
31014.0,2019-12-02,"(1068.25, 1320.0]",4,14,-10
31015.0,2019-12-02,"(300.98, 557.0]",11,13,-2
31015.0,2019-12-02,"(812.0, 1067.0]",2,5,-3
31015.0,2019-12-02,"(1067.0, 1322.0]",1,3,-2
31016.0,2019-12-02,"(362.077, 593.75]",5,9,-4
31016.0,2019-12-02,"(593.75, 824.5]",2,4,-2
31016.0,2019-12-02,"(824.5, 1055.25]",1,1,0
31016.0,2019-12-02,"(1055.25, 1286.0]",3,6,-3
31017.0,2019-12-02,"(393.164, 603.0]",3,4,-1
31017.0,2019-12-02,"(603.0, 812.0]",1,3,-2
31017.0,2019-12-02,"(812.0, 1021.0]",1,4,-3
31017.0,2019-12-02,"(1021.0, 1230.0]",3,8,-5
31018.0,2019-12-02,"(348.997, 600.75]",1,7,-6
31018.0,2019-12-02,"(1102.25, 1353.0]",4,1,3
31019.0,2019-12-02,"(888.0, 1108.0]",1,3,-2
,,,,1.0,
,,,,1.0,
,,,,1.0,
31021.0,2019-12-02,"(496.345, 660.75]",1,5,-4
31021.0,2019-12-02,"(660.75, 824.5]",3,6,-3
31021.0,2019-12-02,"(824.5, 988.25]",1,3,-2
31021.0,2019-12-02,"(988.25, 1152.0]",2,5,-3
31022.0,2019-12-02,"(667.0, 892.0]",2,3,-1
31023.0,2019-12-02,"(430.107, 654.25]",3,7,-4
31023.0,2019-12-02,"(877.5, 1100.75]",1,2,-1
31023.0,2019-12-02,"(1100.75, 1324.0]",1,4,-3
31024.0,2019-12-02,"(424.108, 648.0]",1,5,-4
31024.0,2019-12-02,"(648.0, 871.0]",1,1,0
31024.0,2019-12-02,"(871.0, 1094.0]",1,2,-1
31024.0,2019-12-02,"(1094.0, 1317.0]",2,3,-1
31025.0,2019-12-02,"(993.25, 1018.0]",1,2,-1
31026.0,2019-12-02,"(821.5, 1094.0]",1,1,0
31027.0,2019-12-02,"(1083.5, 1145.0]",1,1,0
31027.0,2019-12-02,"(1145.0, 1206.5]",1,1,0
31028.0,2019-12-02,"(637.0, 870.0]",1,1,0
31028.0,2019-12-02,"(1103.0, 1336.0]",1,1,0
31029.0,2019-12-02,"(857.0, 1063.5]",2,7,-5
31029.0,2019-12-02,"(1063.5, 1270.0]",5,2,3
31030.0,2019-12-02,"(169.787, 474.25]",1,2,-1
31030.0,2019-12-02,"(777.5, 1080.75]",5,6,-1
31030.0,2019-12-02,"(1080.75, 1384.0]",5,7,-2
31031.0,2019-12-02,"(359.013, 606.75]",1,7,-6
31031.0,2019-12-02,"(606.75, 853.5]",1,2,-1
31031.0,2019-12-02,"(853.5, 1100.25]",3,3,0
31031.0,2019-12-02,"(1100.25, 1347.0]",3,4,-1
31032.0,2019-12-02,"(994.0, 1168.0]",2,1,1
31033.0,2019-12-02,"(401.25, 535.0]",1,1,0
31034.0,2019-12-02,"(501.542, 616.5]",4,6,-2
31034.0,2019-12-02,"(845.5, 960.0]",1,3,-2
31035.0,2019-12-02,"(321.906, 596.5]",1,4,-3
31035.0,2019-12-02,"(870.0, 1143.5]",4,6,-2
31035.0,2019-12-02,"(1143.5, 1417.0]",2,4,-2
31036.0,2019-12-02,"(467.248, 656.0]",3,8,-5
31036.0,2019-12-02,"(656.0, 844.0]",1,1,0
31036.0,2019-12-02,"(844.0, 1032.0]",2,4,-2
31036.0,2019-12-02,"(1032.0, 1220.0]",4,5,-1
31037.0,2019-12-02,"(404.063, 639.25]",13,20,-7
31037.0,2019-12-02,"(639.25, 873.5]",2,3,-1
31037.0,2019-12-02,"(873.5, 1107.75]",3,14,-11
31038.0,2019-12-02,"(494.149, 707.75]",3,5,-2
31038.0,2019-12-02,"(707.75, 920.5]",1,2,-1
31038.0,2019-12-02,"(1133.25, 1346.0]",1,1,0
31039.0,2019-12-02,"(452.222, 647.5]",2,5,-3
31039.0,2019-12-02,"(1036.5, 1231.0]",2,1,1
31040.0,2019-12-02,"(451.13, 669.5]",2,2,0
31041.0,2019-12-02,"(520.622, 615.5]",3,3,0
31042.0,2019-12-02,"(397.145, 611.75]",7,9,-2
31042.0,2019-12-02,"(1039.25, 1253.0]",3,9,-6
31043.0,2019-12-02,"(411.387, 565.25]",2,3,-1
31043.0,2019-12-02,"(871.75, 1025.0]",1,3,-2
31044.0,2019-12-02,"(550.5, 576.0]",1,2,-1
31045.0,2019-12-02,"(495.167, 704.25]",1,3,-2
31045.0,2019-12-02,"(912.5, 1120.75]",2,3,-1
31045.0,2019-12-02,"(1120.75, 1329.0]",1,1,0
31046.0,2019-12-02,"(394.336, 561.0]",1,4,-3
31046.0,2019-12-02,"(893.0, 1059.0]",1,1,0
31047.0,2019-12-02,"(363.127, 582.25]",11,17,-6
31047.0,2019-12-02,"(582.25, 800.5]",2,2,0
31047.0,2019-12-02,"(1018.75, 1237.0]",3,2,1
31048.0,2019-12-02,"(635.25, 872.5]",1,1,0
31048.0,2019-12-02,"(872.5, 1109.75]",6,3,3
31048.0,2019-12-02,"(1109.75, 1347.0]",1,8,-7
31049.0,2019-12-02,"(428.101, 653.75]",2,2,0
31049.0,2019-12-02,"(1103.25, 1328.0]",2,1,1
31050.0,2019-12-02,"(334.468, 468.0]",1,1,0
31051.0,2019-12-02,"(298.158, 509.5]",1,6,-5
31051.0,2019-12-02,"(930.5, 1141.0]",5,2,3
31052.0,2019-12-02,"(393.179, 599.25]",4,6,-2
31052.0,2019-12-02,"(804.5, 1009.75]",1,1,0
31052.0,2019-12-02,"(1009.75, 1215.0]",2,3,-1
,,,,1.0,
,,,,1.0,
,,,,1.0,
,,,,2.0,
31055.0,2019-12-02,"(492.346, 656.5]",1,2,-1
31055.0,2019-12-02,"(983.5, 1147.0]",2,2,0
31056.0,2019-12-02,"(932.75, 1080.0]",1,2,-1
31057.0,2019-12-02,"(375.75, 501.0]",1,1,0
31058.0,2019-12-02,"(712.5, 950.0]",1,1,0
31059.0,2019-12-02,"(887.25, 1044.0]",2,1,1
,,,,2.0,
,,,,2.0,
31062.0,2019-12-02,"(502.344, 667.0]",1,2,-1
31062.0,2019-12-02,"(831.0, 995.0]",1,1,0
31062.0,2019-12-02,"(995.0, 1159.0]",2,2,0
,,,,2.0,
31064.0,2019-12-02,"(864.75, 980.0]",1,2,-1
31065.0,2019-12-02,"(835.0, 965.0]",2,1,1
31066.0,2019-12-02,"(1033.25, 1224.0]",1,1,0
31067.0,2019-12-02,"(487.05, 725.5]",1,2,-1
31067.0,2019-12-02,"(963.0, 1200.5]",2,4,-2
31067.0,2019-12-02,"(1200.5, 1438.0]",2,4,-2
31068.0,2019-12-02,"(536.176, 743.0]",1,2,-1
31068.0,2019-12-02,"(1155.0, 1361.0]",2,2,0
31069.0,2019-12-02,"(397.255, 584.25]",2,10,-8
31069.0,2019-12-02,"(770.5, 956.75]",3,1,2
31069.0,2019-12-02,"(956.75, 1143.0]",4,3,1
31070.0,2019-12-02,"(599.212, 797.0]",1,3,-2
31070.0,2019-12-02,"(1191.0, 1388.0]",3,1,2
31071.0,2019-12-02,"(397.213, 594.75]",2,4,-2
31071.0,2019-12-02,"(594.75, 791.5]",2,2,0
31071.0,2019-12-02,"(988.25, 1185.0]",4,6,-2
31072.0,2019-12-02,"(363.0, 484.0]",1,1,0
31073.0,2019-12-02,"(499.826, 543.5]",2,3,-1
31073.0,2019-12-02,"(630.5, 674.0]",1,1,0
31074.0,2019-12-02,"(485.362, 645.5]",1,5,-4
31074.0,2019-12-02,"(964.5, 1124.0]",3,5,-2
,,,,2.0,
31076.0,2019-12-02,"(423.388, 577.0]",1,2,-1
31077.0,2019-12-02,"(547.203, 747.25]",4,7,-3
31077.0,2019-12-02,"(946.5, 1145.75]",2,2,0
31077.0,2019-12-02,"(1145.75, 1345.0]",2,2,0
31078.0,2019-12-02,"(465.384, 620.0]",3,4,-1
31078.0,2019-12-02,"(928.0, 1082.0]",1,3,-2
31079.0,2019-12-02,"(406.002, 656.5]",1,8,-7
31079.0,2019-12-02,"(906.0, 1155.5]",2,1,1
31079.0,2019-12-02,"(1155.5, 1405.0]",5,2,3
31080.0,2019-12-02,"(855.5, 1128.75]",2,7,-5
31080.0,2019-12-02,"(1128.75, 1402.0]",7,1,6
31081.0,2019-12-02,"(483.351, 646.25]",2,2,0
31081.0,2019-12-02,"(808.5, 970.75]",1,1,0
31081.0,2019-12-02,"(970.75, 1133.0]",2,6,-4
,,,,1.0,
,,,,1.0,
31083.0,2019-12-02,"(778.5, 920.25]",1,2,-1
31083.0,2019-12-02,"(920.25, 1062.0]",3,1,2
31084.0,2019-12-02,"(401.013, 648.75]",1,1,0
31084.0,2019-12-02,"(648.75, 895.5]",3,4,-1
31084.0,2019-12-02,"(895.5, 1142.25]",1,5,-4
31084.0,2019-12-02,"(1142.25, 1389.0]",1,4,-3
31085.0,2019-12-02,"(399.24, 590.0]",1,3,-2
31085.0,2019-12-02,"(970.0, 1160.0]",1,1,0
,,,,1.0,
,,,,2.0,
31087.0,2019-12-02,"(566.0, 725.0]",1,3,-2
31087.0,2019-12-02,"(884.0, 1043.0]",1,1,0
31088.0,2019-12-02,"(861.5, 1037.25]",2,4,-2
31088.0,2019-12-02,"(1037.25, 1213.0]",3,2,1
31089.0,2019-12-02,"(163.835, 456.25]",1,3,-2
31089.0,2019-12-02,"(456.25, 747.5]",9,12,-3
31089.0,2019-12-02,"(747.5, 1038.75]",3,12,-9
31089.0,2019-12-02,"(1038.75, 1330.0]",2,16,-14
,,,,2.0,
31091.0,2019-12-02,"(363.192, 566.0]",1,5,-4
31091.0,2019-12-02,"(566.0, 768.0]",1,3,-2
31091.0,2019-12-02,"(970.0, 1172.0]",5,6,-1
31092.0,2019-12-02,"(955.25, 1119.0]",1,1,0
,,,,1.0,
,,,,3.0,
,,,,1.0,
,,,,1.0,
,,,,1.0,
,,,,2.0,
31096.0,2019-12-02,"(577.5, 866.25]",1,1,0
31096.0,2019-12-02,"(866.25, 1155.0]",1,1,0
31097.0,2019-12-02,"(536.475, 668.25]",1,1,0
31098.0,2019-12-02,"(437.08, 668.0]",8,13,-5
31098.0,2019-12-02,"(668.0, 898.0]",1,1,0
31098.0,2019-12-02,"(898.0, 1128.0]",5,9,-4
31098.0,2019-12-02,"(1128.0, 1358.0]",2,3,-1
31099.0,2019-12-02,"(965.75, 1137.0]",2,1,1
31100.0,2019-12-02,"(473.255, 660.25]",13,14,-1
31100.0,2019-12-02,"(846.5, 1032.75]",2,6,-4
31101.0,2019-12-02,"(321.896, 599.0]",9,37,-28
31101.0,2019-12-02,"(599.0, 875.0]",5,12,-7
31101.0,2019-12-02,"(875.0, 1151.0]",34,49,-15
31101.0,2019-12-02,"(1151.0, 1427.0]",9,16,-7
31102.0,2019-12-02,"(282.939, 549.25]",1,14,-13
31102.0,2019-12-02,"(814.5, 1079.75]",3,2,1
31102.0,2019-12-02,"(1079.75, 1345.0]",7,7,0
31103.0,2019-12-02,"(311.009, 559.75]",1,33,-32
31103.0,2019-12-02,"(559.75, 807.5]",1,15,-14
31103.0,2019-12-02,"(807.5, 1055.25]",6,13,-7
31103.0,2019-12-02,"(1055.25, 1303.0]",8,18,-10
31104.0,2019-12-02,"(6.584, 362.0]",1,3,-2
31104.0,2019-12-02,"(362.0, 716.0]",3,13,-10
31104.0,2019-12-02,"(716.0, 1070.0]",3,6,-3
31104.0,2019-12-02,"(1070.0, 1424.0]",15,22,-7
31105.0,2019-12-02,"(349.045, 588.75]",2,9,-7
31105.0,2019-12-02,"(827.5, 1066.25]",1,2,-1
31105.0,2019-12-02,"(1066.25, 1305.0]",5,5,0
31106.0,2019-12-02,"(451.305, 625.75]",2,9,-7
31106.0,2019-12-02,"(973.25, 1147.0]",2,1,1
31107.0,2019-12-02,"(419.108, 643.0]",3,21,-18
31107.0,2019-12-02,"(643.0, 866.0]",1,3,-2
31107.0,2019-12-02,"(866.0, 1089.0]",5,13,-8
31107.0,2019-12-02,"(1089.0, 1312.0]",9,12,-3
31108.0,2019-12-02,"(40.74, 357.0]",1,1,0
31108.0,2019-12-02,"(357.0, 672.0]",6,22,-16
31108.0,2019-12-02,"(672.0, 987.0]",7,13,-6
31108.0,2019-12-02,"(987.0, 1302.0]",32,45,-13
31109.0,2019-12-02,"(318.993, 571.75]",5,10,-5
31109.0,2019-12-02,"(571.75, 823.5]",2,3,-1
31109.0,2019-12-02,"(823.5, 1075.25]",5,8,-3
31109.0,2019-12-02,"(1075.25, 1327.0]",8,11,-3
31110.0,2019-12-02,"(314.911, 588.25]",11,33,-22
31110.0,2019-12-02,"(588.25, 860.5]",6,12,-6
31110.0,2019-12-02,"(860.5, 1132.75]",14,27,-13
31110.0,2019-12-02,"(1132.75, 1405.0]",10,19,-9
31111.0,2019-12-02,"(381.011, 629.25]",3,17,-14
31111.0,2019-12-02,"(876.5, 1123.75]",10,3,7
31111.0,2019-12-02,"(1123.75, 1371.0]",10,15,-5
31112.0,2019-12-02,"(372.259, 558.25]",1,3,-2
31112.0,2019-12-02,"(928.75, 1114.0]",4,1,3
31113.0,2019-12-02,"(593.75, 870.5]",1,11,-10
31113.0,2019-12-02,"(870.5, 1147.25]",5,7,-2
31113.0,2019-12-02,"(1147.25, 1424.0]",2,10,-8
31114.0,2019-12-02,"(350.987, 605.25]",5,27,-22
31114.0,2019-12-02,"(605.25, 858.5]",1,4,-3
31114.0,2019-12-02,"(858.5, 1111.75]",12,20,-8
31114.0,2019-12-02,"(1111.75, 1365.0]",15,24,-9
31115.0,2019-12-02,"(340.996, 593.0]",1,15,-14
31115.0,2019-12-02,"(844.0, 1095.0]",7,1,6
31115.0,2019-12-02,"(1095.0, 1346.0]",8,10,-2
31116.0,2019-12-02,"(27.658, 364.5]",1,1,0
31116.0,2019-12-02,"(364.5, 700.0]",5,26,-21
31116.0,2019-12-02,"(700.0, 1035.5]",6,8,-2
31116.0,2019-12-02,"(1035.5, 1371.0]",16,20,-4
31117.0,2019-12-02,"(312.966, 572.5]",1,19,-18
31117.0,2019-12-02,"(572.5, 831.0]",2,6,-4
31117.0,2019-12-02,"(831.0, 1089.5]",4,9,-5
31117.0,2019-12-02,"(1089.5, 1348.0]",12,19,-7
31118.0,2019-12-02,"(417.104, 642.0]",1,8,-7
31118.0,2019-12-02,"(866.0, 1090.0]",9,4,5
31118.0,2019-12-02,"(1090.0, 1314.0]",7,13,-6
31119.0,2019-12-02,"(343.916, 616.0]",11,30,-19
31119.0,2019-12-02,"(616.0, 887.0]",2,5,-3
31119.0,2019-12-02,"(887.0, 1158.0]",15,22,-7
31119.0,2019-12-02,"(1158.0, 1429.0]",10,18,-8
31120.0,2019-12-02,"(362.75, 692.5]",3,1,2
31120.0,2019-12-02,"(692.5, 1022.25]",2,19,-17
31120.0,2019-12-02,"(1022.25, 1352.0]",12,5,7
31121.0,2019-12-02,"(356.074, 588.5]",15,22,-7
31121.0,2019-12-02,"(588.5, 820.0]",1,1,0
31121.0,2019-12-02,"(820.0, 1051.5]",3,6,-3
31121.0,2019-12-02,"(1051.5, 1283.0]",4,9,-5
31122.0,2019-12-02,"(436.138, 652.5]",1,7,-6
31122.0,2019-12-02,"(652.5, 868.0]",2,2,0
31122.0,2019-12-02,"(868.0, 1083.5]",3,5,-2
31122.0,2019-12-02,"(1083.5, 1299.0]",3,7,-4
31123.0,2019-12-02,"(632.0, 901.0]",1,19,-18
31123.0,2019-12-02,"(901.0, 1170.0]",6,3,3
31123.0,2019-12-02,"(1170.0, 1439.0]",3,11,-8
31124.0,2019-12-02,"(402.006, 651.5]",18,41,-23
31124.0,2019-12-02,"(651.5, 900.0]",3,7,-4
31124.0,2019-12-02,"(900.0, 1148.5]",19,42,-23
31124.0,2019-12-02,"(1148.5, 1397.0]",9,24,-15
31125.0,2019-12-02,"(370.0, 715.0]",6,2,4
31125.0,2019-12-02,"(715.0, 1060.0]",13,24,-11
31125.0,2019-12-02,"(1060.0, 1405.0]",16,17,-1
31126.0,2019-12-02,"(339.971, 598.25]",4,19,-15
31126.0,2019-12-02,"(855.5, 1112.75]",16,1,15
31126.0,2019-12-02,"(1112.75, 1370.0]",14,20,-6
,,,,2.0,
31128.0,2019-12-02,"(-1.309, 327.25]",1,2,-1
31128.0,2019-12-02,"(327.25, 654.5]",20,29,-9
31128.0,2019-12-02,"(654.5, 981.75]",8,14,-6
31128.0,2019-12-02,"(981.75, 1309.0]",9,23,-14
31129.0,2019-12-02,"(407.335, 574.25]",12,12,0
31129.0,2019-12-02,"(574.25, 740.5]",3,4,-1
31129.0,2019-12-02,"(740.5, 906.75]",5,10,-5
31129.0,2019-12-02,"(906.75, 1073.0]",4,8,-4
31130.0,2019-12-02,"(372.083, 602.25]",3,17,-14
31130.0,2019-12-02,"(602.25, 831.5]",1,2,-1
31130.0,2019-12-02,"(831.5, 1060.75]",4,6,-2
31130.0,2019-12-02,"(1060.75, 1290.0]",8,13,-5
31131.0,2019-12-02,"(432.221, 627.75]",1,11,-10
31131.0,2019-12-02,"(627.75, 822.5]",1,2,-1
31131.0,2019-12-02,"(822.5, 1017.25]",1,6,-5
31131.0,2019-12-02,"(1017.25, 1212.0]",6,7,-1
31200.0,2019-12-02,"(373.994, 626.5]",23,33,-10
31200.0,2019-12-02,"(626.5, 878.0]",1,3,-2
31200.0,2019-12-02,"(878.0, 1129.5]",15,36,-21
31200.0,2019-12-02,"(1129.5, 1381.0]",15,23,-8
31201.0,2019-12-02,"(294.912, 568.0]",12,35,-23
31201.0,2019-12-02,"(568.0, 840.0]",10,16,-6
31201.0,2019-12-02,"(840.0, 1112.0]",39,62,-23
31201.0,2019-12-02,"(1112.0, 1384.0]",25,50,-25
31202.0,2019-12-02,"(337.02, 583.0]",7,23,-16
31202.0,2019-12-02,"(583.0, 828.0]",7,16,-9
31202.0,2019-12-02,"(828.0, 1073.0]",17,27,-10
31202.0,2019-12-02,"(1073.0, 1318.0]",10,22,-12
31203.0,2019-12-02,"(8.6, 360.0]",2,3,-1
31203.0,2019-12-02,"(360.0, 710.0]",4,23,-19
31203.0,2019-12-02,"(710.0, 1060.0]",15,21,-6
31203.0,2019-12-02,"(1060.0, 1410.0]",14,25,-11
31204.0,2019-12-02,"(463.07, 696.5]",11,14,-3
31204.0,2019-12-02,"(696.5, 929.0]",3,5,-2
31204.0,2019-12-02,"(929.0, 1161.5]",1,12,-11
31204.0,2019-12-02,"(1161.5, 1394.0]",1,2,-1
31205.0,2019-12-02,"(400.25, 692.5]",29,2,27
31205.0,2019-12-02,"(692.5, 984.75]",12,34,-22
31205.0,2019-12-02,"(984.75, 1277.0]",11,16,-5
31206.0,2019-12-02,"(451.112, 674.0]",3,5,-2
31206.0,2019-12-02,"(674.0, 896.0]",1,2,-1
31206.0,2019-12-02,"(896.0, 1118.0]",3,6,-3
31207.0,2019-12-02,"(479.043, 719.25]",3,10,-7
31207.0,2019-12-02,"(958.5, 1197.75]",2,1,1
31207.0,2019-12-02,"(1197.75, 1437.0]",5,7,-2
31208.0,2019-12-02,"(322.18, 528.0]",11,12,-1
31208.0,2019-12-02,"(733.0, 938.0]",1,2,-1
31208.0,2019-12-02,"(938.0, 1143.0]",3,10,-7
31209.0,2019-12-02,"(392.329, 560.75]",2,2,0
31209.0,2019-12-02,"(560.75, 728.5]",2,3,-1
31209.0,2019-12-02,"(896.25, 1064.0]",3,4,-1
31211.0,2019-12-02,"(413.052, 651.0]",3,5,-2
31211.0,2019-12-02,"(651.0, 888.0]",1,5,-4
31211.0,2019-12-02,"(888.0, 1125.0]",6,10,-4
31211.0,2019-12-02,"(1125.0, 1362.0]",1,2,-1
31212.0,2019-12-02,"(321.013, 568.75]",19,30,-11
31212.0,2019-12-02,"(568.75, 815.5]",5,9,-4
31212.0,2019-12-02,"(815.5, 1062.25]",10,21,-11
31212.0,2019-12-02,"(1062.25, 1309.0]",9,22,-13
31213.0,2019-12-02,"(367.067, 601.25]",27,42,-15
31213.0,2019-12-02,"(601.25, 834.5]",10,13,-3
31213.0,2019-12-02,"(834.5, 1067.75]",14,25,-11
31213.0,2019-12-02,"(1067.75, 1301.0]",8,24,-16
31214.0,2019-12-02,"(80.698, 407.5]",2,6,-4
31214.0,2019-12-02,"(407.5, 733.0]",13,38,-25
31214.0,2019-12-02,"(733.0, 1058.5]",17,34,-17
31214.0,2019-12-02,"(1058.5, 1384.0]",18,23,-5
31215.0,2019-12-02,"(396.074, 628.5]",16,17,-1
31215.0,2019-12-02,"(628.5, 860.0]",4,5,-1
31215.0,2019-12-02,"(860.0, 1091.5]",7,14,-7
31215.0,2019-12-02,"(1091.5, 1323.0]",2,7,-5
31216.0,2019-12-02,"(307.929, 576.75]",15,15,0
31216.0,2019-12-02,"(844.5, 1112.25]",4,3,1
31216.0,2019-12-02,"(1112.25, 1380.0]",3,17,-14
31217.0,2019-12-02,"(352.313, 524.75]",12,13,-1
31217.0,2019-12-02,"(524.75, 696.5]",3,5,-2
31217.0,2019-12-02,"(696.5, 868.25]",1,1,0
31217.0,2019-12-02,"(868.25, 1040.0]",2,13,-11
31218.0,2019-12-02,"(346.914, 619.5]",11,25,-14
31218.0,2019-12-02,"(891.0, 1162.5]",10,1,9
31219.0,2019-12-02,"(460.213, 657.75]",13,15,-2
31219.0,2019-12-02,"(657.75, 854.5]",2,3,-1
31219.0,2019-12-02,"(854.5, 1051.25]",2,10,-8
31219.0,2019-12-02,"(1051.25, 1248.0]",1,6,-5
31220.0,2019-12-02,"(308.031, 551.25]",16,20,-4
31220.0,2019-12-02,"(793.5, 1035.75]",2,2,0
31220.0,2019-12-02,"(1035.75, 1278.0]",1,8,-7
31221.0,2019-12-02,"(453.108, 677.0]",28,30,-2
31221.0,2019-12-02,"(677.0, 900.0]",4,6,-2
31221.0,2019-12-02,"(900.0, 1123.0]",10,34,-24
31221.0,2019-12-02,"(1123.0, 1346.0]",4,8,-4
31222.0,2019-12-02,"(408.035, 650.25]",22,26,-4
31222.0,2019-12-02,"(891.5, 1132.75]",2,13,-11
31222.0,2019-12-02,"(1132.75, 1374.0]",1,5,-4
31223.0,2019-12-02,"(2.598, 354.5]",1,3,-2
31223.0,2019-12-02,"(354.5, 705.0]",12,27,-15
31223.0,2019-12-02,"(705.0, 1055.5]",6,17,-11
31223.0,2019-12-02,"(1055.5, 1406.0]",11,19,-8
31224.0,2019-12-02,"(331.188, 535.0]",13,13,0
31224.0,2019-12-02,"(535.0, 738.0]",4,4,0
31224.0,2019-12-02,"(738.0, 941.0]",4,7,-3
31224.0,2019-12-02,"(941.0, 1144.0]",4,14,-10
31225.0,2019-12-02,"(477.053, 714.75]",13,20,-7
31225.0,2019-12-02,"(714.75, 951.5]",1,2,-1
31225.0,2019-12-02,"(951.5, 1188.25]",3,14,-11
31225.0,2019-12-02,"(1188.25, 1425.0]",2,4,-2
31226.0,2019-12-02,"(456.206, 655.5]",2,8,-6
31226.0,2019-12-02,"(655.5, 854.0]",1,4,-3
31226.0,2019-12-02,"(854.0, 1052.5]",2,6,-4
31226.0,2019-12-02,"(1052.5, 1251.0]",6,9,-3
31227.0,2019-12-02,"(410.285, 589.75]",40,44,-4
31227.0,2019-12-02,"(589.75, 768.5]",6,8,-2
31227.0,2019-12-02,"(768.5, 947.25]",4,9,-5
31227.0,2019-12-02,"(947.25, 1126.0]",3,12,-9
31228.0,2019-12-02,"(4.582, 360.5]",5,5,0
31228.0,2019-12-02,"(360.5, 715.0]",20,26,-6
31228.0,2019-12-02,"(715.0, 1069.5]",14,28,-14
31228.0,2019-12-02,"(1069.5, 1424.0]",7,18,-11
31229.0,2019-12-02,"(348.95, 612.5]",11,41,-30
31229.0,2019-12-02,"(612.5, 875.0]",5,16,-11
31229.0,2019-12-02,"(875.0, 1137.5]",28,43,-15
31229.0,2019-12-02,"(1137.5, 1400.0]",8,18,-10
31230.0,2019-12-02,"(371.2, 572.0]",41,50,-9
31230.0,2019-12-02,"(572.0, 772.0]",11,15,-4
31230.0,2019-12-02,"(772.0, 972.0]",5,7,-2
31230.0,2019-12-02,"(972.0, 1172.0]",10,43,-33
31231.0,2019-12-02,"(372.959, 634.25]",18,22,-4
31231.0,2019-12-02,"(634.25, 894.5]",4,5,-1
31231.0,2019-12-02,"(894.5, 1154.75]",6,15,-9
31232.0,2019-12-02,"(331.974, 589.5]",17,23,-6
31232.0,2019-12-02,"(589.5, 846.0]",4,6,-2
31232.0,2019-12-02,"(846.0, 1102.5]",10,16,-6
31232.0,2019-12-02,"(1102.5, 1359.0]",4,9,-5
31233.0,2019-12-02,"(371.024, 616.0]",35,42,-7
31233.0,2019-12-02,"(616.0, 860.0]",2,4,-2
31233.0,2019-12-02,"(860.0, 1104.0]",7,16,-9
31233.0,2019-12-02,"(1104.0, 1348.0]",4,7,-3
31234.0,2019-12-02,"(374.0, 728.0]",13,1,12
31234.0,2019-12-02,"(728.0, 1082.0]",16,30,-14
31234.0,2019-12-02,"(1082.0, 1436.0]",8,26,-18
31235.0,2019-12-02,"(449.119, 670.25]",4,5,-1
31235.0,2019-12-02,"(670.25, 890.5]",1,2,-1
31235.0,2019-12-02,"(890.5, 1110.75]",5,12,-7
31235.0,2019-12-02,"(1110.75, 1331.0]",1,2,-1
31236.0,2019-12-02,"(461.124, 681.0]",20,23,-3
31236.0,2019-12-02,"(681.0, 900.0]",3,7,-4
31236.0,2019-12-02,"(900.0, 1119.0]",9,23,-14
31236.0,2019-12-02,"(1119.0, 1338.0]",2,16,-14
31237.0,2019-12-02,"(439.088, 668.0]",5,11,-6
31237.0,2019-12-02,"(668.0, 896.0]",5,9,-4
31237.0,2019-12-02,"(896.0, 1124.0]",11,17,-6
31237.0,2019-12-02,"(1124.0, 1352.0]",8,14,-6
31238.0,2019-12-02,"(56.865, 341.75]",1,1,0
31238.0,2019-12-02,"(341.75, 625.5]",7,9,-2
31238.0,2019-12-02,"(625.5, 909.25]",2,4,-2
31238.0,2019-12-02,"(909.25, 1193.0]",5,31,-26
31239.0,2019-12-02,"(230.046, 469.5]",9,10,-1
31239.0,2019-12-02,"(469.5, 708.0]",24,27,-3
31239.0,2019-12-02,"(708.0, 946.5]",9,11,-2
31239.0,2019-12-02,"(946.5, 1185.0]",8,31,-23
31240.0,2019-12-02,"(995.5, 1162.0]",1,1,0
31241.0,2019-12-02,"(297.926, 567.5]",18,37,-19
31241.0,2019-12-02,"(567.5, 836.0]",7,11,-4
31241.0,2019-12-02,"(836.0, 1104.5]",10,25,-15
31241.0,2019-12-02,"(1104.5, 1373.0]",10,26,-16
31242.0,2019-12-02,"(397.048, 636.0]",33,34,-1
31242.0,2019-12-02,"(636.0, 874.0]",10,13,-3
31242.0,2019-12-02,"(874.0, 1112.0]",1,25,-24
31243.0,2019-12-02,"(375.996, 628.0]",25,33,-8
31243.0,2019-12-02,"(628.0, 879.0]",1,5,-4
31243.0,2019-12-02,"(879.0, 1130.0]",5,20,-15
31243.0,2019-12-02,"(1130.0, 1381.0]",1,3,-2
31244.0,2019-12-02,"(352.025, 596.75]",18,29,-11
31244.0,2019-12-02,"(596.75, 840.5]",2,7,-5
31244.0,2019-12-02,"(840.5, 1084.25]",7,19,-12
31244.0,2019-12-02,"(1084.25, 1328.0]",7,9,-2
31245.0,2019-12-02,"(382.058, 618.5]",7,23,-16
31245.0,2019-12-02,"(618.5, 854.0]",2,5,-3
31245.0,2019-12-02,"(854.0, 1089.5]",7,15,-8
31245.0,2019-12-02,"(1089.5, 1325.0]",11,20,-9
31246.0,2019-12-02,"(389.953, 652.75]",13,23,-10
31246.0,2019-12-02,"(652.75, 914.5]",8,14,-6
31246.0,2019-12-02,"(914.5, 1176.25]",13,22,-9
31246.0,2019-12-02,"(1176.25, 1438.0]",5,9,-4
31247.0,2019-12-02,"(437.156, 649.0]",8,11,-3
31247.0,2019-12-02,"(860.0, 1071.0]",9,16,-7
31247.0,2019-12-02,"(1071.0, 1282.0]",1,3,-2
31248.0,2019-12-02,"(352.082, 582.5]",9,13,-4
31248.0,2019-12-02,"(582.5, 812.0]",4,7,-3
31248.0,2019-12-02,"(812.0, 1041.5]",3,6,-3
31248.0,2019-12-02,"(1041.5, 1271.0]",3,6,-3
31249.0,2019-12-02,"(421.315, 593.25]",8,13,-5
31249.0,2019-12-02,"(593.25, 764.5]",4,8,-4
31249.0,2019-12-02,"(935.75, 1107.0]",1,2,-1
31250.0,2019-12-02,"(464.096, 691.0]",16,19,-3
31250.0,2019-12-02,"(691.0, 917.0]",1,4,-3
31250.0,2019-12-02,"(917.0, 1143.0]",2,19,-17
31250.0,2019-12-02,"(1143.0, 1369.0]",3,4,-1
31251.0,2019-12-02,"(66.671, 400.25]",1,3,-2
31251.0,2019-12-02,"(400.25, 732.5]",24,41,-17
31251.0,2019-12-02,"(732.5, 1064.75]",6,20,-14
31251.0,2019-12-02,"(1064.75, 1397.0]",11,20,-9
31252.0,2019-12-02,"(492.386, 646.5]",13,14,-1
31252.0,2019-12-02,"(646.5, 800.0]",5,10,-5
31252.0,2019-12-02,"(800.0, 953.5]",2,5,-3
31252.0,2019-12-02,"(953.5, 1107.0]",3,14,-11
31253.0,2019-12-02,"(392.096, 619.0]",19,20,-1
31253.0,2019-12-02,"(619.0, 845.0]",3,3,0
31253.0,2019-12-02,"(845.0, 1071.0]",5,13,-8
31253.0,2019-12-02,"(1071.0, 1297.0]",3,14,-11
31254.0,2019-12-02,"(296.261, 481.75]",6,8,-2
31254.0,2019-12-02,"(481.75, 666.5]",13,13,0
31254.0,2019-12-02,"(851.25, 1036.0]",3,14,-11
31255.0,2019-12-02,"(371.075, 603.25]",20,26,-6
31255.0,2019-12-02,"(603.25, 834.5]",2,5,-3
31255.0,2019-12-02,"(834.5, 1065.75]",5,14,-9
31255.0,2019-12-02,"(1065.75, 1297.0]",4,8,-4
31256.0,2019-12-02,"(270.062, 505.5]",5,6,-1
31256.0,2019-12-02,"(505.5, 740.0]",6,6,0
31256.0,2019-12-02,"(740.0, 974.5]",3,5,-2
31256.0,2019-12-02,"(974.5, 1209.0]",2,9,-7
31257.0,2019-12-02,"(321.897, 598.75]",11,20,-9
31257.0,2019-12-02,"(598.75, 874.5]",4,9,-5
31257.0,2019-12-02,"(874.5, 1150.25]",12,29,-17
31257.0,2019-12-02,"(1150.25, 1426.0]",3,14,-11
31258.0,2019-12-02,"(508.302, 683.5]",2,9,-7
31258.0,2019-12-02,"(858.0, 1032.5]",1,1,0
31258.0,2019-12-02,"(1032.5, 1207.0]",4,3,1
31259.0,2019-12-02,"(459.425, 603.75]",12,12,0
31259.0,2019-12-02,"(747.5, 891.25]",1,3,-2
31259.0,2019-12-02,"(891.25, 1035.0]",2,6,-4
31260.0,2019-12-02,"(351.053, 588.75]",12,16,-4
31260.0,2019-12-02,"(588.75, 825.5]",1,2,-1
31260.0,2019-12-02,"(825.5, 1062.25]",4,14,-10
31260.0,2019-12-02,"(1062.25, 1299.0]",2,10,-8
31261.0,2019-12-02,"(413.122, 633.5]",12,12,0
31261.0,2019-12-02,"(633.5, 853.0]",1,1,0
31261.0,2019-12-02,"(853.0, 1072.5]",1,7,-6
31261.0,2019-12-02,"(1072.5, 1292.0]",1,2,-1
31262.0,2019-12-02,"(424.138, 640.5]",11,13,-2
31262.0,2019-12-02,"(640.5, 856.0]",2,2,0
31262.0,2019-12-02,"(856.0, 1071.5]",2,6,-4
31262.0,2019-12-02,"(1071.5, 1287.0]",5,13,-8
31263.0,2019-12-02,"(362.102, 587.5]",22,32,-10
31263.0,2019-12-02,"(587.5, 812.0]",2,5,-3
31263.0,2019-12-02,"(812.0, 1036.5]",8,18,-10
31263.0,2019-12-02,"(1036.5, 1261.0]",6,18,-12
31264.0,2019-12-02,"(456.068, 690.0]",13,16,-3
31264.0,2019-12-02,"(690.0, 923.0]",1,2,-1
31264.0,2019-12-02,"(923.0, 1156.0]",3,12,-9
31265.0,2019-12-02,"(114.829, 408.75]",3,5,-2
31265.0,2019-12-02,"(408.75, 701.5]",12,29,-17
31265.0,2019-12-02,"(701.5, 994.25]",2,7,-5
31265.0,2019-12-02,"(994.25, 1287.0]",24,33,-9
31266.0,2019-12-02,"(10.73, 329.5]",1,5,-4
31266.0,2019-12-02,"(329.5, 647.0]",6,27,-21
31266.0,2019-12-02,"(647.0, 964.5]",4,13,-9
31266.0,2019-12-02,"(964.5, 1282.0]",26,43,-17
31267.0,2019-12-02,"(368.984, 624.0]",17,34,-17
31267.0,2019-12-02,"(624.0, 878.0]",6,11,-5
31267.0,2019-12-02,"(878.0, 1132.0]",14,26,-12
31267.0,2019-12-02,"(1132.0, 1386.0]",11,26,-15
31268.0,2019-12-02,"(398.047, 637.25]",12,32,-20
31268.0,2019-12-02,"(637.25, 875.5]",3,4,-1
31268.0,2019-12-02,"(875.5, 1113.75]",15,21,-6
31268.0,2019-12-02,"(1113.75, 1352.0]",15,22,-7
31269.0,2019-12-02,"(360.052, 598.0]",5,11,-6
31269.0,2019-12-02,"(598.0, 835.0]",3,4,-1
31269.0,2019-12-02,"(835.0, 1072.0]",2,7,-5
31269.0,2019-12-02,"(1072.0, 1309.0]",8,13,-5
31270.0,2019-12-02,"(351.169, 559.75]",10,14,-4
31270.0,2019-12-02,"(559.75, 767.5]",4,5,-1
31270.0,2019-12-02,"(767.5, 975.25]",3,12,-9
31270.0,2019-12-02,"(975.25, 1183.0]",6,11,-5
31271.0,2019-12-02,"(450.197, 651.75]",13,13,0
31271.0,2019-12-02,"(852.5, 1053.25]",3,1,2
31271.0,2019-12-02,"(1053.25, 1254.0]",1,11,-10
31272.0,2019-12-02,"(290.946, 555.5]",25,27,-2
31272.0,2019-12-02,"(555.5, 819.0]",3,3,0
31272.0,2019-12-02,"(819.0, 1082.5]",4,20,-16
31272.0,2019-12-02,"(1082.5, 1346.0]",2,7,-5
31273.0,2019-12-02,"(831.75, 940.0]",1,1,0
31274.0,2019-12-02,"(393.065, 627.75]",18,23,-5
31274.0,2019-12-02,"(627.75, 861.5]",2,2,0
31274.0,2019-12-02,"(861.5, 1095.25]",4,9,-5
31274.0,2019-12-02,"(1095.25, 1329.0]",2,10,-8
31275.0,2019-12-02,"(66.673, 399.75]",5,9,-4
31275.0,2019-12-02,"(399.75, 731.5]",29,44,-15
31275.0,2019-12-02,"(731.5, 1063.25]",5,10,-5
31275.0,2019-12-02,"(1063.25, 1395.0]",2,9,-7
31276.0,2019-12-02,"(385.046, 624.5]",22,26,-4
31276.0,2019-12-02,"(624.5, 863.0]",1,4,-3
31276.0,2019-12-02,"(863.0, 1101.5]",3,16,-13
31276.0,2019-12-02,"(1101.5, 1340.0]",1,13,-12
31277.0,2019-12-02,"(415.072, 648.0]",26,31,-5
31277.0,2019-12-02,"(648.0, 880.0]",2,3,-1
31277.0,2019-12-02,"(880.0, 1112.0]",3,24,-21
31277.0,2019-12-02,"(1112.0, 1344.0]",1,4,-3
31278.0,2019-12-02,"(299.003, 549.25]",10,28,-18
31278.0,2019-12-02,"(549.25, 798.5]",4,14,-10
31278.0,2019-12-02,"(798.5, 1047.75]",6,11,-5
31278.0,2019-12-02,"(1047.75, 1297.0]",16,24,-8
31279.0,2019-12-02,"(380.038, 621.5]",26,30,-4
31279.0,2019-12-02,"(621.5, 862.0]",4,10,-6
31279.0,2019-12-02,"(862.0, 1102.5]",6,23,-17
31279.0,2019-12-02,"(1102.5, 1343.0]",1,8,-7
31280.0,2019-12-02,"(352.198, 553.5]",6,16,-10
31280.0,2019-12-02,"(754.0, 954.5]",3,2,1
31280.0,2019-12-02,"(954.5, 1155.0]",9,3,6
31000.0,2019-12-03,"(1057.854, 1094.5]",1,1,0
,,,,2.0,
31002.0,2019-12-03,"(351.5, 690.0]",3,1,2
31002.0,2019-12-03,"(690.0, 1028.5]",3,7,-4
31002.0,2019-12-03,"(1028.5, 1367.0]",2,5,-3
31003.0,2019-12-03,"(377.242, 567.5]",2,5,-3
31003.0,2019-12-03,"(567.5, 757.0]",1,1,0
31003.0,2019-12-03,"(757.0, 946.5]",1,1,0
31003.0,2019-12-03,"(946.5, 1136.0]",1,3,-2
31004.0,2019-12-03,"(712.987, 716.25]",1,1,0
31005.0,2019-12-03,"(439.25, 627.5]",3,3,0
31005.0,2019-12-03,"(627.5, 815.0]",2,4,-2
31005.0,2019-12-03,"(1002.5, 1190.0]",5,1,4
31006.0,2019-12-03,"(1057.75, 1213.0]",7,1,6
31007.0,2019-12-03,"(4.574, 362.5]",1,2,-1
31007.0,2019-12-03,"(362.5, 719.0]",6,18,-12
31007.0,2019-12-03,"(719.0, 1075.5]",6,17,-11
31007.0,2019-12-03,"(1075.5, 1432.0]",6,14,-8
31009.0,2019-12-03,"(457.153, 669.75]",7,8,-1
31009.0,2019-12-03,"(669.75, 881.5]",2,3,-1
31009.0,2019-12-03,"(1093.25, 1305.0]",2,2,0
31010.0,2019-12-03,"(443.125, 662.75]",2,4,-2
31010.0,2019-12-03,"(662.75, 881.5]",2,2,0
31010.0,2019-12-03,"(1100.25, 1319.0]",1,1,0
31011.0,2019-12-03,"(330.15, 543.5]",7,7,0
31011.0,2019-12-03,"(543.5, 756.0]",3,5,-2
31011.0,2019-12-03,"(968.5, 1181.0]",1,1,0
31012.0,2019-12-03,"(359.167, 568.25]",3,3,0
31013.0,2019-12-03,"(736.75, 954.5]",1,3,-2
31013.0,2019-12-03,"(954.5, 1172.25]",2,1,1
31013.0,2019-12-03,"(1172.25, 1390.0]",2,2,0
31014.0,2019-12-03,"(316.892, 595.0]",25,33,-8
31014.0,2019-12-03,"(595.0, 872.0]",10,16,-6
31014.0,2019-12-03,"(872.0, 1149.0]",6,14,-8
31014.0,2019-12-03,"(1149.0, 1426.0]",4,7,-3
31015.0,2019-12-03,"(295.902, 571.5]",13,14,-1
31015.0,2019-12-03,"(571.5, 846.0]",6,6,0
31015.0,2019-12-03,"(846.0, 1120.5]",3,7,-4
31015.0,2019-12-03,"(1120.5, 1395.0]",1,3,-2
31016.0,2019-12-03,"(440.164, 650.0]",4,8,-4
31016.0,2019-12-03,"(650.0, 859.0]",3,3,0
31016.0,2019-12-03,"(859.0, 1068.0]",2,5,-3
31016.0,2019-12-03,"(1068.0, 1277.0]",3,5,-2
31017.0,2019-12-03,"(312.5, 565.0]",3,1,2
31017.0,2019-12-03,"(565.0, 817.5]",2,4,-2
31017.0,2019-12-03,"(817.5, 1070.0]",2,4,-2
31018.0,2019-12-03,"(1031.0, 1244.0]",3,6,-3
31019.0,2019-12-03,"(392.024, 637.0]",1,2,-1
31019.0,2019-12-03,"(637.0, 881.0]",1,3,-2
31019.0,2019-12-03,"(881.0, 1125.0]",4,6,-2
31020.0,2019-12-03,"(325.197, 526.75]",1,3,-2
31020.0,2019-12-03,"(727.5, 928.25]",1,1,0
31020.0,2019-12-03,"(928.25, 1129.0]",2,5,-3
31021.0,2019-12-03,"(371.214, 568.5]",1,7,-6
31021.0,2019-12-03,"(568.5, 765.0]",2,3,-1
31021.0,2019-12-03,"(961.5, 1158.0]",2,2,0
31022.0,2019-12-03,"(380.105, 604.75]",5,10,-5
31022.0,2019-12-03,"(604.75, 828.5]",3,7,-4
31022.0,2019-12-03,"(828.5, 1052.25]",1,2,-1
31022.0,2019-12-03,"(1052.25, 1276.0]",2,8,-6
31023.0,2019-12-03,"(386.045, 625.75]",1,4,-3
31023.0,2019-12-03,"(864.5, 1103.25]",2,3,-1
31024.0,2019-12-03,"(408.052, 646.0]",5,9,-4
31024.0,2019-12-03,"(646.0, 883.0]",1,1,0
31024.0,2019-12-03,"(883.0, 1120.0]",2,8,-6
31024.0,2019-12-03,"(1120.0, 1357.0]",1,4,-3
31025.0,2019-12-03,"(999.993, 1001.75]",1,1,0
31026.0,2019-12-03,"(321.5, 608.0]",1,1,0
31026.0,2019-12-03,"(608.0, 894.5]",1,3,-2
31026.0,2019-12-03,"(894.5, 1181.0]",2,1,1
,,,,1.0,
,,,,2.0,
,,,,1.0,
31028.0,2019-12-03,"(517.262, 702.5]",1,1,0
31028.0,2019-12-03,"(1071.5, 1256.0]",1,1,0
31029.0,2019-12-03,"(668.5, 877.0]",1,3,-2
31029.0,2019-12-03,"(877.0, 1085.5]",6,2,4
31029.0,2019-12-03,"(1085.5, 1294.0]",3,7,-4
31030.0,2019-12-03,"(445.187, 649.25]",1,12,-11
31030.0,2019-12-03,"(852.5, 1055.75]",2,5,-3
31030.0,2019-12-03,"(1055.75, 1259.0]",5,3,2
31031.0,2019-12-03,"(904.5, 1052.0]",2,3,-1
31032.0,2019-12-03,"(621.5, 811.0]",1,3,-2
31032.0,2019-12-03,"(1000.5, 1190.0]",2,1,1
,,,,1.0,
,,,,1.0,
31034.0,2019-12-03,"(480.122, 700.5]",5,8,-3
31034.0,2019-12-03,"(700.5, 920.0]",2,4,-2
31034.0,2019-12-03,"(920.0, 1139.5]",1,2,-1
31034.0,2019-12-03,"(1139.5, 1359.0]",1,2,-1
31035.0,2019-12-03,"(68.807, 368.25]",1,1,0
31035.0,2019-12-03,"(368.25, 666.5]",2,7,-5
31035.0,2019-12-03,"(666.5, 964.75]",1,3,-2
31035.0,2019-12-03,"(964.75, 1263.0]",6,9,-3
31036.0,2019-12-03,"(392.102, 617.5]",1,7,-6
31036.0,2019-12-03,"(842.0, 1066.5]",3,1,2
31036.0,2019-12-03,"(1066.5, 1291.0]",4,4,0
31037.0,2019-12-03,"(374.937, 641.75]",19,24,-5
31037.0,2019-12-03,"(641.75, 907.5]",1,3,-2
31037.0,2019-12-03,"(907.5, 1173.25]",2,19,-17
31037.0,2019-12-03,"(1173.25, 1439.0]",1,3,-2
31038.0,2019-12-03,"(395.014, 642.5]",2,3,-1
31038.0,2019-12-03,"(642.5, 889.0]",1,3,-2
31039.0,2019-12-03,"(332.948, 597.0]",6,9,-3
31039.0,2019-12-03,"(597.0, 860.0]",1,5,-4
31039.0,2019-12-03,"(860.0, 1123.0]",4,7,-3
31039.0,2019-12-03,"(1123.0, 1386.0]",3,6,-3
31040.0,2019-12-03,"(459.283, 639.25]",2,2,0
31040.0,2019-12-03,"(639.25, 818.5]",1,2,-1
31040.0,2019-12-03,"(818.5, 997.75]",1,1,0
31040.0,2019-12-03,"(997.75, 1177.0]",1,2,-1
31041.0,2019-12-03,"(536.667, 620.25]",1,1,0
31041.0,2019-12-03,"(703.5, 786.75]",1,1,0
31042.0,2019-12-03,"(438.131, 656.25]",11,13,-2
31042.0,2019-12-03,"(656.25, 873.5]",1,2,-1
31042.0,2019-12-03,"(873.5, 1090.75]",1,11,-10
31042.0,2019-12-03,"(1090.75, 1308.0]",1,3,-2
31043.0,2019-12-03,"(428.346, 592.5]",2,3,-1
31044.0,2019-12-03,"(466.197, 667.75]",1,2,-1
31044.0,2019-12-03,"(868.5, 1069.25]",1,1,0
31044.0,2019-12-03,"(1069.25, 1270.0]",3,1,2
31045.0,2019-12-03,"(504.367, 663.25]",2,5,-3
31045.0,2019-12-03,"(663.25, 821.5]",1,1,0
31045.0,2019-12-03,"(979.75, 1138.0]",4,1,3
31046.0,2019-12-03,"(397.358, 558.5]",1,3,-2
31047.0,2019-12-03,"(347.921, 618.75]",19,27,-8
31047.0,2019-12-03,"(618.75, 888.5]",3,6,-3
31047.0,2019-12-03,"(888.5, 1158.25]",4,22,-18
31047.0,2019-12-03,"(1158.25, 1428.0]",2,7,-5
31048.0,2019-12-03,"(307.041, 547.75]",4,5,-1
31048.0,2019-12-03,"(787.5, 1027.25]",1,1,0
31048.0,2019-12-03,"(1027.25, 1267.0]",1,3,-2
31049.0,2019-12-03,"(304.0, 608.0]",2,1,1
31049.0,2019-12-03,"(912.0, 1216.0]",1,2,-1
31050.0,2019-12-03,"(1097.0, 1291.0]",2,1,1
31051.0,2019-12-03,"(884.25, 1078.0]",6,4,2
31052.0,2019-12-03,"(291.179, 497.25]",1,2,-1
31052.0,2019-12-03,"(907.75, 1113.0]",2,4,-2
31053.0,2019-12-03,"(951.25, 1091.0]",1,1,0
31054.0,2019-12-03,"(754.5, 1006.0]",1,1,0
31055.0,2019-12-03,"(900.0, 1038.0]",3,2,1
31056.0,2019-12-03,"(975.5, 1102.0]",1,1,0
31057.0,2019-12-03,"(377.25, 503.0]",1,1,0
,,,,2.0,
,,,,2.0,
31060.0,2019-12-03,"(813.75, 1085.0]",2,1,1
,,,,1.0,
,,,,1.0,
31062.0,2019-12-03,"(539.628, 633.0]",2,4,-2
31062.0,2019-12-03,"(633.0, 726.0]",1,1,0
31062.0,2019-12-03,"(726.0, 819.0]",1,2,-1
,,,,2.0,
31064.0,2019-12-03,"(504.338, 670.5]",2,4,-2
31064.0,2019-12-03,"(670.5, 836.0]",1,3,-2
31064.0,2019-12-03,"(836.0, 1001.5]",1,2,-1
31064.0,2019-12-03,"(1001.5, 1167.0]",3,6,-3
31065.0,2019-12-03,"(722.5, 900.25]",2,2,0
31066.0,2019-12-03,"(825.0, 1100.0]",2,1,1
31067.0,2019-12-03,"(496.302, 671.5]",1,2,-1
31067.0,2019-12-03,"(671.5, 846.0]",1,3,-2
31067.0,2019-12-03,"(1020.5, 1195.0]",2,5,-3
31068.0,2019-12-03,"(769.0, 966.0]",4,1,3
31068.0,2019-12-03,"(1163.0, 1360.0]",4,6,-2
31069.0,2019-12-03,"(843.0, 1067.5]",3,7,-4
31069.0,2019-12-03,"(1067.5, 1292.0]",2,3,-1
31070.0,2019-12-03,"(846.764, 906.0]",1,2,-1
31070.0,2019-12-03,"(965.0, 1024.0]",1,1,0
31070.0,2019-12-03,"(1024.0, 1083.0]",1,1,0
31071.0,2019-12-03,"(324.109, 547.75]",3,5,-2
31071.0,2019-12-03,"(547.75, 770.5]",3,6,-3
31071.0,2019-12-03,"(770.5, 993.25]",1,4,-3
31071.0,2019-12-03,"(993.25, 1216.0]",11,16,-5
,,,,1.0,
,,,,1.0,
31073.0,2019-12-03,"(494.747, 558.25]",2,3,-1
31073.0,2019-12-03,"(621.5, 684.75]",1,1,0
31073.0,2019-12-03,"(684.75, 748.0]",1,2,-1
31074.0,2019-12-03,"(803.5, 959.75]",1,1,0
31074.0,2019-12-03,"(959.75, 1116.0]",5,3,2
,,,,1.0,
,,,,1.0,
,,,,2.0,
,,,,2.0,
31077.0,2019-12-03,"(667.5, 911.0]",1,3,-2
31077.0,2019-12-03,"(911.0, 1154.5]",2,2,0
31077.0,2019-12-03,"(1154.5, 1398.0]",3,4,-1
31078.0,2019-12-03,"(497.555, 609.25]",6,6,0
31078.0,2019-12-03,"(720.5, 831.75]",1,1,0
31079.0,2019-12-03,"(39.668, 374.0]",1,1,0
31079.0,2019-12-03,"(707.0, 1040.0]",2,8,-6
31079.0,2019-12-03,"(1040.0, 1373.0]",4,3,1
31080.0,2019-12-03,"(472.091, 700.25]",1,10,-9
31080.0,2019-12-03,"(700.25, 927.5]",1,2,-1
31080.0,2019-12-03,"(927.5, 1154.75]",9,15,-6
31080.0,2019-12-03,"(1154.75, 1382.0]",4,4,0
31081.0,2019-12-03,"(483.179, 689.25]",3,4,-1
31081.0,2019-12-03,"(894.5, 1099.75]",2,7,-5
31081.0,2019-12-03,"(1099.75, 1305.0]",1,3,-2
,,,,1.0,
,,,,2.0,
31083.0,2019-12-03,"(742.5, 914.25]",2,4,-2
31083.0,2019-12-03,"(914.25, 1086.0]",5,3,2
31084.0,2019-12-03,"(302.996, 555.0]",1,2,-1
31084.0,2019-12-03,"(555.0, 806.0]",5,5,0
31084.0,2019-12-03,"(806.0, 1057.0]",1,2,-1
31084.0,2019-12-03,"(1057.0, 1308.0]",1,5,-4
31085.0,2019-12-03,"(403.218, 599.5]",1,3,-2
31085.0,2019-12-03,"(990.5, 1186.0]",1,1,0
31086.0,2019-12-03,"(846.0, 1041.0]",1,1,0
31086.0,2019-12-03,"(1041.0, 1236.0]",2,1,1
31087.0,2019-12-03,"(712.25, 952.5]",1,1,0
31087.0,2019-12-03,"(952.5, 1192.75]",3,1,2
31087.0,2019-12-03,"(1192.75, 1433.0]",2,3,-1
31088.0,2019-12-03,"(915.25, 1090.0]",5,2,3
31089.0,2019-12-03,"(405.118, 626.5]",8,13,-5
31089.0,2019-12-03,"(626.5, 847.0]",3,6,-3
31089.0,2019-12-03,"(847.0, 1067.5]",2,15,-13
31089.0,2019-12-03,"(1067.5, 1288.0]",3,10,-7
31090.0,2019-12-03,"(998.25, 1147.0]",3,2,1
31091.0,2019-12-03,"(19.741, 335.75]",1,1,0
31091.0,2019-12-03,"(965.25, 1280.0]",5,4,1
31092.0,2019-12-03,"(971.5, 1140.0]",2,2,0
,,,,1.0,
,,,,1.0,
,,,,4.0,
31094.0,2019-12-03,"(914.5, 1050.0]",1,1,0
,,,,2.0,
31096.0,2019-12-03,"(661.25, 829.5]",1,1,0
31096.0,2019-12-03,"(997.75, 1166.0]",1,1,0
31097.0,2019-12-03,"(472.233, 664.75]",3,4,-1
31097.0,2019-12-03,"(664.75, 856.5]",1,1,0
31097.0,2019-12-03,"(1048.25, 1240.0]",1,2,-1
31098.0,2019-12-03,"(379.081, 609.75]",5,11,-6
31098.0,2019-12-03,"(839.5, 1069.25]",9,3,6
31098.0,2019-12-03,"(1069.25, 1299.0]",4,13,-9
31099.0,2019-12-03,"(999.25, 1176.0]",1,2,-1
31100.0,2019-12-03,"(462.289, 640.75]",16,18,-2
31100.0,2019-12-03,"(818.5, 996.25]",1,2,-1
31100.0,2019-12-03,"(996.25, 1174.0]",3,21,-18
31101.0,2019-12-03,"(-0.434, 359.5]",2,6,-4
31101.0,2019-12-03,"(359.5, 718.0]",14,50,-36
31101.0,2019-12-03,"(718.0, 1076.5]",34,49,-15
31101.0,2019-12-03,"(1076.5, 1435.0]",23,34,-11
31102.0,2019-12-03,"(355.956, 618.0]",2,21,-19
31102.0,2019-12-03,"(879.0, 1140.0]",4,4,0
31102.0,2019-12-03,"(1140.0, 1401.0]",8,12,-4
31103.0,2019-12-03,"(357.25, 707.5]",2,2,0
31103.0,2019-12-03,"(707.5, 1057.75]",4,34,-30
31103.0,2019-12-03,"(1057.75, 1408.0]",11,16,-5
31104.0,2019-12-03,"(306.879, 588.25]",3,13,-10
31104.0,2019-12-03,"(588.25, 868.5]",2,6,-4
31104.0,2019-12-03,"(868.5, 1148.75]",14,24,-10
31104.0,2019-12-03,"(1148.75, 1429.0]",5,11,-6
31105.0,2019-12-03,"(364.032, 607.0]",1,11,-10
31105.0,2019-12-03,"(849.0, 1091.0]",4,1,3
31105.0,2019-12-03,"(1091.0, 1333.0]",1,10,-9
31106.0,2019-12-03,"(405.127, 624.25]",2,13,-11
31106.0,2019-12-03,"(842.5, 1060.75]",2,2,0
31106.0,2019-12-03,"(1060.75, 1279.0]",2,3,-1
31107.0,2019-12-03,"(335.961, 596.75]",3,29,-26
31107.0,2019-12-03,"(596.75, 856.5]",6,10,-4
31107.0,2019-12-03,"(856.5, 1116.25]",19,27,-8
31107.0,2019-12-03,"(1116.25, 1376.0]",11,17,-6
31108.0,2019-12-03,"(370.944, 636.0]",9,30,-21
31108.0,2019-12-03,"(636.0, 900.0]",8,19,-11
31108.0,2019-12-03,"(900.0, 1164.0]",22,40,-18
31108.0,2019-12-03,"(1164.0, 1428.0]",15,18,-3
31109.0,2019-12-03,"(121.807, 421.25]",3,4,-1
31109.0,2019-12-03,"(421.25, 719.5]",7,23,-16
31109.0,2019-12-03,"(719.5, 1017.75]",8,12,-4
31109.0,2019-12-03,"(1017.75, 1316.0]",18,31,-13
31110.0,2019-12-03,"(317.933, 585.75]",13,34,-21
31110.0,2019-12-03,"(585.75, 852.5]",5,18,-13
31110.0,2019-12-03,"(852.5, 1119.25]",17,32,-15
31110.0,2019-12-03,"(1119.25, 1386.0]",15,23,-8
31111.0,2019-12-03,"(137.744, 453.0]",4,6,-2
31111.0,2019-12-03,"(453.0, 767.0]",4,20,-16
31111.0,2019-12-03,"(767.0, 1081.0]",10,13,-3
31111.0,2019-12-03,"(1081.0, 1395.0]",16,29,-13
31112.0,2019-12-03,"(364.011, 612.25]",1,4,-3
31112.0,2019-12-03,"(859.5, 1106.75]",4,5,-1
31112.0,2019-12-03,"(1106.75, 1354.0]",3,5,-2
31113.0,2019-12-03,"(582.0, 849.0]",3,20,-17
31113.0,2019-12-03,"(849.0, 1116.0]",6,11,-5
31113.0,2019-12-03,"(1116.0, 1383.0]",14,10,4
31114.0,2019-12-03,"(4.687, 334.25]",2,3,-1
31114.0,2019-12-03,"(334.25, 662.5]",2,26,-24
31114.0,2019-12-03,"(662.5, 990.75]",9,15,-6
31114.0,2019-12-03,"(990.75, 1319.0]",17,26,-9
31115.0,2019-12-03,"(623.75, 872.5]",1,19,-18
31115.0,2019-12-03,"(872.5, 1121.25]",9,3,6
31115.0,2019-12-03,"(1121.25, 1370.0]",7,13,-6
31116.0,2019-12-03,"(325.939, 592.25]",3,23,-20
31116.0,2019-12-03,"(592.25, 857.5]",5,9,-4
31116.0,2019-12-03,"(857.5, 1122.75]",20,28,-8
31116.0,2019-12-03,"(1122.75, 1388.0]",10,15,-5
31117.0,2019-12-03,"(341.75, 679.5]",2,2,0
31117.0,2019-12-03,"(679.5, 1017.25]",6,25,-19
31117.0,2019-12-03,"(1017.25, 1355.0]",18,17,1
31118.0,2019-12-03,"(360.983, 616.25]",3,21,-18
31118.0,2019-12-03,"(616.25, 870.5]",2,2,0
31118.0,2019-12-03,"(870.5, 1124.75]",12,15,-3
31118.0,2019-12-03,"(1124.75, 1379.0]",5,7,-2
31119.0,2019-12-03,"(313.951, 577.25]",7,22,-15
31119.0,2019-12-03,"(577.25, 839.5]",6,10,-4
31119.0,2019-12-03,"(839.5, 1101.75]",12,18,-6
31119.0,2019-12-03,"(1101.75, 1364.0]",12,21,-9
31120.0,2019-12-03,"(450.058, 686.5]",1,11,-10
31120.0,2019-12-03,"(686.5, 922.0]",1,3,-2
31120.0,2019-12-03,"(922.0, 1157.5]",8,13,-5
31120.0,2019-12-03,"(1157.5, 1393.0]",12,17,-5
31121.0,2019-12-03,"(343.949, 607.75]",13,21,-8
31121.0,2019-12-03,"(607.75, 870.5]",1,6,-5
31121.0,2019-12-03,"(870.5, 1133.25]",6,18,-12
31121.0,2019-12-03,"(1133.25, 1396.0]",6,11,-5
31122.0,2019-12-03,"(311.917, 583.75]",2,13,-11
31122.0,2019-12-03,"(854.5, 1125.25]",8,14,-6
31122.0,2019-12-03,"(1125.25, 1396.0]",5,11,-6
31123.0,2019-12-03,"(408.75, 742.5]",2,3,-1
31123.0,2019-12-03,"(742.5, 1076.25]",3,23,-20
31123.0,2019-12-03,"(1076.25, 1410.0]",6,6,0
31124.0,2019-12-03,"(303.882, 584.5]",17,39,-22
31124.0,2019-12-03,"(584.5, 864.0]",9,32,-23
31124.0,2019-12-03,"(864.0, 1143.5]",17,49,-32
31124.0,2019-12-03,"(1143.5, 1423.0]",14,34,-20
31125.0,2019-12-03,"(32.676, 365.0]",1,3,-2
31125.0,2019-12-03,"(365.0, 696.0]",5,27,-22
31125.0,2019-12-03,"(696.0, 1027.0]",10,14,-4
31125.0,2019-12-03,"(1027.0, 1358.0]",20,29,-9
31126.0,2019-12-03,"(298.934, 566.5]",3,24,-21
31126.0,2019-12-03,"(566.5, 833.0]",3,13,-10
31126.0,2019-12-03,"(833.0, 1099.5]",12,17,-5
31126.0,2019-12-03,"(1099.5, 1366.0]",14,19,-5
,,,,2.0,
31128.0,2019-12-03,"(310.887, 590.25]",31,45,-14
31128.0,2019-12-03,"(590.25, 868.5]",12,23,-11
31128.0,2019-12-03,"(868.5, 1146.75]",21,34,-13
31128.0,2019-12-03,"(1146.75, 1425.0]",7,19,-12
31129.0,2019-12-03,"(324.135, 541.25]",4,7,-3
31129.0,2019-12-03,"(541.25, 757.5]",12,15,-3
31129.0,2019-12-03,"(757.5, 973.75]",2,7,-5
31129.0,2019-12-03,"(973.75, 1190.0]",1,8,-7
31130.0,2019-12-03,"(120.71, 444.5]",1,3,-2
31130.0,2019-12-03,"(444.5, 767.0]",7,16,-9
31130.0,2019-12-03,"(767.0, 1089.5]",5,7,-2
31130.0,2019-12-03,"(1089.5, 1412.0]",11,16,-5
31131.0,2019-12-03,"(12.741, 328.75]",1,1,0
31131.0,2019-12-03,"(958.25, 1273.0]",5,13,-8
31200.0,2019-12-03,"(98.729, 417.75]",5,6,-1
31200.0,2019-12-03,"(417.75, 735.5]",41,58,-17
31200.0,2019-12-03,"(735.5, 1053.25]",20,44,-24
31200.0,2019-12-03,"(1053.25, 1371.0]",25,56,-31
31201.0,2019-12-03,"(359.75, 689.5]",20,2,18
31201.0,2019-12-03,"(689.5, 1019.25]",24,50,-26
31201.0,2019-12-03,"(1019.25, 1349.0]",39,39,0
31202.0,2019-12-03,"(34.731, 353.25]",1,1,0
31202.0,2019-12-03,"(353.25, 670.5]",10,32,-22
31202.0,2019-12-03,"(670.5, 987.75]",8,15,-7
31202.0,2019-12-03,"(987.75, 1305.0]",30,48,-18
31203.0,2019-12-03,"(351.982, 607.5]",9,29,-20
31203.0,2019-12-03,"(607.5, 862.0]",14,30,-16
31203.0,2019-12-03,"(862.0, 1116.5]",16,29,-13
31203.0,2019-12-03,"(1116.5, 1371.0]",13,20,-7
31204.0,2019-12-03,"(443.167, 652.25]",14,14,0
31204.0,2019-12-03,"(652.25, 860.5]",6,11,-5
31204.0,2019-12-03,"(860.5, 1068.75]",9,20,-11
31204.0,2019-12-03,"(1068.75, 1277.0]",8,19,-11
31205.0,2019-12-03,"(102.726, 422.5]",1,3,-2
31205.0,2019-12-03,"(422.5, 741.0]",41,48,-7
31205.0,2019-12-03,"(741.0, 1059.5]",28,42,-14
31205.0,2019-12-03,"(1059.5, 1378.0]",5,30,-25
31206.0,2019-12-03,"(406.129, 624.75]",2,3,-1
31206.0,2019-12-03,"(624.75, 842.5]",1,1,0
31206.0,2019-12-03,"(842.5, 1060.25]",3,7,-4
31207.0,2019-12-03,"(588.0, 830.0]",1,7,-6
31207.0,2019-12-03,"(830.0, 1072.0]",1,2,-1
31207.0,2019-12-03,"(1072.0, 1314.0]",4,1,3
31208.0,2019-12-03,"(322.067, 556.25]",13,15,-2
31208.0,2019-12-03,"(556.25, 789.5]",1,3,-2
31208.0,2019-12-03,"(789.5, 1022.75]",3,10,-7
31208.0,2019-12-03,"(1022.75, 1256.0]",8,13,-5
31209.0,2019-12-03,"(468.163, 678.25]",2,3,-1
31209.0,2019-12-03,"(678.25, 887.5]",4,5,-1
31209.0,2019-12-03,"(887.5, 1096.75]",6,7,-1
31209.0,2019-12-03,"(1096.75, 1306.0]",6,10,-4
31211.0,2019-12-03,"(453.22, 649.0]",11,14,-3
31211.0,2019-12-03,"(844.0, 1039.0]",1,2,-1
31211.0,2019-12-03,"(1039.0, 1234.0]",4,13,-9
31212.0,2019-12-03,"(306.907, 581.25]",31,43,-12
31212.0,2019-12-03,"(581.25, 854.5]",16,24,-8
31212.0,2019-12-03,"(854.5, 1127.75]",16,35,-19
31212.0,2019-12-03,"(1127.75, 1401.0]",11,20,-9
31213.0,2019-12-03,"(417.033, 659.75]",34,49,-15
31213.0,2019-12-03,"(659.75, 901.5]",12,24,-12
31213.0,2019-12-03,"(901.5, 1143.25]",19,41,-22
31213.0,2019-12-03,"(1143.25, 1385.0]",2,9,-7
31214.0,2019-12-03,"(424.5, 733.0]",7,6,1
31214.0,2019-12-03,"(733.0, 1041.5]",22,27,-5
31214.0,2019-12-03,"(1041.5, 1350.0]",28,36,-8
31215.0,2019-12-03,"(409.125, 628.75]",20,21,-1
31215.0,2019-12-03,"(628.75, 847.5]",1,2,-1
31215.0,2019-12-03,"(847.5, 1066.25]",8,16,-8
31215.0,2019-12-03,"(1066.25, 1285.0]",6,15,-9
31216.0,2019-12-03,"(333.11, 556.5]",18,21,-3
31216.0,2019-12-03,"(556.5, 779.0]",6,9,-3
31216.0,2019-12-03,"(779.0, 1001.5]",15,22,-7
31216.0,2019-12-03,"(1001.5, 1224.0]",6,27,-21
31217.0,2019-12-03,"(375.943, 641.25]",10,11,-1
31217.0,2019-12-03,"(641.25, 905.5]",7,10,-3
31217.0,2019-12-03,"(905.5, 1169.75]",2,11,-9
31217.0,2019-12-03,"(1169.75, 1434.0]",1,1,0
31218.0,2019-12-03,"(322.969, 581.75]",14,28,-14
31218.0,2019-12-03,"(581.75, 839.5]",6,10,-4
31218.0,2019-12-03,"(839.5, 1097.25]",16,26,-10
31218.0,2019-12-03,"(1097.25, 1355.0]",3,6,-3
31219.0,2019-12-03,"(360.192, 563.0]",12,13,-1
31219.0,2019-12-03,"(563.0, 765.0]",15,17,-2
31219.0,2019-12-03,"(765.0, 967.0]",4,13,-9
31219.0,2019-12-03,"(967.0, 1169.0]",1,9,-8
31220.0,2019-12-03,"(303.256, 490.0]",11,16,-5
31220.0,2019-12-03,"(490.0, 676.0]",11,13,-2
31220.0,2019-12-03,"(862.0, 1048.0]",1,1,0
31221.0,2019-12-03,"(411.058, 647.5]",34,38,-4
31221.0,2019-12-03,"(647.5, 883.0]",13,18,-5
31221.0,2019-12-03,"(883.0, 1118.5]",7,30,-23
31221.0,2019-12-03,"(1118.5, 1354.0]",3,12,-9
31222.0,2019-12-03,"(383.957, 645.75]",14,14,0
31222.0,2019-12-03,"(645.75, 906.5]",4,8,-4
31222.0,2019-12-03,"(906.5, 1167.25]",2,16,-14
31222.0,2019-12-03,"(1167.25, 1428.0]",3,8,-5
31223.0,2019-12-03,"(2.59, 356.5]",2,3,-1
31223.0,2019-12-03,"(356.5, 709.0]",11,34,-23
31223.0,2019-12-03,"(709.0, 1061.5]",3,13,-10
31223.0,2019-12-03,"(1061.5, 1414.0]",20,29,-9
31224.0,2019-12-03,"(316.064, 551.0]",16,16,0
31224.0,2019-12-03,"(551.0, 785.0]",7,11,-4
31224.0,2019-12-03,"(785.0, 1019.0]",1,7,-6
31224.0,2019-12-03,"(1019.0, 1253.0]",2,7,-5
31225.0,2019-12-03,"(433.031, 676.25]",9,23,-14
31225.0,2019-12-03,"(676.25, 918.5]",9,11,-2
31225.0,2019-12-03,"(918.5, 1160.75]",3,16,-13
31225.0,2019-12-03,"(1160.75, 1403.0]",1,3,-2
31226.0,2019-12-03,"(320.061, 555.75]",4,11,-7
31226.0,2019-12-03,"(555.75, 790.5]",3,5,-2
31226.0,2019-12-03,"(790.5, 1025.25]",2,5,-3
31226.0,2019-12-03,"(1025.25, 1260.0]",8,14,-6
31227.0,2019-12-03,"(423.119, 644.25]",37,41,-4
31227.0,2019-12-03,"(644.25, 864.5]",7,13,-6
31227.0,2019-12-03,"(864.5, 1084.75]",7,20,-13
31227.0,2019-12-03,"(1084.75, 1305.0]",4,17,-13
31228.0,2019-12-03,"(82.744, 398.0]",6,7,-1
31228.0,2019-12-03,"(398.0, 712.0]",22,32,-10
31228.0,2019-12-03,"(712.0, 1026.0]",18,33,-15
31228.0,2019-12-03,"(1026.0, 1340.0]",30,63,-33
31229.0,2019-12-03,"(332.908, 607.0]",10,55,-45
31229.0,2019-12-03,"(607.0, 880.0]",10,31,-21
31229.0,2019-12-03,"(880.0, 1153.0]",42,61,-19
31229.0,2019-12-03,"(1153.0, 1426.0]",11,25,-14
31230.0,2019-12-03,"(331.918, 603.5]",61,70,-9
31230.0,2019-12-03,"(603.5, 874.0]",18,27,-9
31230.0,2019-12-03,"(874.0, 1144.5]",3,18,-15
31230.0,2019-12-03,"(1144.5, 1415.0]",6,19,-13
31231.0,2019-12-03,"(330.917, 602.75]",25,29,-4
31231.0,2019-12-03,"(602.75, 873.5]",9,15,-6
31231.0,2019-12-03,"(873.5, 1144.25]",14,31,-17
31231.0,2019-12-03,"(1144.25, 1415.0]",1,3,-2
31232.0,2019-12-03,"(292.929, 561.75]",11,14,-3
31232.0,2019-12-03,"(561.75, 829.5]",6,11,-5
31232.0,2019-12-03,"(829.5, 1097.25]",15,21,-6
31232.0,2019-12-03,"(1097.25, 1365.0]",12,25,-13
31233.0,2019-12-03,"(403.97, 662.5]",50,55,-5
31233.0,2019-12-03,"(662.5, 920.0]",12,16,-4
31233.0,2019-12-03,"(920.0, 1177.5]",10,26,-16
31233.0,2019-12-03,"(1177.5, 1435.0]",3,6,-3
31234.0,2019-12-03,"(37.6, 389.0]",1,3,-2
31234.0,2019-12-03,"(389.0, 739.0]",24,49,-25
31234.0,2019-12-03,"(739.0, 1089.0]",12,22,-10
31234.0,2019-12-03,"(1089.0, 1439.0]",10,22,-12
31235.0,2019-12-03,"(503.369, 661.75]",6,6,0
31235.0,2019-12-03,"(661.75, 819.5]",3,3,0
31235.0,2019-12-03,"(819.5, 977.25]",2,3,-1
31235.0,2019-12-03,"(977.25, 1135.0]",2,9,-7
31236.0,2019-12-03,"(405.974, 663.5]",19,23,-4
31236.0,2019-12-03,"(663.5, 920.0]",14,27,-13
31236.0,2019-12-03,"(920.0, 1176.5]",10,24,-14
31236.0,2019-12-03,"(1176.5, 1433.0]",1,14,-13
31237.0,2019-12-03,"(171.736, 489.0]",4,7,-3
31237.0,2019-12-03,"(489.0, 805.0]",10,19,-9
31237.0,2019-12-03,"(805.0, 1121.0]",14,23,-9
31237.0,2019-12-03,"(1121.0, 1437.0]",4,15,-11
31238.0,2019-12-03,"(69.649, 408.75]",2,3,-1
31238.0,2019-12-03,"(408.75, 746.5]",23,27,-4
31238.0,2019-12-03,"(746.5, 1084.25]",7,29,-22
31238.0,2019-12-03,"(1084.25, 1422.0]",5,14,-9
31239.0,2019-12-03,"(359.102, 584.5]",26,28,-2
31239.0,2019-12-03,"(584.5, 809.0]",9,11,-2
31239.0,2019-12-03,"(809.0, 1033.5]",4,12,-8
31239.0,2019-12-03,"(1033.5, 1258.0]",11,29,-18
31240.0,2019-12-03,"(885.805, 934.75]",2,3,-1
31240.0,2019-12-03,"(1032.25, 1081.0]",1,1,0
31241.0,2019-12-03,"(6.637, 348.75]",2,4,-2
31241.0,2019-12-03,"(348.75, 689.5]",27,59,-32
31241.0,2019-12-03,"(689.5, 1030.25]",14,33,-19
31241.0,2019-12-03,"(1030.25, 1371.0]",20,42,-22
31242.0,2019-12-03,"(295.873, 578.75]",27,28,-1
31242.0,2019-12-03,"(578.75, 860.5]",3,7,-4
31242.0,2019-12-03,"(860.5, 1142.25]",5,31,-26
31242.0,2019-12-03,"(1142.25, 1424.0]",1,14,-13
31243.0,2019-12-03,"(350.135, 567.25]",30,37,-7
31243.0,2019-12-03,"(567.25, 783.5]",6,7,-1
31243.0,2019-12-03,"(783.5, 999.75]",5,17,-12
31243.0,2019-12-03,"(999.75, 1216.0]",4,16,-12
31244.0,2019-12-03,"(348.975, 606.25]",12,20,-8
31244.0,2019-12-03,"(606.25, 862.5]",2,5,-3
31244.0,2019-12-03,"(862.5, 1118.75]",8,23,-15
31244.0,2019-12-03,"(1118.75, 1375.0]",7,16,-9
31245.0,2019-12-03,"(389.051, 627.25]",9,17,-8
31245.0,2019-12-03,"(627.25, 864.5]",4,11,-7
31245.0,2019-12-03,"(864.5, 1101.75]",13,21,-8
31245.0,2019-12-03,"(1101.75, 1339.0]",12,23,-11
31246.0,2019-12-03,"(338.25, 675.5]",15,2,13
31246.0,2019-12-03,"(675.5, 1012.75]",11,25,-14
31246.0,2019-12-03,"(1012.75, 1350.0]",17,19,-2
31247.0,2019-12-03,"(409.148, 623.0]",13,17,-4
31247.0,2019-12-03,"(623.0, 836.0]",7,11,-4
31247.0,2019-12-03,"(836.0, 1049.0]",11,24,-13
31247.0,2019-12-03,"(1049.0, 1262.0]",3,8,-5
31248.0,2019-12-03,"(376.199, 577.25]",10,15,-5
31248.0,2019-12-03,"(577.25, 777.5]",5,6,-1
31248.0,2019-12-03,"(777.5, 977.75]",1,8,-7
31248.0,2019-12-03,"(977.75, 1178.0]",9,19,-10
31249.0,2019-12-03,"(448.035, 690.25]",5,10,-5
31249.0,2019-12-03,"(690.25, 931.5]",4,8,-4
31249.0,2019-12-03,"(931.5, 1172.75]",2,4,-2
31249.0,2019-12-03,"(1172.75, 1414.0]",1,1,0
31250.0,2019-12-03,"(410.127, 629.25]",15,17,-2
31250.0,2019-12-03,"(629.25, 847.5]",2,8,-6
31250.0,2019-12-03,"(847.5, 1065.75]",7,13,-6
31250.0,2019-12-03,"(1065.75, 1284.0]",3,18,-15
31251.0,2019-12-03,"(363.019, 609.25]",27,50,-23
31251.0,2019-12-03,"(609.25, 854.5]",8,16,-8
31251.0,2019-12-03,"(854.5, 1099.75]",19,33,-14
31251.0,2019-12-03,"(1099.75, 1345.0]",7,17,-10
31252.0,2019-12-03,"(428.177, 634.75]",19,20,-1
31252.0,2019-12-03,"(634.75, 840.5]",3,7,-4
31252.0,2019-12-03,"(840.5, 1046.25]",4,14,-10
31252.0,2019-12-03,"(1046.25, 1252.0]",3,16,-13
31253.0,2019-12-03,"(393.123, 613.25]",24,25,-1
31253.0,2019-12-03,"(613.25, 832.5]",2,5,-3
31253.0,2019-12-03,"(832.5, 1051.75]",7,17,-10
31253.0,2019-12-03,"(1051.75, 1271.0]",3,18,-15
31254.0,2019-12-03,"(433.157, 644.75]",13,14,-1
31254.0,2019-12-03,"(644.75, 855.5]",1,5,-4
31254.0,2019-12-03,"(855.5, 1066.25]",2,20,-18
31254.0,2019-12-03,"(1066.25, 1277.0]",5,15,-10
31255.0,2019-12-03,"(369.994, 622.5]",20,27,-7
31255.0,2019-12-03,"(622.5, 874.0]",4,9,-5
31255.0,2019-12-03,"(874.0, 1125.5]",6,15,-9
31255.0,2019-12-03,"(1125.5, 1377.0]",5,10,-5
31256.0,2019-12-03,"(263.074, 495.5]",5,6,-1
31256.0,2019-12-03,"(495.5, 727.0]",10,10,0
31256.0,2019-12-03,"(727.0, 958.5]",1,6,-5
31256.0,2019-12-03,"(958.5, 1190.0]",11,22,-11
31257.0,2019-12-03,"(2.59, 356.5]",2,3,-1
31257.0,2019-12-03,"(356.5, 709.0]",31,48,-17
31257.0,2019-12-03,"(709.0, 1061.5]",15,32,-17
31257.0,2019-12-03,"(1061.5, 1414.0]",8,28,-20
31258.0,2019-12-03,"(582.414, 729.5]",2,5,-3
31258.0,2019-12-03,"(876.0, 1022.5]",2,1,1
31258.0,2019-12-03,"(1022.5, 1169.0]",1,5,-4
31259.0,2019-12-03,"(408.993, 661.75]",10,11,-1
31259.0,2019-12-03,"(661.75, 913.5]",1,3,-2
31259.0,2019-12-03,"(913.5, 1165.25]",1,8,-7
31259.0,2019-12-03,"(1165.25, 1417.0]",1,2,-1
31260.0,2019-12-03,"(135.94, 402.0]",4,4,0
31260.0,2019-12-03,"(402.0, 667.0]",14,20,-6
31260.0,2019-12-03,"(667.0, 932.0]",3,6,-3
31260.0,2019-12-03,"(932.0, 1197.0]",4,13,-9
31261.0,2019-12-03,"(424.389, 577.75]",15,16,-1
31261.0,2019-12-03,"(577.75, 730.5]",2,2,0
31261.0,2019-12-03,"(730.5, 883.25]",1,3,-2
31261.0,2019-12-03,"(883.25, 1036.0]",1,7,-6
31262.0,2019-12-03,"(258.866, 543.5]",6,7,-1
31262.0,2019-12-03,"(543.5, 827.0]",4,8,-4
31262.0,2019-12-03,"(827.0, 1110.5]",3,7,-4
31262.0,2019-12-03,"(1110.5, 1394.0]",1,10,-9
31263.0,2019-12-03,"(335.03, 578.5]",19,31,-12
31263.0,2019-12-03,"(578.5, 821.0]",7,13,-6
31263.0,2019-12-03,"(821.0, 1063.5]",8,19,-11
31263.0,2019-12-03,"(1063.5, 1306.0]",9,21,-12
31264.0,2019-12-03,"(452.109, 675.75]",17,23,-6
31264.0,2019-12-03,"(675.75, 898.5]",5,9,-4
31264.0,2019-12-03,"(898.5, 1121.25]",4,14,-10
31264.0,2019-12-03,"(1121.25, 1344.0]",2,2,0
31265.0,2019-12-03,"(375.953, 638.75]",11,34,-23
31265.0,2019-12-03,"(638.75, 900.5]",5,12,-7
31265.0,2019-12-03,"(900.5, 1162.25]",23,37,-14
31265.0,2019-12-03,"(1162.25, 1424.0]",9,19,-10
31266.0,2019-12-03,"(104.687, 434.25]",2,10,-8
31266.0,2019-12-03,"(434.25, 762.5]",7,29,-22
31266.0,2019-12-03,"(762.5, 1090.75]",16,30,-14
31266.0,2019-12-03,"(1090.75, 1419.0]",22,39,-17
31267.0,2019-12-03,"(-0.369, 343.25]",1,5,-4
31267.0,2019-12-03,"(343.25, 685.5]",25,47,-22
31267.0,2019-12-03,"(685.5, 1027.75]",11,27,-16
31267.0,2019-12-03,"(1027.75, 1370.0]",25,41,-16
31268.0,2019-12-03,"(333.978, 590.5]",14,44,-30
31268.0,2019-12-03,"(590.5, 846.0]",3,9,-6
31268.0,2019-12-03,"(846.0, 1101.5]",16,21,-5
31268.0,2019-12-03,"(1101.5, 1357.0]",18,26,-8
31269.0,2019-12-03,"(327.987, 582.25]",7,11,-4
31269.0,2019-12-03,"(582.25, 835.5]",6,12,-6
31269.0,2019-12-03,"(835.5, 1088.75]",4,14,-10
31269.0,2019-12-03,"(1088.75, 1342.0]",6,13,-7
31270.0,2019-12-03,"(357.015, 604.25]",19,26,-7
31270.0,2019-12-03,"(604.25, 850.5]",4,12,-8
31270.0,2019-12-03,"(850.5, 1096.75]",14,23,-9
31270.0,2019-12-03,"(1096.75, 1343.0]",6,8,-2
31271.0,2019-12-03,"(455.039, 696.25]",18,22,-4
31271.0,2019-12-03,"(696.25, 936.5]",7,14,-7
31271.0,2019-12-03,"(936.5, 1176.75]",5,20,-15
31271.0,2019-12-03,"(1176.75, 1417.0]",2,8,-6
31272.0,2019-12-03,"(387.132, 605.0]",25,28,-3
31272.0,2019-12-03,"(605.0, 822.0]",4,5,-1
31272.0,2019-12-03,"(822.0, 1039.0]",1,10,-9
31272.0,2019-12-03,"(1039.0, 1256.0]",5,12,-7
31273.0,2019-12-03,"(802.0, 942.0]",4,3,1
31273.0,2019-12-03,"(942.0, 1082.0]",1,2,-1
31274.0,2019-12-03,"(349.022, 594.5]",15,15,0
31274.0,2019-12-03,"(594.5, 839.0]",1,3,-2
31274.0,2019-12-03,"(839.0, 1083.5]",5,15,-10
31274.0,2019-12-03,"(1083.5, 1328.0]",7,13,-6
31275.0,2019-12-03,"(304.876, 587.0]",15,22,-7
31275.0,2019-12-03,"(587.0, 868.0]",7,17,-10
31275.0,2019-12-03,"(868.0, 1149.0]",12,27,-15
31275.0,2019-12-03,"(1149.0, 1430.0]",6,15,-9
31276.0,2019-12-03,"(361.045, 600.75]",20,24,-4
31276.0,2019-12-03,"(600.75, 839.5]",5,9,-4
31276.0,2019-12-03,"(839.5, 1078.25]",2,20,-18
31276.0,2019-12-03,"(1078.25, 1317.0]",4,13,-9
31277.0,2019-12-03,"(330.97, 589.5]",37,40,-3
31277.0,2019-12-03,"(589.5, 847.0]",13,17,-4
31277.0,2019-12-03,"(847.0, 1104.5]",15,47,-32
31277.0,2019-12-03,"(1104.5, 1362.0]",2,9,-7
31278.0,2019-12-03,"(24.754, 337.5]",1,2,-1
31278.0,2019-12-03,"(337.5, 649.0]",13,44,-31
31278.0,2019-12-03,"(649.0, 960.5]",12,20,-8
31278.0,2019-12-03,"(960.5, 1272.0]",24,40,-16
31279.0,2019-12-03,"(308.5, 582.0]",22,1,21
31279.0,2019-12-03,"(582.0, 855.5]",5,23,-18
31279.0,2019-12-03,"(855.5, 1129.0]",8,12,-4
31280.0,2019-12-03,"(374.017, 620.75]",5,24,-19
31280.0,2019-12-03,"(866.5, 1112.25]",10,4,6
31280.0,2019-12-03,"(1112.25, 1358.0]",14,16,-2
31000.0,2019-12-04,"(573.374, 730.5]",1,2,-1
31000.0,2019-12-04,"(1043.5, 1200.0]",1,1,0
,,,,1.0,
,,,,1.0,
31002.0,2019-12-04,"(319.5, 637.0]",6,1,5
31002.0,2019-12-04,"(637.0, 954.5]",1,9,-8
31002.0,2019-12-04,"(954.5, 1272.0]",4,4,0
31003.0,2019-12-04,"(387.219, 583.25]",1,3,-2
31003.0,2019-12-04,"(583.25, 778.5]",2,3,-1
31003.0,2019-12-04,"(778.5, 973.75]",1,1,0
31003.0,2019-12-04,"(973.75, 1169.0]",3,4,-1
31004.0,2019-12-04,"(854.0, 1033.0]",1,2,-1
31004.0,2019-12-04,"(1033.0, 1212.0]",2,1,1
31005.0,2019-12-04,"(431.213, 628.75]",5,6,-1
31005.0,2019-12-04,"(628.75, 825.5]",3,4,-1
31005.0,2019-12-04,"(825.5, 1022.25]",1,2,-1
31005.0,2019-12-04,"(1022.25, 1219.0]",3,13,-10
31006.0,2019-12-04,"(1236.25, 1322.0]",1,1,0
31007.0,2019-12-04,"(397.102, 622.5]",11,22,-11
31007.0,2019-12-04,"(622.5, 847.0]",4,8,-4
31007.0,2019-12-04,"(847.0, 1071.5]",6,18,-12
31007.0,2019-12-04,"(1071.5, 1296.0]",7,13,-6
31009.0,2019-12-04,"(431.276, 613.0]",5,5,0
,,,,2.0,
31011.0,2019-12-04,"(510.223, 705.25]",5,8,-3
31011.0,2019-12-04,"(705.25, 899.5]",2,5,-3
31011.0,2019-12-04,"(899.5, 1093.75]",2,5,-3
31011.0,2019-12-04,"(1093.75, 1288.0]",1,2,-1
31012.0,2019-12-04,"(392.278, 573.5]",3,3,0
31012.0,2019-12-04,"(573.5, 754.0]",1,2,-1
31012.0,2019-12-04,"(754.0, 934.5]",1,1,0
31013.0,2019-12-04,"(936.0, 1165.0]",6,4,2
31013.0,2019-12-04,"(1165.0, 1394.0]",1,2,-1
31014.0,2019-12-04,"(353.075, 585.25]",19,26,-7
31014.0,2019-12-04,"(585.25, 816.5]",9,11,-2
31014.0,2019-12-04,"(816.5, 1047.75]",4,7,-3
31014.0,2019-12-04,"(1047.75, 1279.0]",8,22,-14
31015.0,2019-12-04,"(299.908, 574.0]",14,15,-1
31015.0,2019-12-04,"(574.0, 847.0]",4,5,-1
31015.0,2019-12-04,"(847.0, 1120.0]",4,9,-5
31015.0,2019-12-04,"(1120.0, 1393.0]",1,3,-2
31016.0,2019-12-04,"(440.146, 654.5]",5,10,-5
31016.0,2019-12-04,"(868.0, 1081.5]",1,2,-1
31016.0,2019-12-04,"(1081.5, 1295.0]",2,2,0
31017.0,2019-12-04,"(536.381, 691.75]",3,4,-1
31017.0,2019-12-04,"(691.75, 846.5]",1,4,-3
31018.0,2019-12-04,"(350.956, 613.0]",2,6,-4
31018.0,2019-12-04,"(1135.0, 1396.0]",3,1,2
31019.0,2019-12-04,"(842.5, 1039.75]",1,1,0
31019.0,2019-12-04,"(1039.75, 1237.0]",1,1,0
31020.0,2019-12-04,"(459.158, 670.5]",1,1,0
31020.0,2019-12-04,"(670.5, 881.0]",2,4,-2
31021.0,2019-12-04,"(24.682, 355.5]",1,1,0
31021.0,2019-12-04,"(355.5, 685.0]",1,3,-2
31021.0,2019-12-04,"(685.0, 1014.5]",3,6,-3
31021.0,2019-12-04,"(1014.5, 1344.0]",1,4,-3
31022.0,2019-12-04,"(467.173, 674.75]",3,7,-4
31022.0,2019-12-04,"(674.75, 881.5]",2,3,-1
31022.0,2019-12-04,"(881.5, 1088.25]",1,1,0
31022.0,2019-12-04,"(1088.25, 1295.0]",3,13,-10
31023.0,2019-12-04,"(399.083, 629.25]",3,7,-4
31023.0,2019-12-04,"(629.25, 858.5]",2,2,0
31023.0,2019-12-04,"(1087.75, 1317.0]",1,3,-2
31024.0,2019-12-04,"(363.028, 607.0]",3,8,-5
31024.0,2019-12-04,"(607.0, 850.0]",1,2,-1
31024.0,2019-12-04,"(850.0, 1093.0]",3,5,-2
31024.0,2019-12-04,"(1093.0, 1336.0]",2,8,-6
31025.0,2019-12-04,"(910.0, 1085.5]",2,1,1
31025.0,2019-12-04,"(1085.5, 1261.0]",4,2,2
31026.0,2019-12-04,"(484.353, 646.75]",1,2,-1
31026.0,2019-12-04,"(970.25, 1132.0]",1,5,-4
31027.0,2019-12-04,"(1108.25, 1315.0]",2,3,-1
31028.0,2019-12-04,"(858.751, 921.25]",1,2,-1
31029.0,2019-12-04,"(898.5, 1123.25]",2,6,-4
31029.0,2019-12-04,"(1123.25, 1348.0]",6,1,5
31030.0,2019-12-04,"(667.75, 895.5]",1,7,-6
31030.0,2019-12-04,"(895.5, 1123.25]",5,3,2
31030.0,2019-12-04,"(1123.25, 1351.0]",2,5,-3
31031.0,2019-12-04,"(9.792, 313.0]",1,1,0
31031.0,2019-12-04,"(313.0, 615.0]",3,8,-5
31031.0,2019-12-04,"(917.0, 1219.0]",3,3,0
31032.0,2019-12-04,"(756.5, 899.75]",1,2,-1
31032.0,2019-12-04,"(899.75, 1043.0]",1,2,-1
31033.0,2019-12-04,"(345.002, 595.5]",1,2,-1
31033.0,2019-12-04,"(845.0, 1094.5]",1,1,0
31034.0,2019-12-04,"(417.286, 596.5]",5,9,-4
31034.0,2019-12-04,"(596.5, 775.0]",1,2,-1
31034.0,2019-12-04,"(775.0, 953.5]",1,1,0
31035.0,2019-12-04,"(656.5, 882.0]",1,2,-1
31035.0,2019-12-04,"(882.0, 1107.5]",1,3,-2
31035.0,2019-12-04,"(1107.5, 1333.0]",3,2,1
31036.0,2019-12-04,"(488.424, 633.0]",1,3,-2
31036.0,2019-12-04,"(921.0, 1065.0]",3,1,2
31037.0,2019-12-04,"(421.134, 638.5]",11,14,-3
31037.0,2019-12-04,"(638.5, 855.0]",5,8,-3
31037.0,2019-12-04,"(855.0, 1071.5]",3,10,-7
31037.0,2019-12-04,"(1071.5, 1288.0]",3,13,-10
31038.0,2019-12-04,"(469.126, 688.5]",1,3,-2
31038.0,2019-12-04,"(688.5, 907.0]",2,3,-1
31038.0,2019-12-04,"(907.0, 1125.5]",2,4,-2
31038.0,2019-12-04,"(1125.5, 1344.0]",2,3,-1
31039.0,2019-12-04,"(403.067, 637.25]",3,8,-5
31039.0,2019-12-04,"(637.25, 870.5]",1,1,0
31039.0,2019-12-04,"(870.5, 1103.75]",2,6,-4
31039.0,2019-12-04,"(1103.75, 1337.0]",3,6,-3
31040.0,2019-12-04,"(449.245, 638.75]",3,5,-2
31040.0,2019-12-04,"(638.75, 827.5]",1,1,0
31041.0,2019-12-04,"(450.366, 609.5]",2,4,-2
31041.0,2019-12-04,"(609.5, 768.0]",1,3,-2
31041.0,2019-12-04,"(768.0, 926.5]",3,3,0
31041.0,2019-12-04,"(926.5, 1085.0]",3,5,-2
31042.0,2019-12-04,"(449.132, 667.0]",13,14,-1
31042.0,2019-12-04,"(667.0, 884.0]",2,4,-2
31042.0,2019-12-04,"(1101.0, 1318.0]",1,6,-5
31043.0,2019-12-04,"(414.274, 596.5]",1,2,-1
31043.0,2019-12-04,"(959.5, 1141.0]",1,1,0
31044.0,2019-12-04,"(477.357, 638.75]",1,2,-1
31044.0,2019-12-04,"(638.75, 799.5]",1,2,-1
31044.0,2019-12-04,"(960.25, 1121.0]",1,2,-1
31045.0,2019-12-04,"(526.217, 722.75]",1,5,-4
31045.0,2019-12-04,"(722.75, 918.5]",1,1,0
31045.0,2019-12-04,"(1114.25, 1310.0]",3,1,2
31046.0,2019-12-04,"(466.031, 709.25]",1,2,-1
31046.0,2019-12-04,"(709.25, 951.5]",2,4,-2
31046.0,2019-12-04,"(1193.75, 1436.0]",1,1,0
31047.0,2019-12-04,"(370.997, 622.75]",9,21,-12
31047.0,2019-12-04,"(622.75, 873.5]",1,1,0
31047.0,2019-12-04,"(873.5, 1124.25]",8,18,-10
31047.0,2019-12-04,"(1124.25, 1375.0]",3,10,-7
31048.0,2019-12-04,"(397.017, 643.75]",5,7,-2
31048.0,2019-12-04,"(889.5, 1135.25]",5,2,3
31049.0,2019-12-04,"(321.5, 630.0]",1,1,0
31049.0,2019-12-04,"(938.5, 1247.0]",1,1,0
31050.0,2019-12-04,"(870.0, 981.0]",2,1,1
31051.0,2019-12-04,"(296.225, 490.75]",1,4,-3
31051.0,2019-12-04,"(878.25, 1072.0]",6,5,1
31052.0,2019-12-04,"(391.303, 566.25]",3,5,-2
31052.0,2019-12-04,"(566.25, 740.5]",1,2,-1
31052.0,2019-12-04,"(740.5, 914.75]",1,2,-1
31052.0,2019-12-04,"(914.75, 1089.0]",1,3,-2
31053.0,2019-12-04,"(559.896, 586.0]",1,1,0
31054.0,2019-12-04,"(900.841, 940.75]",1,1,0
,,,,1.0,
,,,,3.0,
31056.0,2019-12-04,"(740.25, 987.0]",1,1,0
31057.0,2019-12-04,"(1293.5, 1350.0]",1,1,0
31058.0,2019-12-04,"(721.664, 806.0]",1,2,-1
31058.0,2019-12-04,"(974.0, 1058.0]",1,1,0
31059.0,2019-12-04,"(341.217, 537.75]",1,3,-2
31059.0,2019-12-04,"(929.25, 1125.0]",1,1,0
31060.0,2019-12-04,"(801.682, 881.5]",1,2,-1
31060.0,2019-12-04,"(1040.5, 1120.0]",1,1,0
31061.0,2019-12-04,"(946.25, 1093.0]",1,1,0
31062.0,2019-12-04,"(518.533, 635.75]",1,3,-2
31062.0,2019-12-04,"(869.25, 986.0]",2,3,-1
,,,,2.0,
31064.0,2019-12-04,"(461.289, 639.75]",4,9,-5
31064.0,2019-12-04,"(817.5, 995.25]",1,1,0
31064.0,2019-12-04,"(995.25, 1173.0]",4,3,1
31065.0,2019-12-04,"(839.0, 1039.0]",2,2,0
31065.0,2019-12-04,"(1039.0, 1239.0]",3,1,2
31066.0,2019-12-04,"(868.5, 976.0]",1,1,0
31067.0,2019-12-04,"(822.0, 981.5]",1,2,-1
31067.0,2019-12-04,"(981.5, 1141.0]",1,1,0
31068.0,2019-12-04,"(770.25, 959.5]",1,1,0
31068.0,2019-12-04,"(959.5, 1148.75]",1,3,-2
31068.0,2019-12-04,"(1148.75, 1338.0]",2,1,1
31069.0,2019-12-04,"(667.0, 892.0]",1,3,-2
31069.0,2019-12-04,"(892.0, 1117.0]",3,2,1
31069.0,2019-12-04,"(1117.0, 1342.0]",3,4,-1
31070.0,2019-12-04,"(807.0, 1020.5]",1,2,-1
31070.0,2019-12-04,"(1020.5, 1234.0]",3,3,0
31071.0,2019-12-04,"(406.143, 621.25]",2,4,-2
31071.0,2019-12-04,"(621.25, 835.5]",1,4,-3
31071.0,2019-12-04,"(835.5, 1049.75]",1,2,-1
31071.0,2019-12-04,"(1049.75, 1264.0]",5,9,-4
,,,,2.0,
31073.0,2019-12-04,"(494.619, 590.25]",1,2,-1
31073.0,2019-12-04,"(780.75, 876.0]",1,2,-1
31074.0,2019-12-04,"(683.75, 893.5]",1,3,-2
31074.0,2019-12-04,"(893.5, 1103.25]",2,1,1
31074.0,2019-12-04,"(1103.25, 1313.0]",2,5,-3
,,,,1.0,
,,,,1.0,
31076.0,2019-12-04,"(427.234, 619.5]",1,2,-1
31076.0,2019-12-04,"(1002.5, 1194.0]",4,4,0
31077.0,2019-12-04,"(110.717, 432.75]",1,1,0
31077.0,2019-12-04,"(432.75, 753.5]",2,12,-10
31077.0,2019-12-04,"(753.5, 1074.25]",4,6,-2
31077.0,2019-12-04,"(1074.25, 1395.0]",4,4,0
31078.0,2019-12-04,"(474.478, 605.5]",5,6,-1
31078.0,2019-12-04,"(605.5, 736.0]",1,3,-2
31078.0,2019-12-04,"(736.0, 866.5]",2,3,-1
31078.0,2019-12-04,"(866.5, 997.0]",1,6,-5
31079.0,2019-12-04,"(23.591, 377.25]",1,1,0
31079.0,2019-12-04,"(377.25, 729.5]",1,6,-5
31079.0,2019-12-04,"(729.5, 1081.75]",2,3,-1
31079.0,2019-12-04,"(1081.75, 1434.0]",10,11,-1
31080.0,2019-12-04,"(829.0, 1051.0]",2,10,-8
31080.0,2019-12-04,"(1051.0, 1273.0]",5,4,1
31081.0,2019-12-04,"(480.365, 639.75]",2,2,0
31081.0,2019-12-04,"(639.75, 798.5]",2,3,-1
31081.0,2019-12-04,"(798.5, 957.25]",1,3,-2
31081.0,2019-12-04,"(957.25, 1116.0]",2,4,-2
,,,,1.0,
,,,,2.0,
31083.0,2019-12-04,"(882.25, 1041.0]",4,2,2
31084.0,2019-12-04,"(535.207, 734.25]",7,8,-1
31084.0,2019-12-04,"(734.25, 932.5]",1,3,-2
31084.0,2019-12-04,"(932.5, 1130.75]",2,5,-3
31084.0,2019-12-04,"(1130.75, 1329.0]",1,3,-2
31085.0,2019-12-04,"(400.249, 588.75]",1,3,-2
31085.0,2019-12-04,"(588.75, 776.5]",1,1,0
31085.0,2019-12-04,"(964.25, 1152.0]",1,1,0
31086.0,2019-12-04,"(928.25, 1094.0]",1,2,-1
31087.0,2019-12-04,"(915.75, 1064.0]",2,2,0
31088.0,2019-12-04,"(927.75, 1109.0]",5,3,2
31089.0,2019-12-04,"(475.172, 683.0]",4,9,-5
31089.0,2019-12-04,"(683.0, 890.0]",5,9,-4
31089.0,2019-12-04,"(890.0, 1097.0]",4,14,-10
31089.0,2019-12-04,"(1097.0, 1304.0]",3,11,-8
31090.0,2019-12-04,"(527.452, 665.0]",2,2,0
31090.0,2019-12-04,"(665.0, 802.0]",1,2,-1
31090.0,2019-12-04,"(939.0, 1076.0]",3,5,-2
31091.0,2019-12-04,"(918.0, 1159.5]",3,4,-1
31091.0,2019-12-04,"(1159.5, 1401.0]",2,3,-1
31092.0,2019-12-04,"(789.0, 961.0]",1,3,-2
31092.0,2019-12-04,"(961.0, 1133.0]",4,1,3
,,,,1.0,
,,,,1.0,
,,,,2.0,
,,,,3.0,
31094.0,2019-12-04,"(379.5, 506.0]",1,1,0
,,,,2.0,
31096.0,2019-12-04,"(478.52, 599.0]",2,2,0
31097.0,2019-12-04,"(532.355, 694.25]",3,3,0
31097.0,2019-12-04,"(694.25, 855.5]",1,3,-2
31097.0,2019-12-04,"(1016.75, 1178.0]",1,3,-2
31098.0,2019-12-04,"(442.154, 654.5]",6,15,-9
31098.0,2019-12-04,"(866.0, 1077.5]",5,9,-4
31098.0,2019-12-04,"(1077.5, 1289.0]",4,7,-3
31099.0,2019-12-04,"(884.5, 1129.25]",2,2,0
31099.0,2019-12-04,"(1129.25, 1374.0]",2,2,0
31100.0,2019-12-04,"(421.048, 660.0]",16,17,-1
31100.0,2019-12-04,"(660.0, 898.0]",2,7,-5
31100.0,2019-12-04,"(898.0, 1136.0]",5,20,-15
31100.0,2019-12-04,"(1136.0, 1374.0]",4,10,-6
31101.0,2019-12-04,"(-0.414, 354.5]",3,4,-1
31101.0,2019-12-04,"(354.5, 708.0]",14,53,-39
31101.0,2019-12-04,"(708.0, 1061.5]",21,34,-13
31101.0,2019-12-04,"(1061.5, 1415.0]",29,51,-22
31102.0,2019-12-04,"(353.973, 611.75]",2,19,-17
31102.0,2019-12-04,"(611.75, 868.5]",3,6,-3
31102.0,2019-12-04,"(868.5, 1125.25]",6,14,-8
31102.0,2019-12-04,"(1125.25, 1382.0]",9,12,-3
31103.0,2019-12-04,"(311.937, 578.75]",2,34,-32
31103.0,2019-12-04,"(578.75, 844.5]",5,18,-13
31103.0,2019-12-04,"(844.5, 1110.25]",8,15,-7
31103.0,2019-12-04,"(1110.25, 1376.0]",4,15,-11
31104.0,2019-12-04,"(297.884, 578.0]",7,26,-19
31104.0,2019-12-04,"(578.0, 857.0]",2,5,-3
31104.0,2019-12-04,"(857.0, 1136.0]",12,15,-3
31104.0,2019-12-04,"(1136.0, 1415.0]",13,25,-12
31105.0,2019-12-04,"(586.75, 839.5]",1,18,-17
31105.0,2019-12-04,"(839.5, 1092.25]",3,8,-5
31105.0,2019-12-04,"(1092.25, 1345.0]",9,7,2
31106.0,2019-12-04,"(676.25, 896.5]",1,5,-4
31106.0,2019-12-04,"(1116.75, 1337.0]",6,3,3
31107.0,2019-12-04,"(388.25, 723.5]",4,2,2
31107.0,2019-12-04,"(723.5, 1058.75]",7,25,-18
31107.0,2019-12-04,"(1058.75, 1394.0]",13,22,-9
31108.0,2019-12-04,"(20.676, 353.0]",1,1,0
31108.0,2019-12-04,"(353.0, 684.0]",11,22,-11
31108.0,2019-12-04,"(684.0, 1015.0]",12,24,-12
31108.0,2019-12-04,"(1015.0, 1346.0]",31,40,-9
31109.0,2019-12-04,"(16.803, 317.25]",1,2,-1
31109.0,2019-12-04,"(317.25, 616.5]",6,21,-15
31109.0,2019-12-04,"(616.5, 915.75]",1,6,-5
31109.0,2019-12-04,"(915.75, 1215.0]",26,38,-12
31110.0,2019-12-04,"(32.606, 382.5]",2,3,-1
31110.0,2019-12-04,"(382.5, 731.0]",19,50,-31
31110.0,2019-12-04,"(731.0, 1079.5]",12,28,-16
31110.0,2019-12-04,"(1079.5, 1428.0]",23,37,-14
31111.0,2019-12-04,"(22.596, 375.0]",2,3,-1
31111.0,2019-12-04,"(375.0, 726.0]",6,22,-16
31111.0,2019-12-04,"(726.0, 1077.0]",5,8,-3
31111.0,2019-12-04,"(1077.0, 1428.0]",15,21,-6
31112.0,2019-12-04,"(380.106, 604.5]",2,6,-4
31112.0,2019-12-04,"(828.0, 1051.5]",3,3,0
31112.0,2019-12-04,"(1051.5, 1275.0]",2,4,-2
31113.0,2019-12-04,"(-1.346, 336.5]",3,5,-2
31113.0,2019-12-04,"(336.5, 673.0]",3,18,-15
31113.0,2019-12-04,"(673.0, 1009.5]",2,2,0
31113.0,2019-12-04,"(1009.5, 1346.0]",16,27,-11
31114.0,2019-12-04,"(51.621, 397.75]",1,2,-1
31114.0,2019-12-04,"(397.75, 742.5]",4,26,-22
31114.0,2019-12-04,"(742.5, 1087.25]",14,26,-12
31114.0,2019-12-04,"(1087.25, 1432.0]",24,34,-10
31115.0,2019-12-04,"(859.0, 1117.0]",4,16,-12
31115.0,2019-12-04,"(1117.0, 1375.0]",11,4,7
31116.0,2019-12-04,"(356.015, 603.25]",5,26,-21
31116.0,2019-12-04,"(603.25, 849.5]",3,5,-2
31116.0,2019-12-04,"(849.5, 1095.75]",16,18,-2
31116.0,2019-12-04,"(1095.75, 1342.0]",8,14,-6
31117.0,2019-12-04,"(342.009, 590.75]",1,14,-13
31117.0,2019-12-04,"(590.75, 838.5]",1,5,-4
31117.0,2019-12-04,"(838.5, 1086.25]",11,20,-9
31117.0,2019-12-04,"(1086.25, 1334.0]",8,20,-12
31118.0,2019-12-04,"(460.227, 654.25]",1,16,-15
31118.0,2019-12-04,"(847.5, 1040.75]",2,2,0
31118.0,2019-12-04,"(1040.75, 1234.0]",11,11,0
31119.0,2019-12-04,"(356.932, 625.0]",7,25,-18
31119.0,2019-12-04,"(625.0, 892.0]",3,5,-2
31119.0,2019-12-04,"(892.0, 1159.0]",14,18,-4
31119.0,2019-12-04,"(1159.0, 1426.0]",3,10,-7
31120.0,2019-12-04,"(468.09, 696.5]",1,18,-17
31120.0,2019-12-04,"(696.5, 924.0]",2,6,-4
31120.0,2019-12-04,"(924.0, 1151.5]",6,9,-3
31120.0,2019-12-04,"(1151.5, 1379.0]",8,12,-4
31121.0,2019-12-04,"(340.024, 585.0]",16,26,-10
31121.0,2019-12-04,"(829.0, 1073.0]",3,2,1
31121.0,2019-12-04,"(1073.0, 1317.0]",8,10,-2
31122.0,2019-12-04,"(352.25, 689.5]",1,1,0
31122.0,2019-12-04,"(689.5, 1026.75]",6,12,-6
31122.0,2019-12-04,"(1026.75, 1364.0]",11,12,-1
31123.0,2019-12-04,"(24.606, 374.5]",2,3,-1
31123.0,2019-12-04,"(723.0, 1071.5]",3,19,-16
31123.0,2019-12-04,"(1071.5, 1420.0]",5,7,-2
31124.0,2019-12-04,"(232.881, 513.75]",13,24,-11
31124.0,2019-12-04,"(513.75, 793.5]",10,32,-22
31124.0,2019-12-04,"(793.5, 1073.25]",8,28,-20
31124.0,2019-12-04,"(1073.25, 1353.0]",14,46,-32
31125.0,2019-12-04,"(352.003, 602.25]",3,24,-21
31125.0,2019-12-04,"(602.25, 851.5]",4,6,-2
31125.0,2019-12-04,"(851.5, 1100.75]",20,30,-10
31125.0,2019-12-04,"(1100.75, 1350.0]",18,22,-4
31126.0,2019-12-04,"(295.963, 556.25]",3,25,-22
31126.0,2019-12-04,"(815.5, 1074.75]",7,8,-1
31126.0,2019-12-04,"(1074.75, 1334.0]",18,8,10
,,,,2.0,
31128.0,2019-12-04,"(31.599, 383.25]",4,7,-3
31128.0,2019-12-04,"(383.25, 733.5]",21,32,-11
31128.0,2019-12-04,"(733.5, 1083.75]",23,37,-14
31128.0,2019-12-04,"(1083.75, 1434.0]",14,35,-21
31129.0,2019-12-04,"(416.136, 633.0]",9,12,-3
31129.0,2019-12-04,"(633.0, 849.0]",2,3,-1
31129.0,2019-12-04,"(849.0, 1065.0]",3,7,-4
31129.0,2019-12-04,"(1065.0, 1281.0]",2,5,-3
31130.0,2019-12-04,"(377.977, 634.75]",2,14,-12
31130.0,2019-12-04,"(634.75, 890.5]",2,7,-5
31130.0,2019-12-04,"(890.5, 1146.25]",4,11,-7
31130.0,2019-12-04,"(1146.25, 1402.0]",8,8,0
31131.0,2019-12-04,"(402.17, 610.5]",2,13,-11
31131.0,2019-12-04,"(610.5, 818.0]",1,2,-1
31131.0,2019-12-04,"(818.0, 1025.5]",2,8,-6
31131.0,2019-12-04,"(1025.5, 1233.0]",3,4,-1
31200.0,2019-12-04,"(293.892, 572.0]",30,44,-14
31200.0,2019-12-04,"(572.0, 849.0]",17,32,-15
31200.0,2019-12-04,"(849.0, 1126.0]",24,48,-24
31200.0,2019-12-04,"(1126.0, 1403.0]",16,33,-17
31201.0,2019-12-04,"(304.92, 576.0]",15,39,-24
31201.0,2019-12-04,"(576.0, 846.0]",21,33,-12
31201.0,2019-12-04,"(846.0, 1116.0]",30,50,-20
31201.0,2019-12-04,"(1116.0, 1386.0]",24,41,-17
31202.0,2019-12-04,"(338.973, 596.75]",10,28,-18
31202.0,2019-12-04,"(596.75, 853.5]",10,23,-13
31202.0,2019-12-04,"(853.5, 1110.25]",19,26,-7
31202.0,2019-12-04,"(1110.25, 1367.0]",16,26,-10
31203.0,2019-12-04,"(369.25, 724.5]",12,2,10
31203.0,2019-12-04,"(724.5, 1079.75]",20,25,-5
31203.0,2019-12-04,"(1079.75, 1435.0]",20,35,-15
31204.0,2019-12-04,"(401.977, 658.75]",13,17,-4
31204.0,2019-12-04,"(658.75, 914.5]",15,27,-12
31204.0,2019-12-04,"(914.5, 1170.25]",6,20,-14
31204.0,2019-12-04,"(1170.25, 1426.0]",3,8,-5
31205.0,2019-12-04,"(385.0, 736.0]",42,2,40
31205.0,2019-12-04,"(736.0, 1087.0]",23,49,-26
31205.0,2019-12-04,"(1087.0, 1438.0]",5,39,-34
31206.0,2019-12-04,"(399.077, 630.75]",4,5,-1
31206.0,2019-12-04,"(630.75, 861.5]",2,3,-1
31206.0,2019-12-04,"(861.5, 1092.25]",4,13,-9
31207.0,2019-12-04,"(904.0, 1093.0]",2,9,-7
31207.0,2019-12-04,"(1093.0, 1282.0]",1,3,-2
31208.0,2019-12-04,"(325.894, 603.5]",12,13,-1
31208.0,2019-12-04,"(880.0, 1156.5]",4,1,3
31209.0,2019-12-04,"(487.119, 708.25]",2,3,-1
31209.0,2019-12-04,"(708.25, 928.5]",5,9,-4
31209.0,2019-12-04,"(928.5, 1148.75]",1,1,0
31209.0,2019-12-04,"(1148.75, 1369.0]",3,3,0
31211.0,2019-12-04,"(480.269, 663.75]",12,15,-3
31211.0,2019-12-04,"(663.75, 846.5]",2,4,-2
31211.0,2019-12-04,"(846.5, 1029.25]",1,4,-3
31211.0,2019-12-04,"(1029.25, 1212.0]",2,7,-5
31212.0,2019-12-04,"(64.657, 401.75]",2,3,-1
31212.0,2019-12-04,"(401.75, 737.5]",33,48,-15
31212.0,2019-12-04,"(737.5, 1073.25]",10,22,-12
31212.0,2019-12-04,"(1073.25, 1409.0]",15,30,-15
31213.0,2019-12-04,"(373.993, 626.75]",25,34,-9
31213.0,2019-12-04,"(626.75, 878.5]",6,17,-11
31213.0,2019-12-04,"(878.5, 1130.25]",18,42,-24
31213.0,2019-12-04,"(1130.25, 1382.0]",8,19,-11
31214.0,2019-12-04,"(368.75, 720.5]",12,2,10
31214.0,2019-12-04,"(720.5, 1072.25]",25,39,-14
31214.0,2019-12-04,"(1072.25, 1424.0]",22,47,-25
31215.0,2019-12-04,"(34.626, 379.5]",1,1,0
31215.0,2019-12-04,"(379.5, 723.0]",26,30,-4
31215.0,2019-12-04,"(723.0, 1066.5]",9,20,-11
31215.0,2019-12-04,"(1066.5, 1410.0]",6,13,-7
31216.0,2019-12-04,"(475.294, 652.5]",25,26,-1
31216.0,2019-12-04,"(652.5, 829.0]",6,8,-2
31216.0,2019-12-04,"(829.0, 1005.5]",7,10,-3
31216.0,2019-12-04,"(1005.5, 1182.0]",2,19,-17
31217.0,2019-12-04,"(330.268, 514.0]",7,8,-1
31217.0,2019-12-04,"(514.0, 697.0]",4,4,0
31217.0,2019-12-04,"(697.0, 880.0]",1,4,-3
31217.0,2019-12-04,"(880.0, 1063.0]",1,7,-6
31218.0,2019-12-04,"(327.957, 589.75]",11,28,-17
31218.0,2019-12-04,"(589.75, 850.5]",5,11,-6
31218.0,2019-12-04,"(850.5, 1111.25]",17,24,-7
31219.0,2019-12-04,"(296.0, 574.0]",12,1,11
31219.0,2019-12-04,"(574.0, 852.0]",13,13,0
31219.0,2019-12-04,"(852.0, 1130.0]",6,15,-9
31220.0,2019-12-04,"(289.182, 494.5]",8,12,-4
31220.0,2019-12-04,"(494.5, 699.0]",11,12,-1
31220.0,2019-12-04,"(903.5, 1108.0]",1,1,0
31221.0,2019-12-04,"(417.128, 636.0]",35,39,-4
31221.0,2019-12-04,"(636.0, 854.0]",15,20,-5
31221.0,2019-12-04,"(854.0, 1072.0]",3,15,-12
31221.0,2019-12-04,"(1072.0, 1290.0]",3,15,-12
31222.0,2019-12-04,"(379.071, 612.25]",18,22,-4
31222.0,2019-12-04,"(612.25, 844.5]",3,8,-5
31222.0,2019-12-04,"(844.5, 1076.75]",7,18,-11
31222.0,2019-12-04,"(1076.75, 1309.0]",1,11,-10
31223.0,2019-12-04,"(31.632, 375.0]",3,5,-2
31223.0,2019-12-04,"(375.0, 717.0]",14,44,-30
31223.0,2019-12-04,"(717.0, 1059.0]",11,26,-15
31223.0,2019-12-04,"(1059.0, 1401.0]",21,31,-10
31224.0,2019-12-04,"(307.903, 583.25]",21,24,-3
31224.0,2019-12-04,"(583.25, 857.5]",4,7,-3
31224.0,2019-12-04,"(857.5, 1131.75]",5,13,-8
31225.0,2019-12-04,"(363.035, 605.25]",10,16,-6
31225.0,2019-12-04,"(605.25, 846.5]",13,22,-9
31225.0,2019-12-04,"(846.5, 1087.75]",7,17,-10
31225.0,2019-12-04,"(1087.75, 1329.0]",5,11,-6
31226.0,2019-12-04,"(430.156, 642.0]",4,11,-7
31226.0,2019-12-04,"(642.0, 853.0]",2,4,-2
31226.0,2019-12-04,"(853.0, 1064.0]",10,17,-7
31226.0,2019-12-04,"(1064.0, 1275.0]",4,8,-4
31227.0,2019-12-04,"(418.16, 629.0]",42,48,-6
31227.0,2019-12-04,"(629.0, 839.0]",4,8,-4
31227.0,2019-12-04,"(839.0, 1049.0]",3,10,-7
31227.0,2019-12-04,"(1049.0, 1259.0]",2,17,-15
31228.0,2019-12-04,"(155.732, 474.0]",13,17,-4
31228.0,2019-12-04,"(474.0, 791.0]",21,29,-8
31228.0,2019-12-04,"(791.0, 1108.0]",21,41,-20
31228.0,2019-12-04,"(1108.0, 1425.0]",11,26,-15
31229.0,2019-12-04,"(297.872, 581.0]",11,47,-36
31229.0,2019-12-04,"(581.0, 863.0]",12,31,-19
31229.0,2019-12-04,"(863.0, 1145.0]",25,39,-14
31229.0,2019-12-04,"(1145.0, 1427.0]",9,21,-12
31230.0,2019-12-04,"(21.626, 366.5]",1,3,-2
31230.0,2019-12-04,"(366.5, 710.0]",59,72,-13
31230.0,2019-12-04,"(710.0, 1053.5]",20,38,-18
31230.0,2019-12-04,"(1053.5, 1397.0]",10,37,-27
31231.0,2019-12-04,"(330.914, 603.5]",15,20,-5
31231.0,2019-12-04,"(603.5, 875.0]",6,13,-7
31231.0,2019-12-04,"(875.0, 1146.5]",10,24,-14
31232.0,2019-12-04,"(35.676, 368.0]",2,3,-1
31232.0,2019-12-04,"(368.0, 699.0]",20,28,-8
31232.0,2019-12-04,"(699.0, 1030.0]",5,14,-9
31232.0,2019-12-04,"(1030.0, 1361.0]",10,22,-12
31233.0,2019-12-04,"(2.644, 343.0]",1,3,-2
31233.0,2019-12-04,"(343.0, 682.0]",56,63,-7
31233.0,2019-12-04,"(682.0, 1021.0]",17,26,-9
31233.0,2019-12-04,"(1021.0, 1360.0]",11,32,-21
31234.0,2019-12-04,"(317.909, 591.75]",19,39,-20
31234.0,2019-12-04,"(591.75, 864.5]",7,17,-10
31234.0,2019-12-04,"(864.5, 1137.25]",19,31,-12
31234.0,2019-12-04,"(1137.25, 1410.0]",6,16,-10
31235.0,2019-12-04,"(634.533, 751.75]",2,2,0
31235.0,2019-12-04,"(985.25, 1102.0]",1,2,-1
31236.0,2019-12-04,"(355.091, 583.25]",15,17,-2
31236.0,2019-12-04,"(583.25, 810.5]",12,21,-9
31236.0,2019-12-04,"(810.5, 1037.75]",13,32,-19
31236.0,2019-12-04,"(1037.75, 1265.0]",11,32,-21
31237.0,2019-12-04,"(37.661, 373.75]",1,1,0
31237.0,2019-12-04,"(373.75, 708.5]",8,16,-8
31237.0,2019-12-04,"(708.5, 1043.25]",12,20,-8
31237.0,2019-12-04,"(1043.25, 1378.0]",8,18,-10
31238.0,2019-12-04,"(57.761, 368.75]",1,1,0
31238.0,2019-12-04,"(368.75, 678.5]",26,29,-3
31238.0,2019-12-04,"(678.5, 988.25]",6,13,-7
31238.0,2019-12-04,"(988.25, 1298.0]",4,23,-19
31239.0,2019-12-04,"(360.051, 598.25]",22,24,-2
31239.0,2019-12-04,"(598.25, 835.5]",6,8,-2
31239.0,2019-12-04,"(835.5, 1072.75]",6,17,-11
31239.0,2019-12-04,"(1072.75, 1310.0]",13,32,-19
31240.0,2019-12-04,"(380.282, 560.5]",1,2,-1
31240.0,2019-12-04,"(560.5, 740.0]",1,2,-1
31240.0,2019-12-04,"(919.5, 1099.0]",1,3,-2
31241.0,2019-12-04,"(18.606, 368.5]",1,5,-4
31241.0,2019-12-04,"(368.5, 717.0]",29,53,-24
31241.0,2019-12-04,"(717.0, 1065.5]",12,33,-21
31241.0,2019-12-04,"(1065.5, 1414.0]",18,34,-16
31242.0,2019-12-04,"(142.815, 440.25]",4,6,-2
31242.0,2019-12-04,"(440.25, 736.5]",41,48,-7
31242.0,2019-12-04,"(736.5, 1032.75]",9,30,-21
31242.0,2019-12-04,"(1032.75, 1329.0]",2,28,-26
31243.0,2019-12-04,"(387.998, 639.5]",31,35,-4
31243.0,2019-12-04,"(639.5, 890.0]",2,2,0
31243.0,2019-12-04,"(890.0, 1140.5]",10,35,-25
31243.0,2019-12-04,"(1140.5, 1391.0]",2,5,-3
31244.0,2019-12-04,"(87.747, 402.25]",1,2,-1
31244.0,2019-12-04,"(402.25, 715.5]",10,24,-14
31244.0,2019-12-04,"(715.5, 1028.75]",5,14,-9
31244.0,2019-12-04,"(1028.75, 1342.0]",11,23,-12
31245.0,2019-12-04,"(377.014, 624.5]",8,21,-13
31245.0,2019-12-04,"(624.5, 871.0]",5,13,-8
31245.0,2019-12-04,"(871.0, 1117.5]",15,24,-9
31245.0,2019-12-04,"(1117.5, 1364.0]",8,17,-9
31246.0,2019-12-04,"(346.015, 593.25]",13,20,-7
31246.0,2019-12-04,"(593.25, 839.5]",6,9,-3
31246.0,2019-12-04,"(839.5, 1085.75]",3,6,-3
31246.0,2019-12-04,"(1085.75, 1332.0]",7,18,-11
31247.0,2019-12-04,"(399.222, 594.5]",8,11,-3
31247.0,2019-12-04,"(594.5, 789.0]",4,5,-1
31247.0,2019-12-04,"(789.0, 983.5]",9,19,-10
31247.0,2019-12-04,"(983.5, 1178.0]",3,9,-6
31248.0,2019-12-04,"(356.0, 607.0]",10,14,-4
31248.0,2019-12-04,"(607.0, 857.0]",2,6,-4
31248.0,2019-12-04,"(857.0, 1107.0]",14,26,-12
31248.0,2019-12-04,"(1107.0, 1357.0]",1,6,-5
31249.0,2019-12-04,"(426.256, 613.0]",7,13,-6
31249.0,2019-12-04,"(613.0, 799.0]",2,4,-2
31249.0,2019-12-04,"(799.0, 985.0]",1,3,-2
31249.0,2019-12-04,"(985.0, 1171.0]",5,10,-5
31250.0,2019-12-04,"(410.064, 645.0]",21,22,-1
31250.0,2019-12-04,"(645.0, 879.0]",6,13,-7
31250.0,2019-12-04,"(879.0, 1113.0]",8,23,-15
31250.0,2019-12-04,"(1113.0, 1347.0]",2,7,-5
31251.0,2019-12-04,"(241.808, 541.0]",13,24,-11
31251.0,2019-12-04,"(541.0, 839.0]",6,13,-7
31251.0,2019-12-04,"(839.0, 1137.0]",10,28,-18
31251.0,2019-12-04,"(1137.0, 1435.0]",11,16,-5
31252.0,2019-12-04,"(474.204, 674.0]",17,21,-4
31252.0,2019-12-04,"(674.0, 873.0]",4,6,-2
31252.0,2019-12-04,"(873.0, 1072.0]",3,8,-5
31252.0,2019-12-04,"(1072.0, 1271.0]",1,11,-10
31253.0,2019-12-04,"(365.5, 707.0]",23,1,22
31253.0,2019-12-04,"(707.0, 1048.5]",10,25,-15
31253.0,2019-12-04,"(1048.5, 1390.0]",4,24,-20
31254.0,2019-12-04,"(133.82, 430.0]",1,2,-1
31254.0,2019-12-04,"(430.0, 725.0]",25,28,-3
31254.0,2019-12-04,"(725.0, 1020.0]",4,10,-6
31254.0,2019-12-04,"(1020.0, 1315.0]",2,19,-17
31255.0,2019-12-04,"(373.001, 623.75]",23,35,-12
31255.0,2019-12-04,"(623.75, 873.5]",3,7,-4
31255.0,2019-12-04,"(873.5, 1123.25]",5,17,-12
31255.0,2019-12-04,"(1123.25, 1373.0]",3,7,-4
31256.0,2019-12-04,"(273.999, 525.25]",13,14,-1
31256.0,2019-12-04,"(525.25, 775.5]",5,12,-7
31256.0,2019-12-04,"(775.5, 1025.75]",10,16,-6
31256.0,2019-12-04,"(1025.75, 1276.0]",6,13,-7
31257.0,2019-12-04,"(91.671, 425.25]",4,4,0
31257.0,2019-12-04,"(425.25, 757.5]",29,47,-18
31257.0,2019-12-04,"(757.5, 1089.75]",16,38,-22
31257.0,2019-12-04,"(1089.75, 1422.0]",13,32,-19
31258.0,2019-12-04,"(322.33, 490.5]",15,29,-14
31258.0,2019-12-04,"(490.5, 658.0]",1,2,-1
31258.0,2019-12-04,"(658.0, 825.5]",3,3,0
31258.0,2019-12-04,"(825.5, 993.0]",2,5,-3
31259.0,2019-12-04,"(413.211, 611.25]",10,10,0
31259.0,2019-12-04,"(611.25, 808.5]",1,1,0
31259.0,2019-12-04,"(808.5, 1005.75]",4,7,-3
31259.0,2019-12-04,"(1005.75, 1203.0]",1,13,-12
31260.0,2019-12-04,"(394.064, 629.0]",19,21,-2
31260.0,2019-12-04,"(629.0, 863.0]",2,9,-7
31260.0,2019-12-04,"(863.0, 1097.0]",3,17,-14
31260.0,2019-12-04,"(1097.0, 1331.0]",4,6,-2
31261.0,2019-12-04,"(404.363, 564.25]",15,17,-2
31261.0,2019-12-04,"(564.25, 723.5]",2,2,0
31262.0,2019-12-04,"(420.114, 642.5]",10,11,-1
31262.0,2019-12-04,"(642.5, 864.0]",1,3,-2
31262.0,2019-12-04,"(864.0, 1085.5]",4,8,-4
31262.0,2019-12-04,"(1085.5, 1307.0]",3,9,-6
31263.0,2019-12-04,"(310.96, 572.0]",17,26,-9
31263.0,2019-12-04,"(572.0, 832.0]",5,6,-1
31263.0,2019-12-04,"(832.0, 1092.0]",7,24,-17
31263.0,2019-12-04,"(1092.0, 1352.0]",5,16,-11
31264.0,2019-12-04,"(463.108, 687.0]",23,29,-6
31264.0,2019-12-04,"(687.0, 910.0]",4,8,-4
31264.0,2019-12-04,"(910.0, 1133.0]",10,22,-12
31265.0,2019-12-04,"(22.596, 375.0]",1,3,-2
31265.0,2019-12-04,"(375.0, 726.0]",20,42,-22
31265.0,2019-12-04,"(726.0, 1077.0]",21,33,-12
31265.0,2019-12-04,"(1077.0, 1428.0]",18,32,-14
31266.0,2019-12-04,"(48.682, 379.5]",2,9,-7
31266.0,2019-12-04,"(379.5, 709.0]",12,28,-16
31266.0,2019-12-04,"(709.0, 1038.5]",10,19,-9
31266.0,2019-12-04,"(1038.5, 1368.0]",24,46,-22
31267.0,2019-12-04,"(359.0, 702.0]",21,1,20
31267.0,2019-12-04,"(702.0, 1045.0]",15,43,-28
31267.0,2019-12-04,"(1045.0, 1388.0]",20,33,-13
31268.0,2019-12-04,"(67.741, 383.75]",1,3,-2
31268.0,2019-12-04,"(383.75, 698.5]",18,56,-38
31268.0,2019-12-04,"(698.5, 1013.25]",12,15,-3
31268.0,2019-12-04,"(1013.25, 1328.0]",25,39,-14
31269.0,2019-12-04,"(360.088, 589.0]",10,14,-4
31269.0,2019-12-04,"(589.0, 817.0]",5,11,-6
31269.0,2019-12-04,"(817.0, 1045.0]",7,19,-12
31269.0,2019-12-04,"(1045.0, 1273.0]",5,14,-9
31270.0,2019-12-04,"(259.822, 555.5]",14,20,-6
31270.0,2019-12-04,"(555.5, 850.0]",4,10,-6
31270.0,2019-12-04,"(850.0, 1144.5]",8,19,-11
31270.0,2019-12-04,"(1144.5, 1439.0]",4,9,-5
31271.0,2019-12-04,"(461.264, 646.0]",16,17,-1
31271.0,2019-12-04,"(830.0, 1014.0]",11,4,7
31272.0,2019-12-04,"(293.969, 552.75]",26,28,-2
31272.0,2019-12-04,"(552.75, 810.5]",14,15,-1
31272.0,2019-12-04,"(810.5, 1068.25]",5,17,-12
31272.0,2019-12-04,"(1068.25, 1326.0]",1,11,-10
31273.0,2019-12-04,"(354.125, 573.75]",4,8,-4
31273.0,2019-12-04,"(792.5, 1011.25]",1,1,0
31273.0,2019-12-04,"(1011.25, 1230.0]",3,1,2
31274.0,2019-12-04,"(349.054, 586.5]",17,19,-2
31274.0,2019-12-04,"(586.5, 823.0]",3,5,-2
31274.0,2019-12-04,"(823.0, 1059.5]",3,9,-6
31274.0,2019-12-04,"(1059.5, 1296.0]",3,12,-9
31275.0,2019-12-04,"(-0.346, 337.5]",2,3,-1
31275.0,2019-12-04,"(337.5, 674.0]",24,41,-17
31275.0,2019-12-04,"(674.0, 1010.5]",17,35,-18
31275.0,2019-12-04,"(1010.5, 1347.0]",16,32,-16
31276.0,2019-12-04,"(450.031, 693.25]",24,28,-4
31276.0,2019-12-04,"(693.25, 935.5]",2,4,-2
31276.0,2019-12-04,"(935.5, 1177.75]",7,28,-21
31277.0,2019-12-04,"(259.066, 493.5]",13,15,-2
31277.0,2019-12-04,"(493.5, 727.0]",39,48,-9
31277.0,2019-12-04,"(727.0, 960.5]",12,22,-10
31277.0,2019-12-04,"(960.5, 1194.0]",7,29,-22
31278.0,2019-12-04,"(298.004, 548.0]",4,24,-20
31278.0,2019-12-04,"(548.0, 797.0]",5,15,-10
31278.0,2019-12-04,"(797.0, 1046.0]",7,18,-11
31278.0,2019-12-04,"(1046.0, 1295.0]",21,30,-9
31279.0,2019-12-04,"(398.183, 603.25]",22,24,-2
31279.0,2019-12-04,"(603.25, 807.5]",7,13,-6
31279.0,2019-12-04,"(807.5, 1011.75]",3,9,-6
31279.0,2019-12-04,"(1011.75, 1216.0]",5,26,-21
31280.0,2019-12-04,"(26.7, 353.0]",3,3,0
31280.0,2019-12-04,"(353.0, 678.0]",6,21,-15
31280.0,2019-12-04,"(678.0, 1003.0]",3,10,-7
31280.0,2019-12-04,"(1003.0, 1328.0]",19,29,-10
31000.0,2019-12-05,"(467.35, 630.5]",3,6,-3
31000.0,2019-12-05,"(630.5, 793.0]",1,3,-2
31000.0,2019-12-05,"(793.0, 955.5]",4,4,0
31000.0,2019-12-05,"(955.5, 1118.0]",2,3,-1
,,,,1.0,
,,,,1.0,
,,,,2.0,
31002.0,2019-12-05,"(125.884, 406.0]",1,1,0
31002.0,2019-12-05,"(406.0, 685.0]",6,9,-3
31002.0,2019-12-05,"(685.0, 964.0]",3,4,-1
31002.0,2019-12-05,"(964.0, 1243.0]",3,9,-6
31003.0,2019-12-05,"(470.271, 653.25]",2,5,-3
31003.0,2019-12-05,"(653.25, 835.5]",5,9,-4
31003.0,2019-12-05,"(1017.75, 1200.0]",1,1,0
31004.0,2019-12-05,"(787.0, 945.5]",1,2,-1
31004.0,2019-12-05,"(945.5, 1104.0]",2,1,1
31005.0,2019-12-05,"(435.139, 651.25]",4,5,-1
31005.0,2019-12-05,"(651.25, 866.5]",1,4,-3
31005.0,2019-12-05,"(866.5, 1081.75]",1,1,0
31006.0,2019-12-05,"(587.375, 744.25]",2,2,0
31006.0,2019-12-05,"(744.25, 900.5]",1,2,-1
31006.0,2019-12-05,"(900.5, 1056.75]",1,2,-1
31007.0,2019-12-05,"(361.002, 611.5]",3,14,-11
31007.0,2019-12-05,"(611.5, 861.0]",4,6,-2
31007.0,2019-12-05,"(861.0, 1110.5]",15,29,-14
31007.0,2019-12-05,"(1110.5, 1360.0]",5,7,-2
31009.0,2019-12-05,"(463.255, 650.25]",3,4,-1
31009.0,2019-12-05,"(650.25, 836.5]",2,3,-1
31009.0,2019-12-05,"(1022.75, 1209.0]",2,4,-2
31010.0,2019-12-05,"(438.386, 592.5]",1,1,0
31010.0,2019-12-05,"(592.5, 746.0]",1,2,-1
31011.0,2019-12-05,"(123.873, 406.75]",2,3,-1
31011.0,2019-12-05,"(406.75, 688.5]",5,8,-3
31011.0,2019-12-05,"(688.5, 970.25]",1,9,-8
31011.0,2019-12-05,"(970.25, 1252.0]",3,10,-7
31012.0,2019-12-05,"(365.256, 552.0]",3,3,0
31012.0,2019-12-05,"(552.0, 738.0]",2,3,-1
31013.0,2019-12-05,"(512.154, 724.5]",1,4,-3
31013.0,2019-12-05,"(724.5, 936.0]",1,5,-4
31013.0,2019-12-05,"(936.0, 1147.5]",1,1,0
31013.0,2019-12-05,"(1147.5, 1359.0]",3,6,-3
31014.0,2019-12-05,"(344.927, 614.25]",21,28,-7
31014.0,2019-12-05,"(614.25, 882.5]",7,13,-6
31014.0,2019-12-05,"(882.5, 1150.75]",10,23,-13
31014.0,2019-12-05,"(1150.75, 1419.0]",5,7,-2
31015.0,2019-12-05,"(306.16, 517.0]",9,10,-1
31015.0,2019-12-05,"(517.0, 727.0]",3,5,-2
31015.0,2019-12-05,"(727.0, 937.0]",5,8,-3
31016.0,2019-12-05,"(437.376, 594.0]",6,15,-9
31016.0,2019-12-05,"(750.0, 906.0]",2,5,-3
31016.0,2019-12-05,"(906.0, 1062.0]",3,6,-3
31017.0,2019-12-05,"(474.083, 704.25]",4,5,-1
31017.0,2019-12-05,"(933.5, 1162.75]",2,2,0
31018.0,2019-12-05,"(59.669, 393.75]",1,1,0
31018.0,2019-12-05,"(726.5, 1059.25]",4,6,-2
31018.0,2019-12-05,"(1059.25, 1392.0]",4,4,0
31019.0,2019-12-05,"(374.25, 679.5]",1,1,0
31019.0,2019-12-05,"(679.5, 984.75]",2,3,-1
31019.0,2019-12-05,"(984.75, 1290.0]",3,3,0
31020.0,2019-12-05,"(506.164, 716.0]",1,1,0
31020.0,2019-12-05,"(925.0, 1134.0]",1,3,-2
31021.0,2019-12-05,"(380.943, 646.25]",1,4,-3
31021.0,2019-12-05,"(646.25, 910.5]",1,3,-2
31021.0,2019-12-05,"(910.5, 1174.75]",5,9,-4
31022.0,2019-12-05,"(478.145, 692.75]",1,6,-5
31022.0,2019-12-05,"(906.5, 1120.25]",2,4,-2
31022.0,2019-12-05,"(1120.25, 1334.0]",2,7,-5
31023.0,2019-12-05,"(390.25, 726.5]",1,1,0
31023.0,2019-12-05,"(726.5, 1062.75]",1,3,-2
31024.0,2019-12-05,"(381.981, 637.75]",8,12,-4
31024.0,2019-12-05,"(637.75, 892.5]",1,4,-3
31024.0,2019-12-05,"(892.5, 1147.25]",4,11,-7
31024.0,2019-12-05,"(1147.25, 1402.0]",1,7,-6
,,,,1.0,
,,,,2.0,
,,,,1.0,
,,,,1.0,
31026.0,2019-12-05,"(664.5, 974.75]",1,1,0
31026.0,2019-12-05,"(974.75, 1285.0]",2,2,0
31027.0,2019-12-05,"(713.0, 875.0]",5,1,4
31027.0,2019-12-05,"(875.0, 1037.0]",1,6,-5
31028.0,2019-12-05,"(484.155, 696.25]",1,1,0
31028.0,2019-12-05,"(1118.75, 1330.0]",1,1,0
31029.0,2019-12-05,"(659.75, 872.5]",1,4,-3
31029.0,2019-12-05,"(872.5, 1085.25]",4,1,3
31029.0,2019-12-05,"(1085.25, 1298.0]",2,6,-4
31030.0,2019-12-05,"(864.0, 1075.0]",3,9,-6
31030.0,2019-12-05,"(1075.0, 1286.0]",3,5,-2
31031.0,2019-12-05,"(693.5, 907.0]",2,4,-2
31031.0,2019-12-05,"(907.0, 1120.5]",1,6,-5
31031.0,2019-12-05,"(1120.5, 1334.0]",5,3,2
31032.0,2019-12-05,"(687.75, 851.5]",1,1,0
31032.0,2019-12-05,"(1015.25, 1179.0]",2,1,1
,,,,2.0,
31034.0,2019-12-05,"(384.102, 609.5]",5,8,-3
31034.0,2019-12-05,"(609.5, 834.0]",1,1,0
31034.0,2019-12-05,"(1058.5, 1283.0]",3,7,-4
31035.0,2019-12-05,"(585.243, 775.25]",1,2,-1
31035.0,2019-12-05,"(775.25, 964.5]",2,4,-2
31035.0,2019-12-05,"(964.5, 1153.75]",4,4,0
31035.0,2019-12-05,"(1153.75, 1343.0]",1,1,0
31036.0,2019-12-05,"(764.0, 943.5]",1,4,-3
31036.0,2019-12-05,"(943.5, 1123.0]",3,1,2
31037.0,2019-12-05,"(353.984, 609.0]",13,18,-5
31037.0,2019-12-05,"(609.0, 863.0]",7,11,-4
31037.0,2019-12-05,"(863.0, 1117.0]",4,15,-11
31037.0,2019-12-05,"(1117.0, 1371.0]",2,8,-6
31038.0,2019-12-05,"(540.203, 740.25]",4,5,-1
31038.0,2019-12-05,"(740.25, 939.5]",1,4,-3
31038.0,2019-12-05,"(939.5, 1138.75]",1,3,-2
31038.0,2019-12-05,"(1138.75, 1338.0]",2,2,0
31039.0,2019-12-05,"(452.31, 625.5]",4,10,-6
31039.0,2019-12-05,"(625.5, 798.0]",2,2,0
31039.0,2019-12-05,"(798.0, 970.5]",1,2,-1
31039.0,2019-12-05,"(970.5, 1143.0]",5,9,-4
31040.0,2019-12-05,"(443.562, 553.5]",3,3,0
31041.0,2019-12-05,"(468.624, 563.0]",1,2,-1
31041.0,2019-12-05,"(751.0, 845.0]",1,1,0
31042.0,2019-12-05,"(440.205, 639.75]",11,12,-1
31042.0,2019-12-05,"(639.75, 838.5]",1,3,-2
31042.0,2019-12-05,"(1037.25, 1236.0]",3,6,-3
31043.0,2019-12-05,"(423.296, 600.0]",1,4,-3
31044.0,2019-12-05,"(474.35, 637.5]",2,3,-1
31044.0,2019-12-05,"(637.5, 800.0]",1,1,0
31044.0,2019-12-05,"(962.5, 1125.0]",2,1,1
31045.0,2019-12-05,"(788.5, 868.75]",1,2,-1
31045.0,2019-12-05,"(868.75, 949.0]",1,1,0
31046.0,2019-12-05,"(588.25, 735.5]",1,1,0
31046.0,2019-12-05,"(882.75, 1030.0]",1,2,-1
31047.0,2019-12-05,"(346.973, 604.75]",15,23,-8
31047.0,2019-12-05,"(604.75, 861.5]",2,3,-1
31047.0,2019-12-05,"(861.5, 1118.25]",5,15,-10
31047.0,2019-12-05,"(1118.25, 1375.0]",1,6,-5
31048.0,2019-12-05,"(441.127, 660.25]",4,6,-2
31048.0,2019-12-05,"(878.5, 1096.75]",5,6,-1
31048.0,2019-12-05,"(1096.75, 1315.0]",2,9,-7
31049.0,2019-12-05,"(534.257, 720.75]",2,3,-1
31049.0,2019-12-05,"(1092.25, 1278.0]",1,1,0
,,,,1.0,
,,,,1.0,
31051.0,2019-12-05,"(28.693, 356.75]",1,3,-2
31051.0,2019-12-05,"(683.5, 1010.25]",2,3,-1
31051.0,2019-12-05,"(1010.25, 1337.0]",6,4,2
31052.0,2019-12-05,"(518.391, 671.25]",2,2,0
31052.0,2019-12-05,"(975.75, 1128.0]",1,3,-2
31053.0,2019-12-05,"(971.5, 1015.0]",1,1,0
31053.0,2019-12-05,"(1058.5, 1102.0]",1,1,0
31054.0,2019-12-05,"(753.75, 1005.0]",1,1,0
31055.0,2019-12-05,"(495.915, 517.25]",1,2,-1
31056.0,2019-12-05,"(717.5, 922.0]",1,1,0
31056.0,2019-12-05,"(922.0, 1126.5]",1,2,-1
31056.0,2019-12-05,"(1126.5, 1331.0]",1,1,0
,,,,2.0,
31058.0,2019-12-05,"(726.301, 901.75]",1,2,-1
31059.0,2019-12-05,"(800.25, 1067.0]",1,1,0
,,,,2.0,
31061.0,2019-12-05,"(496.994, 498.5]",1,1,0
31062.0,2019-12-05,"(734.478, 865.5]",2,3,-1
31062.0,2019-12-05,"(996.0, 1126.5]",1,1,0
31062.0,2019-12-05,"(1126.5, 1257.0]",1,1,0
31063.0,2019-12-05,"(912.5, 1002.0]",1,1,0
31064.0,2019-12-05,"(513.263, 698.25]",2,5,-3
31064.0,2019-12-05,"(698.25, 882.5]",1,2,-1
31064.0,2019-12-05,"(1066.75, 1251.0]",1,3,-2
31065.0,2019-12-05,"(767.0, 962.0]",2,2,0
31065.0,2019-12-05,"(962.0, 1157.0]",1,2,-1
31066.0,2019-12-05,"(718.25, 781.0]",1,1,0
31067.0,2019-12-05,"(899.0, 1154.0]",2,1,1
31068.0,2019-12-05,"(59.676, 392.0]",2,2,0
31068.0,2019-12-05,"(392.0, 723.0]",1,3,-2
31068.0,2019-12-05,"(1054.0, 1385.0]",3,4,-1
31069.0,2019-12-05,"(395.149, 608.75]",2,9,-7
31069.0,2019-12-05,"(608.75, 821.5]",2,2,0
31069.0,2019-12-05,"(821.5, 1034.25]",2,4,-2
31069.0,2019-12-05,"(1034.25, 1247.0]",2,2,0
31070.0,2019-12-05,"(906.5, 1159.75]",6,2,4
31070.0,2019-12-05,"(1159.75, 1413.0]",1,1,0
31071.0,2019-12-05,"(322.023, 567.25]",1,4,-3
31071.0,2019-12-05,"(567.25, 811.5]",5,10,-5
31071.0,2019-12-05,"(811.5, 1055.75]",4,7,-3
31071.0,2019-12-05,"(1055.75, 1300.0]",6,10,-4
,,,,2.0,
31073.0,2019-12-05,"(476.444, 616.0]",2,4,-2
31073.0,2019-12-05,"(894.0, 1033.0]",1,1,0
31074.0,2019-12-05,"(724.25, 752.5]",1,1,0
31075.0,2019-12-05,"(906.75, 1209.0]",1,1,0
31076.0,2019-12-05,"(918.0, 1064.0]",2,1,1
31077.0,2019-12-05,"(178.843, 469.25]",1,2,-1
31077.0,2019-12-05,"(469.25, 758.5]",1,7,-6
31077.0,2019-12-05,"(758.5, 1047.75]",8,11,-3
31077.0,2019-12-05,"(1047.75, 1337.0]",7,10,-3
31078.0,2019-12-05,"(465.506, 589.5]",7,7,0
31078.0,2019-12-05,"(713.0, 836.5]",3,3,0
31079.0,2019-12-05,"(47.631, 391.25]",1,1,0
31079.0,2019-12-05,"(733.5, 1075.75]",1,12,-11
31079.0,2019-12-05,"(1075.75, 1418.0]",5,1,4
31080.0,2019-12-05,"(78.709, 402.75]",1,2,-1
31080.0,2019-12-05,"(402.75, 725.5]",1,11,-10
31080.0,2019-12-05,"(725.5, 1048.25]",2,2,0
31080.0,2019-12-05,"(1048.25, 1371.0]",8,11,-3
31081.0,2019-12-05,"(422.327, 591.25]",1,1,0
31081.0,2019-12-05,"(759.5, 927.75]",1,2,-1
31081.0,2019-12-05,"(927.75, 1096.0]",2,3,-1
31082.0,2019-12-05,"(870.611, 968.25]",1,2,-1
31082.0,2019-12-05,"(1162.75, 1260.0]",1,1,0
31083.0,2019-12-05,"(860.75, 968.0]",2,1,1
31084.0,2019-12-05,"(455.266, 639.5]",5,5,0
31084.0,2019-12-05,"(639.5, 823.0]",3,3,0
31084.0,2019-12-05,"(1006.5, 1190.0]",1,4,-3
31085.0,2019-12-05,"(389.026, 633.5]",1,4,-3
31085.0,2019-12-05,"(877.0, 1120.5]",2,2,0
31086.0,2019-12-05,"(913.0, 1141.0]",2,1,1
31086.0,2019-12-05,"(1141.0, 1369.0]",1,3,-2
31087.0,2019-12-05,"(759.0, 918.0]",1,2,-1
31087.0,2019-12-05,"(918.0, 1077.0]",1,2,-1
31088.0,2019-12-05,"(934.5, 1079.0]",3,2,1
31089.0,2019-12-05,"(411.022, 656.5]",11,16,-5
31089.0,2019-12-05,"(656.5, 901.0]",2,3,-1
31089.0,2019-12-05,"(901.0, 1145.5]",4,18,-14
31090.0,2019-12-05,"(622.0, 815.0]",1,2,-1
31090.0,2019-12-05,"(1008.0, 1201.0]",2,1,1
31091.0,2019-12-05,"(1019.75, 1215.0]",2,4,-2
31092.0,2019-12-05,"(671.5, 906.0]",1,3,-2
31092.0,2019-12-05,"(906.0, 1140.5]",2,2,0
31092.0,2019-12-05,"(1140.5, 1375.0]",1,2,-1
,,,,1.0,
,,,,2.0,
,,,,1.0,
,,,,3.0,
31094.0,2019-12-05,"(1260.0, 1338.0]",1,1,0
,,,,2.0,
31096.0,2019-12-05,"(46.058, 282.5]",1,2,-1
31097.0,2019-12-05,"(534.301, 709.75]",2,2,0
31097.0,2019-12-05,"(709.75, 884.5]",1,1,0
31097.0,2019-12-05,"(1059.25, 1234.0]",3,2,1
31098.0,2019-12-05,"(420.07, 653.5]",5,10,-5
31098.0,2019-12-05,"(886.0, 1118.5]",5,1,4
31098.0,2019-12-05,"(1118.5, 1351.0]",2,9,-7
31099.0,2019-12-05,"(760.5, 898.25]",1,2,-1
31099.0,2019-12-05,"(898.25, 1036.0]",2,2,0
31100.0,2019-12-05,"(380.75, 733.5]",17,1,16
31100.0,2019-12-05,"(733.5, 1086.25]",7,19,-12
31100.0,2019-12-05,"(1086.25, 1439.0]",3,24,-21
31101.0,2019-12-05,"(23.617, 370.75]",3,4,-1
31101.0,2019-12-05,"(370.75, 716.5]",13,49,-36
31101.0,2019-12-05,"(716.5, 1062.25]",29,54,-25
31101.0,2019-12-05,"(1062.25, 1408.0]",29,48,-19
31102.0,2019-12-05,"(-0.433, 359.25]",1,2,-1
31102.0,2019-12-05,"(359.25, 717.5]",4,27,-23
31102.0,2019-12-05,"(717.5, 1075.75]",3,13,-10
31102.0,2019-12-05,"(1075.75, 1434.0]",16,23,-7
31103.0,2019-12-05,"(319.957, 581.75]",1,28,-27
31103.0,2019-12-05,"(581.75, 842.5]",1,18,-17
31103.0,2019-12-05,"(842.5, 1103.25]",5,17,-12
31103.0,2019-12-05,"(1103.25, 1364.0]",7,14,-7
31104.0,2019-12-05,"(360.25, 718.5]",8,3,5
31104.0,2019-12-05,"(718.5, 1076.75]",7,23,-16
31104.0,2019-12-05,"(1076.75, 1435.0]",14,12,2
31105.0,2019-12-05,"(28.61, 377.5]",1,2,-1
31105.0,2019-12-05,"(377.5, 725.0]",3,19,-16
31105.0,2019-12-05,"(725.0, 1072.5]",3,7,-4
31105.0,2019-12-05,"(1072.5, 1420.0]",3,11,-8
31106.0,2019-12-05,"(451.078, 682.5]",4,16,-12
31106.0,2019-12-05,"(913.0, 1143.5]",5,1,4
31106.0,2019-12-05,"(1143.5, 1374.0]",2,7,-5
31107.0,2019-12-05,"(14.701, 340.75]",2,4,-2
31107.0,2019-12-05,"(340.75, 665.5]",1,20,-19
31107.0,2019-12-05,"(665.5, 990.25]",5,8,-3
31107.0,2019-12-05,"(990.25, 1315.0]",23,31,-8
31108.0,2019-12-05,"(375.945, 640.75]",12,44,-32
31108.0,2019-12-05,"(640.75, 904.5]",11,18,-7
31108.0,2019-12-05,"(904.5, 1168.25]",29,51,-22
31108.0,2019-12-05,"(1168.25, 1432.0]",13,22,-9
31109.0,2019-12-05,"(329.977, 586.75]",5,18,-13
31109.0,2019-12-05,"(586.75, 842.5]",11,22,-11
31109.0,2019-12-05,"(842.5, 1098.25]",13,28,-15
31109.0,2019-12-05,"(1098.25, 1354.0]",17,25,-8
31110.0,2019-12-05,"(324.904, 600.0]",13,41,-28
31110.0,2019-12-05,"(600.0, 874.0]",7,14,-7
31110.0,2019-12-05,"(874.0, 1148.0]",24,37,-13
31110.0,2019-12-05,"(1148.0, 1422.0]",9,21,-12
31111.0,2019-12-05,"(72.693, 400.75]",2,3,-1
31111.0,2019-12-05,"(400.75, 727.5]",10,27,-17
31111.0,2019-12-05,"(727.5, 1054.25]",5,7,-2
31111.0,2019-12-05,"(1054.25, 1381.0]",15,25,-10
31112.0,2019-12-05,"(353.028, 597.0]",1,6,-5
31112.0,2019-12-05,"(597.0, 840.0]",1,2,-1
31112.0,2019-12-05,"(840.0, 1083.0]",2,2,0
31112.0,2019-12-05,"(1083.0, 1326.0]",5,6,-1
31113.0,2019-12-05,"(314.881, 595.75]",2,21,-19
31113.0,2019-12-05,"(595.75, 875.5]",1,2,-1
31113.0,2019-12-05,"(875.5, 1155.25]",9,16,-7
31113.0,2019-12-05,"(1155.25, 1435.0]",9,15,-6
31114.0,2019-12-05,"(346.955, 609.25]",6,30,-24
31114.0,2019-12-05,"(609.25, 870.5]",6,12,-6
31114.0,2019-12-05,"(870.5, 1131.75]",26,39,-13
31114.0,2019-12-05,"(1131.75, 1393.0]",14,23,-9
31115.0,2019-12-05,"(424.5, 762.0]",1,5,-4
31115.0,2019-12-05,"(762.0, 1099.5]",5,15,-10
31115.0,2019-12-05,"(1099.5, 1437.0]",15,11,4
31116.0,2019-12-05,"(308.935, 576.25]",5,28,-23
31116.0,2019-12-05,"(576.25, 842.5]",2,4,-2
31116.0,2019-12-05,"(842.5, 1108.75]",11,16,-5
31116.0,2019-12-05,"(1108.75, 1375.0]",21,28,-7
31117.0,2019-12-05,"(50.614, 398.5]",1,7,-6
31117.0,2019-12-05,"(398.5, 745.0]",2,19,-17
31117.0,2019-12-05,"(745.0, 1091.5]",8,19,-11
31117.0,2019-12-05,"(1091.5, 1438.0]",9,22,-13
31118.0,2019-12-05,"(420.095, 647.25]",3,18,-15
31118.0,2019-12-05,"(873.5, 1099.75]",9,1,8
31118.0,2019-12-05,"(1099.75, 1326.0]",14,13,1
31119.0,2019-12-05,"(252.837, 544.75]",7,20,-13
31119.0,2019-12-05,"(544.75, 835.5]",3,6,-3
31119.0,2019-12-05,"(835.5, 1126.25]",16,24,-8
31119.0,2019-12-05,"(1126.25, 1417.0]",14,21,-7
31120.0,2019-12-05,"(392.996, 645.0]",5,16,-11
31120.0,2019-12-05,"(645.0, 896.0]",4,9,-5
31120.0,2019-12-05,"(896.0, 1147.0]",6,13,-7
31120.0,2019-12-05,"(1147.0, 1398.0]",13,17,-4
31121.0,2019-12-05,"(62.668, 397.0]",2,4,-2
31121.0,2019-12-05,"(397.0, 730.0]",20,30,-10
31121.0,2019-12-05,"(730.0, 1063.0]",4,13,-9
31121.0,2019-12-05,"(1063.0, 1396.0]",6,18,-12
31122.0,2019-12-05,"(719.0, 1060.5]",1,2,-1
31122.0,2019-12-05,"(1060.5, 1402.0]",3,10,-7
31123.0,2019-12-05,"(656.75, 898.5]",3,22,-19
31123.0,2019-12-05,"(898.5, 1140.25]",4,4,0
31123.0,2019-12-05,"(1140.25, 1382.0]",7,9,-2
31124.0,2019-12-05,"(8.611, 357.25]",3,4,-1
31124.0,2019-12-05,"(357.25, 704.5]",16,44,-28
31124.0,2019-12-05,"(704.5, 1051.75]",9,36,-27
31124.0,2019-12-05,"(1051.75, 1399.0]",22,62,-40
31125.0,2019-12-05,"(21.721, 342.75]",1,1,0
31125.0,2019-12-05,"(342.75, 662.5]",6,30,-24
31125.0,2019-12-05,"(662.5, 982.25]",10,13,-3
31125.0,2019-12-05,"(982.25, 1302.0]",26,37,-11
31126.0,2019-12-05,"(395.105, 619.75]",2,23,-21
31126.0,2019-12-05,"(619.75, 843.5]",4,14,-10
31126.0,2019-12-05,"(843.5, 1067.25]",12,21,-9
31126.0,2019-12-05,"(1067.25, 1291.0]",16,25,-9
,,,,2.0,
31128.0,2019-12-05,"(8.579, 365.25]",1,4,-3
31128.0,2019-12-05,"(365.25, 720.5]",31,47,-16
31128.0,2019-12-05,"(720.5, 1075.75]",27,44,-17
31128.0,2019-12-05,"(1075.75, 1431.0]",15,27,-12
31129.0,2019-12-05,"(347.042, 587.5]",27,31,-4
31129.0,2019-12-05,"(587.5, 827.0]",4,10,-6
31129.0,2019-12-05,"(827.0, 1066.5]",6,13,-7
31129.0,2019-12-05,"(1066.5, 1306.0]",6,11,-5
31130.0,2019-12-05,"(150.743, 466.25]",2,4,-2
31130.0,2019-12-05,"(466.25, 780.5]",2,11,-9
31130.0,2019-12-05,"(780.5, 1094.75]",7,11,-4
31130.0,2019-12-05,"(1094.75, 1409.0]",15,22,-7
31131.0,2019-12-05,"(47.664, 383.0]",1,1,0
31131.0,2019-12-05,"(383.0, 717.0]",1,16,-15
31131.0,2019-12-05,"(717.0, 1051.0]",1,8,-7
31131.0,2019-12-05,"(1051.0, 1385.0]",2,4,-2
31200.0,2019-12-05,"(6.606, 356.5]",2,6,-4
31200.0,2019-12-05,"(356.5, 705.0]",36,55,-19
31200.0,2019-12-05,"(705.0, 1053.5]",28,49,-21
31200.0,2019-12-05,"(1053.5, 1402.0]",26,51,-25
31201.0,2019-12-05,"(292.88, 574.0]",19,41,-22
31201.0,2019-12-05,"(574.0, 854.0]",16,31,-15
31201.0,2019-12-05,"(854.0, 1134.0]",39,68,-29
31201.0,2019-12-05,"(1134.0, 1414.0]",21,41,-20
31202.0,2019-12-05,"(347.961, 608.75]",13,32,-19
31202.0,2019-12-05,"(608.75, 868.5]",12,26,-14
31202.0,2019-12-05,"(868.5, 1128.25]",28,46,-18
31202.0,2019-12-05,"(1128.25, 1388.0]",11,28,-17
31203.0,2019-12-05,"(360.25, 714.5]",14,2,12
31203.0,2019-12-05,"(714.5, 1068.75]",20,34,-14
31203.0,2019-12-05,"(1068.75, 1423.0]",18,29,-11
31204.0,2019-12-05,"(12.659, 349.25]",1,1,0
31204.0,2019-12-05,"(349.25, 684.5]",16,20,-4
31204.0,2019-12-05,"(684.5, 1019.75]",13,28,-15
31204.0,2019-12-05,"(1019.75, 1355.0]",5,22,-17
31205.0,2019-12-05,"(392.75, 736.5]",37,1,36
31205.0,2019-12-05,"(736.5, 1080.25]",27,44,-17
31205.0,2019-12-05,"(1080.25, 1424.0]",4,43,-39
31206.0,2019-12-05,"(386.149, 599.75]",10,11,-1
31206.0,2019-12-05,"(599.75, 812.5]",1,3,-2
31206.0,2019-12-05,"(812.5, 1025.25]",2,11,-9
31206.0,2019-12-05,"(1025.25, 1238.0]",2,6,-4
31207.0,2019-12-05,"(13.691, 342.25]",1,2,-1
31207.0,2019-12-05,"(669.5, 996.75]",1,9,-8
31207.0,2019-12-05,"(996.75, 1324.0]",7,1,6
31208.0,2019-12-05,"(416.078, 647.5]",9,11,-2
31208.0,2019-12-05,"(647.5, 878.0]",2,7,-5
31208.0,2019-12-05,"(878.0, 1108.5]",2,10,-8
31208.0,2019-12-05,"(1108.5, 1339.0]",6,10,-4
31209.0,2019-12-05,"(560.309, 733.75]",1,2,-1
31209.0,2019-12-05,"(733.75, 906.5]",2,4,-2
31209.0,2019-12-05,"(906.5, 1079.25]",4,4,0
31209.0,2019-12-05,"(1079.25, 1252.0]",4,7,-3
31211.0,2019-12-05,"(481.166, 690.5]",9,11,-2
31211.0,2019-12-05,"(899.0, 1107.5]",6,1,5
31211.0,2019-12-05,"(1107.5, 1316.0]",3,13,-10
31212.0,2019-12-05,"(23.619, 370.25]",1,2,-1
31212.0,2019-12-05,"(370.25, 715.5]",30,44,-14
31212.0,2019-12-05,"(715.5, 1060.75]",13,23,-10
31212.0,2019-12-05,"(1060.75, 1406.0]",16,43,-27
31213.0,2019-12-05,"(380.0, 707.0]",30,1,29
31213.0,2019-12-05,"(707.0, 1034.0]",12,44,-32
31213.0,2019-12-05,"(1034.0, 1361.0]",12,23,-11
31214.0,2019-12-05,"(231.814, 529.5]",6,25,-19
31214.0,2019-12-05,"(529.5, 826.0]",18,37,-19
31214.0,2019-12-05,"(826.0, 1122.5]",19,31,-12
31214.0,2019-12-05,"(1122.5, 1419.0]",11,21,-10
31215.0,2019-12-05,"(400.002, 650.5]",30,33,-3
31215.0,2019-12-05,"(650.5, 900.0]",3,7,-4
31215.0,2019-12-05,"(900.0, 1149.5]",11,23,-12
31215.0,2019-12-05,"(1149.5, 1399.0]",1,6,-5
31216.0,2019-12-05,"(436.184, 641.0]",25,28,-3
31216.0,2019-12-05,"(641.0, 845.0]",10,14,-4
31216.0,2019-12-05,"(845.0, 1049.0]",5,11,-6
31216.0,2019-12-05,"(1049.0, 1253.0]",3,14,-11
31217.0,2019-12-05,"(349.254, 536.5]",9,10,-1
31217.0,2019-12-05,"(536.5, 723.0]",3,4,-1
31217.0,2019-12-05,"(723.0, 909.5]",3,6,-3
31217.0,2019-12-05,"(909.5, 1096.0]",3,13,-10
31218.0,2019-12-05,"(324.922, 595.5]",16,31,-15
31218.0,2019-12-05,"(595.5, 865.0]",4,6,-2
31218.0,2019-12-05,"(865.0, 1134.5]",8,17,-9
31218.0,2019-12-05,"(1134.5, 1404.0]",2,3,-1
31219.0,2019-12-05,"(363.231, 556.25]",11,11,0
31219.0,2019-12-05,"(556.25, 748.5]",5,6,-1
31219.0,2019-12-05,"(748.5, 940.75]",2,5,-3
31219.0,2019-12-05,"(940.75, 1133.0]",3,12,-9
31220.0,2019-12-05,"(295.254, 482.5]",8,11,-3
31220.0,2019-12-05,"(482.5, 669.0]",10,10,0
31220.0,2019-12-05,"(669.0, 855.5]",1,3,-2
31220.0,2019-12-05,"(855.5, 1042.0]",2,18,-16
31221.0,2019-12-05,"(385.098, 611.5]",37,42,-5
31221.0,2019-12-05,"(611.5, 837.0]",16,22,-6
31221.0,2019-12-05,"(837.0, 1062.5]",9,28,-19
31221.0,2019-12-05,"(1062.5, 1288.0]",4,14,-10
31222.0,2019-12-05,"(492.175, 699.25]",15,17,-2
31222.0,2019-12-05,"(699.25, 905.5]",4,11,-7
31222.0,2019-12-05,"(905.5, 1111.75]",3,15,-12
31222.0,2019-12-05,"(1111.75, 1318.0]",1,5,-4
31223.0,2019-12-05,"(-0.435, 359.75]",2,4,-2
31223.0,2019-12-05,"(359.75, 718.5]",15,50,-35
31223.0,2019-12-05,"(718.5, 1077.25]",9,27,-18
31223.0,2019-12-05,"(1077.25, 1436.0]",20,39,-19
31224.0,2019-12-05,"(320.883, 601.25]",17,20,-3
31224.0,2019-12-05,"(601.25, 880.5]",2,5,-3
31224.0,2019-12-05,"(880.5, 1159.75]",9,25,-16
31224.0,2019-12-05,"(1159.75, 1439.0]",2,10,-8
31225.0,2019-12-05,"(414.999, 666.25]",8,14,-6
31225.0,2019-12-05,"(666.25, 916.5]",12,14,-2
31225.0,2019-12-05,"(916.5, 1166.75]",9,18,-9
31225.0,2019-12-05,"(1166.75, 1417.0]",3,6,-3
31226.0,2019-12-05,"(460.099, 686.25]",2,7,-5
31226.0,2019-12-05,"(686.25, 911.5]",3,5,-2
31226.0,2019-12-05,"(911.5, 1136.75]",8,13,-5
31226.0,2019-12-05,"(1136.75, 1362.0]",5,6,-1
31227.0,2019-12-05,"(417.044, 657.0]",46,51,-5
31227.0,2019-12-05,"(657.0, 896.0]",11,20,-9
31227.0,2019-12-05,"(896.0, 1135.0]",13,30,-17
31227.0,2019-12-05,"(1135.0, 1374.0]",4,10,-6
31228.0,2019-12-05,"(11.633, 354.75]",3,5,-2
31228.0,2019-12-05,"(354.75, 696.5]",24,32,-8
31228.0,2019-12-05,"(696.5, 1038.25]",24,39,-15
31228.0,2019-12-05,"(1038.25, 1380.0]",20,44,-24
31229.0,2019-12-05,"(8.718, 330.5]",1,2,-1
31229.0,2019-12-05,"(330.5, 651.0]",15,59,-44
31229.0,2019-12-05,"(651.0, 971.5]",11,22,-11
31229.0,2019-12-05,"(971.5, 1292.0]",35,56,-21
31230.0,2019-12-05,"(369.115, 591.25]",51,61,-10
31230.0,2019-12-05,"(591.25, 812.5]",10,13,-3
31230.0,2019-12-05,"(812.5, 1033.75]",15,25,-10
31230.0,2019-12-05,"(1033.75, 1255.0]",14,54,-40
31231.0,2019-12-05,"(324.911, 598.25]",22,24,-2
31231.0,2019-12-05,"(598.25, 870.5]",6,13,-7
31231.0,2019-12-05,"(870.5, 1142.75]",9,24,-15
31231.0,2019-12-05,"(1142.75, 1415.0]",3,6,-3
31232.0,2019-12-05,"(282.869, 566.75]",22,27,-5
31232.0,2019-12-05,"(566.75, 849.5]",8,12,-4
31232.0,2019-12-05,"(849.5, 1132.25]",21,34,-13
31232.0,2019-12-05,"(1132.25, 1415.0]",5,18,-13
31233.0,2019-12-05,"(0.616, 348.0]",1,2,-1
31233.0,2019-12-05,"(348.0, 694.0]",36,43,-7
31233.0,2019-12-05,"(694.0, 1040.0]",26,38,-12
31233.0,2019-12-05,"(1040.0, 1386.0]",14,41,-27
31234.0,2019-12-05,"(362.954, 625.5]",19,36,-17
31234.0,2019-12-05,"(625.5, 887.0]",11,25,-14
31234.0,2019-12-05,"(887.0, 1148.5]",20,36,-16
31234.0,2019-12-05,"(1148.5, 1410.0]",4,11,-7
31235.0,2019-12-05,"(465.158, 676.5]",9,9,0
31235.0,2019-12-05,"(676.5, 887.0]",7,8,-1
31235.0,2019-12-05,"(887.0, 1097.5]",2,7,-5
31236.0,2019-12-05,"(406.017, 652.75]",17,18,-1
31236.0,2019-12-05,"(652.75, 898.5]",9,15,-6
31236.0,2019-12-05,"(898.5, 1144.25]",15,35,-20
31236.0,2019-12-05,"(1144.25, 1390.0]",2,11,-9
31237.0,2019-12-05,"(-0.383, 346.75]",2,5,-3
31237.0,2019-12-05,"(346.75, 692.5]",10,21,-11
31237.0,2019-12-05,"(692.5, 1038.25]",16,24,-8
31237.0,2019-12-05,"(1038.25, 1384.0]",15,29,-14
31238.0,2019-12-05,"(47.635, 390.25]",2,3,-1
31238.0,2019-12-05,"(390.25, 731.5]",20,24,-4
31238.0,2019-12-05,"(731.5, 1072.75]",6,23,-17
31238.0,2019-12-05,"(1072.75, 1414.0]",4,18,-14
31239.0,2019-12-05,"(357.994, 610.5]",22,25,-3
31239.0,2019-12-05,"(610.5, 862.0]",11,17,-6
31239.0,2019-12-05,"(862.0, 1113.5]",13,32,-19
31239.0,2019-12-05,"(1113.5, 1365.0]",3,14,-11
31240.0,2019-12-05,"(400.567, 509.25]",1,2,-1
31240.0,2019-12-05,"(725.75, 834.0]",5,11,-6
31241.0,2019-12-05,"(20.603, 371.25]",4,6,-2
31241.0,2019-12-05,"(371.25, 720.5]",37,71,-34
31241.0,2019-12-05,"(720.5, 1069.75]",15,43,-28
31241.0,2019-12-05,"(1069.75, 1419.0]",19,39,-20
31242.0,2019-12-05,"(399.152, 612.0]",41,44,-3
31242.0,2019-12-05,"(612.0, 824.0]",4,12,-8
31242.0,2019-12-05,"(824.0, 1036.0]",9,24,-15
31242.0,2019-12-05,"(1036.0, 1248.0]",4,24,-20
31243.0,2019-12-05,"(368.093, 595.75]",37,44,-7
31243.0,2019-12-05,"(595.75, 822.5]",5,9,-4
31243.0,2019-12-05,"(822.5, 1049.25]",5,26,-21
31243.0,2019-12-05,"(1049.25, 1276.0]",1,9,-8
31244.0,2019-12-05,"(134.775, 442.25]",4,8,-4
31244.0,2019-12-05,"(442.25, 748.5]",19,26,-7
31244.0,2019-12-05,"(748.5, 1054.75]",13,32,-19
31244.0,2019-12-05,"(1054.75, 1361.0]",8,16,-8
31245.0,2019-12-05,"(307.983, 563.25]",10,20,-10
31245.0,2019-12-05,"(563.25, 817.5]",4,14,-10
31245.0,2019-12-05,"(817.5, 1071.75]",10,21,-11
31245.0,2019-12-05,"(1071.75, 1326.0]",8,18,-10
31246.0,2019-12-05,"(338.03, 581.5]",12,23,-11
31246.0,2019-12-05,"(581.5, 824.0]",7,13,-6
31246.0,2019-12-05,"(824.0, 1066.5]",10,14,-4
31246.0,2019-12-05,"(1066.5, 1309.0]",14,30,-16
31247.0,2019-12-05,"(14.662, 350.5]",3,3,0
31247.0,2019-12-05,"(350.5, 685.0]",10,14,-4
31247.0,2019-12-05,"(685.0, 1019.5]",7,12,-5
31247.0,2019-12-05,"(1019.5, 1354.0]",6,14,-8
31248.0,2019-12-05,"(357.032, 600.0]",10,15,-5
31248.0,2019-12-05,"(600.0, 842.0]",4,15,-11
31248.0,2019-12-05,"(842.0, 1084.0]",8,20,-12
31248.0,2019-12-05,"(1084.0, 1326.0]",9,14,-5
31249.0,2019-12-05,"(364.273, 546.75]",7,11,-4
31249.0,2019-12-05,"(546.75, 728.5]",5,10,-5
31249.0,2019-12-05,"(728.5, 910.25]",2,6,-4
31249.0,2019-12-05,"(910.25, 1092.0]",6,13,-7
31250.0,2019-12-05,"(411.092, 639.0]",21,24,-3
31250.0,2019-12-05,"(639.0, 866.0]",6,15,-9
31250.0,2019-12-05,"(866.0, 1093.0]",7,22,-15
31250.0,2019-12-05,"(1093.0, 1320.0]",3,14,-11
31251.0,2019-12-05,"(54.643, 395.25]",3,6,-3
31251.0,2019-12-05,"(395.25, 734.5]",20,41,-21
31251.0,2019-12-05,"(734.5, 1073.75]",12,21,-9
31251.0,2019-12-05,"(1073.75, 1413.0]",12,21,-9
31252.0,2019-12-05,"(480.28, 661.0]",15,18,-3
31252.0,2019-12-05,"(661.0, 841.0]",3,6,-3
31252.0,2019-12-05,"(841.0, 1021.0]",5,9,-4
31252.0,2019-12-05,"(1021.0, 1201.0]",1,18,-17
31253.0,2019-12-05,"(398.064, 633.0]",19,21,-2
31253.0,2019-12-05,"(633.0, 867.0]",5,10,-5
31253.0,2019-12-05,"(867.0, 1101.0]",2,10,-8
31253.0,2019-12-05,"(1101.0, 1335.0]",4,15,-11
31254.0,2019-12-05,"(418.983, 674.25]",27,31,-4
31254.0,2019-12-05,"(674.25, 928.5]",9,16,-7
31254.0,2019-12-05,"(928.5, 1182.75]",6,31,-25
31254.0,2019-12-05,"(1182.75, 1437.0]",3,6,-3
31255.0,2019-12-05,"(320.961, 581.75]",23,33,-10
31255.0,2019-12-05,"(581.75, 841.5]",11,15,-4
31255.0,2019-12-05,"(841.5, 1101.25]",8,20,-12
31255.0,2019-12-05,"(1101.25, 1361.0]",3,9,-6
31256.0,2019-12-05,"(270.019, 516.25]",7,8,-1
31256.0,2019-12-05,"(516.25, 761.5]",10,11,-1
31256.0,2019-12-05,"(761.5, 1006.75]",3,6,-3
31256.0,2019-12-05,"(1006.75, 1252.0]",6,16,-10
31257.0,2019-12-05,"(20.637, 362.75]",3,3,0
31257.0,2019-12-05,"(362.75, 703.5]",26,42,-16
31257.0,2019-12-05,"(703.5, 1044.25]",16,32,-16
31257.0,2019-12-05,"(1044.25, 1385.0]",16,46,-30
31258.0,2019-12-05,"(434.358, 595.5]",2,4,-2
31258.0,2019-12-05,"(595.5, 756.0]",3,5,-2
31258.0,2019-12-05,"(756.0, 916.5]",6,10,-4
31258.0,2019-12-05,"(916.5, 1077.0]",3,10,-7
31259.0,2019-12-05,"(418.32, 589.0]",13,14,-1
31259.0,2019-12-05,"(589.0, 759.0]",2,3,-1
31259.0,2019-12-05,"(759.0, 929.0]",2,3,-1
31259.0,2019-12-05,"(929.0, 1099.0]",1,13,-12
31260.0,2019-12-05,"(385.039, 626.25]",20,25,-5
31260.0,2019-12-05,"(626.25, 866.5]",2,7,-5
31260.0,2019-12-05,"(866.5, 1106.75]",3,20,-17
31260.0,2019-12-05,"(1106.75, 1347.0]",3,6,-3
31261.0,2019-12-05,"(438.202, 638.5]",14,14,0
31261.0,2019-12-05,"(638.5, 838.0]",1,1,0
31261.0,2019-12-05,"(838.0, 1037.5]",1,5,-4
31262.0,2019-12-05,"(415.047, 654.25]",16,16,0
31262.0,2019-12-05,"(654.25, 892.5]",3,7,-4
31262.0,2019-12-05,"(892.5, 1130.75]",2,5,-3
31262.0,2019-12-05,"(1130.75, 1369.0]",1,9,-8
31263.0,2019-12-05,"(318.897, 595.75]",25,41,-16
31263.0,2019-12-05,"(595.75, 871.5]",10,16,-6
31263.0,2019-12-05,"(871.5, 1147.25]",13,35,-22
31263.0,2019-12-05,"(1147.25, 1423.0]",7,12,-5
31264.0,2019-12-05,"(446.06, 682.0]",16,24,-8
31264.0,2019-12-05,"(682.0, 917.0]",2,3,-1
31264.0,2019-12-05,"(917.0, 1152.0]",9,21,-12
31264.0,2019-12-05,"(1152.0, 1387.0]",5,11,-6
31265.0,2019-12-05,"(37.614, 385.5]",2,4,-2
31265.0,2019-12-05,"(385.5, 732.0]",13,34,-21
31265.0,2019-12-05,"(732.0, 1078.5]",15,37,-22
31265.0,2019-12-05,"(1078.5, 1425.0]",24,37,-13
31266.0,2019-12-05,"(445.25, 763.5]",8,7,1
31266.0,2019-12-05,"(763.5, 1081.75]",18,30,-12
31266.0,2019-12-05,"(1081.75, 1400.0]",18,32,-14
31267.0,2019-12-05,"(5.571, 364.25]",1,3,-2
31267.0,2019-12-05,"(364.25, 721.5]",32,61,-29
31267.0,2019-12-05,"(721.5, 1078.75]",19,36,-17
31267.0,2019-12-05,"(1078.75, 1436.0]",25,47,-22
31268.0,2019-12-05,"(322.98, 579.0]",11,42,-31
31268.0,2019-12-05,"(579.0, 834.0]",4,11,-7
31268.0,2019-12-05,"(834.0, 1089.0]",11,19,-8
31268.0,2019-12-05,"(1089.0, 1344.0]",29,38,-9
31269.0,2019-12-05,"(369.944, 635.0]",7,10,-3
31269.0,2019-12-05,"(635.0, 899.0]",3,8,-5
31269.0,2019-12-05,"(899.0, 1163.0]",10,20,-10
31269.0,2019-12-05,"(1163.0, 1427.0]",4,7,-3
31270.0,2019-12-05,"(267.853, 555.75]",13,18,-5
31270.0,2019-12-05,"(555.75, 842.5]",9,12,-3
31270.0,2019-12-05,"(842.5, 1129.25]",10,19,-9
31270.0,2019-12-05,"(1129.25, 1416.0]",4,10,-6
31271.0,2019-12-05,"(384.059, 620.25]",11,14,-3
31271.0,2019-12-05,"(620.25, 855.5]",2,7,-5
31271.0,2019-12-05,"(855.5, 1090.75]",7,16,-9
31272.0,2019-12-05,"(11.688, 341.0]",1,2,-1
31272.0,2019-12-05,"(341.0, 669.0]",26,31,-5
31272.0,2019-12-05,"(669.0, 997.0]",9,25,-16
31272.0,2019-12-05,"(997.0, 1325.0]",3,19,-16
31273.0,2019-12-05,"(375.243, 565.25]",1,7,-6
31273.0,2019-12-05,"(565.25, 754.5]",2,3,-1
31273.0,2019-12-05,"(754.5, 943.75]",1,2,-1
31273.0,2019-12-05,"(943.75, 1133.0]",4,4,0
31274.0,2019-12-05,"(368.015, 615.25]",19,22,-3
31274.0,2019-12-05,"(615.25, 861.5]",4,8,-4
31274.0,2019-12-05,"(861.5, 1107.75]",10,15,-5
31274.0,2019-12-05,"(1107.75, 1354.0]",1,9,-8
31275.0,2019-12-05,"(317.932, 586.0]",23,34,-11
31275.0,2019-12-05,"(586.0, 853.0]",8,14,-6
31275.0,2019-12-05,"(853.0, 1120.0]",15,38,-23
31275.0,2019-12-05,"(1120.0, 1387.0]",9,24,-15
31276.0,2019-12-05,"(404.15, 617.5]",24,28,-4
31276.0,2019-12-05,"(617.5, 830.0]",2,6,-4
31276.0,2019-12-05,"(830.0, 1042.5]",5,14,-9
31276.0,2019-12-05,"(1042.5, 1255.0]",6,28,-22
31277.0,2019-12-05,"(16.76, 328.0]",3,3,0
31277.0,2019-12-05,"(328.0, 638.0]",35,42,-7
31277.0,2019-12-05,"(638.0, 948.0]",10,22,-12
31277.0,2019-12-05,"(948.0, 1258.0]",10,48,-38
31278.0,2019-12-05,"(297.918, 569.5]",7,30,-23
31278.0,2019-12-05,"(569.5, 840.0]",9,17,-8
31278.0,2019-12-05,"(840.0, 1110.5]",13,22,-9
31278.0,2019-12-05,"(1110.5, 1381.0]",16,21,-5
31279.0,2019-12-05,"(405.234, 597.5]",23,26,-3
31279.0,2019-12-05,"(597.5, 789.0]",7,14,-7
31279.0,2019-12-05,"(789.0, 980.5]",2,9,-7
31279.0,2019-12-05,"(980.5, 1172.0]",5,27,-22
31280.0,2019-12-05,"(375.026, 619.5]",4,22,-18
31280.0,2019-12-05,"(863.0, 1106.5]",4,1,3
31280.0,2019-12-05,"(1106.5, 1350.0]",14,9,5
31000.0,2019-12-06,"(487.263, 672.25]",1,2,-1
31000.0,2019-12-06,"(856.5, 1040.75]",3,3,0
31000.0,2019-12-06,"(1040.75, 1225.0]",1,4,-3
31001.0,2019-12-06,"(751.484, 881.0]",1,1,0
31001.0,2019-12-06,"(1139.0, 1268.0]",2,3,-1
31002.0,2019-12-06,"(449.411, 597.25]",3,3,0
31002.0,2019-12-06,"(597.25, 744.5]",1,1,0
31002.0,2019-12-06,"(891.75, 1039.0]",2,5,-3
31003.0,2019-12-06,"(491.415, 638.25]",2,3,-1
31003.0,2019-12-06,"(784.5, 930.75]",1,1,0
31004.0,2019-12-06,"(731.0, 946.0]",1,1,0
31004.0,2019-12-06,"(946.0, 1161.0]",2,2,0
31005.0,2019-12-06,"(434.167, 643.25]",6,7,-1
31005.0,2019-12-06,"(643.25, 851.5]",2,4,-2
31005.0,2019-12-06,"(851.5, 1059.75]",3,4,-1
31005.0,2019-12-06,"(1059.75, 1268.0]",2,9,-7
31006.0,2019-12-06,"(731.472, 864.0]",1,2,-1
31006.0,2019-12-06,"(864.0, 996.0]",1,1,0
31006.0,2019-12-06,"(996.0, 1128.0]",4,6,-2
31007.0,2019-12-06,"(371.19, 574.5]",6,18,-12
31007.0,2019-12-06,"(574.5, 777.0]",1,2,-1
31007.0,2019-12-06,"(777.0, 979.5]",2,5,-3
31007.0,2019-12-06,"(979.5, 1182.0]",7,19,-12
31009.0,2019-12-06,"(453.425, 597.75]",4,5,-1
31009.0,2019-12-06,"(885.25, 1029.0]",1,3,-2
31010.0,2019-12-06,"(866.5, 989.0]",1,1,0
31010.0,2019-12-06,"(1111.5, 1234.0]",1,1,0
31011.0,2019-12-06,"(422.195, 624.25]",5,9,-4
31011.0,2019-12-06,"(825.5, 1026.75]",3,1,2
31011.0,2019-12-06,"(1026.75, 1228.0]",3,6,-3
31012.0,2019-12-06,"(374.387, 528.25]",3,3,0
31012.0,2019-12-06,"(528.25, 681.5]",1,1,0
31012.0,2019-12-06,"(834.75, 988.0]",1,3,-2
31013.0,2019-12-06,"(634.75, 816.5]",2,2,0
31013.0,2019-12-06,"(998.25, 1180.0]",4,4,0
31014.0,2019-12-06,"(315.922, 586.5]",23,29,-6
31014.0,2019-12-06,"(586.5, 856.0]",6,8,-2
31014.0,2019-12-06,"(856.0, 1125.5]",7,20,-13
31014.0,2019-12-06,"(1125.5, 1395.0]",3,8,-5
31015.0,2019-12-06,"(75.975, 333.25]",2,2,0
31015.0,2019-12-06,"(333.25, 589.5]",13,14,-1
31015.0,2019-12-06,"(845.75, 1102.0]",4,2,2
31016.0,2019-12-06,"(440.163, 650.25]",4,9,-5
31016.0,2019-12-06,"(650.25, 859.5]",3,5,-2
31016.0,2019-12-06,"(859.5, 1068.75]",1,3,-2
31016.0,2019-12-06,"(1068.75, 1278.0]",2,4,-2
31017.0,2019-12-06,"(510.307, 684.25]",3,5,-2
31017.0,2019-12-06,"(684.25, 857.5]",1,1,0
31017.0,2019-12-06,"(857.5, 1030.75]",2,5,-3
31017.0,2019-12-06,"(1030.75, 1204.0]",1,6,-5
31018.0,2019-12-06,"(592.5, 789.0]",1,5,-4
31018.0,2019-12-06,"(789.0, 985.5]",1,1,0
31018.0,2019-12-06,"(985.5, 1182.0]",3,4,-1
31019.0,2019-12-06,"(904.0, 1053.0]",1,3,-2
31020.0,2019-12-06,"(314.25, 585.5]",2,1,1
31020.0,2019-12-06,"(856.75, 1128.0]",1,2,-1
31021.0,2019-12-06,"(361.5, 687.0]",1,2,-1
31021.0,2019-12-06,"(687.0, 1012.5]",3,4,-1
31021.0,2019-12-06,"(1012.5, 1338.0]",3,5,-2
31022.0,2019-12-06,"(455.091, 683.25]",1,3,-2
31022.0,2019-12-06,"(910.5, 1137.75]",3,1,2
31022.0,2019-12-06,"(1137.75, 1365.0]",1,8,-7
31023.0,2019-12-06,"(271.0, 542.0]",1,1,0
31023.0,2019-12-06,"(813.0, 1084.0]",1,1,0
31024.0,2019-12-06,"(342.059, 578.25]",5,7,-2
31024.0,2019-12-06,"(578.25, 813.5]",2,5,-3
31024.0,2019-12-06,"(813.5, 1048.75]",3,4,-1
31024.0,2019-12-06,"(1048.75, 1284.0]",2,5,-3
31025.0,2019-12-06,"(495.575, 602.25]",1,1,0
31025.0,2019-12-06,"(708.5, 814.75]",1,1,0
31026.0,2019-12-06,"(730.0, 928.0]",1,1,0
31026.0,2019-12-06,"(928.0, 1126.0]",1,3,-2
31026.0,2019-12-06,"(1126.0, 1324.0]",1,2,-1
31027.0,2019-12-06,"(862.5, 1046.25]",2,3,-1
,,,,1.0,
,,,,3.0,
31029.0,2019-12-06,"(807.5, 986.75]",1,7,-6
31029.0,2019-12-06,"(986.75, 1166.0]",3,1,2
31030.0,2019-12-06,"(4.674, 337.5]",3,3,0
31030.0,2019-12-06,"(337.5, 669.0]",1,10,-9
31030.0,2019-12-06,"(669.0, 1000.5]",1,2,-1
31030.0,2019-12-06,"(1000.5, 1332.0]",5,7,-2
31031.0,2019-12-06,"(878.0, 1135.0]",3,5,-2
31031.0,2019-12-06,"(1135.0, 1392.0]",1,1,0
31032.0,2019-12-06,"(868.5, 1065.75]",1,2,-1
31032.0,2019-12-06,"(1065.75, 1263.0]",1,2,-1
31033.0,2019-12-06,"(836.75, 947.0]",1,1,0
31034.0,2019-12-06,"(444.041, 684.75]",3,4,-1
31034.0,2019-12-06,"(684.75, 924.5]",1,3,-2
31034.0,2019-12-06,"(924.5, 1164.25]",2,4,-2
31034.0,2019-12-06,"(1164.25, 1404.0]",3,6,-3
31035.0,2019-12-06,"(9.933, 277.75]",1,1,0
31035.0,2019-12-06,"(277.75, 544.5]",1,7,-6
31035.0,2019-12-06,"(544.5, 811.25]",1,1,0
31035.0,2019-12-06,"(811.25, 1078.0]",2,6,-4
31036.0,2019-12-06,"(937.5, 1125.0]",3,5,-2
31037.0,2019-12-06,"(377.015, 624.25]",13,16,-3
31037.0,2019-12-06,"(624.25, 870.5]",1,4,-3
31037.0,2019-12-06,"(870.5, 1116.75]",2,15,-13
31037.0,2019-12-06,"(1116.75, 1363.0]",1,5,-4
31038.0,2019-12-06,"(500.7, 576.0]",2,3,-1
31038.0,2019-12-06,"(651.0, 726.0]",2,1,1
31038.0,2019-12-06,"(726.0, 801.0]",1,3,-2
31039.0,2019-12-06,"(451.166, 660.5]",8,15,-7
31039.0,2019-12-06,"(660.5, 869.0]",3,8,-5
31039.0,2019-12-06,"(869.0, 1077.5]",2,4,-2
31039.0,2019-12-06,"(1077.5, 1286.0]",2,4,-2
31040.0,2019-12-06,"(479.239, 670.25]",2,4,-2
31040.0,2019-12-06,"(670.25, 860.5]",3,5,-2
31040.0,2019-12-06,"(860.5, 1050.75]",1,3,-2
31040.0,2019-12-06,"(1050.75, 1241.0]",1,3,-2
,,,,2.0,
31042.0,2019-12-06,"(375.032, 618.0]",11,14,-3
31042.0,2019-12-06,"(618.0, 860.0]",1,2,-1
31042.0,2019-12-06,"(860.0, 1102.0]",1,10,-9
31042.0,2019-12-06,"(1102.0, 1344.0]",2,2,0
31043.0,2019-12-06,"(519.377, 675.75]",1,2,-1
31043.0,2019-12-06,"(987.25, 1143.0]",1,1,0
31044.0,2019-12-06,"(480.14, 696.0]",3,4,-1
31044.0,2019-12-06,"(911.0, 1126.0]",2,1,1
31044.0,2019-12-06,"(1126.0, 1341.0]",4,2,2
31045.0,2019-12-06,"(434.39, 587.5]",3,3,0
31045.0,2019-12-06,"(892.5, 1045.0]",2,1,1
31046.0,2019-12-06,"(398.085, 627.75]",1,2,-1
31046.0,2019-12-06,"(1085.25, 1314.0]",2,3,-1
31047.0,2019-12-06,"(353.188, 557.0]",8,14,-6
31047.0,2019-12-06,"(557.0, 760.0]",4,4,0
31047.0,2019-12-06,"(760.0, 963.0]",1,5,-4
31047.0,2019-12-06,"(963.0, 1166.0]",5,15,-10
31048.0,2019-12-06,"(429.242, 619.5]",4,4,0
31048.0,2019-12-06,"(619.5, 809.0]",1,3,-2
31048.0,2019-12-06,"(809.0, 998.5]",1,5,-4
31048.0,2019-12-06,"(998.5, 1188.0]",1,6,-5
31049.0,2019-12-06,"(553.342, 718.5]",1,1,0
31049.0,2019-12-06,"(1047.5, 1212.0]",1,2,-1
31050.0,2019-12-06,"(332.01, 580.5]",1,4,-3
31050.0,2019-12-06,"(828.0, 1075.5]",1,1,0
31050.0,2019-12-06,"(1075.5, 1323.0]",1,2,-1
31051.0,2019-12-06,"(693.5, 890.75]",1,2,-1
31051.0,2019-12-06,"(890.75, 1088.0]",6,5,1
31052.0,2019-12-06,"(391.23, 584.5]",2,4,-2
31052.0,2019-12-06,"(584.5, 777.0]",1,2,-1
31052.0,2019-12-06,"(777.0, 969.5]",1,3,-2
31052.0,2019-12-06,"(969.5, 1162.0]",2,2,0
31053.0,2019-12-06,"(1120.75, 1289.0]",2,1,1
,,,,2.0,
31055.0,2019-12-06,"(883.0, 1083.5]",2,2,0
31055.0,2019-12-06,"(1083.5, 1284.0]",2,4,-2
31056.0,2019-12-06,"(93.767, 403.25]",1,1,0
31056.0,2019-12-06,"(711.5, 1019.75]",1,3,-2
31056.0,2019-12-06,"(1019.75, 1328.0]",4,2,2
31057.0,2019-12-06,"(926.536, 927.0]",1,2,-1
31058.0,2019-12-06,"(700.5, 934.0]",1,1,0
31059.0,2019-12-06,"(646.0, 868.0]",1,1,0
31059.0,2019-12-06,"(868.0, 1090.0]",1,1,0
31059.0,2019-12-06,"(1090.0, 1312.0]",2,2,0
31060.0,2019-12-06,"(694.5, 1000.75]",4,1,3
31060.0,2019-12-06,"(1000.75, 1307.0]",2,6,-4
31061.0,2019-12-06,"(913.25, 1062.0]",2,1,1
31062.0,2019-12-06,"(409.401, 559.75]",3,7,-4
31062.0,2019-12-06,"(709.5, 859.25]",2,4,-2
31062.0,2019-12-06,"(859.25, 1009.0]",2,5,-3
31063.0,2019-12-06,"(602.25, 803.0]",1,1,0
31064.0,2019-12-06,"(499.334, 666.5]",3,6,-3
31064.0,2019-12-06,"(666.5, 833.0]",3,6,-3
31064.0,2019-12-06,"(833.0, 999.5]",1,2,-1
31064.0,2019-12-06,"(999.5, 1166.0]",5,10,-5
,,,,1.0,
,,,,1.0,
,,,,1.0,
,,,,2.0,
31066.0,2019-12-06,"(788.823, 833.25]",1,1,0
31067.0,2019-12-06,"(968.5, 1094.0]",3,2,1
,,,,1.0,
,,,,1.0,
,,,,2.0,
31069.0,2019-12-06,"(649.75, 903.5]",1,4,-3
31069.0,2019-12-06,"(903.5, 1157.25]",6,2,4
31069.0,2019-12-06,"(1157.25, 1411.0]",3,6,-3
31070.0,2019-12-06,"(41.06, 277.0]",1,1,0
31070.0,2019-12-06,"(747.0, 982.0]",2,1,1
31071.0,2019-12-06,"(303.142, 518.5]",2,4,-2
31071.0,2019-12-06,"(518.5, 733.0]",1,2,-1
31071.0,2019-12-06,"(947.5, 1162.0]",3,2,1
,,,,2.0,
31073.0,2019-12-06,"(479.427, 623.25]",1,1,0
31073.0,2019-12-06,"(909.75, 1053.0]",1,2,-1
31074.0,2019-12-06,"(592.22, 788.0]",2,4,-2
31074.0,2019-12-06,"(983.0, 1178.0]",1,2,-1
31074.0,2019-12-06,"(1178.0, 1373.0]",1,1,0
31075.0,2019-12-06,"(1048.691, 1126.25]",1,1,0
31076.0,2019-12-06,"(431.096, 658.0]",1,3,-2
31076.0,2019-12-06,"(884.0, 1110.0]",2,2,0
31076.0,2019-12-06,"(1110.0, 1336.0]",1,1,0
31077.0,2019-12-06,"(678.75, 916.5]",4,6,-2
31077.0,2019-12-06,"(916.5, 1154.25]",4,7,-3
31077.0,2019-12-06,"(1154.25, 1392.0]",1,4,-3
31078.0,2019-12-06,"(462.457, 598.75]",5,6,-1
31078.0,2019-12-06,"(734.5, 870.25]",1,2,-1
31078.0,2019-12-06,"(870.25, 1006.0]",1,8,-7
31079.0,2019-12-06,"(403.02, 649.0]",2,8,-6
31079.0,2019-12-06,"(649.0, 894.0]",1,3,-2
31079.0,2019-12-06,"(894.0, 1139.0]",4,6,-2
31079.0,2019-12-06,"(1139.0, 1384.0]",3,4,-1
31080.0,2019-12-06,"(843.0, 1062.0]",3,8,-5
31080.0,2019-12-06,"(1062.0, 1281.0]",3,4,-1
31081.0,2019-12-06,"(363.09, 591.5]",1,2,-1
31081.0,2019-12-06,"(819.0, 1046.5]",1,2,-1
31081.0,2019-12-06,"(1046.5, 1274.0]",1,3,-2
31082.0,2019-12-06,"(695.702, 770.5]",1,2,-1
31083.0,2019-12-06,"(735.5, 899.75]",2,3,-1
31083.0,2019-12-06,"(899.75, 1064.0]",2,2,0
31084.0,2019-12-06,"(522.246, 711.5]",5,5,0
31084.0,2019-12-06,"(711.5, 900.0]",1,4,-3
31084.0,2019-12-06,"(900.0, 1088.5]",1,3,-2
31084.0,2019-12-06,"(1088.5, 1277.0]",1,3,-2
31085.0,2019-12-06,"(403.723, 473.25]",1,2,-1
31085.0,2019-12-06,"(611.75, 681.0]",1,1,0
31086.0,2019-12-06,"(751.5, 891.75]",1,1,0
31086.0,2019-12-06,"(891.75, 1032.0]",1,2,-1
,,,,1.0,
,,,,1.0,
31088.0,2019-12-06,"(519.433, 661.75]",1,3,-2
31088.0,2019-12-06,"(803.5, 945.25]",1,1,0
31088.0,2019-12-06,"(945.25, 1087.0]",1,1,0
31089.0,2019-12-06,"(407.028, 651.0]",13,20,-7
31089.0,2019-12-06,"(651.0, 894.0]",4,8,-4
31089.0,2019-12-06,"(894.0, 1137.0]",4,17,-13
31090.0,2019-12-06,"(591.5, 741.0]",1,2,-1
31090.0,2019-12-06,"(890.5, 1040.0]",1,2,-1
31091.0,2019-12-06,"(57.97, 316.5]",1,1,0
31091.0,2019-12-06,"(831.5, 1089.0]",4,3,1
31092.0,2019-12-06,"(938.0, 1168.0]",1,2,-1
31092.0,2019-12-06,"(1168.0, 1398.0]",1,1,0
,,,,1.0,
,,,,1.0,
,,,,2.0,
,,,,1.0,
31094.0,2019-12-06,"(1082.25, 1246.0]",1,1,0
,,,,2.0,
31096.0,2019-12-06,"(1035.0, 1116.0]",1,1,0
31097.0,2019-12-06,"(552.381, 707.75]",1,1,0
31097.0,2019-12-06,"(862.5, 1017.25]",1,1,0
31097.0,2019-12-06,"(1017.25, 1172.0]",3,4,-1
31098.0,2019-12-06,"(428.118, 649.5]",3,11,-8
31098.0,2019-12-06,"(649.5, 870.0]",1,1,0
31098.0,2019-12-06,"(870.0, 1090.5]",8,16,-8
31098.0,2019-12-06,"(1090.5, 1311.0]",1,6,-5
,,,,2.0,
31100.0,2019-12-06,"(379.259, 565.25]",12,13,-1
31100.0,2019-12-06,"(565.25, 750.5]",2,6,-4
31100.0,2019-12-06,"(750.5, 935.75]",6,11,-5
31100.0,2019-12-06,"(935.75, 1121.0]",1,14,-13
31101.0,2019-12-06,"(-0.438, 360.5]",3,5,-2
31101.0,2019-12-06,"(360.5, 720.0]",13,54,-41
31101.0,2019-12-06,"(720.0, 1079.5]",36,53,-17
31101.0,2019-12-06,"(1079.5, 1439.0]",34,57,-23
31102.0,2019-12-06,"(682.0, 995.5]",5,2,3
31102.0,2019-12-06,"(995.5, 1309.0]",9,18,-9
31103.0,2019-12-06,"(34.61, 383.5]",3,8,-5
31103.0,2019-12-06,"(383.5, 731.0]",5,46,-41
31103.0,2019-12-06,"(731.0, 1078.5]",4,21,-17
31103.0,2019-12-06,"(1078.5, 1426.0]",13,28,-15
31104.0,2019-12-06,"(374.25, 725.5]",1,2,-1
31104.0,2019-12-06,"(725.5, 1076.75]",12,4,8
31104.0,2019-12-06,"(1076.75, 1428.0]",18,22,-4
31105.0,2019-12-06,"(89.762, 400.5]",1,2,-1
31105.0,2019-12-06,"(400.5, 710.0]",5,19,-14
31105.0,2019-12-06,"(710.0, 1019.5]",2,5,-3
31105.0,2019-12-06,"(1019.5, 1329.0]",4,8,-4
31106.0,2019-12-06,"(776.5, 940.75]",3,9,-6
31106.0,2019-12-06,"(940.75, 1105.0]",3,1,2
31107.0,2019-12-06,"(254.841, 545.75]",1,24,-23
31107.0,2019-12-06,"(545.75, 835.5]",8,21,-13
31107.0,2019-12-06,"(835.5, 1125.25]",14,24,-10
31107.0,2019-12-06,"(1125.25, 1415.0]",10,21,-11
31108.0,2019-12-06,"(27.605, 377.75]",2,2,0
31108.0,2019-12-06,"(377.75, 726.5]",13,44,-31
31108.0,2019-12-06,"(726.5, 1075.25]",23,38,-15
31108.0,2019-12-06,"(1075.25, 1424.0]",24,36,-12
31109.0,2019-12-06,"(97.665, 432.75]",1,2,-1
31109.0,2019-12-06,"(432.75, 766.5]",10,32,-22
31109.0,2019-12-06,"(766.5, 1100.25]",15,24,-9
31109.0,2019-12-06,"(1100.25, 1434.0]",16,31,-15
31110.0,2019-12-06,"(324.91, 598.5]",13,31,-18
31110.0,2019-12-06,"(598.5, 871.0]",9,20,-11
31110.0,2019-12-06,"(871.0, 1143.5]",28,45,-17
31110.0,2019-12-06,"(1143.5, 1416.0]",10,20,-10
31111.0,2019-12-06,"(45.628, 390.0]",1,4,-3
31111.0,2019-12-06,"(390.0, 733.0]",6,24,-18
31111.0,2019-12-06,"(733.0, 1076.0]",16,25,-9
31111.0,2019-12-06,"(1076.0, 1419.0]",11,21,-10
31112.0,2019-12-06,"(310.019, 556.25]",1,3,-2
31112.0,2019-12-06,"(801.5, 1046.75]",5,5,0
31112.0,2019-12-06,"(1046.75, 1292.0]",2,5,-3
31113.0,2019-12-06,"(329.908, 604.0]",2,26,-24
31113.0,2019-12-06,"(604.0, 877.0]",2,11,-9
31113.0,2019-12-06,"(877.0, 1150.0]",10,17,-7
31113.0,2019-12-06,"(1150.0, 1423.0]",11,19,-8
31114.0,2019-12-06,"(57.672, 391.0]",4,8,-4
31114.0,2019-12-06,"(391.0, 723.0]",3,24,-21
31114.0,2019-12-06,"(723.0, 1055.0]",9,24,-15
31114.0,2019-12-06,"(1055.0, 1387.0]",30,46,-16
31115.0,2019-12-06,"(2.648, 342.0]",1,1,0
31115.0,2019-12-06,"(342.0, 680.0]",2,20,-18
31115.0,2019-12-06,"(680.0, 1018.0]",5,15,-10
31115.0,2019-12-06,"(1018.0, 1356.0]",12,20,-8
31116.0,2019-12-06,"(326.25, 637.5]",3,1,2
31116.0,2019-12-06,"(637.5, 948.75]",10,23,-13
31116.0,2019-12-06,"(948.75, 1260.0]",19,15,4
31117.0,2019-12-06,"(296.87, 580.5]",3,22,-19
31117.0,2019-12-06,"(580.5, 863.0]",1,12,-11
31117.0,2019-12-06,"(863.0, 1145.5]",13,28,-15
31117.0,2019-12-06,"(1145.5, 1428.0]",8,12,-4
31118.0,2019-12-06,"(389.162, 599.5]",1,17,-16
31118.0,2019-12-06,"(809.0, 1018.5]",1,1,0
31118.0,2019-12-06,"(1018.5, 1228.0]",11,16,-5
31119.0,2019-12-06,"(13.608, 363.0]",3,5,-2
31119.0,2019-12-06,"(363.0, 711.0]",6,26,-20
31119.0,2019-12-06,"(711.0, 1059.0]",6,12,-6
31119.0,2019-12-06,"(1059.0, 1407.0]",20,33,-13
31120.0,2019-12-06,"(5.627, 350.25]",1,1,0
31120.0,2019-12-06,"(350.25, 693.5]",5,25,-20
31120.0,2019-12-06,"(693.5, 1036.75]",6,10,-4
31120.0,2019-12-06,"(1036.75, 1380.0]",16,24,-8
31121.0,2019-12-06,"(341.93, 610.5]",17,26,-9
31121.0,2019-12-06,"(610.5, 878.0]",2,5,-3
31121.0,2019-12-06,"(878.0, 1145.5]",9,21,-12
31121.0,2019-12-06,"(1145.5, 1413.0]",7,13,-6
31122.0,2019-12-06,"(433.125, 652.75]",1,16,-15
31122.0,2019-12-06,"(652.75, 871.5]",2,6,-4
31122.0,2019-12-06,"(871.5, 1090.25]",3,7,-4
31122.0,2019-12-06,"(1090.25, 1309.0]",6,7,-1
31123.0,2019-12-06,"(768.0, 974.5]",2,13,-11
31123.0,2019-12-06,"(974.5, 1181.0]",5,9,-4
31124.0,2019-12-06,"(11.583, 367.25]",2,3,-1
31124.0,2019-12-06,"(367.25, 721.5]",20,52,-32
31124.0,2019-12-06,"(721.5, 1075.75]",23,54,-31
31124.0,2019-12-06,"(1075.75, 1430.0]",17,55,-38
31125.0,2019-12-06,"(346.946, 611.5]",7,32,-25
31125.0,2019-12-06,"(611.5, 875.0]",8,11,-3
31125.0,2019-12-06,"(875.0, 1138.5]",21,29,-8
31125.0,2019-12-06,"(1138.5, 1402.0]",19,33,-14
31126.0,2019-12-06,"(298.864, 584.0]",5,27,-22
31126.0,2019-12-06,"(584.0, 868.0]",8,23,-15
31126.0,2019-12-06,"(868.0, 1152.0]",15,31,-16
31126.0,2019-12-06,"(1152.0, 1436.0]",11,17,-6
,,,,2.0,
31128.0,2019-12-06,"(89.681, 420.75]",4,5,-1
31128.0,2019-12-06,"(420.75, 750.5]",34,58,-24
31128.0,2019-12-06,"(750.5, 1080.25]",18,33,-15
31128.0,2019-12-06,"(1080.25, 1410.0]",7,14,-7
31129.0,2019-12-06,"(477.107, 701.25]",15,20,-5
31129.0,2019-12-06,"(701.25, 924.5]",10,15,-5
31129.0,2019-12-06,"(924.5, 1147.75]",12,21,-9
31130.0,2019-12-06,"(351.983, 607.25]",11,23,-12
31130.0,2019-12-06,"(607.25, 861.5]",4,16,-12
31130.0,2019-12-06,"(861.5, 1115.75]",1,3,-2
31130.0,2019-12-06,"(1115.75, 1370.0]",9,11,-2
31131.0,2019-12-06,"(368.938, 635.5]",1,18,-17
31131.0,2019-12-06,"(635.5, 901.0]",3,9,-6
31131.0,2019-12-06,"(901.0, 1166.5]",4,6,-2
31131.0,2019-12-06,"(1166.5, 1432.0]",2,4,-2
31200.0,2019-12-06,"(35.647, 375.25]",2,4,-2
31200.0,2019-12-06,"(375.25, 713.5]",49,64,-15
31200.0,2019-12-06,"(713.5, 1051.75]",26,57,-31
31200.0,2019-12-06,"(1051.75, 1390.0]",20,41,-21
31201.0,2019-12-06,"(35.639, 377.25]",2,4,-2
31201.0,2019-12-06,"(377.25, 717.5]",26,53,-27
31201.0,2019-12-06,"(717.5, 1057.75]",52,93,-41
31201.0,2019-12-06,"(1057.75, 1398.0]",35,68,-33
31202.0,2019-12-06,"(18.582, 374.5]",2,2,0
31202.0,2019-12-06,"(374.5, 729.0]",15,39,-24
31202.0,2019-12-06,"(729.0, 1083.5]",37,62,-25
31202.0,2019-12-06,"(1083.5, 1438.0]",10,24,-14
31203.0,2019-12-06,"(9.58, 366.0]",1,6,-5
31203.0,2019-12-06,"(366.0, 721.0]",15,43,-28
31203.0,2019-12-06,"(721.0, 1076.0]",33,58,-25
31203.0,2019-12-06,"(1076.0, 1431.0]",34,56,-22
31204.0,2019-12-06,"(23.651, 362.25]",3,4,-1
31204.0,2019-12-06,"(362.25, 699.5]",21,32,-11
31204.0,2019-12-06,"(699.5, 1036.75]",12,34,-22
31204.0,2019-12-06,"(1036.75, 1374.0]",5,12,-7
31205.0,2019-12-06,"(451.097, 677.75]",28,32,-4
31205.0,2019-12-06,"(677.75, 903.5]",10,22,-12
31205.0,2019-12-06,"(903.5, 1129.25]",19,41,-22
31205.0,2019-12-06,"(1129.25, 1355.0]",3,12,-9
31206.0,2019-12-06,"(395.172, 603.0]",7,8,-1
31206.0,2019-12-06,"(603.0, 810.0]",2,6,-4
31206.0,2019-12-06,"(810.0, 1017.0]",2,3,-1
31207.0,2019-12-06,"(20.701, 346.75]",1,2,-1
31207.0,2019-12-06,"(996.25, 1321.0]",2,9,-7
31208.0,2019-12-06,"(353.237, 544.75]",8,11,-3
31208.0,2019-12-06,"(544.75, 735.5]",2,2,0
31208.0,2019-12-06,"(926.25, 1117.0]",9,3,6
31209.0,2019-12-06,"(409.986, 664.5]",5,8,-3
31209.0,2019-12-06,"(664.5, 918.0]",1,2,-1
31209.0,2019-12-06,"(918.0, 1171.5]",11,12,-1
31209.0,2019-12-06,"(1171.5, 1425.0]",1,3,-2
31211.0,2019-12-06,"(425.043, 665.25]",8,9,-1
31211.0,2019-12-06,"(665.25, 904.5]",3,4,-1
31211.0,2019-12-06,"(904.5, 1143.75]",3,8,-5
31211.0,2019-12-06,"(1143.75, 1383.0]",2,6,-4
31212.0,2019-12-06,"(-1.355, 338.75]",5,9,-4
31212.0,2019-12-06,"(338.75, 677.5]",31,44,-13
31212.0,2019-12-06,"(677.5, 1016.25]",12,21,-9
31212.0,2019-12-06,"(1016.25, 1355.0]",12,29,-17
31213.0,2019-12-06,"(394.981, 650.75]",42,58,-16
31213.0,2019-12-06,"(650.75, 905.5]",4,7,-3
31213.0,2019-12-06,"(905.5, 1160.25]",12,23,-11
31213.0,2019-12-06,"(1160.25, 1415.0]",1,6,-5
31214.0,2019-12-06,"(366.934, 634.5]",14,46,-32
31214.0,2019-12-06,"(634.5, 901.0]",13,31,-18
31214.0,2019-12-06,"(901.0, 1167.5]",32,49,-17
31214.0,2019-12-06,"(1167.5, 1434.0]",12,23,-11
31215.0,2019-12-06,"(22.765, 332.75]",2,3,-1
31215.0,2019-12-06,"(332.75, 641.5]",20,20,0
31215.0,2019-12-06,"(641.5, 950.25]",10,10,0
31215.0,2019-12-06,"(950.25, 1259.0]",7,20,-13
31216.0,2019-12-06,"(334.949, 598.75]",20,22,-2
31216.0,2019-12-06,"(598.75, 861.5]",3,6,-3
31216.0,2019-12-06,"(861.5, 1124.25]",3,18,-15
31216.0,2019-12-06,"(1124.25, 1387.0]",1,5,-4
31217.0,2019-12-06,"(375.979, 632.25]",5,7,-2
31217.0,2019-12-06,"(632.25, 887.5]",6,11,-5
31217.0,2019-12-06,"(887.5, 1142.75]",2,9,-7
31218.0,2019-12-06,"(253.849, 542.75]",6,19,-13
31218.0,2019-12-06,"(542.75, 830.5]",5,11,-6
31218.0,2019-12-06,"(830.5, 1118.25]",11,15,-4
31218.0,2019-12-06,"(1118.25, 1406.0]",2,6,-4
31219.0,2019-12-06,"(433.393, 585.75]",7,7,0
31219.0,2019-12-06,"(585.75, 737.5]",6,6,0
31219.0,2019-12-06,"(737.5, 889.25]",4,13,-9
31219.0,2019-12-06,"(889.25, 1041.0]",2,11,-9
31220.0,2019-12-06,"(376.342, 541.5]",15,16,-1
31220.0,2019-12-06,"(541.5, 706.0]",1,1,0
31220.0,2019-12-06,"(706.0, 870.5]",1,6,-5
31220.0,2019-12-06,"(870.5, 1035.0]",3,17,-14
31221.0,2019-12-06,"(376.947, 641.25]",37,41,-4
31221.0,2019-12-06,"(641.25, 904.5]",20,32,-12
31221.0,2019-12-06,"(904.5, 1167.75]",11,29,-18
31221.0,2019-12-06,"(1167.75, 1431.0]",4,11,-7
31222.0,2019-12-06,"(410.065, 644.75]",17,18,-1
31222.0,2019-12-06,"(644.75, 878.5]",5,12,-7
31222.0,2019-12-06,"(878.5, 1112.25]",5,15,-10
31222.0,2019-12-06,"(1112.25, 1346.0]",6,16,-10
31223.0,2019-12-06,"(366.0, 714.0]",11,4,7
31223.0,2019-12-06,"(714.0, 1062.0]",15,38,-23
31223.0,2019-12-06,"(1062.0, 1410.0]",12,22,-10
31224.0,2019-12-06,"(340.25, 656.5]",17,1,16
31224.0,2019-12-06,"(656.5, 972.75]",5,20,-15
31224.0,2019-12-06,"(972.75, 1289.0]",10,11,-1
31225.0,2019-12-06,"(430.102, 655.5]",7,11,-4
31225.0,2019-12-06,"(655.5, 880.0]",2,10,-8
31225.0,2019-12-06,"(880.0, 1104.5]",10,20,-10
31225.0,2019-12-06,"(1104.5, 1329.0]",9,15,-6
31226.0,2019-12-06,"(312.962, 573.5]",2,9,-7
31226.0,2019-12-06,"(573.5, 833.0]",4,6,-2
31226.0,2019-12-06,"(833.0, 1092.5]",8,17,-9
31226.0,2019-12-06,"(1092.5, 1352.0]",2,7,-5
31227.0,2019-12-06,"(345.5, 681.0]",40,1,39
31227.0,2019-12-06,"(681.0, 1016.5]",13,41,-28
31227.0,2019-12-06,"(1016.5, 1352.0]",6,31,-25
31228.0,2019-12-06,"(161.724, 482.0]",6,8,-2
31228.0,2019-12-06,"(482.0, 801.0]",20,28,-8
31228.0,2019-12-06,"(801.0, 1120.0]",35,64,-29
31228.0,2019-12-06,"(1120.0, 1439.0]",8,16,-8
31229.0,2019-12-06,"(-0.387, 347.75]",2,4,-2
31229.0,2019-12-06,"(347.75, 694.5]",12,59,-47
31229.0,2019-12-06,"(694.5, 1041.25]",34,64,-30
31229.0,2019-12-06,"(1041.25, 1388.0]",36,70,-34
31230.0,2019-12-06,"(330.967, 590.25]",49,60,-11
31230.0,2019-12-06,"(590.25, 848.5]",17,21,-4
31230.0,2019-12-06,"(848.5, 1106.75]",16,47,-31
31230.0,2019-12-06,"(1106.75, 1365.0]",5,16,-11
31231.0,2019-12-06,"(374.961, 635.75]",14,16,-2
31231.0,2019-12-06,"(635.75, 895.5]",14,23,-9
31231.0,2019-12-06,"(895.5, 1155.25]",5,9,-4
31232.0,2019-12-06,"(327.896, 605.0]",16,22,-6
31232.0,2019-12-06,"(605.0, 881.0]",13,17,-4
31232.0,2019-12-06,"(881.0, 1157.0]",16,31,-15
31232.0,2019-12-06,"(1157.0, 1433.0]",6,14,-8
31233.0,2019-12-06,"(-0.437, 360.25]",2,2,0
31233.0,2019-12-06,"(360.25, 719.5]",48,58,-10
31233.0,2019-12-06,"(719.5, 1078.75]",34,64,-30
31233.0,2019-12-06,"(1078.75, 1438.0]",7,18,-11
31234.0,2019-12-06,"(9.583, 365.25]",2,2,0
31234.0,2019-12-06,"(365.25, 719.5]",18,35,-17
31234.0,2019-12-06,"(719.5, 1073.75]",21,37,-16
31234.0,2019-12-06,"(1073.75, 1428.0]",15,26,-11
31235.0,2019-12-06,"(473.123, 693.25]",6,6,0
31235.0,2019-12-06,"(693.25, 912.5]",4,5,-1
31235.0,2019-12-06,"(1131.75, 1351.0]",2,4,-2
31236.0,2019-12-06,"(378.994, 631.5]",14,18,-4
31236.0,2019-12-06,"(631.5, 883.0]",17,30,-13
31236.0,2019-12-06,"(883.0, 1134.5]",8,23,-15
31236.0,2019-12-06,"(1134.5, 1386.0]",5,13,-8
31237.0,2019-12-06,"(16.597, 368.75]",1,3,-2
31237.0,2019-12-06,"(368.75, 719.5]",9,21,-12
31237.0,2019-12-06,"(719.5, 1070.25]",17,38,-21
31237.0,2019-12-06,"(1070.25, 1421.0]",5,14,-9
31238.0,2019-12-06,"(53.674, 386.5]",1,1,0
31238.0,2019-12-06,"(386.5, 718.0]",29,38,-9
31238.0,2019-12-06,"(718.0, 1049.5]",6,27,-21
31238.0,2019-12-06,"(1049.5, 1381.0]",6,18,-12
31239.0,2019-12-06,"(53.635, 396.25]",4,5,-1
31239.0,2019-12-06,"(396.25, 737.5]",44,51,-7
31239.0,2019-12-06,"(737.5, 1078.75]",18,44,-26
31239.0,2019-12-06,"(1078.75, 1420.0]",10,17,-7
31240.0,2019-12-06,"(363.243, 553.25]",2,4,-2
31240.0,2019-12-06,"(742.5, 931.75]",2,4,-2
31241.0,2019-12-06,"(22.604, 373.0]",1,4,-3
31241.0,2019-12-06,"(373.0, 722.0]",37,67,-30
31241.0,2019-12-06,"(722.0, 1071.0]",17,32,-15
31241.0,2019-12-06,"(1071.0, 1420.0]",16,31,-15
31242.0,2019-12-06,"(423.224, 618.0]",27,30,-3
31242.0,2019-12-06,"(618.0, 812.0]",7,12,-5
31242.0,2019-12-06,"(812.0, 1006.0]",6,14,-8
31242.0,2019-12-06,"(1006.0, 1200.0]",2,20,-18
31243.0,2019-12-06,"(374.064, 609.0]",23,29,-6
31243.0,2019-12-06,"(609.0, 843.0]",8,9,-1
31243.0,2019-12-06,"(843.0, 1077.0]",3,21,-18
31243.0,2019-12-06,"(1077.0, 1311.0]",5,11,-6
31244.0,2019-12-06,"(367.25, 719.5]",14,2,12
31244.0,2019-12-06,"(719.5, 1071.75]",12,25,-13
31244.0,2019-12-06,"(1071.75, 1424.0]",7,26,-19
31245.0,2019-12-06,"(113.728, 433.0]",5,6,-1
31245.0,2019-12-06,"(433.0, 751.0]",11,34,-23
31245.0,2019-12-06,"(751.0, 1069.0]",15,24,-9
31245.0,2019-12-06,"(1069.0, 1387.0]",8,17,-9
31246.0,2019-12-06,"(3.615, 351.25]",1,3,-2
31246.0,2019-12-06,"(351.25, 697.5]",13,25,-12
31246.0,2019-12-06,"(697.5, 1043.75]",12,24,-12
31246.0,2019-12-06,"(1043.75, 1390.0]",20,36,-16
31247.0,2019-12-06,"(426.196, 628.0]",7,8,-1
31247.0,2019-12-06,"(628.0, 829.0]",4,13,-9
31247.0,2019-12-06,"(829.0, 1030.0]",6,12,-6
31247.0,2019-12-06,"(1030.0, 1231.0]",6,10,-4
31248.0,2019-12-06,"(355.975, 613.25]",14,20,-6
31248.0,2019-12-06,"(613.25, 869.5]",12,22,-10
31248.0,2019-12-06,"(869.5, 1125.75]",18,44,-26
31248.0,2019-12-06,"(1125.75, 1382.0]",3,3,0
31249.0,2019-12-06,"(461.231, 654.25]",4,6,-2
31249.0,2019-12-06,"(654.25, 846.5]",4,12,-8
31249.0,2019-12-06,"(846.5, 1038.75]",8,15,-7
31249.0,2019-12-06,"(1038.75, 1231.0]",3,6,-3
31250.0,2019-12-06,"(409.081, 639.75]",21,23,-2
31250.0,2019-12-06,"(639.75, 869.5]",6,12,-6
31250.0,2019-12-06,"(869.5, 1099.25]",5,21,-16
31250.0,2019-12-06,"(1099.25, 1329.0]",2,9,-7
31251.0,2019-12-06,"(24.614, 372.5]",2,4,-2
31251.0,2019-12-06,"(372.5, 719.0]",23,46,-23
31251.0,2019-12-06,"(719.0, 1065.5]",15,35,-20
31251.0,2019-12-06,"(1065.5, 1412.0]",12,16,-4
31252.0,2019-12-06,"(444.06, 680.0]",20,26,-6
31252.0,2019-12-06,"(680.0, 915.0]",9,19,-10
31252.0,2019-12-06,"(915.0, 1150.0]",4,18,-14
31252.0,2019-12-06,"(1150.0, 1385.0]",5,9,-4
31253.0,2019-12-06,"(385.952, 649.0]",21,27,-6
31253.0,2019-12-06,"(649.0, 911.0]",10,16,-6
31253.0,2019-12-06,"(911.0, 1173.0]",6,15,-9
31254.0,2019-12-06,"(355.996, 608.0]",22,26,-4
31254.0,2019-12-06,"(608.0, 859.0]",2,5,-3
31254.0,2019-12-06,"(859.0, 1110.0]",3,21,-18
31254.0,2019-12-06,"(1110.0, 1361.0]",1,8,-7
31255.0,2019-12-06,"(278.75, 550.5]",15,1,14
31255.0,2019-12-06,"(550.5, 822.25]",7,20,-13
31255.0,2019-12-06,"(822.25, 1094.0]",9,11,-2
31256.0,2019-12-06,"(283.002, 533.5]",9,10,-1
31256.0,2019-12-06,"(533.5, 783.0]",18,21,-3
31256.0,2019-12-06,"(783.0, 1032.5]",4,8,-4
31256.0,2019-12-06,"(1032.5, 1282.0]",7,14,-7
31257.0,2019-12-06,"(322.899, 599.25]",24,34,-10
31257.0,2019-12-06,"(599.25, 874.5]",18,37,-19
31257.0,2019-12-06,"(874.5, 1149.75]",20,47,-27
31257.0,2019-12-06,"(1149.75, 1425.0]",7,15,-8
31258.0,2019-12-06,"(9.673, 342.75]",2,5,-3
31258.0,2019-12-06,"(342.75, 674.5]",4,7,-3
31258.0,2019-12-06,"(674.5, 1006.25]",23,45,-22
31258.0,2019-12-06,"(1006.25, 1338.0]",4,8,-4
31259.0,2019-12-06,"(446.305, 620.75]",11,11,0
31259.0,2019-12-06,"(620.75, 794.5]",3,5,-2
31259.0,2019-12-06,"(794.5, 968.25]",2,7,-5
31260.0,2019-12-06,"(339.964, 600.0]",17,24,-7
31260.0,2019-12-06,"(859.0, 1118.0]",3,4,-1
31260.0,2019-12-06,"(1118.0, 1377.0]",3,14,-11
31261.0,2019-12-06,"(395.069, 628.75]",10,10,0
31261.0,2019-12-06,"(628.75, 861.5]",1,6,-5
31261.0,2019-12-06,"(861.5, 1094.25]",1,10,-9
31262.0,2019-12-06,"(84.71, 408.5]",1,1,0
31262.0,2019-12-06,"(408.5, 731.0]",13,15,-2
31262.0,2019-12-06,"(731.0, 1053.5]",3,10,-7
31262.0,2019-12-06,"(1053.5, 1376.0]",6,14,-8
31263.0,2019-12-06,"(404.106, 628.5]",21,31,-10
31263.0,2019-12-06,"(628.5, 852.0]",4,11,-7
31263.0,2019-12-06,"(852.0, 1075.5]",9,24,-15
31263.0,2019-12-06,"(1075.5, 1299.0]",5,10,-5
31264.0,2019-12-06,"(379.5, 716.0]",15,1,14
31264.0,2019-12-06,"(716.0, 1052.5]",8,24,-16
31264.0,2019-12-06,"(1052.5, 1389.0]",3,15,-12
31265.0,2019-12-06,"(8.585, 363.75]",3,4,-1
31265.0,2019-12-06,"(363.75, 717.5]",21,50,-29
31265.0,2019-12-06,"(717.5, 1071.25]",21,44,-23
31265.0,2019-12-06,"(1071.25, 1425.0]",15,26,-11
31266.0,2019-12-06,"(156.723, 477.25]",2,11,-9
31266.0,2019-12-06,"(477.25, 796.5]",12,36,-24
31266.0,2019-12-06,"(796.5, 1115.75]",25,47,-22
31266.0,2019-12-06,"(1115.75, 1435.0]",21,40,-19
31267.0,2019-12-06,"(4.599, 356.25]",1,3,-2
31267.0,2019-12-06,"(356.25, 706.5]",24,47,-23
31267.0,2019-12-06,"(706.5, 1056.75]",26,49,-23
31267.0,2019-12-06,"(1056.75, 1407.0]",16,35,-19
31268.0,2019-12-06,"(366.945, 631.75]",9,35,-26
31268.0,2019-12-06,"(631.75, 895.5]",7,9,-2
31268.0,2019-12-06,"(895.5, 1159.25]",19,26,-7
31268.0,2019-12-06,"(1159.25, 1423.0]",15,21,-6
31269.0,2019-12-06,"(377.994, 630.5]",15,21,-6
31269.0,2019-12-06,"(630.5, 882.0]",7,17,-10
31269.0,2019-12-06,"(882.0, 1133.5]",8,24,-16
31269.0,2019-12-06,"(1133.5, 1385.0]",8,13,-5
31270.0,2019-12-06,"(393.264, 578.0]",12,15,-3
31270.0,2019-12-06,"(578.0, 762.0]",8,10,-2
31270.0,2019-12-06,"(762.0, 946.0]",3,10,-7
31270.0,2019-12-06,"(946.0, 1130.0]",13,23,-10
31271.0,2019-12-06,"(376.996, 629.0]",14,16,-2
31271.0,2019-12-06,"(629.0, 880.0]",4,22,-18
31271.0,2019-12-06,"(880.0, 1131.0]",11,23,-12
31271.0,2019-12-06,"(1131.0, 1382.0]",4,7,-3
31272.0,2019-12-06,"(292.991, 546.25]",15,17,-2
31272.0,2019-12-06,"(546.25, 798.5]",12,20,-8
31272.0,2019-12-06,"(798.5, 1050.75]",13,25,-12
31272.0,2019-12-06,"(1050.75, 1303.0]",8,21,-13
31273.0,2019-12-06,"(338.194, 540.5]",1,2,-1
31273.0,2019-12-06,"(742.0, 943.5]",1,1,0
31273.0,2019-12-06,"(943.5, 1145.0]",2,2,0
31274.0,2019-12-06,"(407.5, 738.0]",14,3,11
31274.0,2019-12-06,"(738.0, 1068.5]",5,17,-12
31274.0,2019-12-06,"(1068.5, 1399.0]",2,15,-13
31275.0,2019-12-06,"(74.682, 405.5]",8,10,-2
31275.0,2019-12-06,"(405.5, 735.0]",18,37,-19
31275.0,2019-12-06,"(735.0, 1064.5]",18,32,-14
31275.0,2019-12-06,"(1064.5, 1394.0]",11,22,-11
31276.0,2019-12-06,"(34.737, 351.75]",1,1,0
31276.0,2019-12-06,"(351.75, 667.5]",26,30,-4
31276.0,2019-12-06,"(667.5, 983.25]",4,13,-9
31276.0,2019-12-06,"(983.25, 1299.0]",10,29,-19
31277.0,2019-12-06,"(425.063, 660.25]",42,46,-4
31277.0,2019-12-06,"(660.25, 894.5]",13,20,-7
31277.0,2019-12-06,"(894.5, 1128.75]",6,32,-26
31278.0,2019-12-06,"(457.08, 688.0]",14,45,-31
31278.0,2019-12-06,"(688.0, 918.0]",7,17,-10
31278.0,2019-12-06,"(918.0, 1148.0]",22,33,-11
31278.0,2019-12-06,"(1148.0, 1378.0]",4,7,-3
31279.0,2019-12-06,"(427.247, 616.25]",20,23,-3
31279.0,2019-12-06,"(616.25, 804.5]",9,13,-4
31279.0,2019-12-06,"(804.5, 992.75]",8,17,-9
31279.0,2019-12-06,"(992.75, 1181.0]",4,24,-20
31280.0,2019-12-06,"(344.931, 613.25]",5,18,-13
31280.0,2019-12-06,"(613.25, 880.5]",8,15,-7
31280.0,2019-12-06,"(880.5, 1147.75]",4,6,-2
31280.0,2019-12-06,"(1147.75, 1415.0]",1,3,-2
31000.0,2019-12-07,"(888.0, 1087.0]",1,1,0
31000.0,2019-12-07,"(1087.0, 1286.0]",1,4,-3
31001.0,2019-12-07,"(580.187, 784.25]",2,3,-1
31001.0,2019-12-07,"(784.25, 987.5]",1,3,-2
31001.0,2019-12-07,"(1190.75, 1394.0]",2,1,1
31002.0,2019-12-07,"(552.528, 671.0]",2,6,-4
31002.0,2019-12-07,"(789.0, 907.0]",1,1,0
31002.0,2019-12-07,"(907.0, 1025.0]",3,3,0
31003.0,2019-12-07,"(494.53, 612.5]",1,2,-1
31003.0,2019-12-07,"(847.5, 965.0]",1,1,0
31004.0,2019-12-07,"(596.521, 716.75]",2,4,-2
31004.0,2019-12-07,"(716.75, 836.5]",1,2,-1
31004.0,2019-12-07,"(956.25, 1076.0]",1,2,-1
31005.0,2019-12-07,"(573.183, 778.25]",2,4,-2
31005.0,2019-12-07,"(778.25, 982.5]",2,3,-1
31005.0,2019-12-07,"(982.5, 1186.75]",1,2,-1
31006.0,2019-12-07,"(576.174, 783.5]",1,2,-1
31006.0,2019-12-07,"(783.5, 990.0]",1,1,0
31006.0,2019-12-07,"(990.0, 1196.5]",2,6,-4
31007.0,2019-12-07,"(574.211, 772.25]",1,2,-1
31007.0,2019-12-07,"(772.25, 969.5]",2,3,-1
31007.0,2019-12-07,"(969.5, 1166.75]",2,3,-1
31007.0,2019-12-07,"(1166.75, 1364.0]",1,2,-1
31009.0,2019-12-07,"(445.439, 586.25]",2,2,0
31010.0,2019-12-07,"(560.0, 597.0]",1,1,0
31010.0,2019-12-07,"(597.0, 634.0]",2,1,1
31011.0,2019-12-07,"(417.502, 542.5]",2,2,0
,,,,1.0,
,,,,1.0,
31013.0,2019-12-07,"(556.355, 718.25]",1,3,-2
31013.0,2019-12-07,"(718.25, 879.5]",3,5,-2
31013.0,2019-12-07,"(879.5, 1040.75]",2,5,-3
31013.0,2019-12-07,"(1040.75, 1202.0]",2,3,-1
31014.0,2019-12-07,"(211.919, 483.25]",3,3,0
31014.0,2019-12-07,"(483.25, 753.5]",5,9,-4
31014.0,2019-12-07,"(753.5, 1023.75]",6,9,-3
31014.0,2019-12-07,"(1023.75, 1294.0]",5,7,-2
31015.0,2019-12-07,"(346.974, 604.5]",3,3,0
31015.0,2019-12-07,"(604.5, 861.0]",4,5,-1
31015.0,2019-12-07,"(861.0, 1117.5]",5,7,-2
31015.0,2019-12-07,"(1117.5, 1374.0]",3,6,-3
31016.0,2019-12-07,"(350.0, 658.0]",1,1,0
31016.0,2019-12-07,"(658.0, 966.0]",3,3,0
31016.0,2019-12-07,"(966.0, 1274.0]",3,10,-7
31017.0,2019-12-07,"(347.25, 643.5]",2,1,1
31017.0,2019-12-07,"(643.5, 939.75]",2,3,-1
31018.0,2019-12-07,"(727.5, 918.75]",2,1,1
31018.0,2019-12-07,"(918.75, 1110.0]",1,3,-2
31019.0,2019-12-07,"(730.0, 934.0]",3,1,2
31019.0,2019-12-07,"(934.0, 1138.0]",1,4,-3
31020.0,2019-12-07,"(796.75, 912.5]",1,1,0
31020.0,2019-12-07,"(912.5, 1028.25]",1,1,0
31020.0,2019-12-07,"(1028.25, 1144.0]",1,2,-1
31021.0,2019-12-07,"(392.0, 719.0]",1,1,0
31021.0,2019-12-07,"(719.0, 1046.0]",1,3,-2
31021.0,2019-12-07,"(1046.0, 1373.0]",1,7,-6
31022.0,2019-12-07,"(681.0, 964.0]",1,1,0
31022.0,2019-12-07,"(964.0, 1247.0]",2,6,-4
31023.0,2019-12-07,"(181.797, 483.75]",1,2,-1
31023.0,2019-12-07,"(784.5, 1085.25]",4,2,2
31023.0,2019-12-07,"(1085.25, 1386.0]",1,4,-3
31024.0,2019-12-07,"(355.5, 709.0]",2,2,0
31024.0,2019-12-07,"(709.0, 1062.5]",2,5,-3
31024.0,2019-12-07,"(1062.5, 1416.0]",1,5,-4
31025.0,2019-12-07,"(736.453, 873.75]",1,1,0
31025.0,2019-12-07,"(873.75, 1010.5]",2,3,-1
31026.0,2019-12-07,"(553.5, 828.75]",4,1,3
31026.0,2019-12-07,"(828.75, 1104.0]",1,4,-3
31027.0,2019-12-07,"(123.196, 325.0]",1,1,0
31027.0,2019-12-07,"(727.0, 928.0]",3,5,-2
31028.0,2019-12-07,"(728.0, 839.0]",2,1,1
31028.0,2019-12-07,"(950.0, 1061.0]",1,3,-2
31029.0,2019-12-07,"(481.145, 695.75]",2,6,-4
31029.0,2019-12-07,"(695.75, 909.5]",2,6,-4
31030.0,2019-12-07,"(54.624, 400.0]",1,1,0
31030.0,2019-12-07,"(400.0, 744.0]",1,5,-4
31030.0,2019-12-07,"(1088.0, 1432.0]",2,2,0
31031.0,2019-12-07,"(67.641, 408.75]",1,1,0
31031.0,2019-12-07,"(408.75, 748.5]",2,6,-4
31031.0,2019-12-07,"(1088.25, 1428.0]",2,2,0
,,,,2.0,
31033.0,2019-12-07,"(500.511, 623.25]",1,2,-1
31033.0,2019-12-07,"(867.75, 990.0]",1,2,-1
31034.0,2019-12-07,"(185.774, 493.5]",1,1,0
31034.0,2019-12-07,"(493.5, 800.0]",2,4,-2
31034.0,2019-12-07,"(1106.5, 1413.0]",1,3,-2
31035.0,2019-12-07,"(818.25, 1091.0]",1,1,0
31036.0,2019-12-07,"(434.271, 617.25]",1,2,-1
31036.0,2019-12-07,"(981.75, 1164.0]",3,2,1
31037.0,2019-12-07,"(436.072, 669.0]",4,5,-1
31037.0,2019-12-07,"(669.0, 901.0]",4,7,-3
31037.0,2019-12-07,"(901.0, 1133.0]",5,7,-2
31038.0,2019-12-07,"(863.25, 1014.0]",1,1,0
31039.0,2019-12-07,"(852.0, 1000.0]",2,2,0
31040.0,2019-12-07,"(416.272, 599.0]",2,3,-1
31040.0,2019-12-07,"(963.0, 1145.0]",1,1,0
31041.0,2019-12-07,"(568.506, 692.5]",5,5,0
31041.0,2019-12-07,"(692.5, 816.0]",3,5,-2
31041.0,2019-12-07,"(816.0, 939.5]",1,3,-2
31041.0,2019-12-07,"(939.5, 1063.0]",2,3,-1
31042.0,2019-12-07,"(492.244, 682.0]",7,10,-3
31042.0,2019-12-07,"(682.0, 871.0]",3,4,-1
31042.0,2019-12-07,"(871.0, 1060.0]",5,10,-5
31042.0,2019-12-07,"(1060.0, 1249.0]",4,9,-5
31043.0,2019-12-07,"(661.0, 790.0]",3,3,0
31044.0,2019-12-07,"(72.988, 327.0]",1,1,0
31044.0,2019-12-07,"(580.0, 833.0]",5,6,-1
31044.0,2019-12-07,"(833.0, 1086.0]",3,7,-4
31045.0,2019-12-07,"(718.732, 786.0]",1,4,-3
31045.0,2019-12-07,"(853.0, 920.0]",1,2,-1
31045.0,2019-12-07,"(920.0, 987.0]",1,2,-1
31046.0,2019-12-07,"(202.434, 344.5]",1,1,0
31047.0,2019-12-07,"(669.75, 858.5]",1,2,-1
31047.0,2019-12-07,"(858.5, 1047.25]",2,2,0
31047.0,2019-12-07,"(1047.25, 1236.0]",2,5,-3
31048.0,2019-12-07,"(800.436, 942.0]",1,2,-1
31048.0,2019-12-07,"(1083.0, 1224.0]",1,1,0
31048.0,2019-12-07,"(1224.0, 1365.0]",1,1,0
31049.0,2019-12-07,"(756.959, 767.25]",1,3,-2
31049.0,2019-12-07,"(787.75, 798.0]",2,2,0
,,,,1.0,
,,,,2.0,
31051.0,2019-12-07,"(1174.5, 1426.0]",1,2,-1
31052.0,2019-12-07,"(638.501, 763.75]",1,2,-1
31052.0,2019-12-07,"(888.5, 1013.25]",1,1,0
31053.0,2019-12-07,"(100.227, 294.25]",3,6,-3
,,,,1.0,
,,,,1.0,
31055.0,2019-12-07,"(542.753, 604.75]",1,1,0
31055.0,2019-12-07,"(604.75, 666.5]",1,2,-1
31056.0,2019-12-07,"(-1.031, 257.75]",1,2,-1
31056.0,2019-12-07,"(773.25, 1031.0]",2,2,0
31057.0,2019-12-07,"(1021.999, 1022.25]",1,1,0
,,,,1.0,
,,,,1.0,
31059.0,2019-12-07,"(953.75, 1065.5]",1,1,0
31059.0,2019-12-07,"(1177.25, 1289.0]",1,2,-1
31060.0,2019-12-07,"(845.821, 890.75]",1,1,0
31061.0,2019-12-07,"(462.0, 616.0]",1,1,0
31062.0,2019-12-07,"(506.399, 657.25]",2,6,-4
31062.0,2019-12-07,"(657.25, 807.5]",5,8,-3
31062.0,2019-12-07,"(807.5, 957.75]",5,11,-6
31062.0,2019-12-07,"(957.75, 1108.0]",2,4,-2
31063.0,2019-12-07,"(671.731, 739.25]",1,2,-1
31064.0,2019-12-07,"(587.498, 713.5]",2,4,-2
31064.0,2019-12-07,"(713.5, 839.0]",4,9,-5
31064.0,2019-12-07,"(839.0, 964.5]",3,5,-2
31064.0,2019-12-07,"(964.5, 1090.0]",4,6,-2
31065.0,2019-12-07,"(86.998, 87.5]",1,1,0
31065.0,2019-12-07,"(87.5, 88.0]",2,4,-2
31066.0,2019-12-07,"(891.0, 1188.0]",1,1,0
31067.0,2019-12-07,"(18.142, 233.5]",1,1,0
31067.0,2019-12-07,"(662.5, 877.0]",2,2,0
31068.0,2019-12-07,"(73.805, 373.75]",1,1,0
31068.0,2019-12-07,"(971.25, 1270.0]",2,1,1
31069.0,2019-12-07,"(59.767, 369.25]",1,2,-1
31069.0,2019-12-07,"(985.75, 1294.0]",2,2,0
31070.0,2019-12-07,"(620.499, 746.25]",1,3,-2
31070.0,2019-12-07,"(996.75, 1122.0]",1,2,-1
31071.0,2019-12-07,"(410.998, 662.5]",2,6,-4
31071.0,2019-12-07,"(662.5, 913.0]",5,7,-2
31071.0,2019-12-07,"(913.0, 1163.5]",4,5,-1
31071.0,2019-12-07,"(1163.5, 1414.0]",1,3,-2
,,,,2.0,
31073.0,2019-12-07,"(640.551, 753.25]",1,2,-1
31073.0,2019-12-07,"(977.75, 1090.0]",1,3,-2
31074.0,2019-12-07,"(8.624, 354.0]",1,1,0
31074.0,2019-12-07,"(354.0, 698.0]",1,1,0
31074.0,2019-12-07,"(698.0, 1042.0]",1,3,-2
31074.0,2019-12-07,"(1042.0, 1386.0]",1,1,0
31075.0,2019-12-07,"(672.492, 800.0]",1,2,-1
31075.0,2019-12-07,"(1054.0, 1181.0]",1,3,-2
,,,,1.0,
,,,,1.0,
31077.0,2019-12-07,"(462.306, 636.5]",3,6,-3
31077.0,2019-12-07,"(636.5, 810.0]",2,3,-1
31077.0,2019-12-07,"(810.0, 983.5]",2,3,-1
31077.0,2019-12-07,"(983.5, 1157.0]",1,2,-1
,,,,1.0,
,,,,1.0,
31079.0,2019-12-07,"(108.723, 429.25]",1,1,0
31079.0,2019-12-07,"(429.25, 748.5]",3,6,-3
31079.0,2019-12-07,"(748.5, 1067.75]",4,10,-6
31079.0,2019-12-07,"(1067.75, 1387.0]",5,5,0
31080.0,2019-12-07,"(69.721, 390.75]",1,1,0
31080.0,2019-12-07,"(390.75, 710.5]",1,5,-4
31080.0,2019-12-07,"(710.5, 1030.25]",1,4,-3
31080.0,2019-12-07,"(1030.25, 1350.0]",3,3,0
31081.0,2019-12-07,"(1120.25, 1179.0]",1,2,-1
,,,,2.0,
,,,,3.0,
31083.0,2019-12-07,"(682.441, 822.75]",4,6,-2
31083.0,2019-12-07,"(1102.25, 1242.0]",1,1,0
31084.0,2019-12-07,"(785.424, 930.0]",2,2,0
31084.0,2019-12-07,"(1074.0, 1218.0]",1,2,-1
31085.0,2019-12-07,"(860.0, 920.5]",1,1,0
31086.0,2019-12-07,"(557.167, 766.25]",3,4,-1
31086.0,2019-12-07,"(766.25, 974.5]",3,4,-1
31086.0,2019-12-07,"(974.5, 1182.75]",1,1,0
31086.0,2019-12-07,"(1182.75, 1391.0]",1,1,0
31087.0,2019-12-07,"(666.974, 673.5]",1,1,0
31087.0,2019-12-07,"(686.5, 693.0]",1,2,-1
,,,,1.0,
,,,,1.0,
31089.0,2019-12-07,"(94.79, 398.5]",1,1,0
31089.0,2019-12-07,"(398.5, 701.0]",3,6,-3
31089.0,2019-12-07,"(701.0, 1003.5]",4,9,-5
31089.0,2019-12-07,"(1003.5, 1306.0]",3,7,-4
31090.0,2019-12-07,"(859.987, 863.25]",1,2,-1
31090.0,2019-12-07,"(869.75, 873.0]",1,2,-1
31091.0,2019-12-07,"(1237.75, 1394.0]",1,1,0
31092.0,2019-12-07,"(920.87, 953.5]",1,1,0
31093.0,2019-12-07,"(850.25, 937.0]",1,2,-1
31094.0,2019-12-07,"(759.517, 880.75]",1,1,0
,,,,2.0,
,,,,2.0,
31097.0,2019-12-07,"(728.474, 860.5]",2,5,-3
31097.0,2019-12-07,"(992.0, 1123.5]",1,2,-1
31097.0,2019-12-07,"(1123.5, 1255.0]",5,8,-3
31098.0,2019-12-07,"(619.5, 745.0]",3,4,-1
31098.0,2019-12-07,"(870.0, 995.0]",1,1,0
31098.0,2019-12-07,"(995.0, 1120.0]",2,1,1
31099.0,2019-12-07,"(851.5, 947.25]",1,1,0
31099.0,2019-12-07,"(947.25, 1043.0]",1,1,0
31100.0,2019-12-07,"(510.585, 614.75]",2,2,0
31100.0,2019-12-07,"(614.75, 718.5]",3,4,-1
31100.0,2019-12-07,"(718.5, 822.25]",3,5,-2
31100.0,2019-12-07,"(822.25, 926.0]",1,1,0
31101.0,2019-12-07,"(0.624, 346.0]",7,17,-10
31101.0,2019-12-07,"(346.0, 690.0]",33,45,-12
31101.0,2019-12-07,"(690.0, 1034.0]",51,83,-32
31101.0,2019-12-07,"(1034.0, 1378.0]",21,34,-13
31102.0,2019-12-07,"(3.666, 338.5]",2,7,-5
31102.0,2019-12-07,"(338.5, 672.0]",7,18,-11
31102.0,2019-12-07,"(672.0, 1005.5]",6,18,-12
31102.0,2019-12-07,"(1005.5, 1339.0]",7,16,-9
31103.0,2019-12-07,"(65.69, 394.5]",1,3,-2
31103.0,2019-12-07,"(394.5, 722.0]",8,22,-14
31103.0,2019-12-07,"(722.0, 1049.5]",7,35,-28
31103.0,2019-12-07,"(1049.5, 1377.0]",5,22,-17
31104.0,2019-12-07,"(16.612, 365.0]",2,7,-5
31104.0,2019-12-07,"(365.0, 712.0]",4,16,-12
31104.0,2019-12-07,"(712.0, 1059.0]",14,30,-16
31104.0,2019-12-07,"(1059.0, 1406.0]",16,32,-16
31105.0,2019-12-07,"(521.115, 743.25]",3,10,-7
31105.0,2019-12-07,"(743.25, 964.5]",1,5,-4
31105.0,2019-12-07,"(1185.75, 1407.0]",1,5,-4
31106.0,2019-12-07,"(213.109, 436.75]",1,2,-1
31106.0,2019-12-07,"(659.5, 882.25]",2,5,-3
31106.0,2019-12-07,"(882.25, 1105.0]",2,8,-6
31107.0,2019-12-07,"(41.685, 371.75]",3,5,-2
31107.0,2019-12-07,"(371.75, 700.5]",9,24,-15
31107.0,2019-12-07,"(700.5, 1029.25]",8,19,-11
31107.0,2019-12-07,"(1029.25, 1358.0]",6,15,-9
31108.0,2019-12-07,"(6.57, 365.5]",2,4,-2
31108.0,2019-12-07,"(365.5, 723.0]",11,33,-22
31108.0,2019-12-07,"(723.0, 1080.5]",30,50,-20
31108.0,2019-12-07,"(1080.5, 1438.0]",10,19,-9
31109.0,2019-12-07,"(5.609, 354.75]",2,8,-6
31109.0,2019-12-07,"(354.75, 702.5]",6,14,-8
31109.0,2019-12-07,"(702.5, 1050.25]",25,41,-16
31109.0,2019-12-07,"(1050.25, 1398.0]",9,18,-9
31110.0,2019-12-07,"(26.634, 369.5]",3,4,-1
31110.0,2019-12-07,"(369.5, 711.0]",9,24,-15
31110.0,2019-12-07,"(711.0, 1052.5]",17,37,-20
31110.0,2019-12-07,"(1052.5, 1394.0]",5,10,-5
31111.0,2019-12-07,"(70.679, 402.25]",2,8,-6
31111.0,2019-12-07,"(402.25, 732.5]",13,21,-8
31111.0,2019-12-07,"(732.5, 1062.75]",10,18,-8
31111.0,2019-12-07,"(1062.75, 1393.0]",8,19,-11
31112.0,2019-12-07,"(517.416, 664.0]",3,5,-2
31112.0,2019-12-07,"(810.0, 956.0]",1,1,0
31112.0,2019-12-07,"(956.0, 1102.0]",5,2,3
31113.0,2019-12-07,"(8.68, 340.0]",3,6,-3
31113.0,2019-12-07,"(340.0, 670.0]",2,14,-12
31113.0,2019-12-07,"(670.0, 1000.0]",12,32,-20
31113.0,2019-12-07,"(1000.0, 1330.0]",8,14,-6
31114.0,2019-12-07,"(46.614, 394.5]",1,5,-4
31114.0,2019-12-07,"(394.5, 741.0]",9,25,-16
31114.0,2019-12-07,"(741.0, 1087.5]",21,36,-15
31114.0,2019-12-07,"(1087.5, 1434.0]",14,25,-11
31115.0,2019-12-07,"(337.905, 612.75]",1,11,-10
31115.0,2019-12-07,"(612.75, 886.5]",8,20,-12
31115.0,2019-12-07,"(886.5, 1160.25]",12,25,-13
31115.0,2019-12-07,"(1160.25, 1434.0]",4,12,-8
31116.0,2019-12-07,"(382.0, 734.0]",9,2,7
31116.0,2019-12-07,"(734.0, 1086.0]",19,25,-6
31116.0,2019-12-07,"(1086.0, 1438.0]",7,31,-24
31117.0,2019-12-07,"(703.0, 1051.5]",18,4,14
31117.0,2019-12-07,"(1051.5, 1400.0]",4,15,-11
31118.0,2019-12-07,"(354.0, 708.0]",2,1,1
31118.0,2019-12-07,"(708.0, 1062.0]",5,10,-5
31118.0,2019-12-07,"(1062.0, 1416.0]",3,10,-7
31119.0,2019-12-07,"(12.602, 363.5]",2,2,0
31119.0,2019-12-07,"(363.5, 713.0]",13,35,-22
31119.0,2019-12-07,"(713.0, 1062.5]",16,29,-13
31119.0,2019-12-07,"(1062.5, 1412.0]",14,23,-9
31120.0,2019-12-07,"(8.571, 367.25]",1,2,-1
31120.0,2019-12-07,"(367.25, 724.5]",2,11,-9
31120.0,2019-12-07,"(724.5, 1081.75]",6,13,-7
31120.0,2019-12-07,"(1081.75, 1439.0]",13,17,-4
31121.0,2019-12-07,"(36.642, 377.5]",3,4,-1
31121.0,2019-12-07,"(377.5, 717.0]",6,19,-13
31121.0,2019-12-07,"(717.0, 1056.5]",13,25,-12
31121.0,2019-12-07,"(1056.5, 1396.0]",8,12,-4
31122.0,2019-12-07,"(2.6, 354.0]",4,8,-4
31122.0,2019-12-07,"(354.0, 704.0]",2,7,-5
31122.0,2019-12-07,"(704.0, 1054.0]",7,18,-11
31122.0,2019-12-07,"(1054.0, 1404.0]",5,9,-4
31123.0,2019-12-07,"(7.586, 362.5]",3,3,0
31123.0,2019-12-07,"(362.5, 716.0]",1,12,-11
31123.0,2019-12-07,"(716.0, 1069.5]",3,10,-7
31123.0,2019-12-07,"(1069.5, 1423.0]",3,7,-4
31124.0,2019-12-07,"(11.582, 367.5]",4,5,-1
31124.0,2019-12-07,"(367.5, 722.0]",20,38,-18
31124.0,2019-12-07,"(722.0, 1076.5]",22,65,-43
31124.0,2019-12-07,"(1076.5, 1431.0]",12,44,-32
31125.0,2019-12-07,"(13.585, 368.75]",1,3,-2
31125.0,2019-12-07,"(368.75, 722.5]",6,14,-8
31125.0,2019-12-07,"(722.5, 1076.25]",21,50,-29
31125.0,2019-12-07,"(1076.25, 1430.0]",13,24,-11
31126.0,2019-12-07,"(12.588, 367.0]",6,9,-3
31126.0,2019-12-07,"(367.0, 720.0]",5,26,-21
31126.0,2019-12-07,"(720.0, 1073.0]",11,27,-16
31126.0,2019-12-07,"(1073.0, 1426.0]",11,22,-11
,,,,2.0,
31128.0,2019-12-07,"(42.621, 388.75]",3,6,-3
31128.0,2019-12-07,"(388.75, 733.5]",9,16,-7
31128.0,2019-12-07,"(733.5, 1078.25]",14,28,-14
31128.0,2019-12-07,"(1078.25, 1423.0]",5,8,-3
31129.0,2019-12-07,"(214.876, 497.0]",1,2,-1
31129.0,2019-12-07,"(497.0, 778.0]",6,11,-5
31129.0,2019-12-07,"(778.0, 1059.0]",14,28,-14
31129.0,2019-12-07,"(1059.0, 1340.0]",4,7,-3
31130.0,2019-12-07,"(66.717, 388.75]",1,1,0
31130.0,2019-12-07,"(388.75, 709.5]",4,11,-7
31130.0,2019-12-07,"(709.5, 1030.25]",7,13,-6
31130.0,2019-12-07,"(1030.25, 1351.0]",8,12,-4
31131.0,2019-12-07,"(5.57, 364.5]",3,3,0
31131.0,2019-12-07,"(364.5, 722.0]",3,14,-11
31131.0,2019-12-07,"(722.0, 1079.5]",2,7,-5
31131.0,2019-12-07,"(1079.5, 1437.0]",5,5,0
31200.0,2019-12-07,"(32.615, 380.25]",1,4,-3
31200.0,2019-12-07,"(380.25, 726.5]",18,23,-5
31200.0,2019-12-07,"(726.5, 1072.75]",42,59,-17
31200.0,2019-12-07,"(1072.75, 1419.0]",3,11,-8
31201.0,2019-12-07,"(18.583, 374.25]",2,4,-2
31201.0,2019-12-07,"(374.25, 728.5]",38,61,-23
31201.0,2019-12-07,"(728.5, 1082.75]",37,74,-37
31201.0,2019-12-07,"(1082.75, 1437.0]",16,33,-17
31202.0,2019-12-07,"(392.25, 735.5]",24,4,20
31202.0,2019-12-07,"(735.5, 1078.75]",36,34,2
31202.0,2019-12-07,"(1078.75, 1422.0]",14,57,-43
31203.0,2019-12-07,"(3.581, 359.75]",4,13,-9
31203.0,2019-12-07,"(359.75, 714.5]",9,24,-15
31203.0,2019-12-07,"(714.5, 1069.25]",30,50,-20
31203.0,2019-12-07,"(1069.25, 1424.0]",20,24,-4
31204.0,2019-12-07,"(778.0, 996.0]",5,1,4
31204.0,2019-12-07,"(996.0, 1214.0]",4,10,-6
31204.0,2019-12-07,"(1214.0, 1432.0]",9,4,5
31205.0,2019-12-07,"(76.669, 410.75]",1,4,-3
31205.0,2019-12-07,"(410.75, 743.5]",3,7,-4
31205.0,2019-12-07,"(743.5, 1076.25]",12,18,-6
31205.0,2019-12-07,"(1076.25, 1409.0]",2,8,-6
31206.0,2019-12-07,"(531.561, 641.75]",1,1,0
31206.0,2019-12-07,"(751.5, 861.25]",1,1,0
31207.0,2019-12-07,"(29.951, 293.25]",2,3,-1
31207.0,2019-12-07,"(555.5, 817.75]",5,2,3
31208.0,2019-12-07,"(567.61, 665.5]",4,4,0
31208.0,2019-12-07,"(665.5, 763.0]",2,3,-1
31208.0,2019-12-07,"(763.0, 860.5]",1,1,0
31208.0,2019-12-07,"(860.5, 958.0]",5,5,0
31209.0,2019-12-07,"(96.794, 399.5]",1,2,-1
31209.0,2019-12-07,"(399.5, 701.0]",2,10,-8
31209.0,2019-12-07,"(701.0, 1002.5]",4,9,-5
31209.0,2019-12-07,"(1002.5, 1304.0]",6,11,-5
31211.0,2019-12-07,"(554.362, 714.5]",5,6,-1
31211.0,2019-12-07,"(874.0, 1033.5]",10,2,8
31211.0,2019-12-07,"(1033.5, 1193.0]",2,18,-16
31212.0,2019-12-07,"(503.203, 703.25]",7,10,-3
31212.0,2019-12-07,"(703.25, 902.5]",6,13,-7
31212.0,2019-12-07,"(902.5, 1101.75]",2,9,-7
31212.0,2019-12-07,"(1101.75, 1301.0]",3,7,-4
31213.0,2019-12-07,"(117.681, 448.75]",1,2,-1
31213.0,2019-12-07,"(448.75, 778.5]",11,19,-8
31213.0,2019-12-07,"(778.5, 1108.25]",5,10,-5
31214.0,2019-12-07,"(19.59, 373.5]",6,6,0
31214.0,2019-12-07,"(373.5, 726.0]",22,40,-18
31214.0,2019-12-07,"(726.0, 1078.5]",27,55,-28
31214.0,2019-12-07,"(1078.5, 1431.0]",19,31,-12
31215.0,2019-12-07,"(416.161, 626.75]",5,5,0
31215.0,2019-12-07,"(626.75, 836.5]",8,10,-2
31215.0,2019-12-07,"(836.5, 1046.25]",6,16,-10
31215.0,2019-12-07,"(1046.25, 1256.0]",4,5,-1
31216.0,2019-12-07,"(107.836, 400.0]",2,4,-2
31216.0,2019-12-07,"(400.0, 691.0]",1,3,-2
31216.0,2019-12-07,"(691.0, 982.0]",7,15,-8
31216.0,2019-12-07,"(982.0, 1273.0]",4,11,-7
31217.0,2019-12-07,"(10.784, 316.0]",1,1,0
31217.0,2019-12-07,"(316.0, 620.0]",1,2,-1
31217.0,2019-12-07,"(620.0, 924.0]",2,4,-2
31217.0,2019-12-07,"(924.0, 1228.0]",9,10,-1
31218.0,2019-12-07,"(2.852, 291.0]",3,3,0
31218.0,2019-12-07,"(578.0, 865.0]",2,4,-2
31218.0,2019-12-07,"(865.0, 1152.0]",7,15,-8
31219.0,2019-12-07,"(639.233, 831.75]",9,12,-3
31219.0,2019-12-07,"(831.75, 1023.5]",14,17,-3
31219.0,2019-12-07,"(1215.25, 1407.0]",2,6,-4
,,,,2.0,
31221.0,2019-12-07,"(54.736, 372.0]",5,8,-3
31221.0,2019-12-07,"(372.0, 688.0]",8,9,-1
31221.0,2019-12-07,"(688.0, 1004.0]",9,17,-8
31221.0,2019-12-07,"(1004.0, 1320.0]",1,6,-5
31222.0,2019-12-07,"(18.772, 327.0]",4,10,-6
31222.0,2019-12-07,"(327.0, 634.0]",2,2,0
31222.0,2019-12-07,"(634.0, 941.0]",15,20,-5
31222.0,2019-12-07,"(941.0, 1248.0]",7,14,-7
31223.0,2019-12-07,"(31.61, 380.5]",1,4,-3
31223.0,2019-12-07,"(380.5, 728.0]",11,24,-13
31223.0,2019-12-07,"(728.0, 1075.5]",12,25,-13
31223.0,2019-12-07,"(1075.5, 1423.0]",14,20,-6
31224.0,2019-12-07,"(317.25, 622.5]",4,2,2
31224.0,2019-12-07,"(622.5, 927.75]",5,6,-1
31224.0,2019-12-07,"(927.75, 1233.0]",1,5,-4
31225.0,2019-12-07,"(371.0, 654.0]",2,1,1
31225.0,2019-12-07,"(654.0, 937.0]",12,5,7
31225.0,2019-12-07,"(937.0, 1220.0]",8,16,-8
31226.0,2019-12-07,"(71.672, 405.0]",1,1,0
31226.0,2019-12-07,"(405.0, 737.0]",4,10,-6
31226.0,2019-12-07,"(737.0, 1069.0]",3,6,-3
31226.0,2019-12-07,"(1069.0, 1401.0]",3,5,-2
31227.0,2019-12-07,"(355.0, 665.0]",2,4,-2
31227.0,2019-12-07,"(665.0, 975.0]",6,2,4
31227.0,2019-12-07,"(975.0, 1285.0]",1,10,-9
31228.0,2019-12-07,"(60.695, 388.25]",3,4,-1
31228.0,2019-12-07,"(388.25, 714.5]",13,19,-6
31228.0,2019-12-07,"(714.5, 1040.75]",30,44,-14
31228.0,2019-12-07,"(1040.75, 1367.0]",8,15,-7
31229.0,2019-12-07,"(5.575, 363.25]",5,7,-2
31229.0,2019-12-07,"(363.25, 719.5]",23,55,-32
31229.0,2019-12-07,"(719.5, 1075.75]",35,77,-42
31229.0,2019-12-07,"(1075.75, 1432.0]",14,30,-16
31230.0,2019-12-07,"(417.5, 750.0]",6,2,4
31230.0,2019-12-07,"(750.0, 1082.5]",16,13,3
31230.0,2019-12-07,"(1082.5, 1415.0]",1,34,-33
31231.0,2019-12-07,"(612.215, 809.25]",2,2,0
31231.0,2019-12-07,"(809.25, 1005.5]",2,6,-4
31231.0,2019-12-07,"(1201.75, 1398.0]",3,1,2
31232.0,2019-12-07,"(243.818, 540.5]",2,3,-1
31232.0,2019-12-07,"(540.5, 836.0]",17,21,-4
31232.0,2019-12-07,"(836.0, 1131.5]",19,31,-12
31232.0,2019-12-07,"(1131.5, 1427.0]",9,10,-1
31233.0,2019-12-07,"(7.587, 362.25]",2,4,-2
31233.0,2019-12-07,"(362.25, 715.5]",10,15,-5
31233.0,2019-12-07,"(715.5, 1068.75]",11,19,-8
31233.0,2019-12-07,"(1068.75, 1422.0]",1,5,-4
31234.0,2019-12-07,"(10.683, 341.25]",3,5,-2
31234.0,2019-12-07,"(341.25, 670.5]",4,10,-6
31234.0,2019-12-07,"(670.5, 999.75]",13,28,-15
31234.0,2019-12-07,"(999.75, 1329.0]",11,17,-6
31235.0,2019-12-07,"(629.53, 747.5]",2,4,-2
31235.0,2019-12-07,"(747.5, 865.0]",4,4,0
31235.0,2019-12-07,"(982.5, 1100.0]",2,4,-2
31236.0,2019-12-07,"(3.639, 345.25]",1,5,-4
31236.0,2019-12-07,"(345.25, 685.5]",2,6,-4
31236.0,2019-12-07,"(685.5, 1025.75]",24,32,-8
31236.0,2019-12-07,"(1025.75, 1366.0]",1,10,-9
31237.0,2019-12-07,"(15.604, 366.0]",1,2,-1
31237.0,2019-12-07,"(366.0, 715.0]",6,14,-8
31237.0,2019-12-07,"(715.0, 1064.0]",15,26,-11
31237.0,2019-12-07,"(1064.0, 1413.0]",4,6,-2
31238.0,2019-12-07,"(53.848, 343.0]",1,1,0
31238.0,2019-12-07,"(343.0, 631.0]",1,2,-1
31238.0,2019-12-07,"(631.0, 919.0]",13,17,-4
31238.0,2019-12-07,"(919.0, 1207.0]",10,18,-8
31239.0,2019-12-07,"(499.243, 689.25]",8,12,-4
31239.0,2019-12-07,"(689.25, 878.5]",6,13,-7
31239.0,2019-12-07,"(878.5, 1067.75]",3,7,-4
31239.0,2019-12-07,"(1067.75, 1257.0]",5,9,-4
31240.0,2019-12-07,"(542.392, 695.0]",6,12,-6
31240.0,2019-12-07,"(695.0, 847.0]",14,25,-11
31240.0,2019-12-07,"(847.0, 999.0]",1,2,-1
31240.0,2019-12-07,"(999.0, 1151.0]",4,5,-1
31241.0,2019-12-07,"(1.607, 351.25]",3,6,-3
31241.0,2019-12-07,"(351.25, 699.5]",8,25,-17
31241.0,2019-12-07,"(699.5, 1047.75]",16,42,-26
31241.0,2019-12-07,"(1047.75, 1396.0]",10,22,-12
31242.0,2019-12-07,"(818.723, 888.25]",3,3,0
31242.0,2019-12-07,"(888.25, 957.5]",1,1,0
31242.0,2019-12-07,"(1026.75, 1096.0]",1,2,-1
31243.0,2019-12-07,"(550.115, 772.25]",7,9,-2
31243.0,2019-12-07,"(772.25, 993.5]",19,26,-7
31243.0,2019-12-07,"(993.5, 1214.75]",2,6,-4
31244.0,2019-12-07,"(538.127, 757.25]",3,11,-8
31244.0,2019-12-07,"(757.25, 975.5]",2,6,-4
31244.0,2019-12-07,"(975.5, 1193.75]",8,10,-2
31245.0,2019-12-07,"(4.618, 351.5]",3,6,-3
31245.0,2019-12-07,"(351.5, 697.0]",7,12,-5
31245.0,2019-12-07,"(697.0, 1042.5]",10,24,-14
31245.0,2019-12-07,"(1042.5, 1388.0]",7,10,-3
31246.0,2019-12-07,"(460.058, 696.5]",10,12,-2
31246.0,2019-12-07,"(696.5, 932.0]",26,39,-13
31246.0,2019-12-07,"(932.0, 1167.5]",9,22,-13
31246.0,2019-12-07,"(1167.5, 1403.0]",4,7,-3
31247.0,2019-12-07,"(456.342, 621.5]",7,9,-2
31247.0,2019-12-07,"(621.5, 786.0]",17,31,-14
31247.0,2019-12-07,"(786.0, 950.5]",18,36,-18
31247.0,2019-12-07,"(950.5, 1115.0]",1,6,-5
31248.0,2019-12-07,"(503.139, 719.25]",8,16,-8
31248.0,2019-12-07,"(719.25, 934.5]",29,46,-17
31248.0,2019-12-07,"(934.5, 1149.75]",6,12,-6
31248.0,2019-12-07,"(1149.75, 1365.0]",2,4,-2
31249.0,2019-12-07,"(605.566, 714.5]",9,18,-9
31249.0,2019-12-07,"(714.5, 823.0]",6,11,-5
31249.0,2019-12-07,"(823.0, 931.5]",1,7,-6
31249.0,2019-12-07,"(931.5, 1040.0]",3,11,-8
31250.0,2019-12-07,"(255.038, 496.5]",1,3,-2
31250.0,2019-12-07,"(496.5, 737.0]",5,6,-1
31250.0,2019-12-07,"(737.0, 977.5]",3,6,-3
31250.0,2019-12-07,"(977.5, 1218.0]",3,5,-2
31251.0,2019-12-07,"(41.722, 362.5]",4,6,-2
31251.0,2019-12-07,"(362.5, 682.0]",2,13,-11
31251.0,2019-12-07,"(682.0, 1001.5]",10,20,-10
31251.0,2019-12-07,"(1001.5, 1321.0]",5,11,-6
31252.0,2019-12-07,"(493.116, 715.0]",3,4,-1
31252.0,2019-12-07,"(715.0, 936.0]",1,2,-1
31252.0,2019-12-07,"(936.0, 1157.0]",1,1,0
31252.0,2019-12-07,"(1157.0, 1378.0]",3,4,-1
31253.0,2019-12-07,"(346.0, 668.0]",3,2,1
31253.0,2019-12-07,"(668.0, 990.0]",7,4,3
31253.0,2019-12-07,"(990.0, 1312.0]",1,18,-17
31254.0,2019-12-07,"(552.26, 738.0]",3,8,-5
31254.0,2019-12-07,"(738.0, 923.0]",2,5,-3
31254.0,2019-12-07,"(923.0, 1108.0]",1,1,0
31254.0,2019-12-07,"(1108.0, 1293.0]",1,2,-1
31255.0,2019-12-07,"(376.5, 653.0]",3,1,2
31255.0,2019-12-07,"(653.0, 929.5]",5,5,0
31255.0,2019-12-07,"(929.5, 1206.0]",5,9,-4
31256.0,2019-12-07,"(558.292, 736.0]",4,6,-2
31256.0,2019-12-07,"(736.0, 913.0]",3,9,-6
31256.0,2019-12-07,"(913.0, 1090.0]",1,2,-1
31256.0,2019-12-07,"(1090.0, 1267.0]",4,9,-5
31257.0,2019-12-07,"(94.738, 411.5]",2,3,-1
31257.0,2019-12-07,"(411.5, 727.0]",13,16,-3
31257.0,2019-12-07,"(727.0, 1042.5]",14,29,-15
31257.0,2019-12-07,"(1042.5, 1358.0]",7,20,-13
31258.0,2019-12-07,"(449.135, 666.25]",14,19,-5
31258.0,2019-12-07,"(666.25, 882.5]",10,40,-30
31258.0,2019-12-07,"(882.5, 1098.75]",9,17,-8
31258.0,2019-12-07,"(1098.75, 1315.0]",4,9,-5
,,,,2.0,
31260.0,2019-12-07,"(26.692, 355.0]",2,2,0
31260.0,2019-12-07,"(355.0, 682.0]",1,3,-2
31260.0,2019-12-07,"(682.0, 1009.0]",4,10,-6
31260.0,2019-12-07,"(1009.0, 1336.0]",2,4,-2
31261.0,2019-12-07,"(798.744, 863.0]",1,3,-2
31261.0,2019-12-07,"(863.0, 927.0]",2,2,0
31261.0,2019-12-07,"(991.0, 1055.0]",1,3,-2
31262.0,2019-12-07,"(759.574, 866.5]",1,6,-5
31262.0,2019-12-07,"(866.5, 973.0]",2,3,-1
31262.0,2019-12-07,"(973.0, 1079.5]",1,2,-1
31262.0,2019-12-07,"(1079.5, 1186.0]",2,6,-4
31263.0,2019-12-07,"(68.84, 360.0]",1,2,-1
31263.0,2019-12-07,"(360.0, 650.0]",6,8,-2
31263.0,2019-12-07,"(650.0, 940.0]",21,37,-16
31263.0,2019-12-07,"(940.0, 1230.0]",10,20,-10
31264.0,2019-12-07,"(384.5, 722.0]",5,1,4
31264.0,2019-12-07,"(722.0, 1059.5]",6,5,1
31264.0,2019-12-07,"(1059.5, 1397.0]",4,12,-8
31265.0,2019-12-07,"(89.666, 424.5]",2,3,-1
31265.0,2019-12-07,"(424.5, 758.0]",12,23,-11
31265.0,2019-12-07,"(758.0, 1091.5]",12,25,-13
31265.0,2019-12-07,"(1091.5, 1425.0]",5,12,-7
31266.0,2019-12-07,"(41.606, 391.5]",6,9,-3
31266.0,2019-12-07,"(391.5, 740.0]",3,14,-11
31266.0,2019-12-07,"(740.0, 1088.5]",17,41,-24
31266.0,2019-12-07,"(1088.5, 1437.0]",14,19,-5
31267.0,2019-12-07,"(1.616, 349.0]",3,4,-1
31267.0,2019-12-07,"(349.0, 695.0]",11,28,-17
31267.0,2019-12-07,"(695.0, 1041.0]",18,37,-19
31267.0,2019-12-07,"(1041.0, 1387.0]",4,10,-6
31268.0,2019-12-07,"(53.657, 390.75]",3,4,-1
31268.0,2019-12-07,"(390.75, 726.5]",7,12,-5
31268.0,2019-12-07,"(726.5, 1062.25]",20,31,-11
31268.0,2019-12-07,"(1062.25, 1398.0]",17,29,-12
31269.0,2019-12-07,"(371.0, 725.0]",6,2,4
31269.0,2019-12-07,"(725.0, 1079.0]",26,12,14
31269.0,2019-12-07,"(1079.0, 1433.0]",7,53,-46
31270.0,2019-12-07,"(364.5, 675.0]",1,1,0
31270.0,2019-12-07,"(675.0, 985.5]",6,2,4
31270.0,2019-12-07,"(985.5, 1296.0]",4,15,-11
31271.0,2019-12-07,"(516.317, 687.75]",10,15,-5
31271.0,2019-12-07,"(687.75, 858.5]",18,29,-11
31271.0,2019-12-07,"(858.5, 1029.25]",6,12,-6
31271.0,2019-12-07,"(1029.25, 1200.0]",7,8,-1
31272.0,2019-12-07,"(33.728, 353.0]",2,4,-2
31272.0,2019-12-07,"(353.0, 671.0]",5,5,0
31272.0,2019-12-07,"(671.0, 989.0]",10,17,-7
31272.0,2019-12-07,"(989.0, 1307.0]",5,8,-3
31273.0,2019-12-07,"(550.409, 698.75]",7,15,-8
31273.0,2019-12-07,"(698.75, 846.5]",1,2,-1
31273.0,2019-12-07,"(994.25, 1142.0]",1,1,0
31274.0,2019-12-07,"(159.009, 407.75]",2,2,0
31274.0,2019-12-07,"(407.75, 655.5]",1,2,-1
31274.0,2019-12-07,"(655.5, 903.25]",4,5,-1
31274.0,2019-12-07,"(903.25, 1151.0]",8,10,-2
31275.0,2019-12-07,"(2.59, 356.5]",3,9,-6
31275.0,2019-12-07,"(356.5, 709.0]",5,6,-1
31275.0,2019-12-07,"(709.0, 1061.5]",14,24,-10
31275.0,2019-12-07,"(1061.5, 1414.0]",7,16,-9
31276.0,2019-12-07,"(488.168, 697.0]",3,5,-2
31276.0,2019-12-07,"(697.0, 905.0]",1,3,-2
31276.0,2019-12-07,"(905.0, 1113.0]",2,4,-2
31276.0,2019-12-07,"(1113.0, 1321.0]",2,2,0
31277.0,2019-12-07,"(472.046, 711.5]",5,11,-6
31277.0,2019-12-07,"(711.5, 950.0]",16,22,-6
31277.0,2019-12-07,"(950.0, 1188.5]",8,12,-4
31278.0,2019-12-07,"(505.5, 815.0]",13,3,10
31278.0,2019-12-07,"(815.0, 1124.5]",15,30,-15
31278.0,2019-12-07,"(1124.5, 1434.0]",8,33,-25
31279.0,2019-12-07,"(49.817, 346.75]",1,1,0
31279.0,2019-12-07,"(346.75, 642.5]",1,3,-2
31279.0,2019-12-07,"(642.5, 938.25]",1,3,-2
31279.0,2019-12-07,"(938.25, 1234.0]",1,4,-3
31280.0,2019-12-07,"(117.827, 412.25]",1,4,-3
31280.0,2019-12-07,"(412.25, 705.5]",8,22,-14
31280.0,2019-12-07,"(705.5, 998.75]",16,29,-13
31280.0,2019-12-07,"(998.75, 1292.0]",8,15,-7
,,,,2.0,
31001.0,2019-12-08,"(999.673, 1081.75]",1,3,-2
31001.0,2019-12-08,"(1081.75, 1163.5]",1,1,0
31001.0,2019-12-08,"(1245.25, 1327.0]",2,2,0
31002.0,2019-12-08,"(924.0, 977.0]",3,1,2
31003.0,2019-12-08,"(780.75, 1041.0]",2,1,1
31004.0,2019-12-08,"(813.592, 916.0]",1,1,0
31004.0,2019-12-08,"(916.0, 1018.0]",2,3,-1
31005.0,2019-12-08,"(633.5, 928.75]",1,1,0
31005.0,2019-12-08,"(928.75, 1224.0]",4,3,1
31006.0,2019-12-08,"(448.06, 684.0]",1,2,-1
31006.0,2019-12-08,"(684.0, 919.0]",1,2,-1
31006.0,2019-12-08,"(919.0, 1154.0]",3,6,-3
31007.0,2019-12-08,"(773.399, 924.25]",4,6,-2
31007.0,2019-12-08,"(924.25, 1074.5]",1,4,-3
31007.0,2019-12-08,"(1074.5, 1224.75]",1,3,-2
31007.0,2019-12-08,"(1224.75, 1375.0]",1,3,-2
31009.0,2019-12-08,"(620.5, 917.75]",1,2,-1
31009.0,2019-12-08,"(917.75, 1215.0]",1,1,0
31010.0,2019-12-08,"(712.0, 859.0]",2,1,1
31010.0,2019-12-08,"(859.0, 1006.0]",2,4,-2
31010.0,2019-12-08,"(1006.0, 1153.0]",3,6,-3
31011.0,2019-12-08,"(737.25, 823.5]",2,1,1
31011.0,2019-12-08,"(909.75, 996.0]",1,3,-2
,,,,1.0,
,,,,1.0,
31013.0,2019-12-08,"(600.254, 787.5]",1,2,-1
31013.0,2019-12-08,"(974.0, 1160.5]",3,1,2
31013.0,2019-12-08,"(1160.5, 1347.0]",3,4,-1
31014.0,2019-12-08,"(551.235, 743.25]",1,7,-6
31014.0,2019-12-08,"(743.25, 934.5]",4,8,-4
31014.0,2019-12-08,"(934.5, 1125.75]",4,7,-3
31014.0,2019-12-08,"(1125.75, 1317.0]",4,4,0
31015.0,2019-12-08,"(494.35, 657.5]",3,3,0
31015.0,2019-12-08,"(657.5, 820.0]",2,4,-2
31015.0,2019-12-08,"(820.0, 982.5]",5,6,-1
31015.0,2019-12-08,"(982.5, 1145.0]",3,7,-4
31016.0,2019-12-08,"(754.387, 908.25]",1,2,-1
,,,,2.0,
,,,,2.0,
,,,,1.0,
,,,,2.0,
31018.0,2019-12-08,"(1142.75, 1260.0]",1,1,0
31019.0,2019-12-08,"(853.0, 998.0]",1,1,0
31020.0,2019-12-08,"(562.356, 724.0]",1,2,-1
31020.0,2019-12-08,"(1046.0, 1207.0]",1,1,0
31021.0,2019-12-08,"(195.822, 491.5]",1,1,0
31021.0,2019-12-08,"(491.5, 786.0]",1,1,0
31021.0,2019-12-08,"(1080.5, 1375.0]",2,4,-2
31022.0,2019-12-08,"(402.5, 698.0]",2,1,1
31022.0,2019-12-08,"(698.0, 993.5]",6,2,4
31022.0,2019-12-08,"(993.5, 1289.0]",2,15,-13
31023.0,2019-12-08,"(81.687, 411.25]",1,2,-1
31023.0,2019-12-08,"(411.25, 739.5]",4,5,-1
31023.0,2019-12-08,"(739.5, 1067.75]",2,11,-9
31024.0,2019-12-08,"(534.137, 750.75]",3,5,-2
31024.0,2019-12-08,"(750.75, 966.5]",3,4,-1
31024.0,2019-12-08,"(966.5, 1182.25]",1,3,-2
31024.0,2019-12-08,"(1182.25, 1398.0]",1,2,-1
31025.0,2019-12-08,"(781.0, 904.0]",1,1,0
31025.0,2019-12-08,"(1027.0, 1150.0]",1,2,-1
31026.0,2019-12-08,"(697.555, 809.25]",2,4,-2
31026.0,2019-12-08,"(920.5, 1031.75]",2,2,0
31026.0,2019-12-08,"(1031.75, 1143.0]",3,4,-1
31027.0,2019-12-08,"(646.347, 810.25]",1,2,-1
31027.0,2019-12-08,"(1136.75, 1300.0]",1,1,0
31028.0,2019-12-08,"(675.0, 872.0]",1,1,0
31028.0,2019-12-08,"(872.0, 1069.0]",1,2,-1
31028.0,2019-12-08,"(1069.0, 1266.0]",1,1,0
31029.0,2019-12-08,"(829.0, 955.0]",1,1,0
31029.0,2019-12-08,"(1081.0, 1207.0]",3,2,1
31030.0,2019-12-08,"(913.5, 1078.25]",2,1,1
31030.0,2019-12-08,"(1078.25, 1243.0]",1,4,-3
31031.0,2019-12-08,"(970.5, 1150.0]",1,2,-1
31032.0,2019-12-08,"(772.763, 832.25]",1,1,0
31032.0,2019-12-08,"(891.5, 950.75]",1,2,-1
31033.0,2019-12-08,"(662.25, 883.0]",1,1,0
31034.0,2019-12-08,"(578.335, 745.25]",1,3,-2
31034.0,2019-12-08,"(911.5, 1077.75]",1,1,0
31035.0,2019-12-08,"(641.309, 814.75]",1,1,0
31035.0,2019-12-08,"(814.75, 987.5]",2,3,-1
31035.0,2019-12-08,"(987.5, 1160.25]",2,4,-2
31035.0,2019-12-08,"(1160.25, 1333.0]",1,1,0
31036.0,2019-12-08,"(869.75, 958.0]",1,1,0
31037.0,2019-12-08,"(409.75, 715.5]",5,1,4
31037.0,2019-12-08,"(715.5, 1021.25]",3,5,-2
31037.0,2019-12-08,"(1021.25, 1327.0]",4,7,-3
31038.0,2019-12-08,"(581.618, 677.5]",2,2,0
31038.0,2019-12-08,"(868.5, 964.0]",1,1,0
31039.0,2019-12-08,"(360.964, 621.0]",2,3,-1
31039.0,2019-12-08,"(621.0, 880.0]",1,2,-1
31039.0,2019-12-08,"(880.0, 1139.0]",1,5,-4
31039.0,2019-12-08,"(1139.0, 1398.0]",1,2,-1
31040.0,2019-12-08,"(716.482, 846.5]",1,2,-1
31041.0,2019-12-08,"(648.428, 792.0]",1,1,0
31041.0,2019-12-08,"(792.0, 935.0]",2,3,-1
31041.0,2019-12-08,"(935.0, 1078.0]",1,2,-1
31041.0,2019-12-08,"(1078.0, 1221.0]",1,1,0
31042.0,2019-12-08,"(636.633, 728.75]",1,2,-1
31042.0,2019-12-08,"(728.75, 820.5]",3,4,-1
31042.0,2019-12-08,"(912.25, 1004.0]",3,1,2
31043.0,2019-12-08,"(480.441, 620.75]",1,1,0
31043.0,2019-12-08,"(620.75, 760.5]",2,4,-2
31043.0,2019-12-08,"(760.5, 900.25]",3,4,-1
31043.0,2019-12-08,"(900.25, 1040.0]",2,4,-2
31044.0,2019-12-08,"(679.664, 764.0]",1,2,-1
31044.0,2019-12-08,"(764.0, 848.0]",1,1,0
31044.0,2019-12-08,"(932.0, 1016.0]",1,2,-1
31045.0,2019-12-08,"(12.728, 332.0]",1,1,0
31045.0,2019-12-08,"(650.0, 968.0]",2,2,0
31045.0,2019-12-08,"(968.0, 1286.0]",3,2,1
,,,,2.0,
31047.0,2019-12-08,"(843.0, 939.0]",3,1,2
31047.0,2019-12-08,"(939.0, 1035.0]",1,5,-4
31047.0,2019-12-08,"(1035.0, 1131.0]",2,4,-2
,,,,2.0,
,,,,1.0,
,,,,1.0,
,,,,2.0,
,,,,4.0,
31050.0,2019-12-08,"(372.439, 513.25]",1,1,0
31050.0,2019-12-08,"(653.5, 793.75]",1,1,0
31051.0,2019-12-08,"(57.742, 373.5]",1,1,0
31051.0,2019-12-08,"(373.5, 688.0]",1,2,-1
31051.0,2019-12-08,"(1002.5, 1317.0]",4,1,3
31052.0,2019-12-08,"(26.902, 302.5]",2,2,0
31052.0,2019-12-08,"(577.0, 851.5]",1,2,-1
31052.0,2019-12-08,"(851.5, 1126.0]",1,3,-2
31053.0,2019-12-08,"(718.709, 791.75]",2,2,0
,,,,2.0,
,,,,2.0,
31056.0,2019-12-08,"(58.075, 290.25]",1,1,0
31057.0,2019-12-08,"(340.0, 680.0]",2,1,1
31057.0,2019-12-08,"(1020.0, 1360.0]",1,2,-1
,,,,1.0,
,,,,1.0,
,,,,1.0,
,,,,1.0,
31060.0,2019-12-08,"(749.25, 831.5]",1,2,-1
31060.0,2019-12-08,"(831.5, 913.75]",1,1,0
31060.0,2019-12-08,"(913.75, 996.0]",1,2,-1
31061.0,2019-12-08,"(1078.5, 1182.0]",1,1,0
31062.0,2019-12-08,"(27.997, 279.75]",1,1,0
31062.0,2019-12-08,"(530.5, 781.25]",1,3,-2
31062.0,2019-12-08,"(781.25, 1032.0]",8,17,-9
31063.0,2019-12-08,"(563.0, 648.0]",1,1,0
31064.0,2019-12-08,"(468.134, 685.5]",1,3,-2
31064.0,2019-12-08,"(685.5, 902.0]",11,21,-10
31064.0,2019-12-08,"(902.0, 1118.5]",7,15,-8
31064.0,2019-12-08,"(1118.5, 1335.0]",2,4,-2
,,,,1.0,
,,,,1.0,
,,,,2.0,
31066.0,2019-12-08,"(537.75, 717.0]",2,1,1
31067.0,2019-12-08,"(921.729, 989.75]",2,3,-1
31067.0,2019-12-08,"(1125.25, 1193.0]",1,2,-1
31068.0,2019-12-08,"(1014.0, 1352.0]",1,1,0
31069.0,2019-12-08,"(807.5, 964.0]",1,1,0
31070.0,2019-12-08,"(1006.25, 1069.0]",1,2,-1
31071.0,2019-12-08,"(566.172, 774.0]",2,7,-5
31071.0,2019-12-08,"(774.0, 981.0]",1,1,0
31071.0,2019-12-08,"(981.0, 1188.0]",5,9,-4
31071.0,2019-12-08,"(1188.0, 1395.0]",1,1,0
31072.0,2019-12-08,"(242.25, 323.0]",1,1,0
,,,,2.0,
,,,,1.0,
,,,,1.0,
31075.0,2019-12-08,"(876.563, 986.25]",1,3,-2
31075.0,2019-12-08,"(1204.75, 1314.0]",2,4,-2
31076.0,2019-12-08,"(852.0, 1136.0]",1,1,0
31077.0,2019-12-08,"(-0.358, 340.5]",2,3,-1
31077.0,2019-12-08,"(680.0, 1019.5]",4,1,3
31077.0,2019-12-08,"(1019.5, 1359.0]",1,16,-15
,,,,2.0,
31079.0,2019-12-08,"(949.5, 1122.75]",3,3,0
31079.0,2019-12-08,"(1122.75, 1296.0]",4,1,3
31080.0,2019-12-08,"(524.256, 711.0]",1,2,-1
31080.0,2019-12-08,"(711.0, 897.0]",2,3,-1
31080.0,2019-12-08,"(897.0, 1083.0]",1,3,-2
31080.0,2019-12-08,"(1083.0, 1269.0]",2,2,0
31081.0,2019-12-08,"(619.578, 725.5]",2,4,-2
31081.0,2019-12-08,"(936.5, 1042.0]",1,2,-1
31082.0,2019-12-08,"(532.5, 710.0]",1,1,0
31083.0,2019-12-08,"(932.0, 1064.5]",2,1,1
31083.0,2019-12-08,"(1064.5, 1197.0]",3,1,2
31084.0,2019-12-08,"(589.0, 782.0]",1,1,0
31085.0,2019-12-08,"(758.568, 867.0]",1,1,0
31086.0,2019-12-08,"(570.0, 760.0]",2,1,1
31087.0,2019-12-08,"(553.541, 668.75]",1,1,0
31087.0,2019-12-08,"(668.75, 783.5]",1,2,-1
31087.0,2019-12-08,"(783.5, 898.25]",1,1,0
31087.0,2019-12-08,"(898.25, 1013.0]",1,3,-2
31088.0,2019-12-08,"(690.0, 920.0]",2,1,1
31089.0,2019-12-08,"(54.802, 355.5]",1,3,-2
31089.0,2019-12-08,"(355.5, 655.0]",1,2,-1
31089.0,2019-12-08,"(655.0, 954.5]",3,7,-4
31089.0,2019-12-08,"(954.5, 1254.0]",4,9,-5
31090.0,2019-12-08,"(810.856, 847.0]",1,1,0
31091.0,2019-12-08,"(846.0, 924.0]",1,1,0
31091.0,2019-12-08,"(1002.0, 1080.0]",1,1,0
31092.0,2019-12-08,"(94.072, 327.0]",1,1,0
31092.0,2019-12-08,"(791.0, 1023.0]",1,2,-1
31093.0,2019-12-08,"(824.0, 946.0]",1,1,0
31093.0,2019-12-08,"(946.0, 1068.0]",1,2,-1
31094.0,2019-12-08,"(-1.04, 260.0]",1,2,-1
31094.0,2019-12-08,"(520.0, 780.0]",1,1,0
31094.0,2019-12-08,"(780.0, 1040.0]",2,2,0
,,,,2.0,
,,,,2.0,
31097.0,2019-12-08,"(758.686, 837.5]",1,2,-1
31097.0,2019-12-08,"(916.0, 994.5]",1,1,0
31098.0,2019-12-08,"(730.0, 916.0]",1,2,-1
31098.0,2019-12-08,"(916.0, 1102.0]",2,3,-1
31098.0,2019-12-08,"(1102.0, 1288.0]",2,2,0
31099.0,2019-12-08,"(950.75, 973.5]",1,1,0
31099.0,2019-12-08,"(973.5, 996.25]",1,1,0
31099.0,2019-12-08,"(996.25, 1019.0]",1,2,-1
31100.0,2019-12-08,"(624.392, 777.0]",1,1,0
31100.0,2019-12-08,"(777.0, 929.0]",2,3,-1
31100.0,2019-12-08,"(929.0, 1081.0]",1,1,0
31101.0,2019-12-08,"(-1.397, 349.25]",5,15,-10
31101.0,2019-12-08,"(349.25, 698.5]",20,29,-9
31101.0,2019-12-08,"(698.5, 1047.75]",38,74,-36
31101.0,2019-12-08,"(1047.75, 1397.0]",22,44,-22
31102.0,2019-12-08,"(36.662, 372.5]",4,6,-2
31102.0,2019-12-08,"(372.5, 707.0]",5,14,-9
31102.0,2019-12-08,"(707.0, 1041.5]",3,17,-14
31102.0,2019-12-08,"(1041.5, 1376.0]",6,9,-3
31103.0,2019-12-08,"(12.596, 365.0]",2,4,-2
31103.0,2019-12-08,"(365.0, 716.0]",8,27,-19
31103.0,2019-12-08,"(716.0, 1067.0]",8,37,-29
31103.0,2019-12-08,"(1067.0, 1418.0]",9,21,-12
31104.0,2019-12-08,"(17.582, 373.5]",3,9,-6
31104.0,2019-12-08,"(373.5, 728.0]",9,22,-13
31104.0,2019-12-08,"(728.0, 1082.5]",30,61,-31
31104.0,2019-12-08,"(1082.5, 1437.0]",10,24,-14
31105.0,2019-12-08,"(431.107, 655.25]",1,1,0
31105.0,2019-12-08,"(655.25, 878.5]",1,2,-1
31105.0,2019-12-08,"(878.5, 1101.75]",1,2,-1
31106.0,2019-12-08,"(647.441, 787.75]",3,13,-10
31106.0,2019-12-08,"(787.75, 927.5]",2,4,-2
31107.0,2019-12-08,"(6.604, 357.0]",6,6,0
31107.0,2019-12-08,"(357.0, 706.0]",4,14,-10
31107.0,2019-12-08,"(706.0, 1055.0]",12,36,-24
31107.0,2019-12-08,"(1055.0, 1404.0]",4,9,-5
31108.0,2019-12-08,"(106.731, 425.25]",1,1,0
31108.0,2019-12-08,"(425.25, 742.5]",7,20,-13
31108.0,2019-12-08,"(742.5, 1059.75]",13,37,-24
31108.0,2019-12-08,"(1059.75, 1377.0]",15,19,-4
31109.0,2019-12-08,"(107.806, 407.5]",1,3,-2
31109.0,2019-12-08,"(407.5, 706.0]",5,14,-9
31109.0,2019-12-08,"(706.0, 1004.5]",15,28,-13
31109.0,2019-12-08,"(1004.5, 1303.0]",9,15,-6
31110.0,2019-12-08,"(33.646, 373.5]",2,2,0
31110.0,2019-12-08,"(373.5, 712.0]",12,28,-16
31110.0,2019-12-08,"(712.0, 1050.5]",17,34,-17
31110.0,2019-12-08,"(1050.5, 1389.0]",7,11,-4
31111.0,2019-12-08,"(38.681, 369.75]",2,5,-3
31111.0,2019-12-08,"(369.75, 699.5]",5,12,-7
31111.0,2019-12-08,"(699.5, 1029.25]",14,24,-10
31111.0,2019-12-08,"(1029.25, 1359.0]",8,18,-10
31112.0,2019-12-08,"(624.5, 890.75]",3,1,2
31112.0,2019-12-08,"(890.75, 1157.0]",4,8,-4
31113.0,2019-12-08,"(19.582, 375.5]",5,7,-2
31113.0,2019-12-08,"(375.5, 730.0]",4,14,-10
31113.0,2019-12-08,"(730.0, 1084.5]",10,33,-23
31113.0,2019-12-08,"(1084.5, 1439.0]",6,10,-4
31114.0,2019-12-08,"(10.601, 361.75]",3,7,-4
31114.0,2019-12-08,"(361.75, 711.5]",6,15,-9
31114.0,2019-12-08,"(711.5, 1061.25]",11,29,-18
31114.0,2019-12-08,"(1061.25, 1411.0]",8,15,-7
31115.0,2019-12-08,"(58.688, 388.0]",1,2,-1
31115.0,2019-12-08,"(388.0, 716.0]",1,9,-8
31115.0,2019-12-08,"(716.0, 1044.0]",6,17,-11
31115.0,2019-12-08,"(1044.0, 1372.0]",7,11,-4
31116.0,2019-12-08,"(209.774, 517.5]",2,5,-3
31116.0,2019-12-08,"(517.5, 824.0]",11,32,-21
31116.0,2019-12-08,"(824.0, 1130.5]",7,10,-3
31116.0,2019-12-08,"(1130.5, 1437.0]",3,5,-2
31117.0,2019-12-08,"(118.765, 428.75]",1,2,-1
31117.0,2019-12-08,"(428.75, 737.5]",4,16,-12
31117.0,2019-12-08,"(737.5, 1046.25]",11,24,-13
31117.0,2019-12-08,"(1046.25, 1355.0]",7,12,-5
31118.0,2019-12-08,"(106.84, 398.0]",2,3,-1
31118.0,2019-12-08,"(688.0, 978.0]",8,10,-2
31118.0,2019-12-08,"(978.0, 1268.0]",9,18,-9
31119.0,2019-12-08,"(8.58, 365.0]",2,7,-5
31119.0,2019-12-08,"(365.0, 720.0]",9,19,-10
31119.0,2019-12-08,"(720.0, 1075.0]",17,35,-18
31119.0,2019-12-08,"(1075.0, 1430.0]",9,17,-8
31120.0,2019-12-08,"(2.684, 333.0]",5,6,-1
31120.0,2019-12-08,"(333.0, 662.0]",1,4,-3
31120.0,2019-12-08,"(662.0, 991.0]",3,7,-4
31120.0,2019-12-08,"(991.0, 1320.0]",9,14,-5
31121.0,2019-12-08,"(405.0, 707.0]",3,2,1
31121.0,2019-12-08,"(707.0, 1009.0]",19,9,10
31121.0,2019-12-08,"(1009.0, 1311.0]",4,33,-29
31122.0,2019-12-08,"(597.219, 793.25]",5,9,-4
31123.0,2019-12-08,"(26.798, 328.5]",1,2,-1
31123.0,2019-12-08,"(328.5, 629.0]",2,14,-12
31123.0,2019-12-08,"(629.0, 929.5]",10,30,-20
31123.0,2019-12-08,"(929.5, 1230.0]",9,20,-11
31124.0,2019-12-08,"(5.635, 348.25]",1,3,-2
31124.0,2019-12-08,"(348.25, 689.5]",11,22,-11
31124.0,2019-12-08,"(689.5, 1030.75]",24,63,-39
31124.0,2019-12-08,"(1030.75, 1372.0]",13,38,-25
31125.0,2019-12-08,"(9.582, 365.5]",5,8,-3
31125.0,2019-12-08,"(365.5, 720.0]",7,23,-16
31125.0,2019-12-08,"(720.0, 1074.5]",17,30,-13
31125.0,2019-12-08,"(1074.5, 1429.0]",11,20,-9
31126.0,2019-12-08,"(1.591, 355.25]",4,6,-2
31126.0,2019-12-08,"(355.25, 707.5]",9,25,-16
31126.0,2019-12-08,"(707.5, 1059.75]",12,31,-19
31126.0,2019-12-08,"(1059.75, 1412.0]",13,23,-10
,,,,2.0,
31128.0,2019-12-08,"(58.658, 395.5]",1,2,-1
31128.0,2019-12-08,"(395.5, 731.0]",12,17,-5
31128.0,2019-12-08,"(731.0, 1066.5]",18,36,-18
31128.0,2019-12-08,"(1066.5, 1402.0]",4,11,-7
31129.0,2019-12-08,"(0.668, 335.0]",1,2,-1
31129.0,2019-12-08,"(335.0, 668.0]",12,16,-4
31129.0,2019-12-08,"(668.0, 1001.0]",18,34,-16
31129.0,2019-12-08,"(1001.0, 1334.0]",8,13,-5
31130.0,2019-12-08,"(57.698, 384.5]",4,4,0
31130.0,2019-12-08,"(384.5, 710.0]",3,5,-2
31130.0,2019-12-08,"(710.0, 1035.5]",11,23,-12
31130.0,2019-12-08,"(1035.5, 1361.0]",8,11,-3
31131.0,2019-12-08,"(141.88, 423.0]",2,2,0
31131.0,2019-12-08,"(423.0, 703.0]",1,3,-2
31131.0,2019-12-08,"(703.0, 983.0]",4,14,-10
31131.0,2019-12-08,"(983.0, 1263.0]",3,7,-4
31200.0,2019-12-08,"(377.75, 719.5]",40,4,36
31200.0,2019-12-08,"(719.5, 1061.25]",45,60,-15
31200.0,2019-12-08,"(1061.25, 1403.0]",9,81,-72
31201.0,2019-12-08,"(24.665, 359.75]",1,6,-5
31201.0,2019-12-08,"(359.75, 693.5]",23,33,-10
31201.0,2019-12-08,"(693.5, 1027.25]",27,54,-27
31201.0,2019-12-08,"(1027.25, 1361.0]",19,38,-19
31202.0,2019-12-08,"(46.682, 377.5]",1,2,-1
31202.0,2019-12-08,"(377.5, 707.0]",21,28,-7
31202.0,2019-12-08,"(707.0, 1036.5]",13,33,-20
31202.0,2019-12-08,"(1036.5, 1366.0]",14,24,-10
31203.0,2019-12-08,"(13.613, 361.75]",2,8,-6
31203.0,2019-12-08,"(361.75, 708.5]",16,35,-19
31203.0,2019-12-08,"(708.5, 1055.25]",38,59,-21
31203.0,2019-12-08,"(1055.25, 1402.0]",12,23,-11
31204.0,2019-12-08,"(448.25, 776.5]",2,1,1
31204.0,2019-12-08,"(776.5, 1104.75]",2,7,-5
31204.0,2019-12-08,"(1104.75, 1433.0]",6,8,-2
31205.0,2019-12-08,"(380.5, 732.0]",5,3,2
31205.0,2019-12-08,"(732.0, 1083.5]",14,7,7
31205.0,2019-12-08,"(1083.5, 1435.0]",2,25,-23
31206.0,2019-12-08,"(776.791, 829.25]",1,1,0
31206.0,2019-12-08,"(933.75, 986.0]",1,1,0
31207.0,2019-12-08,"(543.28, 724.0]",2,6,-4
31207.0,2019-12-08,"(904.0, 1084.0]",2,4,-2
31207.0,2019-12-08,"(1084.0, 1264.0]",2,4,-2
31208.0,2019-12-08,"(585.405, 734.75]",6,8,-2
31208.0,2019-12-08,"(734.75, 883.5]",1,2,-1
31208.0,2019-12-08,"(1032.25, 1181.0]",1,2,-1
31209.0,2019-12-08,"(745.0, 1087.5]",11,1,10
31209.0,2019-12-08,"(1087.5, 1430.0]",1,3,-2
31211.0,2019-12-08,"(485.239, 676.25]",1,5,-4
31211.0,2019-12-08,"(1056.75, 1247.0]",4,4,0
31212.0,2019-12-08,"(89.741, 405.75]",3,4,-1
31212.0,2019-12-08,"(405.75, 720.5]",6,11,-5
31212.0,2019-12-08,"(720.5, 1035.25]",6,12,-6
31212.0,2019-12-08,"(1035.25, 1350.0]",7,11,-4
31213.0,2019-12-08,"(600.22, 796.0]",8,10,-2
31213.0,2019-12-08,"(796.0, 991.0]",5,15,-10
31213.0,2019-12-08,"(991.0, 1186.0]",4,6,-2
31214.0,2019-12-08,"(27.625, 372.75]",3,7,-4
31214.0,2019-12-08,"(372.75, 716.5]",13,29,-16
31214.0,2019-12-08,"(716.5, 1060.25]",28,53,-25
31214.0,2019-12-08,"(1060.25, 1404.0]",20,37,-17
31215.0,2019-12-08,"(611.224, 806.0]",10,13,-3
31215.0,2019-12-08,"(806.0, 1000.0]",13,18,-5
31215.0,2019-12-08,"(1000.0, 1194.0]",2,3,-1
31215.0,2019-12-08,"(1194.0, 1388.0]",3,7,-4
31216.0,2019-12-08,"(461.27, 644.5]",2,3,-1
31216.0,2019-12-08,"(644.5, 827.0]",3,5,-2
31216.0,2019-12-08,"(827.0, 1009.5]",1,4,-3
31216.0,2019-12-08,"(1009.5, 1192.0]",2,4,-2
31217.0,2019-12-08,"(718.416, 865.0]",4,5,-1
31217.0,2019-12-08,"(865.0, 1011.0]",5,8,-3
31217.0,2019-12-08,"(1157.0, 1303.0]",1,2,-1
31218.0,2019-12-08,"(33.745, 348.75]",1,1,0
31218.0,2019-12-08,"(348.75, 662.5]",1,2,-1
31218.0,2019-12-08,"(662.5, 976.25]",5,10,-5
31218.0,2019-12-08,"(976.25, 1290.0]",3,6,-3
31219.0,2019-12-08,"(443.224, 638.0]",2,2,0
31219.0,2019-12-08,"(638.0, 832.0]",7,16,-9
31219.0,2019-12-08,"(832.0, 1026.0]",9,12,-3
31219.0,2019-12-08,"(1026.0, 1220.0]",2,7,-5
31220.0,2019-12-08,"(794.727, 863.25]",1,1,0
31220.0,2019-12-08,"(863.25, 931.5]",1,1,0
31221.0,2019-12-08,"(478.268, 662.0]",4,4,0
31221.0,2019-12-08,"(662.0, 845.0]",8,10,-2
31221.0,2019-12-08,"(845.0, 1028.0]",7,8,-1
31221.0,2019-12-08,"(1028.0, 1211.0]",2,5,-3
31222.0,2019-12-08,"(335.259, 521.25]",1,2,-1
31222.0,2019-12-08,"(706.5, 891.75]",3,2,1
31222.0,2019-12-08,"(891.75, 1077.0]",3,7,-4
31223.0,2019-12-08,"(52.636, 395.0]",2,5,-3
31223.0,2019-12-08,"(395.0, 736.0]",12,22,-10
31223.0,2019-12-08,"(736.0, 1077.0]",17,39,-22
31223.0,2019-12-08,"(1077.0, 1418.0]",4,11,-7
31224.0,2019-12-08,"(357.25, 674.5]",1,4,-3
31224.0,2019-12-08,"(674.5, 991.75]",2,2,0
31224.0,2019-12-08,"(991.75, 1309.0]",3,4,-1
31225.0,2019-12-08,"(471.237, 662.75]",4,5,-1
31225.0,2019-12-08,"(662.75, 853.5]",4,12,-8
31225.0,2019-12-08,"(853.5, 1044.25]",5,5,0
31225.0,2019-12-08,"(1044.25, 1235.0]",2,4,-2
31226.0,2019-12-08,"(685.75, 856.5]",4,1,3
31226.0,2019-12-08,"(856.5, 1027.25]",2,7,-5
31226.0,2019-12-08,"(1027.25, 1198.0]",2,3,-1
31227.0,2019-12-08,"(531.275, 713.25]",3,3,0
31227.0,2019-12-08,"(713.25, 894.5]",1,2,-1
31227.0,2019-12-08,"(894.5, 1075.75]",2,5,-3
31228.0,2019-12-08,"(96.703, 422.25]",2,4,-2
31228.0,2019-12-08,"(422.25, 746.5]",9,14,-5
31228.0,2019-12-08,"(746.5, 1070.75]",33,52,-19
31228.0,2019-12-08,"(1070.75, 1395.0]",7,19,-12
31229.0,2019-12-08,"(27.624, 373.0]",3,6,-3
31229.0,2019-12-08,"(373.0, 717.0]",17,36,-19
31229.0,2019-12-08,"(717.0, 1061.0]",28,65,-37
31229.0,2019-12-08,"(1061.0, 1405.0]",12,18,-6
31230.0,2019-12-08,"(415.108, 639.0]",1,1,0
31230.0,2019-12-08,"(639.0, 862.0]",15,19,-4
31230.0,2019-12-08,"(862.0, 1085.0]",12,26,-14
31230.0,2019-12-08,"(1085.0, 1308.0]",2,6,-4
31231.0,2019-12-08,"(452.306, 626.5]",2,2,0
31231.0,2019-12-08,"(800.0, 973.5]",4,4,0
31231.0,2019-12-08,"(973.5, 1147.0]",1,4,-3
31232.0,2019-12-08,"(390.0, 723.0]",7,4,3
31232.0,2019-12-08,"(723.0, 1056.0]",32,9,23
31232.0,2019-12-08,"(1056.0, 1389.0]",11,48,-37
31233.0,2019-12-08,"(331.5, 640.0]",2,1,1
31233.0,2019-12-08,"(640.0, 948.5]",10,3,7
31233.0,2019-12-08,"(948.5, 1257.0]",7,14,-7
31234.0,2019-12-08,"(373.5, 692.0]",2,1,1
31234.0,2019-12-08,"(692.0, 1010.5]",9,6,3
31234.0,2019-12-08,"(1010.5, 1329.0]",9,23,-14
31235.0,2019-12-08,"(950.5, 996.0]",1,2,-1
31236.0,2019-12-08,"(51.723, 372.25]",1,1,0
31236.0,2019-12-08,"(372.25, 691.5]",4,8,-4
31236.0,2019-12-08,"(691.5, 1010.75]",11,24,-13
31236.0,2019-12-08,"(1010.75, 1330.0]",9,25,-16
31237.0,2019-12-08,"(-1.33, 332.5]",1,2,-1
31237.0,2019-12-08,"(665.0, 997.5]",13,1,12
31237.0,2019-12-08,"(997.5, 1330.0]",8,25,-17
31238.0,2019-12-08,"(82.726, 402.5]",3,4,-1
31238.0,2019-12-08,"(402.5, 721.0]",9,12,-3
31238.0,2019-12-08,"(721.0, 1039.5]",4,7,-3
31239.0,2019-12-08,"(19.714, 342.5]",1,3,-2
31239.0,2019-12-08,"(342.5, 664.0]",7,8,-1
31239.0,2019-12-08,"(664.0, 985.5]",17,30,-13
31239.0,2019-12-08,"(985.5, 1307.0]",6,8,-2
31240.0,2019-12-08,"(538.597, 639.75]",2,3,-1
31240.0,2019-12-08,"(639.75, 740.5]",2,3,-1
31240.0,2019-12-08,"(740.5, 841.25]",1,3,-2
31240.0,2019-12-08,"(841.25, 942.0]",5,10,-5
31241.0,2019-12-08,"(66.685, 396.75]",1,3,-2
31241.0,2019-12-08,"(396.75, 725.5]",6,16,-10
31241.0,2019-12-08,"(725.5, 1054.25]",14,31,-17
31241.0,2019-12-08,"(1054.25, 1383.0]",12,16,-4
31242.0,2019-12-08,"(573.229, 766.75]",12,15,-3
31242.0,2019-12-08,"(766.75, 959.5]",1,1,0
31243.0,2019-12-08,"(459.157, 670.75]",2,3,-1
31243.0,2019-12-08,"(670.75, 881.5]",3,4,-1
31243.0,2019-12-08,"(881.5, 1092.25]",5,7,-2
31244.0,2019-12-08,"(549.75, 782.5]",7,4,3
31244.0,2019-12-08,"(782.5, 1015.25]",4,14,-10
31244.0,2019-12-08,"(1015.25, 1248.0]",3,6,-3
31245.0,2019-12-08,"(33.892, 312.0]",1,2,-1
31245.0,2019-12-08,"(312.0, 589.0]",1,2,-1
31245.0,2019-12-08,"(589.0, 866.0]",4,7,-3
31245.0,2019-12-08,"(866.0, 1143.0]",11,24,-13
31246.0,2019-12-08,"(343.75, 684.5]",9,1,8
31246.0,2019-12-08,"(684.5, 1025.25]",32,14,18
31246.0,2019-12-08,"(1025.25, 1366.0]",13,61,-48
31247.0,2019-12-08,"(81.808, 381.0]",2,2,0
31247.0,2019-12-08,"(381.0, 679.0]",14,20,-6
31247.0,2019-12-08,"(679.0, 977.0]",12,26,-14
31247.0,2019-12-08,"(977.0, 1275.0]",13,16,-3
31248.0,2019-12-08,"(438.153, 650.75]",11,17,-6
31248.0,2019-12-08,"(650.75, 862.5]",17,29,-12
31248.0,2019-12-08,"(862.5, 1074.25]",20,38,-18
31248.0,2019-12-08,"(1074.25, 1286.0]",5,7,-2
31249.0,2019-12-08,"(38.682, 369.5]",1,2,-1
31249.0,2019-12-08,"(699.0, 1028.5]",17,1,16
31249.0,2019-12-08,"(1028.5, 1358.0]",3,31,-28
31250.0,2019-12-08,"(459.0, 741.0]",2,1,1
31250.0,2019-12-08,"(741.0, 1023.0]",5,5,0
31250.0,2019-12-08,"(1023.0, 1305.0]",2,7,-5
31251.0,2019-12-08,"(57.714, 380.5]",1,2,-1
31251.0,2019-12-08,"(380.5, 702.0]",4,11,-7
31251.0,2019-12-08,"(702.0, 1023.5]",4,9,-5
31251.0,2019-12-08,"(1023.5, 1345.0]",5,10,-5
31252.0,2019-12-08,"(622.256, 809.0]",1,2,-1
31252.0,2019-12-08,"(809.0, 995.0]",1,2,-1
31252.0,2019-12-08,"(995.0, 1181.0]",1,1,0
31253.0,2019-12-08,"(333.0, 594.0]",1,1,0
31253.0,2019-12-08,"(594.0, 855.0]",3,1,2
31253.0,2019-12-08,"(855.0, 1116.0]",4,3,1
31254.0,2019-12-08,"(137.807, 437.25]",1,1,0
31254.0,2019-12-08,"(437.25, 735.5]",1,4,-3
31254.0,2019-12-08,"(735.5, 1033.75]",1,2,-1
31254.0,2019-12-08,"(1033.75, 1332.0]",3,5,-2
31255.0,2019-12-08,"(5.983, 261.25]",1,1,0
31255.0,2019-12-08,"(515.5, 769.75]",1,2,-1
31255.0,2019-12-08,"(769.75, 1024.0]",2,4,-2
31256.0,2019-12-08,"(460.21, 658.5]",5,9,-4
31256.0,2019-12-08,"(658.5, 856.0]",5,7,-2
31256.0,2019-12-08,"(856.0, 1053.5]",9,20,-11
31256.0,2019-12-08,"(1053.5, 1251.0]",1,4,-3
31257.0,2019-12-08,"(203.843, 494.25]",2,4,-2
31257.0,2019-12-08,"(494.25, 783.5]",7,12,-5
31257.0,2019-12-08,"(783.5, 1072.75]",8,13,-5
31257.0,2019-12-08,"(1072.75, 1362.0]",6,13,-7
31258.0,2019-12-08,"(431.125, 650.75]",8,12,-4
31258.0,2019-12-08,"(650.75, 869.5]",13,36,-23
31258.0,2019-12-08,"(869.5, 1088.25]",23,46,-23
31258.0,2019-12-08,"(1088.25, 1307.0]",6,8,-2
,,,,2.0,
31260.0,2019-12-08,"(325.011, 573.25]",1,2,-1
31260.0,2019-12-08,"(573.25, 820.5]",1,3,-2
31260.0,2019-12-08,"(820.5, 1067.75]",4,5,-1
31260.0,2019-12-08,"(1067.75, 1315.0]",2,3,-1
31261.0,2019-12-08,"(1013.892, 1041.0]",2,5,-3
31261.0,2019-12-08,"(1041.0, 1068.0]",1,1,0
31262.0,2019-12-08,"(463.17, 671.5]",2,2,0
31262.0,2019-12-08,"(671.5, 879.0]",6,12,-6
31262.0,2019-12-08,"(879.0, 1086.5]",2,3,-1
31262.0,2019-12-08,"(1086.5, 1294.0]",1,3,-2
31263.0,2019-12-08,"(73.858, 360.5]",3,5,-2
31263.0,2019-12-08,"(360.5, 646.0]",2,10,-8
31263.0,2019-12-08,"(646.0, 931.5]",11,18,-7
31263.0,2019-12-08,"(931.5, 1217.0]",13,19,-6
31264.0,2019-12-08,"(1.61, 350.5]",2,2,0
31264.0,2019-12-08,"(350.5, 698.0]",3,5,-2
31264.0,2019-12-08,"(698.0, 1045.5]",4,11,-7
31264.0,2019-12-08,"(1045.5, 1393.0]",10,13,-3
31265.0,2019-12-08,"(17.648, 357.0]",5,8,-3
31265.0,2019-12-08,"(357.0, 695.0]",5,12,-7
31265.0,2019-12-08,"(695.0, 1033.0]",22,35,-13
31265.0,2019-12-08,"(1033.0, 1371.0]",8,15,-7
31266.0,2019-12-08,"(56.659, 393.25]",3,6,-3
31266.0,2019-12-08,"(393.25, 728.5]",7,26,-19
31266.0,2019-12-08,"(728.5, 1063.75]",16,33,-17
31266.0,2019-12-08,"(1063.75, 1399.0]",14,26,-12
31267.0,2019-12-08,"(25.693, 353.75]",1,2,-1
31267.0,2019-12-08,"(353.75, 680.5]",3,5,-2
31267.0,2019-12-08,"(680.5, 1007.25]",17,27,-10
31267.0,2019-12-08,"(1007.25, 1334.0]",8,21,-13
31268.0,2019-12-08,"(129.729, 448.75]",1,2,-1
31268.0,2019-12-08,"(448.75, 766.5]",8,14,-6
31268.0,2019-12-08,"(766.5, 1084.25]",8,16,-8
31268.0,2019-12-08,"(1084.25, 1402.0]",7,12,-5
31269.0,2019-12-08,"(5.711, 329.25]",1,2,-1
31269.0,2019-12-08,"(329.25, 651.5]",3,6,-3
31269.0,2019-12-08,"(651.5, 973.75]",6,11,-5
31269.0,2019-12-08,"(973.75, 1296.0]",4,6,-2
31270.0,2019-12-08,"(370.75, 692.5]",4,1,3
31270.0,2019-12-08,"(692.5, 1014.25]",7,6,1
31270.0,2019-12-08,"(1014.25, 1336.0]",2,12,-10
31271.0,2019-12-08,"(347.25, 693.5]",3,4,-1
31271.0,2019-12-08,"(693.5, 1039.75]",23,4,19
31271.0,2019-12-08,"(1039.75, 1386.0]",3,51,-48
31272.0,2019-12-08,"(562.429, 705.75]",9,9,0
31272.0,2019-12-08,"(705.75, 848.5]",2,8,-6
31272.0,2019-12-08,"(848.5, 991.25]",7,10,-3
31272.0,2019-12-08,"(991.25, 1134.0]",1,3,-2
31273.0,2019-12-08,"(627.36, 788.0]",1,2,-1
31273.0,2019-12-08,"(788.0, 948.0]",1,2,-1
31273.0,2019-12-08,"(948.0, 1108.0]",2,4,-2
31273.0,2019-12-08,"(1108.0, 1268.0]",1,3,-2
31274.0,2019-12-08,"(41.837, 333.75]",1,4,-3
31274.0,2019-12-08,"(333.75, 624.5]",1,1,0
31274.0,2019-12-08,"(624.5, 915.25]",7,9,-2
31274.0,2019-12-08,"(915.25, 1206.0]",2,6,-4
31275.0,2019-12-08,"(42.672, 376.0]",2,2,0
31275.0,2019-12-08,"(376.0, 708.0]",7,12,-5
31275.0,2019-12-08,"(708.0, 1040.0]",10,19,-9
31275.0,2019-12-08,"(1040.0, 1372.0]",8,10,-2
31276.0,2019-12-08,"(260.86, 547.0]",2,2,0
31276.0,2019-12-08,"(547.0, 832.0]",7,11,-4
31276.0,2019-12-08,"(832.0, 1117.0]",1,4,-3
31276.0,2019-12-08,"(1117.0, 1402.0]",1,3,-2
31277.0,2019-12-08,"(331.001, 581.75]",3,5,-2
31277.0,2019-12-08,"(581.75, 831.5]",9,9,0
31277.0,2019-12-08,"(831.5, 1081.25]",6,14,-8
31277.0,2019-12-08,"(1081.25, 1331.0]",3,4,-1
31278.0,2019-12-08,"(4.615, 352.25]",2,3,-1
31278.0,2019-12-08,"(352.25, 698.5]",3,9,-6
31278.0,2019-12-08,"(698.5, 1044.75]",14,27,-13
31278.0,2019-12-08,"(1044.75, 1391.0]",13,23,-10
31279.0,2019-12-08,"(143.925, 413.75]",1,1,0
31279.0,2019-12-08,"(413.75, 682.5]",2,2,0
31279.0,2019-12-08,"(682.5, 951.25]",2,4,-2
31279.0,2019-12-08,"(951.25, 1220.0]",1,2,-1
31280.0,2019-12-08,"(360.5, 683.0]",6,2,4
31280.0,2019-12-08,"(683.0, 1005.5]",9,13,-4
31280.0,2019-12-08,"(1005.5, 1328.0]",3,19,-16
31000.0,2019-12-09,"(822.0, 1096.0]",1,1,0
31001.0,2019-12-09,"(789.75, 1053.0]",1,1,0
31002.0,2019-12-09,"(525.147, 739.25]",3,5,-2
31002.0,2019-12-09,"(952.5, 1165.75]",2,3,-1
31003.0,2019-12-09,"(377.169, 585.75]",1,3,-2
31003.0,2019-12-09,"(585.75, 793.5]",1,1,0
31003.0,2019-12-09,"(1001.25, 1209.0]",1,5,-4
31004.0,2019-12-09,"(879.5, 1080.75]",1,2,-1
31004.0,2019-12-09,"(1080.75, 1282.0]",2,1,1
31005.0,2019-12-09,"(434.155, 646.25]",4,5,-1
31005.0,2019-12-09,"(1068.75, 1280.0]",3,3,0
31006.0,2019-12-09,"(506.117, 727.75]",1,2,-1
31006.0,2019-12-09,"(1169.25, 1390.0]",1,2,-1
31007.0,2019-12-09,"(362.099, 588.25]",5,18,-13
31007.0,2019-12-09,"(588.25, 813.5]",1,2,-1
31007.0,2019-12-09,"(1038.75, 1264.0]",5,2,3
31009.0,2019-12-09,"(427.456, 564.0]",5,5,0
31009.0,2019-12-09,"(564.0, 700.0]",1,1,0
31010.0,2019-12-09,"(355.25, 430.0]",1,1,0
31011.0,2019-12-09,"(138.893, 416.75]",3,3,0
31011.0,2019-12-09,"(416.75, 693.5]",6,8,-2
31011.0,2019-12-09,"(693.5, 970.25]",1,1,0
31011.0,2019-12-09,"(970.25, 1247.0]",1,6,-5
31012.0,2019-12-09,"(365.246, 554.5]",3,3,0
31012.0,2019-12-09,"(554.5, 743.0]",2,2,0
31013.0,2019-12-09,"(1034.5, 1213.0]",1,3,-2
31014.0,2019-12-09,"(396.111, 619.25]",22,27,-5
31014.0,2019-12-09,"(841.5, 1063.75]",2,6,-4
31014.0,2019-12-09,"(1063.75, 1286.0]",6,11,-5
31015.0,2019-12-09,"(43.981, 299.75]",1,1,0
31015.0,2019-12-09,"(299.75, 554.5]",10,11,-1
31015.0,2019-12-09,"(809.25, 1064.0]",2,4,-2
31016.0,2019-12-09,"(461.261, 646.75]",4,8,-4
31016.0,2019-12-09,"(1016.25, 1201.0]",4,5,-1
31017.0,2019-12-09,"(491.303, 666.25]",3,5,-2
31018.0,2019-12-09,"(346.212, 544.0]",2,7,-5
31018.0,2019-12-09,"(938.0, 1135.0]",4,5,-1
31019.0,2019-12-09,"(975.5, 1144.0]",5,1,4
31020.0,2019-12-09,"(391.001, 641.75]",1,1,0
31021.0,2019-12-09,"(380.29, 558.5]",1,6,-5
31021.0,2019-12-09,"(558.5, 736.0]",1,2,-1
31021.0,2019-12-09,"(913.5, 1091.0]",1,4,-3
31022.0,2019-12-09,"(485.16, 696.0]",2,6,-4
31022.0,2019-12-09,"(906.0, 1116.0]",1,4,-3
31022.0,2019-12-09,"(1116.0, 1326.0]",1,4,-3
31023.0,2019-12-09,"(1109.883, 1139.25]",1,2,-1
31024.0,2019-12-09,"(409.223, 604.25]",1,1,0
31025.0,2019-12-09,"(1092.959, 1103.25]",1,1,0
,,,,1.0,
,,,,3.0,
,,,,2.0,
31027.0,2019-12-09,"(982.75, 1147.0]",1,3,-2
,,,,1.0,
,,,,2.0,
31029.0,2019-12-09,"(1010.5, 1198.0]",4,7,-3
31030.0,2019-12-09,"(468.075, 700.25]",1,6,-5
31030.0,2019-12-09,"(931.5, 1162.75]",4,6,-2
31030.0,2019-12-09,"(1162.75, 1394.0]",1,1,0
31031.0,2019-12-09,"(358.161, 568.75]",2,5,-3
31031.0,2019-12-09,"(778.5, 988.25]",1,1,0
31032.0,2019-12-09,"(969.75, 1135.0]",1,1,0
31033.0,2019-12-09,"(992.969, 1000.75]",1,1,0
31034.0,2019-12-09,"(515.0, 532.0]",2,2,0
31034.0,2019-12-09,"(549.0, 566.0]",1,2,-1
31035.0,2019-12-09,"(903.5, 1088.0]",1,3,-2
31036.0,2019-12-09,"(947.0, 1114.0]",2,2,0
31037.0,2019-12-09,"(368.25, 671.5]",10,1,9
31037.0,2019-12-09,"(671.5, 974.75]",1,15,-14
31037.0,2019-12-09,"(974.75, 1278.0]",2,2,0
31038.0,2019-12-09,"(575.327, 744.25]",1,1,0
31039.0,2019-12-09,"(416.279, 597.25]",1,2,-1
31039.0,2019-12-09,"(957.75, 1138.0]",1,2,-1
31040.0,2019-12-09,"(452.364, 612.0]",2,3,-1
31040.0,2019-12-09,"(930.0, 1089.0]",2,6,-4
31041.0,2019-12-09,"(488.524, 608.0]",2,2,0
31042.0,2019-12-09,"(440.312, 613.0]",7,7,0
31042.0,2019-12-09,"(957.0, 1129.0]",1,4,-3
31043.0,2019-12-09,"(424.264, 609.0]",2,4,-2
31043.0,2019-12-09,"(609.0, 793.0]",1,1,0
,,,,2.0,
31045.0,2019-12-09,"(56.941, 322.75]",1,1,0
31045.0,2019-12-09,"(852.25, 1117.0]",2,1,1
31046.0,2019-12-09,"(395.3, 571.0]",1,3,-2
31046.0,2019-12-09,"(571.0, 746.0]",1,2,-1
31046.0,2019-12-09,"(921.0, 1096.0]",2,2,0
31047.0,2019-12-09,"(5.754, 318.5]",1,1,0
31047.0,2019-12-09,"(318.5, 630.0]",12,19,-7
31047.0,2019-12-09,"(630.0, 941.5]",1,1,0
31047.0,2019-12-09,"(941.5, 1253.0]",9,19,-10
31048.0,2019-12-09,"(471.147, 685.25]",1,1,0
31048.0,2019-12-09,"(898.5, 1111.75]",1,1,0
31048.0,2019-12-09,"(1111.75, 1325.0]",1,3,-2
31049.0,2019-12-09,"(1055.715, 1127.25]",2,2,0
31050.0,2019-12-09,"(363.844, 403.0]",1,1,0
31051.0,2019-12-09,"(303.161, 513.75]",1,4,-3
31051.0,2019-12-09,"(933.25, 1143.0]",3,4,-1
31052.0,2019-12-09,"(266.016, 513.0]",1,4,-3
31052.0,2019-12-09,"(513.0, 759.0]",3,4,-1
31052.0,2019-12-09,"(1005.0, 1251.0]",2,2,0
31053.0,2019-12-09,"(116.591, 219.25]",1,2,-1
,,,,2.0,
31055.0,2019-12-09,"(865.0, 1049.0]",1,1,0
31055.0,2019-12-09,"(1049.0, 1233.0]",2,1,1
31056.0,2019-12-09,"(106.597, 207.75]",1,1,0
,,,,1.0,
,,,,1.0,
,,,,1.0,
,,,,1.0,
31059.0,2019-12-09,"(834.0, 1042.0]",1,1,0
31059.0,2019-12-09,"(1042.0, 1250.0]",1,1,0
31060.0,2019-12-09,"(864.5, 1122.0]",1,1,0
31061.0,2019-12-09,"(391.5, 522.0]",1,1,0
31062.0,2019-12-09,"(633.0, 844.0]",1,1,0
31063.0,2019-12-09,"(474.32, 645.0]",2,2,0
31063.0,2019-12-09,"(985.0, 1155.0]",1,2,-1
31064.0,2019-12-09,"(515.35, 678.5]",2,4,-2
31064.0,2019-12-09,"(1003.5, 1166.0]",2,4,-2
31065.0,2019-12-09,"(827.5, 978.0]",1,2,-1
,,,,2.0,
31067.0,2019-12-09,"(414.044, 654.0]",1,2,-1
31067.0,2019-12-09,"(893.0, 1132.0]",2,3,-1
31067.0,2019-12-09,"(1132.0, 1371.0]",1,2,-1
31068.0,2019-12-09,"(1095.751, 1158.25]",1,2,-1
31068.0,2019-12-09,"(1282.75, 1345.0]",1,1,0
31069.0,2019-12-09,"(782.0, 952.5]",1,3,-2
31069.0,2019-12-09,"(952.5, 1123.0]",3,1,2
31070.0,2019-12-09,"(1179.0, 1188.0]",1,1,0
31071.0,2019-12-09,"(337.258, 523.5]",1,3,-2
31071.0,2019-12-09,"(894.5, 1080.0]",2,3,-1
,,,,1.0,
,,,,1.0,
31073.0,2019-12-09,"(493.937, 509.75]",1,1,0
31073.0,2019-12-09,"(541.25, 557.0]",1,2,-1
31074.0,2019-12-09,"(1045.5, 1234.0]",3,1,2
31075.0,2019-12-09,"(974.0, 1119.0]",1,1,0
31076.0,2019-12-09,"(425.366, 584.5]",1,1,0
31076.0,2019-12-09,"(901.5, 1060.0]",1,2,-1
31077.0,2019-12-09,"(862.0, 1098.5]",2,2,0
31077.0,2019-12-09,"(1098.5, 1335.0]",1,2,-1
31078.0,2019-12-09,"(501.55, 614.5]",4,4,0
31079.0,2019-12-09,"(405.091, 633.25]",1,7,-6
31079.0,2019-12-09,"(860.5, 1087.75]",1,1,0
31079.0,2019-12-09,"(1087.75, 1315.0]",3,4,-1
31080.0,2019-12-09,"(402.997, 654.75]",1,13,-12
31080.0,2019-12-09,"(905.5, 1156.25]",2,4,-2
31080.0,2019-12-09,"(1156.25, 1407.0]",3,3,0
31081.0,2019-12-09,"(432.113, 654.75]",2,2,0
,,,,2.0,
31083.0,2019-12-09,"(19.888, 299.0]",1,1,0
31083.0,2019-12-09,"(855.0, 1133.0]",3,1,2
,,,,2.0,
,,,,1.0,
31085.0,2019-12-09,"(400.331, 568.25]",1,3,-2
31085.0,2019-12-09,"(902.75, 1070.0]",1,1,0
,,,,2.0,
,,,,1.0,
31087.0,2019-12-09,"(413.344, 578.0]",1,3,-2
31087.0,2019-12-09,"(906.0, 1070.0]",1,1,0
31088.0,2019-12-09,"(973.5, 1125.0]",3,2,1
31089.0,2019-12-09,"(473.164, 683.0]",8,10,-2
31089.0,2019-12-09,"(1101.0, 1310.0]",3,5,-2
,,,,2.0,
,,,,1.0,
,,,,2.0,
,,,,2.0,
31092.0,2019-12-09,"(1002.5, 1196.0]",2,3,-1
,,,,2.0,
,,,,2.0,
,,,,2.0,
31096.0,2019-12-09,"(868.5, 1158.0]",1,1,0
31097.0,2019-12-09,"(506.383, 661.25]",3,3,0
31097.0,2019-12-09,"(969.75, 1124.0]",2,1,1
31098.0,2019-12-09,"(428.33, 596.5]",2,6,-4
31098.0,2019-12-09,"(931.5, 1099.0]",3,6,-3
31099.0,2019-12-09,"(871.75, 1003.0]",1,1,0
31100.0,2019-12-09,"(439.062, 674.5]",14,16,-2
31100.0,2019-12-09,"(674.5, 909.0]",1,3,-2
31100.0,2019-12-09,"(909.0, 1143.5]",2,7,-5
31100.0,2019-12-09,"(1143.5, 1378.0]",1,6,-5
31101.0,2019-12-09,"(319.886, 599.5]",6,34,-28
31101.0,2019-12-09,"(599.5, 878.0]",2,5,-3
31101.0,2019-12-09,"(878.0, 1156.5]",18,27,-9
31101.0,2019-12-09,"(1156.5, 1435.0]",14,21,-7
31102.0,2019-12-09,"(335.028, 579.0]",1,18,-17
31102.0,2019-12-09,"(822.0, 1065.0]",2,5,-3
31102.0,2019-12-09,"(1065.0, 1308.0]",6,11,-5
31103.0,2019-12-09,"(361.02, 607.0]",2,28,-26
31103.0,2019-12-09,"(607.0, 852.0]",1,6,-5
31103.0,2019-12-09,"(852.0, 1097.0]",5,11,-6
31103.0,2019-12-09,"(1097.0, 1342.0]",2,7,-5
31104.0,2019-12-09,"(837.0, 1100.5]",8,5,3
31104.0,2019-12-09,"(1100.5, 1364.0]",9,11,-2
31105.0,2019-12-09,"(453.202, 653.5]",2,12,-10
31105.0,2019-12-09,"(853.0, 1052.5]",1,6,-5
31105.0,2019-12-09,"(1052.5, 1252.0]",4,7,-3
31106.0,2019-12-09,"(385.115, 607.25]",1,10,-9
31106.0,2019-12-09,"(1049.75, 1271.0]",6,9,-3
31107.0,2019-12-09,"(301.012, 549.0]",1,20,-19
31107.0,2019-12-09,"(549.0, 796.0]",2,2,0
31107.0,2019-12-09,"(796.0, 1043.0]",3,4,-1
31107.0,2019-12-09,"(1043.0, 1290.0]",7,9,-2
31108.0,2019-12-09,"(38.727, 358.25]",1,1,0
31108.0,2019-12-09,"(358.25, 676.5]",6,21,-15
31108.0,2019-12-09,"(676.5, 994.75]",2,3,-1
31108.0,2019-12-09,"(994.75, 1313.0]",20,28,-8
31109.0,2019-12-09,"(370.5, 683.0]",7,1,6
31109.0,2019-12-09,"(683.0, 995.5]",3,18,-15
31109.0,2019-12-09,"(995.5, 1308.0]",12,4,8
31110.0,2019-12-09,"(16.599, 368.25]",2,4,-2
31110.0,2019-12-09,"(368.25, 718.5]",9,28,-19
31110.0,2019-12-09,"(718.5, 1068.75]",8,19,-11
31110.0,2019-12-09,"(1068.75, 1419.0]",12,20,-8
31111.0,2019-12-09,"(343.5, 649.0]",8,2,6
31111.0,2019-12-09,"(954.5, 1260.0]",11,17,-6
31112.0,2019-12-09,"(895.5, 1079.25]",1,4,-3
31112.0,2019-12-09,"(1079.25, 1263.0]",2,1,1
31113.0,2019-12-09,"(584.75, 853.5]",1,16,-15
31113.0,2019-12-09,"(853.5, 1122.25]",5,2,3
31113.0,2019-12-09,"(1122.25, 1391.0]",4,8,-4
31114.0,2019-12-09,"(356.987, 611.25]",2,33,-31
31114.0,2019-12-09,"(864.5, 1117.75]",6,3,3
31114.0,2019-12-09,"(1117.75, 1371.0]",8,8,0
31115.0,2019-12-09,"(572.5, 798.0]",1,16,-15
31115.0,2019-12-09,"(798.0, 1023.5]",1,1,0
31115.0,2019-12-09,"(1023.5, 1249.0]",13,2,11
31116.0,2019-12-09,"(32.681, 363.75]",1,2,-1
31116.0,2019-12-09,"(363.75, 693.5]",9,27,-18
31116.0,2019-12-09,"(693.5, 1023.25]",2,2,0
31116.0,2019-12-09,"(1023.25, 1353.0]",22,33,-11
31117.0,2019-12-09,"(339.053, 576.75]",4,21,-17
31117.0,2019-12-09,"(576.75, 813.5]",2,3,-1
31117.0,2019-12-09,"(813.5, 1050.25]",3,6,-3
31117.0,2019-12-09,"(1050.25, 1287.0]",10,22,-12
31118.0,2019-12-09,"(430.081, 660.75]",1,14,-13
31118.0,2019-12-09,"(890.5, 1120.25]",11,14,-3
31118.0,2019-12-09,"(1120.25, 1350.0]",6,7,-1
31119.0,2019-12-09,"(308.984, 564.0]",6,14,-8
31119.0,2019-12-09,"(564.0, 818.0]",1,2,-1
31119.0,2019-12-09,"(818.0, 1072.0]",4,5,-1
31119.0,2019-12-09,"(1072.0, 1326.0]",15,21,-6
31120.0,2019-12-09,"(372.5, 715.0]",2,1,1
31120.0,2019-12-09,"(715.0, 1057.5]",4,19,-15
31120.0,2019-12-09,"(1057.5, 1400.0]",7,6,1
31121.0,2019-12-09,"(349.08, 580.0]",14,21,-7
31121.0,2019-12-09,"(580.0, 810.0]",1,3,-2
31121.0,2019-12-09,"(810.0, 1040.0]",1,5,-4
31121.0,2019-12-09,"(1040.0, 1270.0]",5,10,-5
31122.0,2019-12-09,"(448.097, 674.75]",1,7,-6
31122.0,2019-12-09,"(674.75, 900.5]",1,3,-2
31122.0,2019-12-09,"(900.5, 1126.25]",3,3,0
31122.0,2019-12-09,"(1126.25, 1352.0]",5,8,-3
31123.0,2019-12-09,"(373.049, 611.75]",1,22,-21
31123.0,2019-12-09,"(611.75, 849.5]",1,1,0
31123.0,2019-12-09,"(849.5, 1087.25]",3,5,-2
31123.0,2019-12-09,"(1087.25, 1325.0]",5,9,-4
31124.0,2019-12-09,"(310.936, 578.0]",16,30,-14
31124.0,2019-12-09,"(844.0, 1110.0]",8,10,-2
31124.0,2019-12-09,"(1110.0, 1376.0]",11,26,-15
31125.0,2019-12-09,"(0.695, 328.25]",1,1,0
31125.0,2019-12-09,"(328.25, 654.5]",10,28,-18
31125.0,2019-12-09,"(980.75, 1307.0]",28,37,-9
31126.0,2019-12-09,"(1.572, 360.0]",1,3,-2
31126.0,2019-12-09,"(360.0, 717.0]",4,18,-14
31126.0,2019-12-09,"(717.0, 1074.0]",8,12,-4
31126.0,2019-12-09,"(1074.0, 1431.0]",19,24,-5
,,,,2.0,
31128.0,2019-12-09,"(1.574, 359.5]",3,4,-1
31128.0,2019-12-09,"(359.5, 716.0]",21,29,-8
31128.0,2019-12-09,"(716.0, 1072.5]",12,18,-6
31128.0,2019-12-09,"(1072.5, 1429.0]",9,21,-12
31129.0,2019-12-09,"(407.091, 635.25]",8,8,0
31129.0,2019-12-09,"(862.5, 1089.75]",4,1,3
31129.0,2019-12-09,"(1089.75, 1317.0]",1,5,-4
31130.0,2019-12-09,"(412.057, 648.75]",3,8,-5
31130.0,2019-12-09,"(884.5, 1120.25]",7,11,-4
31130.0,2019-12-09,"(1120.25, 1356.0]",4,4,0
31131.0,2019-12-09,"(936.5, 1180.25]",5,14,-9
31131.0,2019-12-09,"(1180.25, 1424.0]",4,8,-4
31200.0,2019-12-09,"(340.964, 601.0]",25,31,-6
31200.0,2019-12-09,"(601.0, 860.0]",5,12,-7
31200.0,2019-12-09,"(860.0, 1119.0]",7,16,-9
31200.0,2019-12-09,"(1119.0, 1378.0]",6,19,-13
31201.0,2019-12-09,"(73.685, 403.75]",2,6,-4
31201.0,2019-12-09,"(403.75, 732.5]",11,26,-15
31201.0,2019-12-09,"(732.5, 1061.25]",12,18,-6
31201.0,2019-12-09,"(1061.25, 1390.0]",7,21,-14
31202.0,2019-12-09,"(355.948, 620.0]",7,23,-16
31202.0,2019-12-09,"(620.0, 883.0]",2,4,-2
31202.0,2019-12-09,"(883.0, 1146.0]",7,14,-7
31202.0,2019-12-09,"(1146.0, 1409.0]",6,13,-7
31203.0,2019-12-09,"(362.962, 623.5]",6,17,-11
31203.0,2019-12-09,"(623.5, 883.0]",4,7,-3
31203.0,2019-12-09,"(883.0, 1142.5]",14,22,-8
31203.0,2019-12-09,"(1142.5, 1402.0]",10,18,-8
31204.0,2019-12-09,"(415.118, 636.5]",10,12,-2
31204.0,2019-12-09,"(636.5, 857.0]",2,2,0
31204.0,2019-12-09,"(857.0, 1077.5]",4,13,-9
31204.0,2019-12-09,"(1077.5, 1298.0]",3,5,-2
31205.0,2019-12-09,"(374.5, 716.0]",23,1,22
31205.0,2019-12-09,"(716.0, 1057.5]",6,26,-20
31205.0,2019-12-09,"(1057.5, 1399.0]",5,10,-5
31206.0,2019-12-09,"(456.378, 612.5]",5,7,-2
31206.0,2019-12-09,"(612.5, 768.0]",1,1,0
31206.0,2019-12-09,"(923.5, 1079.0]",4,10,-6
31207.0,2019-12-09,"(44.92, 316.0]",1,1,0
31207.0,2019-12-09,"(856.0, 1126.0]",1,4,-3
31208.0,2019-12-09,"(318.926, 588.5]",10,11,-1
31208.0,2019-12-09,"(857.0, 1125.5]",1,5,-4
31208.0,2019-12-09,"(1125.5, 1394.0]",4,6,-2
31209.0,2019-12-09,"(508.393, 660.75]",2,2,0
31209.0,2019-12-09,"(660.75, 812.5]",1,1,0
31209.0,2019-12-09,"(964.25, 1116.0]",2,1,1
31211.0,2019-12-09,"(399.042, 639.5]",7,9,-2
31211.0,2019-12-09,"(639.5, 879.0]",1,1,0
31211.0,2019-12-09,"(879.0, 1118.5]",3,8,-5
31211.0,2019-12-09,"(1118.5, 1358.0]",1,3,-2
31212.0,2019-12-09,"(76.679, 408.25]",3,5,-2
31212.0,2019-12-09,"(408.25, 738.5]",30,40,-10
31212.0,2019-12-09,"(738.5, 1068.75]",10,18,-8
31212.0,2019-12-09,"(1068.75, 1399.0]",6,13,-7
31213.0,2019-12-09,"(376.172, 584.0]",31,39,-8
31213.0,2019-12-09,"(584.0, 791.0]",2,3,-1
31213.0,2019-12-09,"(791.0, 998.0]",3,4,-1
31213.0,2019-12-09,"(998.0, 1205.0]",15,40,-25
31214.0,2019-12-09,"(380.5, 732.0]",13,3,10
31214.0,2019-12-09,"(732.0, 1083.5]",10,35,-25
31214.0,2019-12-09,"(1083.5, 1435.0]",17,20,-3
31215.0,2019-12-09,"(410.179, 616.25]",23,24,-1
31215.0,2019-12-09,"(821.5, 1026.75]",1,2,-1
31215.0,2019-12-09,"(1026.75, 1232.0]",1,10,-9
31216.0,2019-12-09,"(333.999, 585.25]",20,20,0
31216.0,2019-12-09,"(835.5, 1085.75]",2,9,-7
31216.0,2019-12-09,"(1085.75, 1336.0]",4,14,-10
31217.0,2019-12-09,"(386.234, 578.5]",10,11,-1
31217.0,2019-12-09,"(578.5, 770.0]",4,5,-1
31217.0,2019-12-09,"(961.5, 1153.0]",1,2,-1
31218.0,2019-12-09,"(395.006, 644.5]",14,28,-14
31218.0,2019-12-09,"(893.0, 1141.5]",6,1,5
31218.0,2019-12-09,"(1141.5, 1390.0]",1,15,-14
31219.0,2019-12-09,"(356.209, 554.75]",6,6,0
31219.0,2019-12-09,"(554.75, 752.5]",6,6,0
31220.0,2019-12-09,"(306.207, 505.25]",6,10,-4
31220.0,2019-12-09,"(505.25, 703.5]",12,13,-1
31220.0,2019-12-09,"(703.5, 901.75]",2,4,-2
31220.0,2019-12-09,"(901.75, 1100.0]",1,15,-14
31221.0,2019-12-09,"(432.136, 649.0]",31,35,-4
31221.0,2019-12-09,"(649.0, 865.0]",2,3,-1
31221.0,2019-12-09,"(1081.0, 1297.0]",5,14,-9
31222.0,2019-12-09,"(471.152, 684.0]",19,21,-2
31222.0,2019-12-09,"(896.0, 1108.0]",1,14,-13
31222.0,2019-12-09,"(1108.0, 1320.0]",2,4,-2
31223.0,2019-12-09,"(47.623, 393.25]",1,2,-1
31223.0,2019-12-09,"(393.25, 737.5]",11,30,-19
31223.0,2019-12-09,"(737.5, 1081.75]",8,17,-9
31223.0,2019-12-09,"(1081.75, 1426.0]",8,12,-4
31224.0,2019-12-09,"(385.066, 619.5]",13,16,-3
31224.0,2019-12-09,"(619.5, 853.0]",1,2,-1
31224.0,2019-12-09,"(853.0, 1086.5]",4,12,-8
31224.0,2019-12-09,"(1086.5, 1320.0]",1,6,-5
31225.0,2019-12-09,"(352.95, 616.5]",7,15,-8
31225.0,2019-12-09,"(616.5, 879.0]",2,2,0
31225.0,2019-12-09,"(879.0, 1141.5]",4,10,-6
31225.0,2019-12-09,"(1141.5, 1404.0]",6,8,-2
31226.0,2019-12-09,"(272.931, 541.25]",3,7,-4
31226.0,2019-12-09,"(808.5, 1075.75]",2,3,-1
31226.0,2019-12-09,"(1075.75, 1343.0]",2,4,-2
31227.0,2019-12-09,"(451.096, 678.0]",31,34,-3
31227.0,2019-12-09,"(678.0, 904.0]",1,1,0
31227.0,2019-12-09,"(904.0, 1130.0]",3,13,-10
31227.0,2019-12-09,"(1130.0, 1356.0]",1,2,-1
31228.0,2019-12-09,"(102.674, 435.5]",7,7,0
31228.0,2019-12-09,"(435.5, 767.0]",17,25,-8
31228.0,2019-12-09,"(767.0, 1098.5]",7,13,-6
31228.0,2019-12-09,"(1098.5, 1430.0]",6,18,-12
31229.0,2019-12-09,"(77.666, 412.5]",4,10,-6
31229.0,2019-12-09,"(412.5, 746.0]",8,41,-33
31229.0,2019-12-09,"(746.0, 1079.5]",16,21,-5
31229.0,2019-12-09,"(1079.5, 1413.0]",10,20,-10
31230.0,2019-12-09,"(389.0, 640.0]",45,57,-12
31230.0,2019-12-09,"(890.0, 1140.0]",5,23,-18
31230.0,2019-12-09,"(1140.0, 1390.0]",3,7,-4
31231.0,2019-12-09,"(325.218, 521.5]",11,13,-2
31231.0,2019-12-09,"(521.5, 717.0]",9,10,-1
31231.0,2019-12-09,"(912.5, 1108.0]",5,1,4
31232.0,2019-12-09,"(331.94, 598.0]",15,17,-2
31232.0,2019-12-09,"(863.0, 1128.0]",10,1,9
31232.0,2019-12-09,"(1128.0, 1393.0]",6,15,-9
31233.0,2019-12-09,"(58.66, 395.0]",2,2,0
31233.0,2019-12-09,"(395.0, 730.0]",32,35,-3
31233.0,2019-12-09,"(730.0, 1065.0]",3,8,-5
31233.0,2019-12-09,"(1065.0, 1400.0]",5,8,-3
31234.0,2019-12-09,"(15.583, 371.25]",2,3,-1
31234.0,2019-12-09,"(371.25, 725.5]",12,25,-13
31234.0,2019-12-09,"(725.5, 1079.75]",6,16,-10
31234.0,2019-12-09,"(1079.75, 1434.0]",5,12,-7
31235.0,2019-12-09,"(511.169, 719.75]",2,2,0
31235.0,2019-12-09,"(927.5, 1135.25]",1,5,-4
31235.0,2019-12-09,"(1135.25, 1343.0]",1,1,0
31236.0,2019-12-09,"(393.978, 650.5]",16,16,0
31236.0,2019-12-09,"(906.0, 1161.5]",5,2,3
31236.0,2019-12-09,"(1161.5, 1417.0]",2,15,-13
31237.0,2019-12-09,"(33.609, 382.75]",1,1,0
31237.0,2019-12-09,"(382.75, 730.5]",4,14,-10
31237.0,2019-12-09,"(730.5, 1078.25]",7,10,-3
31237.0,2019-12-09,"(1078.25, 1426.0]",6,13,-7
31238.0,2019-12-09,"(56.702, 382.5]",1,1,0
31238.0,2019-12-09,"(382.5, 707.0]",6,8,-2
31238.0,2019-12-09,"(707.0, 1031.5]",2,9,-7
31238.0,2019-12-09,"(1031.5, 1356.0]",4,16,-12
31239.0,2019-12-09,"(21.589, 375.75]",2,2,0
31239.0,2019-12-09,"(375.75, 728.5]",23,26,-3
31239.0,2019-12-09,"(728.5, 1081.25]",4,16,-12
31239.0,2019-12-09,"(1081.25, 1434.0]",5,15,-10
31240.0,2019-12-09,"(531.999, 532.25]",2,2,0
31241.0,2019-12-09,"(0.576, 358.0]",2,4,-2
31241.0,2019-12-09,"(358.0, 714.0]",28,47,-19
31241.0,2019-12-09,"(714.0, 1070.0]",4,11,-7
31241.0,2019-12-09,"(1070.0, 1426.0]",11,23,-12
31242.0,2019-12-09,"(408.19, 611.5]",29,33,-4
31242.0,2019-12-09,"(611.5, 814.0]",3,3,0
31242.0,2019-12-09,"(814.0, 1016.5]",1,1,0
31243.0,2019-12-09,"(376.995, 629.25]",26,30,-4
31243.0,2019-12-09,"(880.5, 1131.75]",2,1,1
31243.0,2019-12-09,"(1131.75, 1383.0]",4,14,-10
31244.0,2019-12-09,"(348.011, 596.25]",20,33,-13
31244.0,2019-12-09,"(596.25, 843.5]",1,1,0
31244.0,2019-12-09,"(843.5, 1090.75]",4,12,-8
31244.0,2019-12-09,"(1090.75, 1338.0]",2,5,-3
31245.0,2019-12-09,"(390.986, 645.5]",14,30,-16
31245.0,2019-12-09,"(645.5, 899.0]",3,4,-1
31245.0,2019-12-09,"(899.0, 1152.5]",5,13,-8
31245.0,2019-12-09,"(1152.5, 1406.0]",4,10,-6
31246.0,2019-12-09,"(473.037, 714.75]",5,10,-5
31246.0,2019-12-09,"(955.5, 1196.25]",8,2,6
31246.0,2019-12-09,"(1196.25, 1437.0]",4,17,-13
31247.0,2019-12-09,"(430.337, 596.75]",6,9,-3
31247.0,2019-12-09,"(596.75, 762.5]",1,1,0
31247.0,2019-12-09,"(928.25, 1094.0]",1,5,-4
31248.0,2019-12-09,"(387.101, 612.75]",10,15,-5
31248.0,2019-12-09,"(837.5, 1062.25]",4,6,-2
31248.0,2019-12-09,"(1062.25, 1287.0]",3,5,-2
31249.0,2019-12-09,"(408.332, 576.0]",5,10,-5
31249.0,2019-12-09,"(910.0, 1077.0]",1,2,-1
31250.0,2019-12-09,"(416.008, 665.0]",13,16,-3
31250.0,2019-12-09,"(665.0, 913.0]",1,1,0
31250.0,2019-12-09,"(913.0, 1161.0]",2,14,-12
31250.0,2019-12-09,"(1161.0, 1409.0]",2,5,-3
31251.0,2019-12-09,"(363.956, 626.0]",15,26,-11
31251.0,2019-12-09,"(626.0, 887.0]",3,4,-1
31251.0,2019-12-09,"(887.0, 1148.0]",7,16,-9
31251.0,2019-12-09,"(1148.0, 1409.0]",7,11,-4
31252.0,2019-12-09,"(430.146, 644.5]",9,9,0
31252.0,2019-12-09,"(1071.5, 1285.0]",1,5,-4
31253.0,2019-12-09,"(409.168, 618.0]",17,19,-2
31253.0,2019-12-09,"(618.0, 826.0]",1,1,0
31253.0,2019-12-09,"(826.0, 1034.0]",2,9,-7
31253.0,2019-12-09,"(1034.0, 1242.0]",3,16,-13
31254.0,2019-12-09,"(427.085, 656.75]",20,21,-1
31254.0,2019-12-09,"(656.75, 885.5]",2,3,-1
31254.0,2019-12-09,"(1114.25, 1343.0]",2,14,-12
31255.0,2019-12-09,"(370.099, 596.25]",16,24,-8
31255.0,2019-12-09,"(596.25, 821.5]",3,4,-1
31255.0,2019-12-09,"(821.5, 1046.75]",3,9,-6
31255.0,2019-12-09,"(1046.75, 1272.0]",4,7,-3
31256.0,2019-12-09,"(269.008, 518.0]",6,6,0
31256.0,2019-12-09,"(518.0, 766.0]",2,6,-4
31256.0,2019-12-09,"(766.0, 1014.0]",1,2,-1
31256.0,2019-12-09,"(1014.0, 1262.0]",1,10,-9
31257.0,2019-12-09,"(34.622, 380.5]",1,2,-1
31257.0,2019-12-09,"(380.5, 725.0]",12,22,-10
31257.0,2019-12-09,"(725.0, 1069.5]",6,14,-8
31257.0,2019-12-09,"(1069.5, 1414.0]",4,20,-16
31258.0,2019-12-09,"(508.928, 527.0]",1,2,-1
31258.0,2019-12-09,"(545.0, 563.0]",1,1,0
31259.0,2019-12-09,"(454.283, 634.25]",5,5,0
31259.0,2019-12-09,"(813.5, 992.75]",1,2,-1
31260.0,2019-12-09,"(375.03, 618.5]",15,20,-5
31260.0,2019-12-09,"(861.0, 1103.5]",2,1,1
31260.0,2019-12-09,"(1103.5, 1346.0]",2,9,-7
31261.0,2019-12-09,"(408.35, 571.5]",11,12,-1
31262.0,2019-12-09,"(448.156, 660.0]",8,8,0
31262.0,2019-12-09,"(871.0, 1082.0]",1,3,-2
31262.0,2019-12-09,"(1082.0, 1293.0]",1,9,-8
31263.0,2019-12-09,"(314.95, 578.5]",26,35,-9
31263.0,2019-12-09,"(578.5, 841.0]",1,4,-3
31263.0,2019-12-09,"(841.0, 1103.5]",6,16,-10
31263.0,2019-12-09,"(1103.5, 1366.0]",2,6,-4
31264.0,2019-12-09,"(453.063, 688.25]",13,19,-6
31264.0,2019-12-09,"(688.25, 922.5]",1,1,0
31264.0,2019-12-09,"(922.5, 1156.75]",3,11,-8
31264.0,2019-12-09,"(1156.75, 1391.0]",2,4,-2
31265.0,2019-12-09,"(6.657, 343.75]",1,1,0
31265.0,2019-12-09,"(343.75, 679.5]",10,27,-17
31265.0,2019-12-09,"(679.5, 1015.25]",7,12,-5
31265.0,2019-12-09,"(1015.25, 1351.0]",11,20,-9
31266.0,2019-12-09,"(98.691, 427.25]",1,5,-4
31266.0,2019-12-09,"(427.25, 754.5]",3,18,-15
31266.0,2019-12-09,"(754.5, 1081.75]",10,15,-5
31266.0,2019-12-09,"(1081.75, 1409.0]",13,23,-10
31267.0,2019-12-09,"(422.009, 670.75]",23,38,-15
31267.0,2019-12-09,"(670.75, 918.5]",7,12,-5
31267.0,2019-12-09,"(918.5, 1166.25]",14,28,-14
31267.0,2019-12-09,"(1166.25, 1414.0]",4,8,-4
31268.0,2019-12-09,"(366.929, 635.75]",9,32,-23
31268.0,2019-12-09,"(635.75, 903.5]",3,3,0
31268.0,2019-12-09,"(903.5, 1171.25]",15,22,-7
31268.0,2019-12-09,"(1171.25, 1439.0]",6,9,-3
31269.0,2019-12-09,"(406.104, 631.0]",4,8,-4
31269.0,2019-12-09,"(855.0, 1079.0]",1,6,-5
31269.0,2019-12-09,"(1079.0, 1303.0]",3,10,-7
31270.0,2019-12-09,"(389.992, 643.0]",16,18,-2
31270.0,2019-12-09,"(895.0, 1147.0]",3,2,1
31270.0,2019-12-09,"(1147.0, 1399.0]",2,12,-10
31271.0,2019-12-09,"(382.173, 589.75]",12,12,0
31271.0,2019-12-09,"(589.75, 796.5]",2,3,-1
31271.0,2019-12-09,"(796.5, 1003.25]",1,1,0
31271.0,2019-12-09,"(1003.25, 1210.0]",3,8,-5
31272.0,2019-12-09,"(23.851, 312.25]",1,2,-1
31272.0,2019-12-09,"(312.25, 599.5]",13,14,-1
31272.0,2019-12-09,"(599.5, 886.75]",2,2,0
31272.0,2019-12-09,"(886.75, 1174.0]",4,16,-12
31273.0,2019-12-09,"(886.0, 1064.5]",1,2,-1
31273.0,2019-12-09,"(1064.5, 1243.0]",3,1,2
31274.0,2019-12-09,"(443.078, 674.5]",10,14,-4
31274.0,2019-12-09,"(674.5, 905.0]",4,5,-1
31274.0,2019-12-09,"(905.0, 1135.5]",5,8,-3
31274.0,2019-12-09,"(1135.5, 1366.0]",1,5,-4
31275.0,2019-12-09,"(310.878, 592.5]",12,22,-10
31275.0,2019-12-09,"(592.5, 873.0]",5,9,-4
31275.0,2019-12-09,"(873.0, 1153.5]",10,24,-14
31276.0,2019-12-09,"(45.627, 390.25]",1,1,0
31276.0,2019-12-09,"(390.25, 733.5]",27,29,-2
31276.0,2019-12-09,"(733.5, 1076.75]",4,9,-5
31276.0,2019-12-09,"(1076.75, 1420.0]",1,14,-13
31277.0,2019-12-09,"(442.135, 659.25]",26,32,-6
31277.0,2019-12-09,"(659.25, 875.5]",1,4,-3
31277.0,2019-12-09,"(875.5, 1091.75]",2,20,-18
31277.0,2019-12-09,"(1091.75, 1308.0]",4,9,-5
31278.0,2019-12-09,"(425.121, 645.75]",11,29,-18
31278.0,2019-12-09,"(865.5, 1085.25]",5,1,4
31278.0,2019-12-09,"(1085.25, 1305.0]",11,8,3
31279.0,2019-12-09,"(425.116, 647.0]",17,18,-1
31279.0,2019-12-09,"(868.0, 1089.0]",3,1,2
31279.0,2019-12-09,"(1089.0, 1310.0]",1,13,-12
31280.0,2019-12-09,"(341.994, 594.5]",3,13,-10
31280.0,2019-12-09,"(594.5, 846.0]",1,2,-1
31280.0,2019-12-09,"(846.0, 1097.5]",8,9,-1
31280.0,2019-12-09,"(1097.5, 1349.0]",4,8,-4
,,,,1.0,
,,,,1.0,
,,,,1.0,
,,,,1.0,
31002.0,2019-12-10,"(261.218, 457.5]",2,2,0
31002.0,2019-12-10,"(457.5, 653.0]",3,6,-3
31002.0,2019-12-10,"(848.5, 1044.0]",2,1,1
31003.0,2019-12-10,"(377.195, 579.25]",4,7,-3
31003.0,2019-12-10,"(579.25, 780.5]",1,1,0
31003.0,2019-12-10,"(780.5, 981.75]",4,8,-4
31003.0,2019-12-10,"(981.75, 1183.0]",1,3,-2
31004.0,2019-12-10,"(928.25, 1077.0]",1,2,-1
31005.0,2019-12-10,"(438.238, 629.5]",6,7,-1
31005.0,2019-12-10,"(820.0, 1010.5]",2,1,1
,,,,2.0,
31007.0,2019-12-10,"(395.993, 648.75]",8,25,-17
31007.0,2019-12-10,"(648.75, 900.5]",3,4,-1
31007.0,2019-12-10,"(900.5, 1152.25]",3,8,-5
31007.0,2019-12-10,"(1152.25, 1404.0]",1,5,-4
31009.0,2019-12-10,"(465.471, 598.25]",7,7,0
31010.0,2019-12-10,"(532.122, 752.5]",1,1,0
31010.0,2019-12-10,"(752.5, 972.0]",1,1,0
31010.0,2019-12-10,"(1191.5, 1411.0]",2,3,-1
31011.0,2019-12-10,"(376.281, 556.75]",4,5,-1
31011.0,2019-12-10,"(556.75, 736.5]",3,5,-2
31011.0,2019-12-10,"(916.25, 1096.0]",2,1,1
31012.0,2019-12-10,"(382.263, 567.25]",6,7,-1
31012.0,2019-12-10,"(567.25, 751.5]",2,2,0
31013.0,2019-12-10,"(563.5, 732.0]",1,2,-1
31013.0,2019-12-10,"(900.5, 1069.0]",3,2,1
31014.0,2019-12-10,"(198.776, 506.0]",15,15,0
31014.0,2019-12-10,"(506.0, 812.0]",23,30,-7
31014.0,2019-12-10,"(812.0, 1118.0]",4,8,-4
31014.0,2019-12-10,"(1118.0, 1424.0]",4,7,-3
31015.0,2019-12-10,"(370.182, 575.5]",12,15,-3
31015.0,2019-12-10,"(575.5, 780.0]",1,1,0
31015.0,2019-12-10,"(780.0, 984.5]",1,2,-1
31015.0,2019-12-10,"(984.5, 1189.0]",2,3,-1
31016.0,2019-12-10,"(441.28, 622.0]",4,6,-2
31016.0,2019-12-10,"(622.0, 802.0]",1,1,0
31016.0,2019-12-10,"(802.0, 982.0]",1,1,0
31016.0,2019-12-10,"(982.0, 1162.0]",2,5,-3
31017.0,2019-12-10,"(497.144, 712.0]",5,7,-2
31017.0,2019-12-10,"(712.0, 926.0]",2,5,-3
31017.0,2019-12-10,"(926.0, 1140.0]",1,5,-4
31018.0,2019-12-10,"(401.309, 574.75]",1,9,-8
31018.0,2019-12-10,"(574.75, 747.5]",2,2,0
31018.0,2019-12-10,"(747.5, 920.25]",1,2,-1
31018.0,2019-12-10,"(920.25, 1093.0]",2,2,0
31019.0,2019-12-10,"(821.5, 1000.25]",1,1,0
31020.0,2019-12-10,"(533.522, 653.5]",1,1,0
31021.0,2019-12-10,"(325.986, 580.5]",2,10,-8
31021.0,2019-12-10,"(580.5, 834.0]",1,3,-2
31021.0,2019-12-10,"(834.0, 1087.5]",2,2,0
31022.0,2019-12-10,"(443.333, 610.75]",2,7,-5
31022.0,2019-12-10,"(610.75, 777.5]",1,2,-1
31022.0,2019-12-10,"(777.5, 944.25]",3,3,0
31022.0,2019-12-10,"(944.25, 1111.0]",1,7,-6
31023.0,2019-12-10,"(403.199, 604.25]",2,5,-3
31023.0,2019-12-10,"(1004.75, 1205.0]",1,2,-1
31024.0,2019-12-10,"(310.025, 554.75]",2,4,-2
31024.0,2019-12-10,"(554.75, 798.5]",1,1,0
31025.0,2019-12-10,"(400.433, 542.75]",1,1,0
31026.0,2019-12-10,"(417.023, 662.25]",2,5,-3
31026.0,2019-12-10,"(906.5, 1150.75]",1,1,0
31027.0,2019-12-10,"(1077.75, 1242.0]",2,2,0
31028.0,2019-12-10,"(489.365, 648.75]",1,2,-1
31028.0,2019-12-10,"(966.25, 1125.0]",1,3,-2
31029.0,2019-12-10,"(730.0, 958.0]",1,5,-4
31029.0,2019-12-10,"(1186.0, 1414.0]",4,3,1
31030.0,2019-12-10,"(320.209, 518.75]",1,5,-4
31030.0,2019-12-10,"(914.25, 1112.0]",5,3,2
31031.0,2019-12-10,"(658.5, 876.0]",1,1,0
31031.0,2019-12-10,"(876.0, 1093.5]",1,2,-1
31031.0,2019-12-10,"(1093.5, 1311.0]",2,1,1
31032.0,2019-12-10,"(870.0, 1018.0]",1,1,0
,,,,1.0,
,,,,1.0,
31034.0,2019-12-10,"(531.434, 673.5]",2,3,-1
31034.0,2019-12-10,"(673.5, 815.0]",1,2,-1
31035.0,2019-12-10,"(729.5, 850.75]",1,3,-2
31035.0,2019-12-10,"(850.75, 972.0]",1,3,-2
31036.0,2019-12-10,"(949.75, 1122.0]",3,3,0
31037.0,2019-12-10,"(419.044, 659.0]",12,16,-4
31037.0,2019-12-10,"(659.0, 898.0]",1,2,-1
31037.0,2019-12-10,"(898.0, 1137.0]",1,10,-9
31037.0,2019-12-10,"(1137.0, 1376.0]",1,4,-3
31038.0,2019-12-10,"(620.427, 764.25]",1,2,-1
31038.0,2019-12-10,"(907.5, 1050.75]",1,1,0
31039.0,2019-12-10,"(408.227, 602.25]",2,2,0
31039.0,2019-12-10,"(795.5, 988.75]",1,1,0
31040.0,2019-12-10,"(456.21, 654.5]",2,2,0
31041.0,2019-12-10,"(607.475, 739.25]",1,1,0
31041.0,2019-12-10,"(1001.75, 1133.0]",2,3,-1
31042.0,2019-12-10,"(440.332, 608.0]",9,9,0
31042.0,2019-12-10,"(775.0, 942.0]",1,1,0
31042.0,2019-12-10,"(942.0, 1109.0]",1,2,-1
31043.0,2019-12-10,"(401.243, 591.25]",1,3,-2
31043.0,2019-12-10,"(591.25, 780.5]",1,1,0
31043.0,2019-12-10,"(969.75, 1159.0]",2,5,-3
31044.0,2019-12-10,"(478.233, 670.75]",3,4,-1
31044.0,2019-12-10,"(1054.25, 1246.0]",2,4,-2
31045.0,2019-12-10,"(496.363, 656.25]",1,1,0
31045.0,2019-12-10,"(974.75, 1134.0]",1,1,0
31046.0,2019-12-10,"(451.5, 478.75]",1,1,0
31047.0,2019-12-10,"(356.14, 572.0]",10,18,-8
31047.0,2019-12-10,"(572.0, 787.0]",2,6,-4
31047.0,2019-12-10,"(1002.0, 1217.0]",5,2,3
31048.0,2019-12-10,"(476.258, 662.5]",3,4,-1
31049.0,2019-12-10,"(406.5, 542.0]",1,1,0
,,,,1.0,
,,,,1.0,
,,,,3.0,
31051.0,2019-12-10,"(662.0, 887.0]",1,5,-4
31051.0,2019-12-10,"(887.0, 1112.0]",2,2,0
31051.0,2019-12-10,"(1112.0, 1337.0]",4,3,1
31052.0,2019-12-10,"(1113.25, 1165.0]",1,1,0
31053.0,2019-12-10,"(105.837, 397.75]",2,4,-2
31053.0,2019-12-10,"(979.25, 1270.0]",1,2,-1
,,,,2.0,
,,,,1.0,
,,,,2.0,
31056.0,2019-12-10,"(152.045, 391.75]",1,1,0
31056.0,2019-12-10,"(869.25, 1108.0]",1,1,0
31057.0,2019-12-10,"(567.5, 577.0]",1,1,0
31058.0,2019-12-10,"(958.5, 1278.0]",1,1,0
,,,,2.0,
,,,,2.0,
,,,,1.0,
31061.0,2019-12-10,"(516.25, 518.0]",1,1,0
31062.0,2019-12-10,"(958.951, 971.25]",1,2,-1
31062.0,2019-12-10,"(995.75, 1008.0]",1,1,0
31063.0,2019-12-10,"(518.0, 777.0]",2,1,1
31063.0,2019-12-10,"(777.0, 1036.0]",2,2,0
31064.0,2019-12-10,"(442.402, 592.5]",4,8,-4
31064.0,2019-12-10,"(891.5, 1041.0]",1,2,-1
31065.0,2019-12-10,"(95.146, 309.5]",2,4,-2
31065.0,2019-12-10,"(309.5, 523.0]",1,4,-3
31065.0,2019-12-10,"(736.5, 950.0]",1,1,0
,,,,1.0,
,,,,1.0,
,,,,1.0,
31067.0,2019-12-10,"(441.074, 673.5]",2,4,-2
31067.0,2019-12-10,"(905.0, 1136.5]",1,1,0
31067.0,2019-12-10,"(1136.5, 1368.0]",1,2,-1
31068.0,2019-12-10,"(1075.0, 1079.0]",1,1,0
31068.0,2019-12-10,"(1083.0, 1087.0]",1,1,0
31069.0,2019-12-10,"(426.084, 656.0]",1,5,-4
31069.0,2019-12-10,"(885.0, 1114.0]",1,1,0
31069.0,2019-12-10,"(1114.0, 1343.0]",2,2,0
31070.0,2019-12-10,"(975.0, 1187.5]",2,1,1
31070.0,2019-12-10,"(1187.5, 1400.0]",1,2,-1
31071.0,2019-12-10,"(618.5, 821.0]",2,4,-2
31071.0,2019-12-10,"(1023.5, 1226.0]",2,3,-1
,,,,2.0,
31073.0,2019-12-10,"(343.635, 435.25]",1,1,0
31073.0,2019-12-10,"(435.25, 526.5]",1,1,0
31074.0,2019-12-10,"(434.051, 672.25]",1,2,-1
31074.0,2019-12-10,"(1146.75, 1384.0]",1,1,0
31075.0,2019-12-10,"(690.75, 742.0]",2,1,1
,,,,1.0,
,,,,1.0,
31077.0,2019-12-10,"(108.014, 355.5]",1,1,0
31077.0,2019-12-10,"(848.5, 1095.0]",2,3,-1
31078.0,2019-12-10,"(495.553, 607.75]",2,2,0
31079.0,2019-12-10,"(-0.348, 338.0]",1,1,0
31079.0,2019-12-10,"(338.0, 675.0]",1,7,-6
31079.0,2019-12-10,"(675.0, 1012.0]",1,2,-1
31079.0,2019-12-10,"(1012.0, 1349.0]",4,4,0
31080.0,2019-12-10,"(897.0, 1148.0]",2,11,-9
31080.0,2019-12-10,"(1148.0, 1399.0]",3,3,0
31081.0,2019-12-10,"(478.383, 633.25]",1,1,0
,,,,1.0,
,,,,1.0,
31083.0,2019-12-10,"(822.25, 962.0]",2,1,1
31084.0,2019-12-10,"(549.538, 665.5]",3,3,0
31084.0,2019-12-10,"(665.5, 781.0]",3,3,0
31085.0,2019-12-10,"(401.325, 570.75]",2,4,-2
31085.0,2019-12-10,"(908.25, 1077.0]",1,1,0
31086.0,2019-12-10,"(423.187, 627.25]",1,2,-1
31086.0,2019-12-10,"(1033.75, 1237.0]",1,2,-1
31087.0,2019-12-10,"(957.0, 1131.0]",2,3,-1
31088.0,2019-12-10,"(586.75, 772.5]",1,2,-1
31088.0,2019-12-10,"(958.25, 1144.0]",4,1,3
31089.0,2019-12-10,"(411.122, 631.5]",8,10,-2
31089.0,2019-12-10,"(631.5, 851.0]",3,8,-5
31089.0,2019-12-10,"(851.0, 1070.5]",1,6,-5
31090.0,2019-12-10,"(914.75, 1050.0]",2,1,1
31091.0,2019-12-10,"(1012.0, 1204.0]",2,4,-2
31092.0,2019-12-10,"(842.0, 1030.0]",1,3,-2
31092.0,2019-12-10,"(1030.0, 1218.0]",3,1,2
,,,,1.0,
,,,,2.0,
,,,,2.0,
,,,,2.0,
31096.0,2019-12-10,"(1031.5, 1205.0]",1,1,0
31097.0,2019-12-10,"(511.184, 716.0]",5,5,0
31097.0,2019-12-10,"(920.0, 1124.0]",1,1,0
31097.0,2019-12-10,"(1124.0, 1328.0]",1,3,-2
31098.0,2019-12-10,"(405.129, 623.75]",4,11,-7
31098.0,2019-12-10,"(841.5, 1059.25]",2,2,0
31098.0,2019-12-10,"(1059.25, 1277.0]",2,4,-2
31099.0,2019-12-10,"(537.5, 663.0]",1,2,-1
31099.0,2019-12-10,"(913.0, 1038.0]",1,1,0
31100.0,2019-12-10,"(353.991, 607.25]",10,13,-3
31100.0,2019-12-10,"(607.25, 859.5]",1,2,-1
31100.0,2019-12-10,"(1111.75, 1364.0]",3,5,-2
31101.0,2019-12-10,"(16.643, 357.25]",2,6,-4
31101.0,2019-12-10,"(357.25, 696.5]",14,51,-37
31101.0,2019-12-10,"(696.5, 1035.75]",11,23,-12
31101.0,2019-12-10,"(1035.75, 1375.0]",26,40,-14
31102.0,2019-12-10,"(24.788, 329.0]",1,1,0
31102.0,2019-12-10,"(329.0, 632.0]",1,25,-24
31102.0,2019-12-10,"(632.0, 935.0]",1,2,-1
31102.0,2019-12-10,"(935.0, 1238.0]",5,10,-5
31103.0,2019-12-10,"(347.076, 579.0]",2,30,-28
31103.0,2019-12-10,"(810.0, 1041.0]",3,8,-5
31103.0,2019-12-10,"(1041.0, 1272.0]",2,7,-5
31104.0,2019-12-10,"(327.068, 561.0]",1,11,-10
31104.0,2019-12-10,"(561.0, 794.0]",2,3,-1
31104.0,2019-12-10,"(794.0, 1027.0]",7,10,-3
31104.0,2019-12-10,"(1027.0, 1260.0]",13,19,-6
31105.0,2019-12-10,"(614.5, 830.0]",1,9,-8
31105.0,2019-12-10,"(830.0, 1045.5]",2,5,-3
31105.0,2019-12-10,"(1045.5, 1261.0]",5,5,0
31106.0,2019-12-10,"(447.046, 686.5]",1,7,-6
31106.0,2019-12-10,"(925.0, 1163.5]",2,4,-2
31106.0,2019-12-10,"(1163.5, 1402.0]",2,2,0
31107.0,2019-12-10,"(340.955, 603.25]",5,27,-22
31107.0,2019-12-10,"(603.25, 864.5]",1,6,-5
31107.0,2019-12-10,"(864.5, 1125.75]",14,27,-13
31107.0,2019-12-10,"(1125.75, 1387.0]",9,11,-2
31108.0,2019-12-10,"(345.947, 610.25]",7,30,-23
31108.0,2019-12-10,"(610.25, 873.5]",6,16,-10
31108.0,2019-12-10,"(873.5, 1136.75]",12,18,-6
31108.0,2019-12-10,"(1136.75, 1400.0]",7,10,-3
31109.0,2019-12-10,"(439.065, 673.75]",7,22,-15
31109.0,2019-12-10,"(673.75, 907.5]",7,12,-5
31109.0,2019-12-10,"(907.5, 1141.25]",11,17,-6
31109.0,2019-12-10,"(1141.25, 1375.0]",5,11,-6
31110.0,2019-12-10,"(33.632, 377.0]",2,4,-2
31110.0,2019-12-10,"(377.0, 719.0]",13,35,-22
31110.0,2019-12-10,"(719.0, 1061.0]",8,17,-9
31110.0,2019-12-10,"(1061.0, 1403.0]",14,22,-8
31111.0,2019-12-10,"(325.055, 562.25]",8,24,-16
31111.0,2019-12-10,"(562.25, 798.5]",3,10,-7
31111.0,2019-12-10,"(798.5, 1034.75]",4,4,0
31111.0,2019-12-10,"(1034.75, 1271.0]",8,10,-2
31112.0,2019-12-10,"(20.845, 310.75]",1,1,0
31112.0,2019-12-10,"(310.75, 599.5]",1,7,-6
31112.0,2019-12-10,"(599.5, 888.25]",1,2,-1
31112.0,2019-12-10,"(888.25, 1177.0]",5,9,-4
31113.0,2019-12-10,"(311.931, 580.25]",1,25,-24
31113.0,2019-12-10,"(580.25, 847.5]",1,2,-1
31113.0,2019-12-10,"(847.5, 1114.75]",4,6,-2
31113.0,2019-12-10,"(1114.75, 1382.0]",4,9,-5
31114.0,2019-12-10,"(-0.408, 353.0]",1,2,-1
31114.0,2019-12-10,"(353.0, 705.0]",3,26,-23
31114.0,2019-12-10,"(705.0, 1057.0]",7,17,-10
31114.0,2019-12-10,"(1057.0, 1409.0]",15,25,-10
31115.0,2019-12-10,"(32.627, 377.25]",1,1,0
31115.0,2019-12-10,"(377.25, 720.5]",1,19,-18
31115.0,2019-12-10,"(720.5, 1063.75]",5,10,-5
31115.0,2019-12-10,"(1063.75, 1407.0]",10,13,-3
31116.0,2019-12-10,"(316.003, 566.25]",7,28,-21
31116.0,2019-12-10,"(566.25, 815.5]",7,11,-4
31116.0,2019-12-10,"(815.5, 1064.75]",6,10,-4
31116.0,2019-12-10,"(1064.75, 1314.0]",14,16,-2
31117.0,2019-12-10,"(351.999, 603.25]",2,24,-22
31117.0,2019-12-10,"(603.25, 853.5]",2,4,-2
31117.0,2019-12-10,"(853.5, 1103.75]",6,14,-8
31117.0,2019-12-10,"(1103.75, 1354.0]",6,13,-7
31118.0,2019-12-10,"(348.0, 664.0]",2,1,1
31118.0,2019-12-10,"(980.0, 1296.0]",17,18,-1
31119.0,2019-12-10,"(37.61, 386.5]",3,9,-6
31119.0,2019-12-10,"(386.5, 734.0]",5,18,-13
31119.0,2019-12-10,"(734.0, 1081.5]",5,9,-4
31119.0,2019-12-10,"(1081.5, 1429.0]",15,25,-10
31120.0,2019-12-10,"(339.977, 596.75]",1,11,-10
31120.0,2019-12-10,"(596.75, 852.5]",2,4,-2
31120.0,2019-12-10,"(852.5, 1108.25]",4,6,-2
31120.0,2019-12-10,"(1108.25, 1364.0]",7,10,-3
31121.0,2019-12-10,"(361.25, 706.5]",18,1,17
31121.0,2019-12-10,"(706.5, 1051.75]",4,29,-25
31121.0,2019-12-10,"(1051.75, 1397.0]",5,5,0
31122.0,2019-12-10,"(315.967, 575.25]",2,17,-15
31122.0,2019-12-10,"(575.25, 833.5]",1,2,-1
31122.0,2019-12-10,"(833.5, 1091.75]",7,7,0
31122.0,2019-12-10,"(1091.75, 1350.0]",7,13,-6
31123.0,2019-12-10,"(365.965, 625.75]",2,27,-25
31123.0,2019-12-10,"(884.5, 1143.25]",3,3,0
31123.0,2019-12-10,"(1143.25, 1402.0]",4,5,-1
31124.0,2019-12-10,"(29.63, 373.5]",2,4,-2
31124.0,2019-12-10,"(373.5, 716.0]",17,43,-26
31124.0,2019-12-10,"(716.0, 1058.5]",12,26,-14
31124.0,2019-12-10,"(1058.5, 1401.0]",15,48,-33
31125.0,2019-12-10,"(225.841, 516.75]",2,21,-19
31125.0,2019-12-10,"(516.75, 806.5]",6,13,-7
31125.0,2019-12-10,"(806.5, 1096.25]",9,14,-5
31125.0,2019-12-10,"(1096.25, 1386.0]",17,21,-4
31126.0,2019-12-10,"(16.621, 362.75]",1,6,-5
31126.0,2019-12-10,"(362.75, 707.5]",3,24,-21
31126.0,2019-12-10,"(707.5, 1052.25]",7,21,-14
31126.0,2019-12-10,"(1052.25, 1397.0]",15,21,-6
,,,,2.0,
31128.0,2019-12-10,"(149.761, 460.75]",8,10,-2
31128.0,2019-12-10,"(460.75, 770.5]",25,34,-9
31128.0,2019-12-10,"(770.5, 1080.25]",9,14,-5
31128.0,2019-12-10,"(1080.25, 1390.0]",6,11,-5
31129.0,2019-12-10,"(348.5, 688.0]",14,1,13
31129.0,2019-12-10,"(688.0, 1027.5]",4,16,-12
31129.0,2019-12-10,"(1027.5, 1367.0]",3,6,-3
31130.0,2019-12-10,"(113.68, 445.0]",3,10,-7
31130.0,2019-12-10,"(445.0, 775.0]",8,21,-13
31130.0,2019-12-10,"(775.0, 1105.0]",5,11,-6
31130.0,2019-12-10,"(1105.0, 1435.0]",7,10,-3
31131.0,2019-12-10,"(644.5, 881.0]",1,11,-10
31131.0,2019-12-10,"(881.0, 1117.5]",2,1,1
31131.0,2019-12-10,"(1117.5, 1354.0]",3,4,-1
31200.0,2019-12-10,"(323.912, 597.0]",21,30,-9
31200.0,2019-12-10,"(597.0, 869.0]",14,23,-9
31200.0,2019-12-10,"(869.0, 1141.0]",13,32,-19
31200.0,2019-12-10,"(1141.0, 1413.0]",6,17,-11
31201.0,2019-12-10,"(296.948, 561.0]",19,44,-25
31201.0,2019-12-10,"(561.0, 824.0]",12,21,-9
31201.0,2019-12-10,"(824.0, 1087.0]",21,32,-11
31201.0,2019-12-10,"(1087.0, 1350.0]",13,34,-21
31202.0,2019-12-10,"(351.99, 605.5]",7,26,-19
31202.0,2019-12-10,"(605.5, 858.0]",8,14,-6
31202.0,2019-12-10,"(858.0, 1110.5]",18,26,-8
31202.0,2019-12-10,"(1110.5, 1363.0]",7,13,-6
31203.0,2019-12-10,"(10.635, 353.25]",2,2,0
31203.0,2019-12-10,"(353.25, 694.5]",11,30,-19
31203.0,2019-12-10,"(694.5, 1035.75]",14,33,-19
31203.0,2019-12-10,"(1035.75, 1377.0]",29,43,-14
31204.0,2019-12-10,"(58.671, 392.25]",1,2,-1
31204.0,2019-12-10,"(392.25, 724.5]",11,15,-4
31204.0,2019-12-10,"(724.5, 1056.75]",4,8,-4
31204.0,2019-12-10,"(1056.75, 1389.0]",4,8,-4
31205.0,2019-12-10,"(151.858, 438.5]",2,3,-1
31205.0,2019-12-10,"(438.5, 724.0]",46,51,-5
31205.0,2019-12-10,"(724.0, 1009.5]",16,24,-8
31205.0,2019-12-10,"(1009.5, 1295.0]",1,12,-11
31206.0,2019-12-10,"(404.385, 558.75]",8,9,-1
31206.0,2019-12-10,"(866.25, 1020.0]",3,1,2
31207.0,2019-12-10,"(990.75, 1206.0]",3,6,-3
31208.0,2019-12-10,"(321.013, 568.75]",15,17,-2
31208.0,2019-12-10,"(568.75, 815.5]",1,2,-1
31208.0,2019-12-10,"(815.5, 1062.25]",1,11,-10
31208.0,2019-12-10,"(1062.25, 1309.0]",3,6,-3
31209.0,2019-12-10,"(483.118, 704.5]",6,8,-2
31209.0,2019-12-10,"(704.5, 925.0]",3,3,0
31209.0,2019-12-10,"(925.0, 1145.5]",2,3,-1
31209.0,2019-12-10,"(1145.5, 1366.0]",2,3,-1
31211.0,2019-12-10,"(393.069, 626.75]",9,11,-2
31211.0,2019-12-10,"(626.75, 859.5]",2,3,-1
31211.0,2019-12-10,"(1092.25, 1325.0]",1,3,-2
31212.0,2019-12-10,"(11.585, 366.75]",4,6,-2
31212.0,2019-12-10,"(366.75, 720.5]",29,44,-15
31212.0,2019-12-10,"(720.5, 1074.25]",16,27,-11
31212.0,2019-12-10,"(1074.25, 1428.0]",11,25,-14
31213.0,2019-12-10,"(364.25, 700.5]",32,2,30
31213.0,2019-12-10,"(700.5, 1036.75]",10,45,-35
31213.0,2019-12-10,"(1036.75, 1373.0]",10,23,-13
31214.0,2019-12-10,"(96.856, 384.0]",2,4,-2
31214.0,2019-12-10,"(384.0, 670.0]",5,26,-21
31214.0,2019-12-10,"(670.0, 956.0]",11,19,-8
31214.0,2019-12-10,"(956.0, 1242.0]",20,33,-13
31215.0,2019-12-10,"(398.012, 646.0]",20,22,-2
31215.0,2019-12-10,"(646.0, 893.0]",8,11,-3
31215.0,2019-12-10,"(893.0, 1140.0]",3,10,-7
31216.0,2019-12-10,"(429.211, 627.25]",21,21,0
31216.0,2019-12-10,"(627.25, 824.5]",3,6,-3
31216.0,2019-12-10,"(824.5, 1021.75]",1,4,-3
31216.0,2019-12-10,"(1021.75, 1219.0]",4,19,-15
31217.0,2019-12-10,"(376.309, 549.75]",15,17,-2
31217.0,2019-12-10,"(549.75, 722.5]",3,4,-1
31217.0,2019-12-10,"(895.25, 1068.0]",1,2,-1
31218.0,2019-12-10,"(324.188, 528.0]",12,24,-12
31218.0,2019-12-10,"(528.0, 731.0]",6,9,-3
31218.0,2019-12-10,"(731.0, 934.0]",3,6,-3
31218.0,2019-12-10,"(934.0, 1137.0]",5,9,-4
31219.0,2019-12-10,"(360.229, 553.75]",10,10,0
31219.0,2019-12-10,"(553.75, 746.5]",7,9,-2
31219.0,2019-12-10,"(746.5, 939.25]",4,4,0
31219.0,2019-12-10,"(939.25, 1132.0]",2,13,-11
31220.0,2019-12-10,"(360.252, 548.0]",15,20,-5
31220.0,2019-12-10,"(548.0, 735.0]",5,5,0
31220.0,2019-12-10,"(735.0, 922.0]",1,4,-3
31221.0,2019-12-10,"(378.02, 624.0]",31,35,-4
31221.0,2019-12-10,"(624.0, 869.0]",7,11,-4
31221.0,2019-12-10,"(869.0, 1114.0]",11,26,-15
31221.0,2019-12-10,"(1114.0, 1359.0]",2,8,-6
31222.0,2019-12-10,"(324.157, 535.75]",8,10,-2
31222.0,2019-12-10,"(535.75, 746.5]",8,9,-1
31222.0,2019-12-10,"(957.25, 1168.0]",5,18,-13
31223.0,2019-12-10,"(29.606, 379.5]",3,4,-1
31223.0,2019-12-10,"(379.5, 728.0]",12,43,-31
31223.0,2019-12-10,"(728.0, 1076.5]",8,17,-9
31223.0,2019-12-10,"(1076.5, 1425.0]",7,12,-5
31224.0,2019-12-10,"(380.043, 620.25]",19,21,-2
31224.0,2019-12-10,"(620.25, 859.5]",5,8,-3
31225.0,2019-12-10,"(426.203, 626.25]",5,8,-3
31225.0,2019-12-10,"(626.25, 825.5]",3,6,-3
31225.0,2019-12-10,"(825.5, 1024.75]",3,4,-1
31225.0,2019-12-10,"(1024.75, 1224.0]",3,9,-6
31226.0,2019-12-10,"(316.062, 551.5]",3,7,-4
31226.0,2019-12-10,"(551.5, 786.0]",3,5,-2
31226.0,2019-12-10,"(1020.5, 1255.0]",4,2,2
31227.0,2019-12-10,"(433.101, 658.75]",24,26,-2
31227.0,2019-12-10,"(658.75, 883.5]",5,11,-6
31227.0,2019-12-10,"(883.5, 1108.25]",5,12,-7
31227.0,2019-12-10,"(1108.25, 1333.0]",2,8,-6
31228.0,2019-12-10,"(-0.425, 357.25]",2,2,0
31228.0,2019-12-10,"(357.25, 713.5]",30,45,-15
31228.0,2019-12-10,"(713.5, 1069.75]",19,35,-16
31228.0,2019-12-10,"(1069.75, 1426.0]",9,21,-12
31229.0,2019-12-10,"(289.878, 571.5]",11,42,-31
31229.0,2019-12-10,"(571.5, 852.0]",9,27,-18
31229.0,2019-12-10,"(852.0, 1132.5]",15,23,-8
31229.0,2019-12-10,"(1132.5, 1413.0]",11,23,-12
31230.0,2019-12-10,"(328.912, 602.0]",51,64,-13
31230.0,2019-12-10,"(602.0, 874.0]",5,10,-5
31230.0,2019-12-10,"(874.0, 1146.0]",15,46,-31
31230.0,2019-12-10,"(1146.0, 1418.0]",2,8,-6
31231.0,2019-12-10,"(324.909, 598.75]",23,26,-3
31231.0,2019-12-10,"(598.75, 871.5]",6,11,-5
31231.0,2019-12-10,"(871.5, 1144.25]",9,18,-9
31232.0,2019-12-10,"(294.938, 561.5]",18,25,-7
31232.0,2019-12-10,"(561.5, 827.0]",12,14,-2
31232.0,2019-12-10,"(827.0, 1092.5]",8,16,-8
31232.0,2019-12-10,"(1092.5, 1358.0]",3,7,-4
31233.0,2019-12-10,"(383.75, 704.5]",40,1,39
31233.0,2019-12-10,"(704.5, 1025.25]",13,47,-34
31233.0,2019-12-10,"(1025.25, 1346.0]",5,18,-13
31234.0,2019-12-10,"(371.002, 621.5]",26,43,-17
31234.0,2019-12-10,"(621.5, 871.0]",5,11,-6
31234.0,2019-12-10,"(871.0, 1120.5]",9,18,-9
31234.0,2019-12-10,"(1120.5, 1370.0]",4,10,-6
31235.0,2019-12-10,"(505.44, 646.0]",3,3,0
31235.0,2019-12-10,"(926.0, 1066.0]",1,4,-3
31236.0,2019-12-10,"(360.0, 713.0]",18,4,14
31236.0,2019-12-10,"(713.0, 1066.0]",6,22,-16
31236.0,2019-12-10,"(1066.0, 1419.0]",2,19,-17
31237.0,2019-12-10,"(88.715, 411.25]",2,2,0
31237.0,2019-12-10,"(411.25, 732.5]",8,24,-16
31237.0,2019-12-10,"(732.5, 1053.75]",6,10,-4
31237.0,2019-12-10,"(1053.75, 1375.0]",5,9,-4
31238.0,2019-12-10,"(85.843, 376.25]",1,1,0
31238.0,2019-12-10,"(376.25, 665.5]",16,19,-3
31238.0,2019-12-10,"(665.5, 954.75]",5,10,-5
31238.0,2019-12-10,"(954.75, 1244.0]",4,20,-16
31239.0,2019-12-10,"(34.814, 332.5]",2,2,0
31239.0,2019-12-10,"(332.5, 629.0]",33,38,-5
31239.0,2019-12-10,"(629.0, 925.5]",13,20,-7
31239.0,2019-12-10,"(925.5, 1222.0]",6,21,-15
31240.0,2019-12-10,"(474.762, 475.0]",1,2,-1
31241.0,2019-12-10,"(10.673, 343.75]",2,3,-1
31241.0,2019-12-10,"(343.75, 675.5]",27,51,-24
31241.0,2019-12-10,"(675.5, 1007.25]",8,21,-13
31241.0,2019-12-10,"(1007.25, 1339.0]",16,27,-11
31242.0,2019-12-10,"(398.18, 604.0]",42,45,-3
31242.0,2019-12-10,"(604.0, 809.0]",12,20,-8
31242.0,2019-12-10,"(809.0, 1014.0]",3,5,-2
31242.0,2019-12-10,"(1014.0, 1219.0]",1,12,-11
31243.0,2019-12-10,"(375.259, 561.25]",23,30,-7
31243.0,2019-12-10,"(561.25, 746.5]",4,4,0
31243.0,2019-12-10,"(746.5, 931.75]",2,3,-1
31243.0,2019-12-10,"(931.75, 1117.0]",7,21,-14
31244.0,2019-12-10,"(14.67, 348.5]",1,2,-1
31244.0,2019-12-10,"(348.5, 681.0]",19,32,-13
31244.0,2019-12-10,"(681.0, 1013.5]",4,10,-6
31244.0,2019-12-10,"(1013.5, 1346.0]",3,7,-4
31245.0,2019-12-10,"(415.982, 671.5]",16,35,-19
31245.0,2019-12-10,"(671.5, 926.0]",4,9,-5
31245.0,2019-12-10,"(926.0, 1180.5]",9,18,-9
31245.0,2019-12-10,"(1180.5, 1435.0]",6,9,-3
31246.0,2019-12-10,"(-0.357, 340.25]",1,2,-1
31246.0,2019-12-10,"(340.25, 679.5]",14,22,-8
31246.0,2019-12-10,"(679.5, 1018.75]",10,19,-9
31246.0,2019-12-10,"(1018.75, 1358.0]",14,27,-13
31247.0,2019-12-10,"(236.133, 453.75]",3,5,-2
31247.0,2019-12-10,"(453.75, 670.5]",5,8,-3
31247.0,2019-12-10,"(670.5, 887.25]",12,17,-5
31247.0,2019-12-10,"(887.25, 1104.0]",7,14,-7
31248.0,2019-12-10,"(386.238, 577.5]",11,17,-6
31248.0,2019-12-10,"(577.5, 768.0]",2,4,-2
31248.0,2019-12-10,"(768.0, 958.5]",3,10,-7
31248.0,2019-12-10,"(958.5, 1149.0]",6,9,-3
31249.0,2019-12-10,"(356.239, 547.25]",6,11,-5
31249.0,2019-12-10,"(547.25, 737.5]",3,5,-2
31249.0,2019-12-10,"(737.5, 927.75]",1,2,-1
31249.0,2019-12-10,"(927.75, 1118.0]",5,11,-6
31250.0,2019-12-10,"(355.994, 608.5]",13,15,-2
31250.0,2019-12-10,"(608.5, 860.0]",5,8,-3
31250.0,2019-12-10,"(860.0, 1111.5]",4,10,-6
31250.0,2019-12-10,"(1111.5, 1363.0]",3,14,-11
31251.0,2019-12-10,"(155.759, 467.25]",4,11,-7
31251.0,2019-12-10,"(467.25, 777.5]",21,36,-15
31251.0,2019-12-10,"(777.5, 1087.75]",8,19,-11
31251.0,2019-12-10,"(1087.75, 1398.0]",6,10,-4
31252.0,2019-12-10,"(327.115, 549.25]",15,16,-1
31252.0,2019-12-10,"(549.25, 770.5]",4,9,-5
31252.0,2019-12-10,"(770.5, 991.75]",5,9,-4
31252.0,2019-12-10,"(991.75, 1213.0]",2,16,-14
31253.0,2019-12-10,"(382.095, 609.25]",21,22,-1
31253.0,2019-12-10,"(609.25, 835.5]",2,7,-5
31253.0,2019-12-10,"(835.5, 1061.75]",4,11,-7
31253.0,2019-12-10,"(1061.75, 1288.0]",3,8,-5
31254.0,2019-12-10,"(349.058, 585.5]",26,28,-2
31254.0,2019-12-10,"(585.5, 821.0]",7,10,-3
31254.0,2019-12-10,"(1056.5, 1292.0]",5,14,-9
31255.0,2019-12-10,"(402.5, 717.0]",19,1,18
31255.0,2019-12-10,"(717.0, 1031.5]",5,29,-24
31255.0,2019-12-10,"(1031.5, 1346.0]",3,13,-10
31256.0,2019-12-10,"(269.947, 534.25]",10,10,0
31256.0,2019-12-10,"(797.5, 1060.75]",2,5,-3
31256.0,2019-12-10,"(1060.75, 1324.0]",3,8,-5
31257.0,2019-12-10,"(0.683, 331.25]",1,2,-1
31257.0,2019-12-10,"(331.25, 660.5]",23,34,-11
31257.0,2019-12-10,"(660.5, 989.75]",16,24,-8
31257.0,2019-12-10,"(989.75, 1319.0]",8,20,-12
31258.0,2019-12-10,"(478.386, 632.5]",3,6,-3
31258.0,2019-12-10,"(786.0, 939.5]",3,7,-4
31258.0,2019-12-10,"(939.5, 1093.0]",3,5,-2
31259.0,2019-12-10,"(325.75, 601.5]",9,1,8
31259.0,2019-12-10,"(601.5, 877.25]",4,9,-5
31259.0,2019-12-10,"(877.25, 1153.0]",2,5,-3
31260.0,2019-12-10,"(85.703, 411.25]",2,2,0
31260.0,2019-12-10,"(411.25, 735.5]",16,23,-7
31260.0,2019-12-10,"(735.5, 1059.75]",3,6,-3
31260.0,2019-12-10,"(1059.75, 1384.0]",2,8,-6
31261.0,2019-12-10,"(397.354, 559.5]",11,12,-1
31262.0,2019-12-10,"(131.827, 426.25]",2,4,-2
31262.0,2019-12-10,"(426.25, 719.5]",10,10,0
31262.0,2019-12-10,"(719.5, 1012.75]",1,3,-2
31262.0,2019-12-10,"(1012.75, 1306.0]",3,16,-13
31263.0,2019-12-10,"(345.96, 607.0]",24,35,-11
31263.0,2019-12-10,"(607.0, 867.0]",7,11,-4
31263.0,2019-12-10,"(867.0, 1127.0]",11,27,-16
31263.0,2019-12-10,"(1127.0, 1387.0]",3,7,-4
31264.0,2019-12-10,"(369.14, 585.0]",15,23,-8
31264.0,2019-12-10,"(585.0, 800.0]",4,6,-2
31264.0,2019-12-10,"(800.0, 1015.0]",3,7,-4
31264.0,2019-12-10,"(1015.0, 1230.0]",5,12,-7
31265.0,2019-12-10,"(7.58, 364.0]",2,4,-2
31265.0,2019-12-10,"(364.0, 719.0]",17,36,-19
31265.0,2019-12-10,"(719.0, 1074.0]",15,25,-10
31265.0,2019-12-10,"(1074.0, 1429.0]",11,18,-7
31266.0,2019-12-10,"(163.918, 435.5]",3,13,-10
31266.0,2019-12-10,"(435.5, 706.0]",7,17,-10
31266.0,2019-12-10,"(706.0, 976.5]",8,13,-5
31266.0,2019-12-10,"(976.5, 1247.0]",20,34,-14
31267.0,2019-12-10,"(5.655, 343.25]",1,3,-2
31267.0,2019-12-10,"(343.25, 679.5]",27,50,-23
31267.0,2019-12-10,"(679.5, 1015.75]",10,22,-12
31267.0,2019-12-10,"(1015.75, 1352.0]",21,33,-12
31268.0,2019-12-10,"(333.979, 590.25]",18,45,-27
31268.0,2019-12-10,"(845.5, 1100.75]",9,5,4
31268.0,2019-12-10,"(1100.75, 1356.0]",12,17,-5
31269.0,2019-12-10,"(339.163, 549.25]",5,10,-5
31269.0,2019-12-10,"(549.25, 758.5]",3,8,-5
31269.0,2019-12-10,"(758.5, 967.75]",3,5,-2
31269.0,2019-12-10,"(967.75, 1177.0]",4,6,-2
31270.0,2019-12-10,"(328.944, 594.0]",20,30,-10
31270.0,2019-12-10,"(594.0, 858.0]",1,9,-8
31270.0,2019-12-10,"(858.0, 1122.0]",9,17,-8
31270.0,2019-12-10,"(1122.0, 1386.0]",2,5,-3
31271.0,2019-12-10,"(445.266, 629.5]",14,15,-1
31271.0,2019-12-10,"(629.5, 813.0]",2,2,0
31271.0,2019-12-10,"(813.0, 996.5]",5,7,-2
31272.0,2019-12-10,"(326.0, 591.0]",26,1,25
31272.0,2019-12-10,"(591.0, 856.0]",7,26,-19
31272.0,2019-12-10,"(856.0, 1121.0]",5,10,-5
31273.0,2019-12-10,"(402.438, 543.5]",6,12,-6
31273.0,2019-12-10,"(824.5, 965.0]",3,3,0
31274.0,2019-12-10,"(359.25, 694.5]",16,1,15
31274.0,2019-12-10,"(694.5, 1029.75]",5,18,-13
31274.0,2019-12-10,"(1029.75, 1365.0]",4,11,-7
31275.0,2019-12-10,"(23.643, 364.25]",4,6,-2
31275.0,2019-12-10,"(364.25, 703.5]",16,24,-8
31275.0,2019-12-10,"(703.5, 1042.75]",5,15,-10
31275.0,2019-12-10,"(1042.75, 1382.0]",8,17,-9
31276.0,2019-12-10,"(439.212, 637.0]",34,36,-2
31276.0,2019-12-10,"(637.0, 834.0]",5,10,-5
31276.0,2019-12-10,"(834.0, 1031.0]",4,11,-7
31276.0,2019-12-10,"(1031.0, 1228.0]",1,15,-14
31277.0,2019-12-10,"(426.015, 673.25]",31,32,-1
31277.0,2019-12-10,"(673.25, 919.5]",6,9,-3
31277.0,2019-12-10,"(919.5, 1165.75]",12,32,-20
31278.0,2019-12-10,"(340.981, 596.75]",10,36,-26
31278.0,2019-12-10,"(596.75, 851.5]",2,9,-7
31278.0,2019-12-10,"(851.5, 1106.25]",8,10,-2
31278.0,2019-12-10,"(1106.25, 1361.0]",10,16,-6
31279.0,2019-12-10,"(453.143, 668.25]",17,18,-1
31279.0,2019-12-10,"(668.25, 882.5]",2,5,-3
31279.0,2019-12-10,"(882.5, 1096.75]",2,15,-13
31280.0,2019-12-10,"(372.0, 623.0]",7,24,-17
31280.0,2019-12-10,"(623.0, 873.0]",2,3,-1
31280.0,2019-12-10,"(873.0, 1123.0]",2,5,-3
31280.0,2019-12-10,"(1123.0, 1373.0]",5,6,-1
31000.0,2019-12-11,"(855.0, 1140.0]",1,1,0
31001.0,2019-12-11,"(814.5, 1086.0]",2,1,1
31002.0,2019-12-11,"(532.562, 642.5]",3,5,-2
31002.0,2019-12-11,"(752.0, 861.5]",2,3,-1
31002.0,2019-12-11,"(861.5, 971.0]",2,4,-2
31003.0,2019-12-11,"(402.065, 636.75]",4,8,-4
31003.0,2019-12-11,"(870.5, 1104.25]",2,1,1
31003.0,2019-12-11,"(1104.25, 1338.0]",3,4,-1
31004.0,2019-12-11,"(903.25, 1045.0]",1,3,-2
31005.0,2019-12-11,"(426.291, 604.25]",5,6,-1
31005.0,2019-12-11,"(958.75, 1136.0]",3,8,-5
31006.0,2019-12-11,"(676.292, 854.0]",2,2,0
31006.0,2019-12-11,"(854.0, 1031.0]",2,3,-1
31006.0,2019-12-11,"(1031.0, 1208.0]",1,4,-3
31006.0,2019-12-11,"(1208.0, 1385.0]",1,1,0
31007.0,2019-12-11,"(376.022, 621.5]",6,15,-9
31007.0,2019-12-11,"(621.5, 866.0]",5,8,-3
31007.0,2019-12-11,"(866.0, 1110.5]",10,19,-9
31007.0,2019-12-11,"(1110.5, 1355.0]",1,7,-6
31009.0,2019-12-11,"(379.96, 641.0]",4,4,0
31009.0,2019-12-11,"(1161.0, 1421.0]",1,2,-1
31010.0,2019-12-11,"(547.123, 767.25]",1,3,-2
31010.0,2019-12-11,"(767.25, 986.5]",1,3,-2
31010.0,2019-12-11,"(986.5, 1205.75]",1,3,-2
31010.0,2019-12-11,"(1205.75, 1425.0]",1,1,0
31011.0,2019-12-11,"(493.132, 711.0]",3,3,0
31011.0,2019-12-11,"(928.0, 1145.0]",1,2,-1
31011.0,2019-12-11,"(1145.0, 1362.0]",1,4,-3
31012.0,2019-12-11,"(98.019, 344.25]",1,1,0
31012.0,2019-12-11,"(344.25, 589.5]",3,4,-1
31012.0,2019-12-11,"(589.5, 834.75]",1,2,-1
31013.0,2019-12-11,"(752.0, 968.0]",1,1,0
31013.0,2019-12-11,"(968.0, 1184.0]",2,1,1
31013.0,2019-12-11,"(1184.0, 1400.0]",1,2,-1
31014.0,2019-12-11,"(403.009, 651.75]",24,29,-5
31014.0,2019-12-11,"(651.75, 899.5]",9,13,-4
31014.0,2019-12-11,"(899.5, 1147.25]",6,17,-11
31014.0,2019-12-11,"(1147.25, 1395.0]",5,6,-1
31015.0,2019-12-11,"(306.003, 556.25]",7,9,-2
31015.0,2019-12-11,"(556.25, 805.5]",5,6,-1
31015.0,2019-12-11,"(805.5, 1054.75]",1,4,-3
31015.0,2019-12-11,"(1054.75, 1304.0]",1,4,-3
31016.0,2019-12-11,"(441.161, 651.75]",4,8,-4
31016.0,2019-12-11,"(651.75, 861.5]",3,3,0
31016.0,2019-12-11,"(861.5, 1071.25]",4,7,-3
31016.0,2019-12-11,"(1071.25, 1281.0]",3,6,-3
31017.0,2019-12-11,"(494.096, 721.0]",3,5,-2
31017.0,2019-12-11,"(947.0, 1173.0]",1,6,-5
31017.0,2019-12-11,"(1173.0, 1399.0]",1,3,-2
31018.0,2019-12-11,"(895.0, 1142.5]",4,5,-1
31018.0,2019-12-11,"(1142.5, 1390.0]",1,4,-3
31019.0,2019-12-11,"(868.25, 993.0]",1,2,-1
31020.0,2019-12-11,"(988.25, 1137.0]",2,3,-1
31021.0,2019-12-11,"(545.395, 697.25]",1,4,-3
31021.0,2019-12-11,"(848.5, 999.75]",2,5,-3
31022.0,2019-12-11,"(706.456, 843.0]",1,3,-2
31022.0,2019-12-11,"(843.0, 979.0]",2,3,-1
31022.0,2019-12-11,"(979.0, 1115.0]",3,5,-2
31022.0,2019-12-11,"(1115.0, 1251.0]",3,11,-8
31023.0,2019-12-11,"(448.065, 682.75]",3,3,0
31023.0,2019-12-11,"(916.5, 1150.25]",2,1,1
31023.0,2019-12-11,"(1150.25, 1384.0]",1,3,-2
31024.0,2019-12-11,"(494.219, 690.25]",1,4,-3
31024.0,2019-12-11,"(690.25, 885.5]",1,1,0
31024.0,2019-12-11,"(885.5, 1080.75]",2,6,-4
31025.0,2019-12-11,"(910.89, 938.5]",1,2,-1
31025.0,2019-12-11,"(993.5, 1021.0]",2,3,-1
31026.0,2019-12-11,"(433.221, 628.75]",1,4,-3
31026.0,2019-12-11,"(1018.25, 1213.0]",2,1,1
31027.0,2019-12-11,"(59.703, 385.25]",1,1,0
31027.0,2019-12-11,"(1033.75, 1358.0]",4,2,2
31028.0,2019-12-11,"(554.206, 753.5]",1,1,0
31028.0,2019-12-11,"(753.5, 952.0]",1,2,-1
31029.0,2019-12-11,"(925.0, 1171.0]",3,9,-6
31029.0,2019-12-11,"(1171.0, 1417.0]",2,3,-1
31030.0,2019-12-11,"(500.225, 694.75]",1,8,-7
31030.0,2019-12-11,"(888.5, 1082.25]",3,1,2
31030.0,2019-12-11,"(1082.25, 1276.0]",4,6,-2
31031.0,2019-12-11,"(358.087, 587.25]",1,3,-2
31031.0,2019-12-11,"(815.5, 1043.75]",2,2,0
31031.0,2019-12-11,"(1043.75, 1272.0]",5,5,0
31032.0,2019-12-11,"(972.25, 1161.0]",2,1,1
,,,,2.0,
31034.0,2019-12-11,"(360.182, 565.5]",1,3,-2
31034.0,2019-12-11,"(565.5, 770.0]",2,2,0
31034.0,2019-12-11,"(974.5, 1179.0]",1,5,-4
31035.0,2019-12-11,"(588.324, 758.0]",1,2,-1
31035.0,2019-12-11,"(758.0, 927.0]",1,3,-2
31035.0,2019-12-11,"(927.0, 1096.0]",3,4,-1
31035.0,2019-12-11,"(1096.0, 1265.0]",2,4,-2
31036.0,2019-12-11,"(610.0, 801.0]",1,4,-3
31036.0,2019-12-11,"(801.0, 992.0]",2,2,0
31036.0,2019-12-11,"(992.0, 1183.0]",4,3,1
31037.0,2019-12-11,"(419.074, 651.5]",8,13,-5
31037.0,2019-12-11,"(651.5, 883.0]",3,6,-3
31037.0,2019-12-11,"(883.0, 1114.5]",3,14,-11
31037.0,2019-12-11,"(1114.5, 1346.0]",2,7,-5
31038.0,2019-12-11,"(568.423, 713.25]",1,2,-1
31038.0,2019-12-11,"(713.25, 857.5]",1,3,-2
31039.0,2019-12-11,"(482.33, 650.5]",2,5,-3
31039.0,2019-12-11,"(650.5, 818.0]",2,2,0
31039.0,2019-12-11,"(818.0, 985.5]",2,5,-3
31039.0,2019-12-11,"(985.5, 1153.0]",2,4,-2
31040.0,2019-12-11,"(479.439, 620.25]",2,2,0
31040.0,2019-12-11,"(900.75, 1041.0]",2,4,-2
31041.0,2019-12-11,"(467.498, 593.5]",4,4,0
31042.0,2019-12-11,"(454.156, 666.0]",5,6,-1
31043.0,2019-12-11,"(422.411, 570.25]",1,2,-1
31043.0,2019-12-11,"(864.75, 1012.0]",2,1,1
31044.0,2019-12-11,"(475.229, 668.75]",4,5,-1
31044.0,2019-12-11,"(861.5, 1054.25]",1,3,-2
31044.0,2019-12-11,"(1054.25, 1247.0]",1,1,0
31045.0,2019-12-11,"(575.246, 764.5]",2,5,-3
31045.0,2019-12-11,"(764.5, 953.0]",4,5,-1
31045.0,2019-12-11,"(953.0, 1141.5]",2,4,-2
31045.0,2019-12-11,"(1141.5, 1330.0]",1,1,0
31046.0,2019-12-11,"(447.5, 472.25]",1,1,0
31047.0,2019-12-11,"(350.97, 609.5]",11,20,-9
31047.0,2019-12-11,"(609.5, 867.0]",2,2,0
31047.0,2019-12-11,"(867.0, 1124.5]",6,15,-9
31048.0,2019-12-11,"(484.305, 658.75]",1,4,-3
31048.0,2019-12-11,"(658.75, 832.5]",1,1,0
31048.0,2019-12-11,"(1006.25, 1180.0]",1,2,-1
31049.0,2019-12-11,"(958.5, 1125.0]",1,1,0
31050.0,2019-12-11,"(856.5, 1142.0]",1,1,0
31051.0,2019-12-11,"(732.5, 947.25]",1,4,-3
31051.0,2019-12-11,"(947.25, 1162.0]",5,1,4
31052.0,2019-12-11,"(517.368, 676.0]",3,5,-2
31052.0,2019-12-11,"(992.0, 1150.0]",1,1,0
31053.0,2019-12-11,"(137.064, 372.0]",1,1,0
31053.0,2019-12-11,"(606.0, 840.0]",1,2,-1
31053.0,2019-12-11,"(840.0, 1074.0]",2,3,-1
31054.0,2019-12-11,"(614.25, 819.0]",1,1,0
31055.0,2019-12-11,"(497.449, 635.75]",1,2,-1
31055.0,2019-12-11,"(911.25, 1049.0]",1,1,0
31056.0,2019-12-11,"(848.5, 1024.75]",1,1,0
31056.0,2019-12-11,"(1024.75, 1201.0]",1,1,0
,,,,1.0,
,,,,1.0,
31058.0,2019-12-11,"(814.5, 1086.0]",2,1,1
31059.0,2019-12-11,"(818.0, 1018.5]",1,1,0
31059.0,2019-12-11,"(1018.5, 1219.0]",3,1,2
31060.0,2019-12-11,"(786.0, 1048.0]",1,1,0
31061.0,2019-12-11,"(503.0, 754.5]",1,1,0
31061.0,2019-12-11,"(754.5, 1006.0]",2,1,1
31062.0,2019-12-11,"(827.5, 858.0]",1,1,0
31063.0,2019-12-11,"(679.5, 906.0]",1,1,0
31064.0,2019-12-11,"(548.375, 705.25]",1,3,-2
31064.0,2019-12-11,"(705.25, 861.5]",1,2,-1
31064.0,2019-12-11,"(861.5, 1017.75]",1,2,-1
31064.0,2019-12-11,"(1017.75, 1174.0]",1,2,-1
31065.0,2019-12-11,"(582.5, 737.0]",1,1,0
31065.0,2019-12-11,"(891.5, 1046.0]",1,1,0
31066.0,2019-12-11,"(1060.25, 1244.0]",2,1,1
31067.0,2019-12-11,"(458.75, 723.5]",1,1,0
31067.0,2019-12-11,"(723.5, 988.25]",1,3,-2
31067.0,2019-12-11,"(988.25, 1253.0]",3,1,2
31068.0,2019-12-11,"(958.5, 1152.75]",1,1,0
31068.0,2019-12-11,"(1152.75, 1347.0]",1,3,-2
31069.0,2019-12-11,"(820.5, 1012.25]",1,3,-2
31069.0,2019-12-11,"(1012.25, 1204.0]",2,1,1
31070.0,2019-12-11,"(992.25, 1186.0]",1,3,-2
31071.0,2019-12-11,"(529.151, 742.25]",1,3,-2
31071.0,2019-12-11,"(954.5, 1166.75]",2,1,1
31071.0,2019-12-11,"(1166.75, 1379.0]",3,7,-4
,,,,2.0,
31073.0,2019-12-11,"(501.4, 652.0]",2,2,0
31073.0,2019-12-11,"(802.0, 952.0]",1,1,0
31073.0,2019-12-11,"(952.0, 1102.0]",3,2,1
31074.0,2019-12-11,"(906.0, 1111.0]",2,1,1
31074.0,2019-12-11,"(1111.0, 1316.0]",2,4,-2
31075.0,2019-12-11,"(1006.25, 1178.0]",3,1,2
31076.0,2019-12-11,"(423.212, 621.0]",1,1,0
31076.0,2019-12-11,"(1015.0, 1212.0]",1,1,0
31077.0,2019-12-11,"(698.25, 911.5]",2,5,-3
31077.0,2019-12-11,"(911.5, 1124.75]",3,4,-1
31077.0,2019-12-11,"(1124.75, 1338.0]",3,3,0
31078.0,2019-12-11,"(501.492, 629.0]",5,5,0
31078.0,2019-12-11,"(629.0, 756.0]",1,1,0
31078.0,2019-12-11,"(883.0, 1010.0]",1,5,-4
31079.0,2019-12-11,"(488.085, 717.75]",2,8,-6
31079.0,2019-12-11,"(717.75, 946.5]",1,3,-2
31079.0,2019-12-11,"(946.5, 1175.25]",4,7,-3
31079.0,2019-12-11,"(1175.25, 1404.0]",4,4,0
31080.0,2019-12-11,"(983.75, 1176.0]",9,10,-1
31081.0,2019-12-11,"(487.345, 651.75]",2,2,0
31081.0,2019-12-11,"(815.5, 979.25]",1,3,-2
31082.0,2019-12-11,"(563.533, 680.75]",1,1,0
31083.0,2019-12-11,"(948.812, 996.0]",1,1,0
31083.0,2019-12-11,"(996.0, 1043.0]",1,1,0
31083.0,2019-12-11,"(1043.0, 1090.0]",1,2,-1
31083.0,2019-12-11,"(1090.0, 1137.0]",1,1,0
31084.0,2019-12-11,"(547.323, 717.25]",4,5,-1
31084.0,2019-12-11,"(717.25, 886.5]",1,3,-2
31085.0,2019-12-11,"(402.115, 624.25]",1,3,-2
31085.0,2019-12-11,"(845.5, 1066.75]",1,1,0
31085.0,2019-12-11,"(1066.75, 1288.0]",1,2,-1
31086.0,2019-12-11,"(1121.25, 1356.0]",3,1,2
31087.0,2019-12-11,"(916.25, 1066.0]",4,3,1
31088.0,2019-12-11,"(1000.5, 1201.0]",6,4,2
31089.0,2019-12-11,"(478.057, 714.75]",8,12,-4
31089.0,2019-12-11,"(714.75, 950.5]",1,4,-3
31089.0,2019-12-11,"(950.5, 1186.25]",3,20,-17
31089.0,2019-12-11,"(1186.25, 1422.0]",2,5,-3
31090.0,2019-12-11,"(409.299, 585.25]",1,2,-1
31090.0,2019-12-11,"(935.75, 1111.0]",3,5,-2
31091.0,2019-12-11,"(677.0, 920.0]",1,4,-3
31091.0,2019-12-11,"(920.0, 1163.0]",3,2,1
31091.0,2019-12-11,"(1163.0, 1406.0]",2,3,-1
31092.0,2019-12-11,"(920.25, 1061.0]",1,2,-1
,,,,1.0,
,,,,1.0,
,,,,1.0,
,,,,1.0,
,,,,2.0,
,,,,2.0,
31096.0,2019-12-11,"(1030.0, 1181.0]",2,1,1
31097.0,2019-12-11,"(469.198, 670.5]",2,3,-1
31097.0,2019-12-11,"(871.0, 1071.5]",4,5,-1
31097.0,2019-12-11,"(1071.5, 1272.0]",2,3,-1
31098.0,2019-12-11,"(442.139, 658.25]",2,7,-5
31098.0,2019-12-11,"(658.25, 873.5]",1,1,0
31098.0,2019-12-11,"(873.5, 1088.75]",5,12,-7
31098.0,2019-12-11,"(1088.75, 1304.0]",1,1,0
31099.0,2019-12-11,"(941.5, 1098.0]",3,1,2
31100.0,2019-12-11,"(329.25, 645.5]",11,1,10
31100.0,2019-12-11,"(645.5, 961.75]",2,12,-10
31101.0,2019-12-11,"(31.648, 371.0]",3,3,0
31101.0,2019-12-11,"(371.0, 709.0]",5,35,-30
31101.0,2019-12-11,"(709.0, 1047.0]",17,28,-11
31101.0,2019-12-11,"(1047.0, 1385.0]",32,43,-11
31102.0,2019-12-11,"(361.5, 702.0]",3,1,2
31102.0,2019-12-11,"(702.0, 1042.5]",4,23,-19
31102.0,2019-12-11,"(1042.5, 1383.0]",6,13,-7
31103.0,2019-12-11,"(531.0, 801.0]",9,14,-5
31103.0,2019-12-11,"(801.0, 1071.0]",7,34,-27
31103.0,2019-12-11,"(1071.0, 1341.0]",5,15,-10
31104.0,2019-12-11,"(395.75, 739.5]",3,3,0
31104.0,2019-12-11,"(739.5, 1083.25]",9,14,-5
31104.0,2019-12-11,"(1083.25, 1427.0]",20,15,5
31105.0,2019-12-11,"(372.995, 625.25]",1,13,-12
31105.0,2019-12-11,"(625.25, 876.5]",1,1,0
31105.0,2019-12-11,"(876.5, 1127.75]",3,7,-4
31105.0,2019-12-11,"(1127.75, 1379.0]",2,5,-3
31106.0,2019-12-11,"(497.248, 686.0]",1,8,-7
31106.0,2019-12-11,"(874.0, 1062.0]",1,1,0
31106.0,2019-12-11,"(1062.0, 1250.0]",2,2,0
31107.0,2019-12-11,"(344.953, 607.75]",2,17,-15
31107.0,2019-12-11,"(607.75, 869.5]",2,11,-9
31107.0,2019-12-11,"(869.5, 1131.25]",14,22,-8
31107.0,2019-12-11,"(1131.25, 1393.0]",4,8,-4
31108.0,2019-12-11,"(411.041, 651.75]",9,28,-19
31108.0,2019-12-11,"(651.75, 891.5]",8,18,-10
31108.0,2019-12-11,"(891.5, 1131.25]",18,28,-10
31108.0,2019-12-11,"(1131.25, 1371.0]",16,17,-1
31109.0,2019-12-11,"(335.968, 595.0]",5,17,-12
31109.0,2019-12-11,"(595.0, 853.0]",3,6,-3
31109.0,2019-12-11,"(853.0, 1111.0]",13,16,-3
31109.0,2019-12-11,"(1111.0, 1369.0]",11,20,-9
31110.0,2019-12-11,"(314.913, 587.75]",7,21,-14
31110.0,2019-12-11,"(587.75, 859.5]",10,16,-6
31110.0,2019-12-11,"(859.5, 1131.25]",12,26,-14
31110.0,2019-12-11,"(1131.25, 1403.0]",18,36,-18
31111.0,2019-12-11,"(97.744, 413.0]",1,2,-1
31111.0,2019-12-11,"(413.0, 727.0]",5,17,-12
31111.0,2019-12-11,"(727.0, 1041.0]",10,13,-3
31111.0,2019-12-11,"(1041.0, 1355.0]",22,32,-10
31112.0,2019-12-11,"(358.096, 585.0]",1,5,-4
31112.0,2019-12-11,"(585.0, 811.0]",2,3,-1
31112.0,2019-12-11,"(811.0, 1037.0]",2,4,-2
31112.0,2019-12-11,"(1037.0, 1263.0]",4,5,-1
31113.0,2019-12-11,"(15.688, 345.0]",1,2,-1
31113.0,2019-12-11,"(345.0, 673.0]",1,22,-21
31113.0,2019-12-11,"(673.0, 1001.0]",3,11,-8
31113.0,2019-12-11,"(1001.0, 1329.0]",14,16,-2
31114.0,2019-12-11,"(371.984, 627.0]",5,19,-14
31114.0,2019-12-11,"(627.0, 881.0]",1,4,-3
31114.0,2019-12-11,"(881.0, 1135.0]",15,23,-8
31114.0,2019-12-11,"(1135.0, 1389.0]",9,18,-9
31115.0,2019-12-11,"(635.5, 880.0]",1,18,-17
31115.0,2019-12-11,"(880.0, 1124.5]",7,2,5
31115.0,2019-12-11,"(1124.5, 1369.0]",6,11,-5
31116.0,2019-12-11,"(345.022, 590.5]",5,26,-21
31116.0,2019-12-11,"(590.5, 835.0]",3,5,-2
31116.0,2019-12-11,"(835.0, 1079.5]",9,10,-1
31116.0,2019-12-11,"(1079.5, 1324.0]",12,16,-4
31117.0,2019-12-11,"(355.25, 697.5]",6,6,0
31117.0,2019-12-11,"(697.5, 1039.75]",5,28,-23
31117.0,2019-12-11,"(1039.75, 1382.0]",14,12,2
31118.0,2019-12-11,"(860.5, 1112.75]",9,11,-2
31118.0,2019-12-11,"(1112.75, 1365.0]",8,13,-5
31119.0,2019-12-11,"(304.937, 571.75]",11,27,-16
31119.0,2019-12-11,"(571.75, 837.5]",7,12,-5
31119.0,2019-12-11,"(837.5, 1103.25]",15,21,-6
31119.0,2019-12-11,"(1103.25, 1369.0]",10,19,-9
31120.0,2019-12-11,"(52.712, 376.0]",1,1,0
31120.0,2019-12-11,"(376.0, 698.0]",1,13,-12
31120.0,2019-12-11,"(698.0, 1020.0]",5,9,-4
31120.0,2019-12-11,"(1020.0, 1342.0]",8,13,-5
31121.0,2019-12-11,"(70.721, 391.75]",1,1,0
31121.0,2019-12-11,"(391.75, 711.5]",12,21,-9
31121.0,2019-12-11,"(711.5, 1031.25]",1,7,-6
31121.0,2019-12-11,"(1031.25, 1351.0]",12,23,-11
31122.0,2019-12-11,"(450.015, 697.25]",2,10,-8
31122.0,2019-12-11,"(697.25, 943.5]",4,8,-4
31122.0,2019-12-11,"(943.5, 1189.75]",7,14,-7
31122.0,2019-12-11,"(1189.75, 1436.0]",7,11,-4
31123.0,2019-12-11,"(337.964, 598.0]",1,17,-16
31123.0,2019-12-11,"(598.0, 857.0]",1,12,-11
31123.0,2019-12-11,"(857.0, 1116.0]",5,7,-2
31123.0,2019-12-11,"(1116.0, 1375.0]",5,8,-3
31124.0,2019-12-11,"(5.642, 346.5]",1,2,-1
31124.0,2019-12-11,"(346.5, 686.0]",17,43,-26
31124.0,2019-12-11,"(686.0, 1025.5]",8,31,-23
31124.0,2019-12-11,"(1025.5, 1365.0]",20,53,-33
31125.0,2019-12-11,"(362.95, 626.5]",4,24,-20
31125.0,2019-12-11,"(626.5, 889.0]",5,8,-3
31125.0,2019-12-11,"(889.0, 1151.5]",23,32,-9
31125.0,2019-12-11,"(1151.5, 1414.0]",9,20,-11
31126.0,2019-12-11,"(160.835, 453.25]",2,7,-5
31126.0,2019-12-11,"(453.25, 744.5]",5,25,-20
31126.0,2019-12-11,"(744.5, 1035.75]",8,19,-11
31126.0,2019-12-11,"(1035.75, 1327.0]",17,23,-6
,,,,2.0,
31128.0,2019-12-11,"(364.75, 717.5]",27,1,26
31128.0,2019-12-11,"(717.5, 1070.25]",25,39,-14
31128.0,2019-12-11,"(1070.25, 1423.0]",9,41,-32
31129.0,2019-12-11,"(450.225, 644.75]",12,12,0
31129.0,2019-12-11,"(644.75, 838.5]",1,3,-2
31129.0,2019-12-11,"(838.5, 1032.25]",8,9,-1
31129.0,2019-12-11,"(1032.25, 1226.0]",4,8,-4
31130.0,2019-12-11,"(370.94, 637.0]",3,16,-13
31130.0,2019-12-11,"(637.0, 902.0]",2,6,-4
31130.0,2019-12-11,"(902.0, 1167.0]",11,13,-2
31130.0,2019-12-11,"(1167.0, 1432.0]",4,6,-2
31131.0,2019-12-11,"(85.673, 418.75]",1,2,-1
31131.0,2019-12-11,"(418.75, 750.5]",1,12,-11
31131.0,2019-12-11,"(750.5, 1082.25]",2,5,-3
31131.0,2019-12-11,"(1082.25, 1414.0]",10,12,-2
31200.0,2019-12-11,"(22.642, 363.5]",1,2,-1
31200.0,2019-12-11,"(363.5, 703.0]",24,45,-21
31200.0,2019-12-11,"(703.0, 1042.5]",16,45,-29
31200.0,2019-12-11,"(1042.5, 1382.0]",21,52,-31
31201.0,2019-12-11,"(297.871, 581.25]",20,38,-18
31201.0,2019-12-11,"(581.25, 863.5]",17,29,-12
31201.0,2019-12-11,"(863.5, 1145.75]",31,57,-26
31201.0,2019-12-11,"(1145.75, 1428.0]",17,32,-15
31202.0,2019-12-11,"(351.75, 700.5]",11,2,9
31202.0,2019-12-11,"(700.5, 1049.25]",17,28,-11
31202.0,2019-12-11,"(1049.25, 1398.0]",19,31,-12
31203.0,2019-12-11,"(425.5, 757.0]",8,3,5
31203.0,2019-12-11,"(757.0, 1088.5]",15,30,-15
31203.0,2019-12-11,"(1088.5, 1420.0]",18,25,-7
31204.0,2019-12-11,"(375.0, 706.0]",19,1,18
31204.0,2019-12-11,"(706.0, 1037.0]",6,22,-16
31204.0,2019-12-11,"(1037.0, 1368.0]",9,15,-6
31205.0,2019-12-11,"(384.041, 624.75]",39,47,-8
31205.0,2019-12-11,"(624.75, 864.5]",23,31,-8
31205.0,2019-12-11,"(864.5, 1104.25]",13,22,-9
31205.0,2019-12-11,"(1104.25, 1344.0]",2,12,-10
31206.0,2019-12-11,"(541.49, 669.5]",1,2,-1
31206.0,2019-12-11,"(797.0, 924.5]",1,3,-2
31206.0,2019-12-11,"(924.5, 1052.0]",2,9,-7
31207.0,2019-12-11,"(728.5, 960.0]",1,7,-6
31207.0,2019-12-11,"(960.0, 1191.5]",3,1,2
31207.0,2019-12-11,"(1191.5, 1423.0]",2,4,-2
31208.0,2019-12-11,"(321.018, 567.5]",10,11,-1
31208.0,2019-12-11,"(567.5, 813.0]",2,4,-2
31208.0,2019-12-11,"(813.0, 1058.5]",6,16,-10
31208.0,2019-12-11,"(1058.5, 1304.0]",3,7,-4
31209.0,2019-12-11,"(534.214, 731.5]",3,4,-1
31209.0,2019-12-11,"(731.5, 928.0]",4,6,-2
31209.0,2019-12-11,"(928.0, 1124.5]",2,5,-3
31209.0,2019-12-11,"(1124.5, 1321.0]",2,2,0
31211.0,2019-12-11,"(364.148, 578.0]",7,8,-1
31211.0,2019-12-11,"(578.0, 791.0]",3,4,-1
31211.0,2019-12-11,"(791.0, 1004.0]",2,4,-2
31211.0,2019-12-11,"(1004.0, 1217.0]",6,10,-4
31212.0,2019-12-11,"(9.603, 360.25]",1,1,0
31212.0,2019-12-11,"(360.25, 709.5]",32,48,-16
31212.0,2019-12-11,"(709.5, 1058.75]",10,24,-14
31212.0,2019-12-11,"(1058.75, 1408.0]",12,29,-17
31213.0,2019-12-11,"(373.965, 633.75]",36,52,-16
31213.0,2019-12-11,"(633.75, 892.5]",11,20,-9
31213.0,2019-12-11,"(892.5, 1151.25]",21,43,-22
31213.0,2019-12-11,"(1151.25, 1410.0]",5,13,-8
31214.0,2019-12-11,"(361.5, 702.0]",6,1,5
31214.0,2019-12-11,"(702.0, 1042.5]",14,27,-13
31214.0,2019-12-11,"(1042.5, 1383.0]",24,26,-2
31215.0,2019-12-11,"(425.2, 626.0]",20,22,-2
31215.0,2019-12-11,"(626.0, 826.0]",4,4,0
31215.0,2019-12-11,"(826.0, 1026.0]",13,23,-10
31215.0,2019-12-11,"(1026.0, 1226.0]",5,20,-15
31216.0,2019-12-11,"(433.145, 647.75]",13,13,0
31216.0,2019-12-11,"(647.75, 861.5]",2,4,-2
31216.0,2019-12-11,"(861.5, 1075.25]",2,6,-4
31216.0,2019-12-11,"(1075.25, 1289.0]",2,19,-17
31217.0,2019-12-11,"(376.259, 562.25]",13,14,-1
31217.0,2019-12-11,"(747.5, 932.75]",1,3,-2
31217.0,2019-12-11,"(932.75, 1118.0]",2,1,1
31218.0,2019-12-11,"(348.949, 612.75]",14,28,-14
31218.0,2019-12-11,"(612.75, 875.5]",1,4,-3
31218.0,2019-12-11,"(875.5, 1138.25]",9,19,-10
31218.0,2019-12-11,"(1138.25, 1401.0]",2,3,-1
31219.0,2019-12-11,"(443.156, 655.0]",13,15,-2
31219.0,2019-12-11,"(655.0, 866.0]",5,7,-2
31219.0,2019-12-11,"(866.0, 1077.0]",4,18,-14
31220.0,2019-12-11,"(295.181, 500.75]",8,13,-5
31220.0,2019-12-11,"(500.75, 705.5]",12,12,0
31220.0,2019-12-11,"(705.5, 910.25]",2,5,-3
31220.0,2019-12-11,"(910.25, 1115.0]",1,16,-15
31221.0,2019-12-11,"(384.007, 633.25]",22,22,0
31221.0,2019-12-11,"(633.25, 881.5]",8,12,-4
31221.0,2019-12-11,"(881.5, 1129.75]",12,34,-22
31221.0,2019-12-11,"(1129.75, 1378.0]",1,2,-1
31222.0,2019-12-11,"(322.038, 563.5]",10,12,-2
31222.0,2019-12-11,"(563.5, 804.0]",1,4,-3
31222.0,2019-12-11,"(804.0, 1044.5]",3,14,-11
31222.0,2019-12-11,"(1044.5, 1285.0]",7,17,-10
31223.0,2019-12-11,"(16.612, 365.0]",2,4,-2
31223.0,2019-12-11,"(365.0, 712.0]",12,37,-25
31223.0,2019-12-11,"(712.0, 1059.0]",7,21,-14
31223.0,2019-12-11,"(1059.0, 1406.0]",21,38,-17
31224.0,2019-12-11,"(389.125, 608.75]",17,18,-1
31224.0,2019-12-11,"(608.75, 827.5]",2,3,-1
31224.0,2019-12-11,"(827.5, 1046.25]",1,6,-5
31224.0,2019-12-11,"(1046.25, 1265.0]",1,11,-10
31225.0,2019-12-11,"(404.115, 626.25]",11,19,-8
31225.0,2019-12-11,"(626.25, 847.5]",4,9,-5
31225.0,2019-12-11,"(847.5, 1068.75]",9,18,-9
31225.0,2019-12-11,"(1068.75, 1290.0]",7,14,-7
31226.0,2019-12-11,"(319.883, 600.25]",2,5,-3
31226.0,2019-12-11,"(600.25, 879.5]",2,3,-1
31226.0,2019-12-11,"(879.5, 1158.75]",6,9,-3
31226.0,2019-12-11,"(1158.75, 1438.0]",1,3,-2
31227.0,2019-12-11,"(406.215, 603.25]",29,32,-3
31227.0,2019-12-11,"(603.25, 799.5]",14,20,-6
31227.0,2019-12-11,"(799.5, 995.75]",4,9,-5
31227.0,2019-12-11,"(995.75, 1192.0]",9,23,-14
31228.0,2019-12-11,"(62.626, 407.5]",5,6,-1
31228.0,2019-12-11,"(407.5, 751.0]",19,28,-9
31228.0,2019-12-11,"(751.0, 1094.5]",25,43,-18
31228.0,2019-12-11,"(1094.5, 1438.0]",12,22,-10
31229.0,2019-12-11,"(353.93, 622.5]",4,40,-36
31229.0,2019-12-11,"(622.5, 890.0]",5,22,-17
31229.0,2019-12-11,"(890.0, 1157.5]",25,40,-15
31229.0,2019-12-11,"(1157.5, 1425.0]",16,27,-11
31230.0,2019-12-11,"(402.042, 642.5]",48,58,-10
31230.0,2019-12-11,"(642.5, 882.0]",11,17,-6
31230.0,2019-12-11,"(882.0, 1121.5]",21,46,-25
31230.0,2019-12-11,"(1121.5, 1361.0]",4,15,-11
31231.0,2019-12-11,"(390.976, 648.0]",13,15,-2
31231.0,2019-12-11,"(648.0, 904.0]",6,10,-4
31231.0,2019-12-11,"(904.0, 1160.0]",11,27,-16
31232.0,2019-12-11,"(296.939, 563.25]",17,22,-5
31232.0,2019-12-11,"(563.25, 828.5]",10,13,-3
31232.0,2019-12-11,"(828.5, 1093.75]",11,23,-12
31232.0,2019-12-11,"(1093.75, 1359.0]",7,17,-10
31233.0,2019-12-11,"(19.589, 373.75]",1,1,0
31233.0,2019-12-11,"(373.75, 726.5]",16,19,-3
31233.0,2019-12-11,"(726.5, 1079.25]",18,35,-17
31233.0,2019-12-11,"(1079.25, 1432.0]",10,18,-8
31234.0,2019-12-11,"(7.591, 361.25]",1,2,-1
31234.0,2019-12-11,"(361.25, 713.5]",23,40,-17
31234.0,2019-12-11,"(713.5, 1065.75]",16,28,-12
31234.0,2019-12-11,"(1065.75, 1418.0]",11,29,-18
31235.0,2019-12-11,"(383.217, 579.75]",3,4,-1
31235.0,2019-12-11,"(579.75, 775.5]",1,4,-3
31235.0,2019-12-11,"(775.5, 971.25]",3,6,-3
31235.0,2019-12-11,"(971.25, 1167.0]",3,9,-6
31236.0,2019-12-11,"(387.75, 716.5]",16,1,15
31236.0,2019-12-11,"(716.5, 1045.25]",11,19,-8
31236.0,2019-12-11,"(1045.25, 1374.0]",2,26,-24
31237.0,2019-12-11,"(377.942, 643.5]",11,22,-11
31237.0,2019-12-11,"(643.5, 908.0]",9,16,-7
31237.0,2019-12-11,"(908.0, 1172.5]",12,18,-6
31237.0,2019-12-11,"(1172.5, 1437.0]",1,3,-2
31238.0,2019-12-11,"(82.819, 379.25]",1,1,0
31238.0,2019-12-11,"(379.25, 674.5]",19,27,-8
31238.0,2019-12-11,"(674.5, 969.75]",6,17,-11
31238.0,2019-12-11,"(969.75, 1265.0]",7,29,-22
31239.0,2019-12-11,"(351.05, 589.5]",26,29,-3
31239.0,2019-12-11,"(589.5, 827.0]",7,11,-4
31239.0,2019-12-11,"(827.0, 1064.5]",4,18,-14
31239.0,2019-12-11,"(1064.5, 1302.0]",7,19,-12
,,,,2.0,
31241.0,2019-12-11,"(283.924, 554.0]",16,35,-19
31241.0,2019-12-11,"(554.0, 823.0]",21,34,-13
31241.0,2019-12-11,"(823.0, 1092.0]",11,27,-16
31241.0,2019-12-11,"(1092.0, 1361.0]",19,35,-16
31242.0,2019-12-11,"(402.029, 645.75]",27,27,0
31242.0,2019-12-11,"(645.75, 888.5]",4,10,-6
31242.0,2019-12-11,"(888.5, 1131.25]",6,36,-30
31242.0,2019-12-11,"(1131.25, 1374.0]",2,4,-2
31243.0,2019-12-11,"(373.993, 626.75]",23,27,-4
31243.0,2019-12-11,"(626.75, 878.5]",5,8,-3
31243.0,2019-12-11,"(878.5, 1130.25]",7,27,-20
31243.0,2019-12-11,"(1130.25, 1382.0]",2,9,-7
31244.0,2019-12-11,"(353.019, 599.25]",11,21,-10
31244.0,2019-12-11,"(599.25, 844.5]",8,12,-4
31244.0,2019-12-11,"(844.5, 1089.75]",9,22,-13
31244.0,2019-12-11,"(1089.75, 1335.0]",4,8,-4
31245.0,2019-12-11,"(378.972, 637.0]",10,26,-16
31245.0,2019-12-11,"(637.0, 894.0]",4,6,-2
31245.0,2019-12-11,"(894.0, 1151.0]",11,24,-13
31245.0,2019-12-11,"(1151.0, 1408.0]",7,17,-10
31246.0,2019-12-11,"(20.612, 369.0]",3,3,0
31246.0,2019-12-11,"(369.0, 716.0]",15,24,-9
31246.0,2019-12-11,"(716.0, 1063.0]",15,31,-16
31246.0,2019-12-11,"(1063.0, 1410.0]",13,26,-13
31247.0,2019-12-11,"(423.333, 590.75]",9,14,-5
31247.0,2019-12-11,"(590.75, 757.5]",7,7,0
31247.0,2019-12-11,"(757.5, 924.25]",8,12,-4
31247.0,2019-12-11,"(924.25, 1091.0]",6,12,-6
31248.0,2019-12-11,"(389.222, 584.5]",2,4,-2
31248.0,2019-12-11,"(584.5, 779.0]",1,2,-1
31248.0,2019-12-11,"(779.0, 973.5]",7,8,-1
31248.0,2019-12-11,"(973.5, 1168.0]",4,9,-5
31249.0,2019-12-11,"(407.351, 570.25]",3,4,-1
31249.0,2019-12-11,"(570.25, 732.5]",1,2,-1
31249.0,2019-12-11,"(732.5, 894.75]",4,8,-4
31249.0,2019-12-11,"(894.75, 1057.0]",3,8,-5
31250.0,2019-12-11,"(421.129, 639.75]",19,22,-3
31250.0,2019-12-11,"(639.75, 857.5]",3,6,-3
31250.0,2019-12-11,"(857.5, 1075.25]",2,10,-8
31250.0,2019-12-11,"(1075.25, 1293.0]",1,14,-13
31251.0,2019-12-11,"(2.661, 338.75]",2,3,-1
31251.0,2019-12-11,"(338.75, 673.5]",18,31,-13
31251.0,2019-12-11,"(673.5, 1008.25]",7,14,-7
31251.0,2019-12-11,"(1008.25, 1343.0]",13,30,-17
31252.0,2019-12-11,"(367.25, 711.5]",15,1,14
31252.0,2019-12-11,"(711.5, 1055.75]",2,17,-15
31252.0,2019-12-11,"(1055.75, 1400.0]",2,13,-11
31253.0,2019-12-11,"(381.5, 734.0]",22,1,21
31253.0,2019-12-11,"(734.0, 1086.5]",10,25,-15
31253.0,2019-12-11,"(1086.5, 1439.0]",1,29,-28
31254.0,2019-12-11,"(474.177, 680.75]",25,27,-2
31254.0,2019-12-11,"(680.75, 886.5]",4,9,-5
31254.0,2019-12-11,"(886.5, 1092.25]",1,13,-12
31254.0,2019-12-11,"(1092.25, 1298.0]",1,6,-5
31255.0,2019-12-11,"(349.035, 591.25]",21,33,-12
31255.0,2019-12-11,"(591.25, 832.5]",2,4,-2
31255.0,2019-12-11,"(832.5, 1073.75]",9,21,-12
31255.0,2019-12-11,"(1073.75, 1315.0]",6,13,-7
31256.0,2019-12-11,"(275.919, 547.25]",13,15,-2
31256.0,2019-12-11,"(547.25, 817.5]",4,6,-2
31256.0,2019-12-11,"(817.5, 1087.75]",4,13,-9
31256.0,2019-12-11,"(1087.75, 1358.0]",4,10,-6
31257.0,2019-12-11,"(322.918, 594.5]",15,26,-11
31257.0,2019-12-11,"(594.5, 865.0]",13,26,-13
31257.0,2019-12-11,"(865.0, 1135.5]",15,33,-18
31257.0,2019-12-11,"(1135.5, 1406.0]",5,15,-10
31258.0,2019-12-11,"(326.91, 600.5]",14,35,-21
31258.0,2019-12-11,"(600.5, 873.0]",6,13,-7
31258.0,2019-12-11,"(873.0, 1145.5]",4,10,-6
31258.0,2019-12-11,"(1145.5, 1418.0]",5,8,-3
31259.0,2019-12-11,"(456.37, 614.5]",10,10,0
31259.0,2019-12-11,"(614.5, 772.0]",1,3,-2
31259.0,2019-12-11,"(772.0, 929.5]",1,2,-1
31259.0,2019-12-11,"(929.5, 1087.0]",3,9,-6
31260.0,2019-12-11,"(365.957, 627.75]",10,15,-5
31260.0,2019-12-11,"(627.75, 888.5]",3,8,-5
31260.0,2019-12-11,"(888.5, 1149.25]",4,21,-17
31260.0,2019-12-11,"(1149.25, 1410.0]",2,3,-1
31261.0,2019-12-11,"(366.245, 555.75]",11,11,0
31262.0,2019-12-11,"(386.089, 614.75]",13,16,-3
31262.0,2019-12-11,"(614.75, 842.5]",1,2,-1
31262.0,2019-12-11,"(842.5, 1070.25]",3,5,-2
31262.0,2019-12-11,"(1070.25, 1298.0]",3,12,-9
31263.0,2019-12-11,"(359.25, 680.5]",19,1,18
31263.0,2019-12-11,"(680.5, 1001.75]",15,26,-11
31263.0,2019-12-11,"(1001.75, 1323.0]",12,31,-19
31264.0,2019-12-11,"(461.194, 663.5]",10,15,-5
31264.0,2019-12-11,"(663.5, 865.0]",8,11,-3
31264.0,2019-12-11,"(865.0, 1066.5]",3,12,-9
31264.0,2019-12-11,"(1066.5, 1268.0]",3,6,-3
31265.0,2019-12-11,"(351.928, 621.0]",15,42,-27
31265.0,2019-12-11,"(621.0, 889.0]",9,15,-6
31265.0,2019-12-11,"(889.0, 1157.0]",23,38,-15
31265.0,2019-12-11,"(1157.0, 1425.0]",11,22,-11
31266.0,2019-12-11,"(58.656, 396.0]",1,7,-6
31266.0,2019-12-11,"(396.0, 732.0]",10,37,-27
31266.0,2019-12-11,"(732.0, 1068.0]",15,23,-8
31266.0,2019-12-11,"(1068.0, 1404.0]",24,45,-21
31267.0,2019-12-11,"(360.25, 710.5]",26,2,24
31267.0,2019-12-11,"(710.5, 1060.75]",13,41,-28
31267.0,2019-12-11,"(1060.75, 1411.0]",16,20,-4
31268.0,2019-12-11,"(369.97, 628.5]",15,34,-19
31268.0,2019-12-11,"(628.5, 886.0]",4,9,-5
31268.0,2019-12-11,"(886.0, 1143.5]",22,32,-10
31268.0,2019-12-11,"(1143.5, 1401.0]",11,20,-9
31269.0,2019-12-11,"(333.912, 607.0]",11,16,-5
31269.0,2019-12-11,"(607.0, 879.0]",9,18,-9
31269.0,2019-12-11,"(879.0, 1151.0]",2,15,-13
31269.0,2019-12-11,"(1151.0, 1423.0]",4,8,-4
31270.0,2019-12-11,"(328.016, 575.0]",13,15,-2
31270.0,2019-12-11,"(575.0, 821.0]",5,13,-8
31270.0,2019-12-11,"(821.0, 1067.0]",10,16,-6
31270.0,2019-12-11,"(1067.0, 1313.0]",8,19,-11
31271.0,2019-12-11,"(377.117, 598.75]",9,12,-3
31271.0,2019-12-11,"(598.75, 819.5]",6,9,-3
31271.0,2019-12-11,"(819.5, 1040.25]",7,9,-2
31271.0,2019-12-11,"(1040.25, 1261.0]",1,14,-13
31272.0,2019-12-11,"(311.011, 559.25]",19,21,-2
31272.0,2019-12-11,"(559.25, 806.5]",8,11,-3
31272.0,2019-12-11,"(806.5, 1053.75]",4,15,-11
31272.0,2019-12-11,"(1053.75, 1301.0]",4,16,-12
31273.0,2019-12-11,"(828.5, 981.25]",1,2,-1
31273.0,2019-12-11,"(981.25, 1134.0]",2,1,1
31274.0,2019-12-11,"(434.122, 654.5]",16,19,-3
31274.0,2019-12-11,"(654.5, 874.0]",5,11,-6
31274.0,2019-12-11,"(874.0, 1093.5]",3,10,-7
31274.0,2019-12-11,"(1093.5, 1313.0]",4,8,-4
31275.0,2019-12-11,"(16.636, 359.0]",2,3,-1
31275.0,2019-12-11,"(359.0, 700.0]",13,22,-9
31275.0,2019-12-11,"(700.0, 1041.0]",10,25,-15
31275.0,2019-12-11,"(1041.0, 1382.0]",11,26,-15
31276.0,2019-12-11,"(301.75, 598.5]",18,1,17
31276.0,2019-12-11,"(598.5, 895.25]",3,19,-16
31276.0,2019-12-11,"(895.25, 1192.0]",4,7,-3
31277.0,2019-12-11,"(414.046, 653.5]",38,41,-3
31277.0,2019-12-11,"(653.5, 892.0]",19,24,-5
31277.0,2019-12-11,"(892.0, 1130.5]",13,44,-31
31277.0,2019-12-11,"(1130.5, 1369.0]",3,10,-7
31278.0,2019-12-11,"(373.944, 639.0]",4,24,-20
31278.0,2019-12-11,"(639.0, 903.0]",5,10,-5
31278.0,2019-12-11,"(903.0, 1167.0]",18,26,-8
31278.0,2019-12-11,"(1167.0, 1431.0]",11,14,-3
31279.0,2019-12-11,"(369.128, 588.0]",20,22,-2
31279.0,2019-12-11,"(588.0, 806.0]",3,10,-7
31279.0,2019-12-11,"(806.0, 1024.0]",8,16,-8
31279.0,2019-12-11,"(1024.0, 1242.0]",4,23,-19
31280.0,2019-12-11,"(361.001, 611.75]",4,22,-18
31280.0,2019-12-11,"(611.75, 861.5]",3,6,-3
31280.0,2019-12-11,"(861.5, 1111.25]",11,14,-3
31280.0,2019-12-11,"(1111.25, 1361.0]",11,17,-6
,,,,1.0,
,,,,1.0,
31001.0,2019-12-12,"(491.153, 703.75]",1,2,-1
31001.0,2019-12-12,"(915.5, 1127.25]",1,1,0
31001.0,2019-12-12,"(1127.25, 1339.0]",1,2,-1
31002.0,2019-12-12,"(510.31, 683.5]",3,10,-7
31002.0,2019-12-12,"(683.5, 856.0]",1,2,-1
31002.0,2019-12-12,"(856.0, 1028.5]",3,3,0
31002.0,2019-12-12,"(1028.5, 1201.0]",3,5,-2
31003.0,2019-12-12,"(564.5, 751.0]",3,3,0
31003.0,2019-12-12,"(751.0, 937.5]",2,4,-2
31003.0,2019-12-12,"(937.5, 1124.0]",3,6,-3
31004.0,2019-12-12,"(892.0, 1074.0]",2,1,1
31005.0,2019-12-12,"(347.049, 585.75]",5,6,-1
31005.0,2019-12-12,"(823.5, 1061.25]",2,4,-2
31005.0,2019-12-12,"(1061.25, 1299.0]",2,10,-8
31006.0,2019-12-12,"(677.346, 841.5]",1,2,-1
31006.0,2019-12-12,"(1168.5, 1332.0]",1,1,0
31007.0,2019-12-12,"(378.24, 569.0]",6,13,-7
31007.0,2019-12-12,"(569.0, 759.0]",1,2,-1
31007.0,2019-12-12,"(759.0, 949.0]",4,5,-1
31007.0,2019-12-12,"(949.0, 1139.0]",6,9,-3
31009.0,2019-12-12,"(382.32, 553.0]",4,4,0
31009.0,2019-12-12,"(553.0, 723.0]",1,1,0
31010.0,2019-12-12,"(409.203, 609.25]",3,5,-2
31010.0,2019-12-12,"(808.5, 1007.75]",2,2,0
31010.0,2019-12-12,"(1007.75, 1207.0]",1,3,-2
31011.0,2019-12-12,"(376.259, 562.25]",6,7,-1
31011.0,2019-12-12,"(562.25, 747.5]",3,5,-2
31011.0,2019-12-12,"(747.5, 932.75]",1,1,0
31011.0,2019-12-12,"(932.75, 1118.0]",1,6,-5
31012.0,2019-12-12,"(382.434, 524.5]",4,5,-1
31012.0,2019-12-12,"(524.5, 666.0]",1,1,0
31013.0,2019-12-12,"(951.0, 1126.0]",1,2,-1
31013.0,2019-12-12,"(1126.0, 1301.0]",3,4,-1
31014.0,2019-12-12,"(34.783, 340.25]",1,1,0
31014.0,2019-12-12,"(340.25, 644.5]",21,26,-5
31014.0,2019-12-12,"(644.5, 948.75]",2,7,-5
31014.0,2019-12-12,"(948.75, 1253.0]",13,25,-12
31015.0,2019-12-12,"(27.711, 351.25]",2,2,0
31015.0,2019-12-12,"(351.25, 673.5]",12,13,-1
31015.0,2019-12-12,"(673.5, 995.75]",4,5,-1
31015.0,2019-12-12,"(995.75, 1318.0]",4,9,-5
31016.0,2019-12-12,"(438.214, 635.5]",4,10,-6
31016.0,2019-12-12,"(635.5, 832.0]",1,1,0
31016.0,2019-12-12,"(832.0, 1028.5]",4,8,-4
31016.0,2019-12-12,"(1028.5, 1225.0]",2,7,-5
31017.0,2019-12-12,"(471.175, 678.25]",5,8,-3
31017.0,2019-12-12,"(884.5, 1090.75]",1,1,0
31018.0,2019-12-12,"(589.75, 785.5]",1,5,-4
31018.0,2019-12-12,"(981.25, 1177.0]",2,1,1
31019.0,2019-12-12,"(1010.831, 1053.25]",2,3,-1
31019.0,2019-12-12,"(1137.75, 1180.0]",2,2,0
31020.0,2019-12-12,"(891.0, 1024.0]",1,1,0
31021.0,2019-12-12,"(343.971, 602.25]",2,7,-5
31021.0,2019-12-12,"(602.25, 859.5]",2,7,-5
31021.0,2019-12-12,"(1116.75, 1374.0]",2,6,-4
31022.0,2019-12-12,"(486.071, 719.25]",2,5,-3
31022.0,2019-12-12,"(719.25, 951.5]",1,2,-1
31022.0,2019-12-12,"(951.5, 1183.75]",1,4,-3
31023.0,2019-12-12,"(482.235, 674.25]",1,3,-2
31023.0,2019-12-12,"(865.5, 1056.75]",1,2,-1
31023.0,2019-12-12,"(1056.75, 1248.0]",1,3,-2
31024.0,2019-12-12,"(415.046, 654.5]",5,6,-1
31024.0,2019-12-12,"(654.5, 893.0]",1,4,-3
31024.0,2019-12-12,"(893.0, 1131.5]",4,9,-5
,,,,1.0,
,,,,1.0,
31026.0,2019-12-12,"(478.179, 684.25]",1,3,-2
31026.0,2019-12-12,"(684.25, 889.5]",2,3,-1
31026.0,2019-12-12,"(1094.75, 1300.0]",1,3,-2
31027.0,2019-12-12,"(1122.5, 1303.0]",2,1,1
31028.0,2019-12-12,"(485.284, 665.0]",1,1,0
31028.0,2019-12-12,"(1023.0, 1202.0]",2,1,1
31029.0,2019-12-12,"(859.5, 1078.75]",1,7,-6
31029.0,2019-12-12,"(1078.75, 1298.0]",4,1,3
31030.0,2019-12-12,"(336.917, 608.75]",1,8,-7
31030.0,2019-12-12,"(879.5, 1150.25]",5,1,4
31030.0,2019-12-12,"(1150.25, 1421.0]",6,9,-3
31031.0,2019-12-12,"(61.804, 362.0]",1,1,0
31031.0,2019-12-12,"(960.0, 1259.0]",1,4,-3
31032.0,2019-12-12,"(545.295, 722.25]",1,4,-3
31032.0,2019-12-12,"(898.5, 1074.75]",1,2,-1
31032.0,2019-12-12,"(1074.75, 1251.0]",1,1,0
31033.0,2019-12-12,"(504.0, 672.0]",1,1,0
31034.0,2019-12-12,"(529.249, 717.75]",3,6,-3
31034.0,2019-12-12,"(1093.25, 1281.0]",2,1,1
31035.0,2019-12-12,"(563.75, 753.5]",2,3,-1
31035.0,2019-12-12,"(753.5, 943.25]",1,3,-2
31035.0,2019-12-12,"(943.25, 1133.0]",4,2,2
31036.0,2019-12-12,"(565.25, 745.5]",1,2,-1
31036.0,2019-12-12,"(925.75, 1106.0]",3,3,0
31037.0,2019-12-12,"(389.5, 729.0]",13,1,12
31037.0,2019-12-12,"(729.0, 1068.5]",4,15,-11
31038.0,2019-12-12,"(489.744, 554.0]",1,2,-1
31038.0,2019-12-12,"(554.0, 618.0]",1,3,-2
31038.0,2019-12-12,"(682.0, 746.0]",5,6,-1
31039.0,2019-12-12,"(413.086, 642.5]",4,10,-6
31039.0,2019-12-12,"(642.5, 871.0]",2,2,0
31039.0,2019-12-12,"(871.0, 1099.5]",2,5,-3
31039.0,2019-12-12,"(1099.5, 1328.0]",2,5,-3
31040.0,2019-12-12,"(460.4, 611.0]",2,2,0
31041.0,2019-12-12,"(651.0, 868.0]",2,1,1
31042.0,2019-12-12,"(449.42, 595.0]",10,11,-1
31042.0,2019-12-12,"(595.0, 740.0]",2,6,-4
31042.0,2019-12-12,"(740.0, 885.0]",2,4,-2
31043.0,2019-12-12,"(481.256, 668.0]",1,2,-1
31043.0,2019-12-12,"(668.0, 854.0]",2,4,-2
31043.0,2019-12-12,"(854.0, 1040.0]",3,4,-1
31044.0,2019-12-12,"(415.108, 639.0]",1,3,-2
31044.0,2019-12-12,"(639.0, 862.0]",1,2,-1
31044.0,2019-12-12,"(862.0, 1085.0]",1,1,0
31044.0,2019-12-12,"(1085.0, 1308.0]",1,2,-1
31045.0,2019-12-12,"(484.163, 694.25]",1,3,-2
31045.0,2019-12-12,"(903.5, 1112.75]",4,1,3
31045.0,2019-12-12,"(1112.75, 1322.0]",3,5,-2
31046.0,2019-12-12,"(774.544, 889.0]",1,1,0
31046.0,2019-12-12,"(1117.0, 1231.0]",1,1,0
31047.0,2019-12-12,"(350.979, 607.25]",16,26,-10
31047.0,2019-12-12,"(607.25, 862.5]",2,4,-2
31047.0,2019-12-12,"(862.5, 1117.75]",6,17,-11
31048.0,2019-12-12,"(612.285, 791.75]",1,3,-2
31048.0,2019-12-12,"(970.5, 1149.25]",2,3,-1
31048.0,2019-12-12,"(1149.25, 1328.0]",1,2,-1
31049.0,2019-12-12,"(550.221, 745.75]",2,2,0
31049.0,2019-12-12,"(1135.25, 1330.0]",2,1,1
,,,,1.0,
,,,,1.0,
31051.0,2019-12-12,"(511.75, 719.5]",1,3,-2
31051.0,2019-12-12,"(927.25, 1135.0]",3,2,1
,,,,2.0,
31053.0,2019-12-12,"(949.75, 1101.0]",1,1,0
,,,,2.0,
31055.0,2019-12-12,"(1007.75, 1181.0]",2,1,1
31056.0,2019-12-12,"(988.0, 1133.0]",1,1,0
31057.0,2019-12-12,"(1014.0, 1145.0]",2,1,1
31058.0,2019-12-12,"(605.5, 774.0]",1,1,0
31058.0,2019-12-12,"(942.5, 1111.0]",1,1,0
31059.0,2019-12-12,"(1037.5, 1217.0]",1,1,0
31060.0,2019-12-12,"(989.82, 1035.0]",2,2,0
,,,,2.0,
31062.0,2019-12-12,"(577.869, 610.75]",1,1,0
31062.0,2019-12-12,"(643.5, 676.25]",1,1,0
31063.0,2019-12-12,"(698.25, 727.0]",1,1,0
31064.0,2019-12-12,"(506.384, 661.0]",1,2,-1
31064.0,2019-12-12,"(661.0, 815.0]",1,2,-1
31064.0,2019-12-12,"(815.0, 969.0]",2,2,0
31064.0,2019-12-12,"(969.0, 1123.0]",4,8,-4
31065.0,2019-12-12,"(374.461, 509.75]",1,3,-2
31065.0,2019-12-12,"(779.25, 914.0]",2,3,-1
31066.0,2019-12-12,"(389.212, 587.0]",1,3,-2
31066.0,2019-12-12,"(981.0, 1178.0]",1,1,0
31067.0,2019-12-12,"(989.5, 1182.0]",2,2,0
31068.0,2019-12-12,"(1085.0, 1256.0]",1,1,0
31069.0,2019-12-12,"(658.0, 880.0]",3,3,0
31069.0,2019-12-12,"(880.0, 1102.0]",2,4,-2
31069.0,2019-12-12,"(1102.0, 1324.0]",3,6,-3
31070.0,2019-12-12,"(957.5, 1176.75]",1,1,0
31070.0,2019-12-12,"(1176.75, 1396.0]",3,1,2
31071.0,2019-12-12,"(379.186, 583.5]",1,4,-3
31071.0,2019-12-12,"(583.5, 787.0]",2,4,-2
31071.0,2019-12-12,"(787.0, 990.5]",1,2,-1
31071.0,2019-12-12,"(990.5, 1194.0]",6,7,-1
,,,,1.0,
,,,,1.0,
31073.0,2019-12-12,"(444.132, 662.0]",2,3,-1
31073.0,2019-12-12,"(879.0, 1096.0]",3,1,2
31073.0,2019-12-12,"(1096.0, 1313.0]",1,5,-4
31074.0,2019-12-12,"(672.0, 857.0]",1,2,-1
31074.0,2019-12-12,"(857.0, 1042.0]",1,1,0
31074.0,2019-12-12,"(1042.0, 1227.0]",3,1,2
31075.0,2019-12-12,"(531.413, 678.75]",1,3,-2
31075.0,2019-12-12,"(972.25, 1119.0]",1,1,0
31076.0,2019-12-12,"(130.065, 364.75]",1,1,0
31076.0,2019-12-12,"(832.25, 1066.0]",2,3,-1
31077.0,2019-12-12,"(32.671, 366.25]",1,1,0
31077.0,2019-12-12,"(366.25, 698.5]",1,5,-4
31077.0,2019-12-12,"(698.5, 1030.75]",2,3,-1
31077.0,2019-12-12,"(1030.75, 1363.0]",3,3,0
31078.0,2019-12-12,"(499.579, 605.25]",4,4,0
31078.0,2019-12-12,"(605.25, 710.5]",1,4,-3
31078.0,2019-12-12,"(710.5, 815.75]",1,3,-2
31078.0,2019-12-12,"(815.75, 921.0]",1,2,-1
31079.0,2019-12-12,"(482.338, 648.5]",1,7,-6
31079.0,2019-12-12,"(814.0, 979.5]",2,2,0
31079.0,2019-12-12,"(979.5, 1145.0]",3,4,-1
31080.0,2019-12-12,"(917.0, 1123.0]",2,7,-5
31080.0,2019-12-12,"(1123.0, 1329.0]",2,3,-1
31081.0,2019-12-12,"(470.212, 668.0]",2,3,-1
31081.0,2019-12-12,"(865.0, 1062.0]",1,2,-1
31081.0,2019-12-12,"(1062.0, 1259.0]",1,3,-2
,,,,1.0,
,,,,1.0,
,,,,1.0,
,,,,1.0,
31083.0,2019-12-12,"(861.0, 1011.0]",3,3,0
31084.0,2019-12-12,"(562.277, 743.75]",3,3,0
31084.0,2019-12-12,"(743.75, 924.5]",1,2,-1
31085.0,2019-12-12,"(953.5, 1108.0]",1,1,0
31086.0,2019-12-12,"(764.0, 908.5]",1,2,-1
31086.0,2019-12-12,"(908.5, 1053.0]",1,2,-1
31087.0,2019-12-12,"(702.0, 835.0]",1,1,0
31087.0,2019-12-12,"(968.0, 1101.0]",1,1,0
31088.0,2019-12-12,"(894.25, 1154.0]",3,1,2
31089.0,2019-12-12,"(493.173, 700.75]",4,8,-4
31089.0,2019-12-12,"(700.75, 907.5]",1,2,-1
31089.0,2019-12-12,"(907.5, 1114.25]",1,12,-11
31089.0,2019-12-12,"(1114.25, 1321.0]",2,3,-1
31090.0,2019-12-12,"(578.25, 732.5]",1,1,0
31090.0,2019-12-12,"(886.75, 1041.0]",1,1,0
31091.0,2019-12-12,"(59.936, 327.0]",1,1,0
31091.0,2019-12-12,"(859.0, 1125.0]",4,5,-1
31092.0,2019-12-12,"(906.75, 1048.0]",1,2,-1
,,,,1.0,
,,,,1.0,
,,,,1.0,
,,,,2.0,
31094.0,2019-12-12,"(889.5, 1186.0]",1,1,0
,,,,2.0,
31096.0,2019-12-12,"(814.5, 979.0]",1,1,0
31096.0,2019-12-12,"(979.0, 1143.5]",2,2,0
31096.0,2019-12-12,"(1143.5, 1308.0]",1,2,-1
31097.0,2019-12-12,"(517.278, 698.5]",4,4,0
31097.0,2019-12-12,"(879.0, 1059.5]",1,5,-4
31097.0,2019-12-12,"(1059.5, 1240.0]",1,3,-2
31098.0,2019-12-12,"(419.158, 630.5]",7,12,-5
31098.0,2019-12-12,"(630.5, 841.0]",5,6,-1
31098.0,2019-12-12,"(841.0, 1051.5]",8,14,-6
31098.0,2019-12-12,"(1051.5, 1262.0]",1,3,-2
31099.0,2019-12-12,"(926.0, 1096.0]",3,3,0
31100.0,2019-12-12,"(371.978, 628.5]",13,13,0
31100.0,2019-12-12,"(628.5, 884.0]",1,2,-1
31100.0,2019-12-12,"(884.0, 1139.5]",3,18,-15
31101.0,2019-12-12,"(67.65, 406.5]",2,2,0
31101.0,2019-12-12,"(406.5, 744.0]",10,39,-29
31101.0,2019-12-12,"(744.0, 1081.5]",20,41,-21
31101.0,2019-12-12,"(1081.5, 1419.0]",31,47,-16
31102.0,2019-12-12,"(316.933, 584.75]",2,27,-25
31102.0,2019-12-12,"(584.75, 851.5]",1,5,-4
31102.0,2019-12-12,"(851.5, 1118.25]",6,13,-7
31102.0,2019-12-12,"(1118.25, 1385.0]",5,7,-2
31103.0,2019-12-12,"(649.5, 912.0]",1,29,-28
31103.0,2019-12-12,"(912.0, 1174.5]",13,7,6
31103.0,2019-12-12,"(1174.5, 1437.0]",9,31,-22
31104.0,2019-12-12,"(321.893, 599.75]",2,16,-14
31104.0,2019-12-12,"(599.75, 876.5]",6,10,-4
31104.0,2019-12-12,"(876.5, 1153.25]",14,24,-10
31104.0,2019-12-12,"(1153.25, 1430.0]",12,20,-8
31105.0,2019-12-12,"(29.646, 369.5]",2,3,-1
31105.0,2019-12-12,"(369.5, 708.0]",1,10,-9
31105.0,2019-12-12,"(708.0, 1046.5]",1,3,-2
31105.0,2019-12-12,"(1046.5, 1385.0]",4,7,-3
31106.0,2019-12-12,"(673.75, 898.5]",1,6,-5
31106.0,2019-12-12,"(898.5, 1123.25]",2,1,1
31106.0,2019-12-12,"(1123.25, 1348.0]",1,2,-1
31107.0,2019-12-12,"(340.982, 596.5]",2,21,-19
31107.0,2019-12-12,"(596.5, 851.0]",2,6,-4
31107.0,2019-12-12,"(851.0, 1105.5]",9,16,-7
31107.0,2019-12-12,"(1105.5, 1360.0]",10,17,-7
31108.0,2019-12-12,"(384.98, 641.0]",8,27,-19
31108.0,2019-12-12,"(641.0, 896.0]",13,28,-15
31108.0,2019-12-12,"(896.0, 1151.0]",17,33,-16
31108.0,2019-12-12,"(1151.0, 1406.0]",20,28,-8
31109.0,2019-12-12,"(335.925, 605.75]",2,14,-12
31109.0,2019-12-12,"(605.75, 874.5]",5,10,-5
31109.0,2019-12-12,"(874.5, 1143.25]",16,23,-7
31109.0,2019-12-12,"(1143.25, 1412.0]",6,13,-7
31110.0,2019-12-12,"(7.575, 365.25]",4,5,-1
31110.0,2019-12-12,"(365.25, 721.5]",22,45,-23
31110.0,2019-12-12,"(721.5, 1077.75]",12,27,-15
31110.0,2019-12-12,"(1077.75, 1434.0]",15,29,-14
31111.0,2019-12-12,"(320.897, 597.75]",10,28,-18
31111.0,2019-12-12,"(597.75, 873.5]",1,6,-5
31111.0,2019-12-12,"(873.5, 1149.25]",12,17,-5
31111.0,2019-12-12,"(1149.25, 1425.0]",5,12,-7
31112.0,2019-12-12,"(50.756, 363.0]",2,3,-1
31112.0,2019-12-12,"(985.0, 1296.0]",7,3,4
31113.0,2019-12-12,"(315.975, 573.25]",1,19,-18
31113.0,2019-12-12,"(573.25, 829.5]",2,15,-13
31113.0,2019-12-12,"(829.5, 1085.75]",7,10,-3
31113.0,2019-12-12,"(1085.75, 1342.0]",7,13,-6
31114.0,2019-12-12,"(343.943, 609.25]",2,23,-21
31114.0,2019-12-12,"(609.25, 873.5]",4,6,-2
31114.0,2019-12-12,"(873.5, 1137.75]",14,25,-11
31114.0,2019-12-12,"(1137.75, 1402.0]",16,23,-7
31115.0,2019-12-12,"(243.831, 537.25]",1,14,-13
31115.0,2019-12-12,"(829.5, 1121.75]",4,9,-5
31115.0,2019-12-12,"(1121.75, 1414.0]",7,12,-5
31116.0,2019-12-12,"(1.581, 357.75]",1,3,-2
31116.0,2019-12-12,"(357.75, 712.5]",5,25,-20
31116.0,2019-12-12,"(712.5, 1067.25]",12,22,-10
31116.0,2019-12-12,"(1067.25, 1422.0]",21,32,-11
31117.0,2019-12-12,"(308.904, 584.0]",3,23,-20
31117.0,2019-12-12,"(858.0, 1132.0]",6,14,-8
31117.0,2019-12-12,"(1132.0, 1406.0]",10,17,-7
31118.0,2019-12-12,"(423.029, 666.75]",2,15,-13
31118.0,2019-12-12,"(666.75, 909.5]",2,3,-1
31118.0,2019-12-12,"(909.5, 1152.25]",5,9,-4
31118.0,2019-12-12,"(1152.25, 1395.0]",13,15,-2
31119.0,2019-12-12,"(277.926, 547.5]",8,26,-18
31119.0,2019-12-12,"(547.5, 816.0]",5,10,-5
31119.0,2019-12-12,"(816.0, 1084.5]",8,12,-4
31119.0,2019-12-12,"(1084.5, 1353.0]",14,20,-6
31120.0,2019-12-12,"(17.58, 374.0]",1,2,-1
31120.0,2019-12-12,"(374.0, 729.0]",3,19,-16
31120.0,2019-12-12,"(729.0, 1084.0]",5,6,-1
31120.0,2019-12-12,"(1084.0, 1439.0]",6,13,-7
31121.0,2019-12-12,"(43.654, 381.5]",1,2,-1
31121.0,2019-12-12,"(381.5, 718.0]",12,23,-11
31121.0,2019-12-12,"(718.0, 1054.5]",6,18,-12
31121.0,2019-12-12,"(1054.5, 1391.0]",8,23,-15
31122.0,2019-12-12,"(312.912, 586.0]",2,15,-13
31122.0,2019-12-12,"(586.0, 858.0]",2,4,-2
31122.0,2019-12-12,"(858.0, 1130.0]",5,7,-2
31122.0,2019-12-12,"(1130.0, 1402.0]",4,13,-9
31123.0,2019-12-12,"(376.939, 643.25]",1,24,-23
31123.0,2019-12-12,"(908.5, 1173.75]",2,2,0
31123.0,2019-12-12,"(1173.75, 1439.0]",7,6,1
31124.0,2019-12-12,"(-0.357, 340.25]",2,2,0
31124.0,2019-12-12,"(340.25, 679.5]",19,46,-27
31124.0,2019-12-12,"(679.5, 1018.75]",11,28,-17
31124.0,2019-12-12,"(1018.75, 1358.0]",17,47,-30
31125.0,2019-12-12,"(129.889, 408.75]",2,6,-4
31125.0,2019-12-12,"(408.75, 686.5]",2,17,-15
31125.0,2019-12-12,"(686.5, 964.25]",3,4,-1
31125.0,2019-12-12,"(964.25, 1242.0]",23,31,-8
31126.0,2019-12-12,"(396.978, 653.5]",1,23,-22
31126.0,2019-12-12,"(653.5, 909.0]",1,10,-9
31126.0,2019-12-12,"(909.0, 1164.5]",13,17,-4
31126.0,2019-12-12,"(1164.5, 1420.0]",8,9,-1
,,,,2.0,
31128.0,2019-12-12,"(12.613, 360.75]",5,6,-1
31128.0,2019-12-12,"(360.75, 707.5]",20,32,-12
31128.0,2019-12-12,"(707.5, 1054.25]",12,20,-8
31128.0,2019-12-12,"(1054.25, 1401.0]",8,14,-6
31129.0,2019-12-12,"(419.062, 654.5]",6,6,0
31129.0,2019-12-12,"(654.5, 889.0]",2,7,-5
31129.0,2019-12-12,"(889.0, 1123.5]",4,11,-7
31129.0,2019-12-12,"(1123.5, 1358.0]",3,7,-4
31130.0,2019-12-12,"(37.632, 381.0]",1,2,-1
31130.0,2019-12-12,"(381.0, 723.0]",3,13,-10
31130.0,2019-12-12,"(723.0, 1065.0]",4,8,-4
31130.0,2019-12-12,"(1065.0, 1407.0]",6,9,-3
31131.0,2019-12-12,"(251.882, 532.5]",1,11,-10
31131.0,2019-12-12,"(812.0, 1091.5]",3,4,-1
31131.0,2019-12-12,"(1091.5, 1371.0]",3,5,-2
31200.0,2019-12-12,"(342.915, 615.25]",30,44,-14
31200.0,2019-12-12,"(615.25, 886.5]",23,37,-14
31200.0,2019-12-12,"(886.5, 1157.75]",17,36,-19
31200.0,2019-12-12,"(1157.75, 1429.0]",3,19,-16
31201.0,2019-12-12,"(63.636, 406.0]",6,11,-5
31201.0,2019-12-12,"(406.0, 747.0]",17,44,-27
31201.0,2019-12-12,"(747.0, 1088.0]",28,46,-18
31201.0,2019-12-12,"(1088.0, 1429.0]",33,61,-28
31202.0,2019-12-12,"(350.933, 618.75]",5,20,-15
31202.0,2019-12-12,"(618.75, 885.5]",9,17,-8
31202.0,2019-12-12,"(885.5, 1152.25]",27,40,-13
31202.0,2019-12-12,"(1152.25, 1419.0]",5,12,-7
31203.0,2019-12-12,"(9.584, 365.0]",2,6,-4
31203.0,2019-12-12,"(365.0, 719.0]",8,24,-16
31203.0,2019-12-12,"(719.0, 1073.0]",19,31,-12
31203.0,2019-12-12,"(1073.0, 1427.0]",13,21,-8
31204.0,2019-12-12,"(416.182, 621.5]",8,12,-4
31204.0,2019-12-12,"(621.5, 826.0]",2,4,-2
31204.0,2019-12-12,"(826.0, 1030.5]",5,17,-12
31204.0,2019-12-12,"(1030.5, 1235.0]",1,8,-7
31205.0,2019-12-12,"(411.0, 751.0]",29,2,27
31205.0,2019-12-12,"(751.0, 1091.0]",16,34,-18
31205.0,2019-12-12,"(1091.0, 1431.0]",3,38,-35
31206.0,2019-12-12,"(429.359, 590.25]",7,8,-1
31206.0,2019-12-12,"(750.5, 910.75]",2,1,1
31206.0,2019-12-12,"(910.75, 1071.0]",5,5,0
31207.0,2019-12-12,"(605.75, 867.5]",2,6,-4
31207.0,2019-12-12,"(867.5, 1129.25]",2,4,-2
31207.0,2019-12-12,"(1129.25, 1391.0]",3,4,-1
31208.0,2019-12-12,"(379.981, 635.75]",17,21,-4
31208.0,2019-12-12,"(890.5, 1145.25]",7,1,6
31208.0,2019-12-12,"(1145.25, 1400.0]",3,16,-13
31209.0,2019-12-12,"(512.101, 737.75]",2,5,-3
31209.0,2019-12-12,"(737.75, 962.5]",2,4,-2
31209.0,2019-12-12,"(962.5, 1187.25]",1,2,-1
31209.0,2019-12-12,"(1187.25, 1412.0]",2,2,0
31211.0,2019-12-12,"(455.133, 672.75]",9,13,-4
31211.0,2019-12-12,"(672.75, 889.5]",2,5,-3
31211.0,2019-12-12,"(889.5, 1106.25]",12,15,-3
31211.0,2019-12-12,"(1106.25, 1323.0]",4,8,-4
31212.0,2019-12-12,"(1.59, 355.5]",4,4,0
31212.0,2019-12-12,"(355.5, 708.0]",29,39,-10
31212.0,2019-12-12,"(708.0, 1060.5]",18,36,-18
31212.0,2019-12-12,"(1060.5, 1413.0]",16,26,-10
31213.0,2019-12-12,"(397.989, 651.75]",34,49,-15
31213.0,2019-12-12,"(651.75, 904.5]",8,15,-7
31213.0,2019-12-12,"(904.5, 1157.25]",16,27,-11
31214.0,2019-12-12,"(7.597, 359.75]",1,2,-1
31214.0,2019-12-12,"(359.75, 710.5]",14,38,-24
31214.0,2019-12-12,"(710.5, 1061.25]",18,31,-13
31214.0,2019-12-12,"(1061.25, 1412.0]",16,25,-9
31215.0,2019-12-12,"(413.012, 661.0]",18,19,-1
31215.0,2019-12-12,"(661.0, 908.0]",8,12,-4
31215.0,2019-12-12,"(908.0, 1155.0]",6,17,-11
31215.0,2019-12-12,"(1155.0, 1402.0]",1,5,-4
31216.0,2019-12-12,"(316.924, 587.0]",18,19,-1
31216.0,2019-12-12,"(587.0, 856.0]",4,5,-1
31216.0,2019-12-12,"(856.0, 1125.0]",5,22,-17
31216.0,2019-12-12,"(1125.0, 1394.0]",3,10,-7
31217.0,2019-12-12,"(324.121, 544.75]",10,10,0
31217.0,2019-12-12,"(764.5, 984.25]",1,1,0
31217.0,2019-12-12,"(984.25, 1204.0]",6,5,1
31218.0,2019-12-12,"(412.005, 661.75]",14,27,-13
31218.0,2019-12-12,"(661.75, 910.5]",2,5,-3
31218.0,2019-12-12,"(910.5, 1159.25]",8,14,-6
31218.0,2019-12-12,"(1159.25, 1408.0]",2,4,-2
31219.0,2019-12-12,"(443.283, 623.25]",17,18,-1
31219.0,2019-12-12,"(623.25, 802.5]",7,7,0
31219.0,2019-12-12,"(802.5, 981.75]",2,10,-8
31219.0,2019-12-12,"(981.75, 1161.0]",4,14,-10
31220.0,2019-12-12,"(346.289, 524.75]",15,17,-2
31220.0,2019-12-12,"(524.75, 702.5]",3,4,-1
31220.0,2019-12-12,"(702.5, 880.25]",3,9,-6
31221.0,2019-12-12,"(112.716, 435.0]",4,4,0
31221.0,2019-12-12,"(435.0, 756.0]",34,40,-6
31221.0,2019-12-12,"(756.0, 1077.0]",14,39,-25
31221.0,2019-12-12,"(1077.0, 1398.0]",13,32,-19
31222.0,2019-12-12,"(426.23, 619.5]",15,17,-2
31222.0,2019-12-12,"(619.5, 812.0]",3,3,0
31222.0,2019-12-12,"(812.0, 1004.5]",3,6,-3
31222.0,2019-12-12,"(1004.5, 1197.0]",7,22,-15
31223.0,2019-12-12,"(14.596, 367.0]",2,3,-1
31223.0,2019-12-12,"(367.0, 718.0]",8,34,-26
31223.0,2019-12-12,"(718.0, 1069.0]",8,19,-11
31223.0,2019-12-12,"(1069.0, 1420.0]",11,19,-8
31224.0,2019-12-12,"(374.202, 574.5]",10,10,0
31224.0,2019-12-12,"(574.5, 774.0]",6,7,-1
31224.0,2019-12-12,"(774.0, 973.5]",4,7,-3
31224.0,2019-12-12,"(973.5, 1173.0]",2,13,-11
31225.0,2019-12-12,"(418.092, 646.0]",11,16,-5
31225.0,2019-12-12,"(646.0, 873.0]",4,10,-6
31225.0,2019-12-12,"(873.0, 1100.0]",9,18,-9
31225.0,2019-12-12,"(1100.0, 1327.0]",8,12,-4
31226.0,2019-12-12,"(438.002, 688.5]",4,11,-7
31226.0,2019-12-12,"(688.5, 938.0]",2,4,-2
31226.0,2019-12-12,"(938.0, 1187.5]",4,4,0
31226.0,2019-12-12,"(1187.5, 1437.0]",4,7,-3
31227.0,2019-12-12,"(435.068, 669.0]",26,31,-5
31227.0,2019-12-12,"(669.0, 902.0]",11,16,-5
31227.0,2019-12-12,"(902.0, 1135.0]",13,21,-8
31227.0,2019-12-12,"(1135.0, 1368.0]",1,9,-8
31228.0,2019-12-12,"(6.621, 352.75]",1,3,-2
31228.0,2019-12-12,"(352.75, 697.5]",16,24,-8
31228.0,2019-12-12,"(697.5, 1042.25]",16,31,-15
31228.0,2019-12-12,"(1042.25, 1387.0]",20,37,-17
31229.0,2019-12-12,"(298.022, 543.5]",9,41,-32
31229.0,2019-12-12,"(543.5, 788.0]",10,37,-27
31229.0,2019-12-12,"(788.0, 1032.5]",17,29,-12
31229.0,2019-12-12,"(1032.5, 1277.0]",29,46,-17
31230.0,2019-12-12,"(363.013, 610.75]",56,66,-10
31230.0,2019-12-12,"(610.75, 857.5]",11,15,-4
31230.0,2019-12-12,"(857.5, 1104.25]",17,38,-21
31230.0,2019-12-12,"(1104.25, 1351.0]",8,26,-18
31231.0,2019-12-12,"(326.914, 599.5]",19,22,-3
31231.0,2019-12-12,"(599.5, 871.0]",7,12,-5
31231.0,2019-12-12,"(871.0, 1142.5]",10,22,-12
31231.0,2019-12-12,"(1142.5, 1414.0]",1,4,-3
31232.0,2019-12-12,"(296.939, 563.25]",12,17,-5
31232.0,2019-12-12,"(563.25, 828.5]",4,10,-6
31232.0,2019-12-12,"(828.5, 1093.75]",11,21,-10
31232.0,2019-12-12,"(1093.75, 1359.0]",5,12,-7
31233.0,2019-12-12,"(353.5, 699.0]",30,1,29
31233.0,2019-12-12,"(699.0, 1044.5]",12,37,-25
31233.0,2019-12-12,"(1044.5, 1390.0]",15,25,-10
31234.0,2019-12-12,"(350.5, 677.0]",18,1,17
31234.0,2019-12-12,"(677.0, 1003.5]",13,33,-20
31234.0,2019-12-12,"(1003.5, 1330.0]",18,24,-6
31235.0,2019-12-12,"(503.211, 701.25]",6,6,0
31235.0,2019-12-12,"(701.25, 898.5]",1,2,-1
31235.0,2019-12-12,"(898.5, 1095.75]",2,3,-1
31236.0,2019-12-12,"(435.005, 684.75]",20,23,-3
31236.0,2019-12-12,"(684.75, 933.5]",9,16,-7
31236.0,2019-12-12,"(933.5, 1182.25]",3,18,-15
31236.0,2019-12-12,"(1182.25, 1431.0]",1,9,-8
31237.0,2019-12-12,"(0.567, 360.25]",2,3,-1
31237.0,2019-12-12,"(360.25, 718.5]",7,18,-11
31237.0,2019-12-12,"(718.5, 1076.75]",16,30,-14
31237.0,2019-12-12,"(1076.75, 1435.0]",6,14,-8
31238.0,2019-12-12,"(45.617, 392.75]",1,1,0
31238.0,2019-12-12,"(392.75, 738.5]",22,29,-7
31238.0,2019-12-12,"(738.5, 1084.25]",7,22,-15
31238.0,2019-12-12,"(1084.25, 1430.0]",4,13,-9
31239.0,2019-12-12,"(373.945, 638.75]",32,33,-1
31239.0,2019-12-12,"(638.75, 902.5]",5,15,-10
31239.0,2019-12-12,"(902.5, 1166.25]",10,29,-19
31239.0,2019-12-12,"(1166.25, 1430.0]",3,8,-5
31240.0,2019-12-12,"(418.277, 599.75]",1,2,-1
31240.0,2019-12-12,"(599.75, 780.5]",1,2,-1
31240.0,2019-12-12,"(961.25, 1142.0]",3,4,-1
31241.0,2019-12-12,"(36.602, 387.5]",3,5,-2
31241.0,2019-12-12,"(387.5, 737.0]",31,67,-36
31241.0,2019-12-12,"(737.0, 1086.5]",16,36,-20
31241.0,2019-12-12,"(1086.5, 1436.0]",14,35,-21
31242.0,2019-12-12,"(320.25, 612.5]",30,1,29
31242.0,2019-12-12,"(612.5, 904.75]",14,32,-18
31242.0,2019-12-12,"(904.75, 1197.0]",8,24,-16
31243.0,2019-12-12,"(371.004, 621.0]",34,39,-5
31243.0,2019-12-12,"(621.0, 870.0]",9,14,-5
31243.0,2019-12-12,"(870.0, 1119.0]",7,26,-19
31243.0,2019-12-12,"(1119.0, 1368.0]",3,7,-4
31244.0,2019-12-12,"(323.5, 642.0]",17,2,15
31244.0,2019-12-12,"(642.0, 960.5]",7,27,-20
31244.0,2019-12-12,"(960.5, 1279.0]",16,20,-4
31245.0,2019-12-12,"(19.608, 369.0]",2,3,-1
31245.0,2019-12-12,"(369.0, 717.0]",10,22,-12
31245.0,2019-12-12,"(717.0, 1065.0]",8,20,-12
31245.0,2019-12-12,"(1065.0, 1413.0]",15,25,-10
31246.0,2019-12-12,"(-1.404, 351.0]",2,5,-3
31246.0,2019-12-12,"(351.0, 702.0]",19,28,-9
31246.0,2019-12-12,"(702.0, 1053.0]",15,32,-17
31246.0,2019-12-12,"(1053.0, 1404.0]",15,24,-9
31247.0,2019-12-12,"(420.007, 669.25]",10,12,-2
31247.0,2019-12-12,"(669.25, 917.5]",9,23,-14
31247.0,2019-12-12,"(917.5, 1165.75]",13,19,-6
31247.0,2019-12-12,"(1165.75, 1414.0]",1,6,-5
31248.0,2019-12-12,"(14.827, 309.25]",1,2,-1
31248.0,2019-12-12,"(309.25, 602.5]",12,18,-6
31248.0,2019-12-12,"(602.5, 895.75]",11,15,-4
31248.0,2019-12-12,"(895.75, 1189.0]",10,19,-9
31249.0,2019-12-12,"(357.261, 542.75]",5,9,-4
31249.0,2019-12-12,"(542.75, 727.5]",5,10,-5
31249.0,2019-12-12,"(727.5, 912.25]",3,5,-2
31249.0,2019-12-12,"(912.25, 1097.0]",7,14,-7
31250.0,2019-12-12,"(411.04, 652.0]",21,26,-5
31250.0,2019-12-12,"(652.0, 892.0]",2,5,-3
31250.0,2019-12-12,"(892.0, 1132.0]",9,25,-16
31250.0,2019-12-12,"(1132.0, 1372.0]",1,4,-3
31251.0,2019-12-12,"(337.923, 608.25]",21,38,-17
31251.0,2019-12-12,"(608.25, 877.5]",7,14,-7
31251.0,2019-12-12,"(877.5, 1146.75]",16,35,-19
31251.0,2019-12-12,"(1146.75, 1416.0]",4,4,0
31252.0,2019-12-12,"(370.237, 561.75]",16,17,-1
31252.0,2019-12-12,"(561.75, 752.5]",1,2,-1
31252.0,2019-12-12,"(752.5, 943.25]",3,10,-7
31252.0,2019-12-12,"(943.25, 1134.0]",2,19,-17
31253.0,2019-12-12,"(422.019, 668.25]",23,28,-5
31253.0,2019-12-12,"(668.25, 913.5]",2,6,-4
31253.0,2019-12-12,"(913.5, 1158.75]",8,24,-16
31253.0,2019-12-12,"(1158.75, 1404.0]",1,4,-3
31254.0,2019-12-12,"(439.138, 655.5]",18,20,-2
31254.0,2019-12-12,"(655.5, 871.0]",7,12,-5
31254.0,2019-12-12,"(871.0, 1086.5]",2,14,-12
31254.0,2019-12-12,"(1086.5, 1302.0]",3,14,-11
31255.0,2019-12-12,"(366.5, 686.0]",18,1,17
31255.0,2019-12-12,"(686.0, 1005.5]",2,23,-21
31255.0,2019-12-12,"(1005.5, 1325.0]",8,7,1
31256.0,2019-12-12,"(273.866, 558.5]",9,10,-1
31256.0,2019-12-12,"(558.5, 842.0]",3,4,-1
31256.0,2019-12-12,"(842.0, 1125.5]",3,8,-5
31256.0,2019-12-12,"(1125.5, 1409.0]",5,8,-3
31257.0,2019-12-12,"(27.608, 377.0]",2,4,-2
31257.0,2019-12-12,"(377.0, 725.0]",21,30,-9
31257.0,2019-12-12,"(725.0, 1073.0]",11,31,-20
31257.0,2019-12-12,"(1073.0, 1421.0]",9,23,-14
31258.0,2019-12-12,"(33.664, 369.0]",1,2,-1
31258.0,2019-12-12,"(369.0, 703.0]",5,13,-8
31258.0,2019-12-12,"(703.0, 1037.0]",9,16,-7
31258.0,2019-12-12,"(1037.0, 1371.0]",3,5,-2
31259.0,2019-12-12,"(454.275, 636.25]",12,12,0
31259.0,2019-12-12,"(817.5, 998.75]",1,2,-1
31260.0,2019-12-12,"(396.976, 654.0]",16,22,-6
31260.0,2019-12-12,"(654.0, 910.0]",8,14,-6
31260.0,2019-12-12,"(910.0, 1166.0]",7,23,-16
31260.0,2019-12-12,"(1166.0, 1422.0]",4,6,-2
31261.0,2019-12-12,"(417.32, 588.0]",9,9,0
31261.0,2019-12-12,"(758.0, 928.0]",1,1,0
31262.0,2019-12-12,"(355.5, 700.0]",7,1,6
31262.0,2019-12-12,"(700.0, 1044.5]",2,7,-5
31262.0,2019-12-12,"(1044.5, 1389.0]",4,7,-3
31263.0,2019-12-12,"(340.949, 604.75]",22,32,-10
31263.0,2019-12-12,"(604.75, 867.5]",8,15,-7
31263.0,2019-12-12,"(867.5, 1130.25]",12,28,-16
31263.0,2019-12-12,"(1130.25, 1393.0]",3,6,-3
31264.0,2019-12-12,"(441.052, 679.0]",17,23,-6
31264.0,2019-12-12,"(679.0, 916.0]",4,7,-3
31264.0,2019-12-12,"(916.0, 1153.0]",4,14,-10
31264.0,2019-12-12,"(1153.0, 1390.0]",2,3,-1
31265.0,2019-12-12,"(35.612, 384.0]",3,3,0
31265.0,2019-12-12,"(384.0, 731.0]",22,51,-29
31265.0,2019-12-12,"(731.0, 1078.0]",15,25,-10
31265.0,2019-12-12,"(1078.0, 1425.0]",14,25,-11
31266.0,2019-12-12,"(138.705, 463.75]",3,12,-9
31266.0,2019-12-12,"(463.75, 787.5]",6,25,-19
31266.0,2019-12-12,"(787.5, 1111.25]",25,50,-25
31266.0,2019-12-12,"(1111.25, 1435.0]",12,21,-9
31267.0,2019-12-12,"(76.639, 418.25]",2,3,-1
31267.0,2019-12-12,"(418.25, 758.5]",19,33,-14
31267.0,2019-12-12,"(758.5, 1098.75]",17,32,-15
31267.0,2019-12-12,"(1098.75, 1439.0]",10,24,-14
31268.0,2019-12-12,"(322.915, 595.25]",14,43,-29
31268.0,2019-12-12,"(595.25, 866.5]",3,7,-4
31268.0,2019-12-12,"(866.5, 1137.75]",18,23,-5
31268.0,2019-12-12,"(1137.75, 1409.0]",5,9,-4
31269.0,2019-12-12,"(334.0, 585.0]",7,15,-8
31269.0,2019-12-12,"(585.0, 835.0]",8,10,-2
31269.0,2019-12-12,"(835.0, 1085.0]",5,15,-10
31269.0,2019-12-12,"(1085.0, 1335.0]",2,5,-3
31270.0,2019-12-12,"(412.976, 670.0]",14,17,-3
31270.0,2019-12-12,"(670.0, 926.0]",3,8,-5
31270.0,2019-12-12,"(926.0, 1182.0]",7,15,-8
31270.0,2019-12-12,"(1182.0, 1438.0]",1,2,-1
31271.0,2019-12-12,"(382.048, 621.0]",13,14,-1
31271.0,2019-12-12,"(621.0, 859.0]",3,8,-5
31271.0,2019-12-12,"(859.0, 1097.0]",7,25,-18
31271.0,2019-12-12,"(1097.0, 1335.0]",5,20,-15
31272.0,2019-12-12,"(376.0, 674.0]",24,1,23
31272.0,2019-12-12,"(674.0, 972.0]",6,24,-18
31272.0,2019-12-12,"(972.0, 1270.0]",7,15,-8
31273.0,2019-12-12,"(523.19, 726.5]",1,3,-2
31273.0,2019-12-12,"(726.5, 929.0]",1,1,0
31273.0,2019-12-12,"(929.0, 1131.5]",5,7,-2
31273.0,2019-12-12,"(1131.5, 1334.0]",2,2,0
31274.0,2019-12-12,"(423.064, 658.0]",18,21,-3
31274.0,2019-12-12,"(658.0, 892.0]",3,6,-3
31274.0,2019-12-12,"(892.0, 1126.0]",3,8,-5
31274.0,2019-12-12,"(1126.0, 1360.0]",2,10,-8
31275.0,2019-12-12,"(95.667, 430.25]",4,6,-2
31275.0,2019-12-12,"(430.25, 763.5]",17,28,-11
31275.0,2019-12-12,"(763.5, 1096.75]",19,36,-17
31275.0,2019-12-12,"(1096.75, 1430.0]",10,21,-11
31276.0,2019-12-12,"(435.189, 638.75]",23,27,-4
31276.0,2019-12-12,"(638.75, 841.5]",7,12,-5
31276.0,2019-12-12,"(841.5, 1044.25]",8,16,-8
31276.0,2019-12-12,"(1044.25, 1247.0]",4,18,-14
31277.0,2019-12-12,"(432.17, 640.5]",33,36,-3
31277.0,2019-12-12,"(640.5, 848.0]",17,25,-8
31277.0,2019-12-12,"(848.0, 1055.5]",9,30,-21
31277.0,2019-12-12,"(1055.5, 1263.0]",6,24,-18
31278.0,2019-12-12,"(373.942, 639.5]",6,26,-20
31278.0,2019-12-12,"(639.5, 904.0]",6,14,-8
31278.0,2019-12-12,"(904.0, 1168.5]",16,30,-14
31278.0,2019-12-12,"(1168.5, 1433.0]",9,16,-7
31279.0,2019-12-12,"(404.213, 601.75]",18,18,0
31279.0,2019-12-12,"(601.75, 798.5]",2,5,-3
31279.0,2019-12-12,"(798.5, 995.25]",3,7,-4
31279.0,2019-12-12,"(995.25, 1192.0]",2,23,-21
31280.0,2019-12-12,"(350.014, 597.5]",9,25,-16
31280.0,2019-12-12,"(597.5, 844.0]",5,8,-3
31280.0,2019-12-12,"(844.0, 1090.5]",5,6,-1
31280.0,2019-12-12,"(1090.5, 1337.0]",6,12,-6
31000.0,2019-12-13,"(456.0, 608.0]",1,1,0
31001.0,2019-12-13,"(1035.86, 1071.0]",1,2,-1
31001.0,2019-12-13,"(1141.0, 1176.0]",1,1,0
31002.0,2019-12-13,"(364.181, 569.75]",1,5,-4
31002.0,2019-12-13,"(569.75, 774.5]",1,2,-1
31002.0,2019-12-13,"(979.25, 1184.0]",3,6,-3
31003.0,2019-12-13,"(487.505, 611.75]",1,2,-1
31003.0,2019-12-13,"(859.25, 983.0]",1,3,-2
31004.0,2019-12-13,"(941.5, 1169.75]",2,3,-1
31004.0,2019-12-13,"(1169.75, 1398.0]",1,1,0
31005.0,2019-12-13,"(420.027, 664.25]",6,6,0
31005.0,2019-12-13,"(664.25, 907.5]",1,2,-1
31005.0,2019-12-13,"(907.5, 1150.75]",1,4,-3
31005.0,2019-12-13,"(1150.75, 1394.0]",1,2,-1
31006.0,2019-12-13,"(836.25, 1115.0]",1,1,0
31007.0,2019-12-13,"(1108.0, 1111.0]",1,1,0
31009.0,2019-12-13,"(276.75, 369.0]",1,1,0
31010.0,2019-12-13,"(360.193, 562.75]",3,3,0
31010.0,2019-12-13,"(562.75, 764.5]",2,3,-1
31010.0,2019-12-13,"(966.25, 1168.0]",3,1,2
31011.0,2019-12-13,"(397.283, 577.25]",3,3,0
31012.0,2019-12-13,"(571.476, 703.0]",2,2,0
31013.0,2019-12-13,"(765.5, 928.0]",2,1,1
31013.0,2019-12-13,"(1090.5, 1253.0]",1,2,-1
31014.0,2019-12-13,"(55.639, 397.25]",2,3,-1
31014.0,2019-12-13,"(397.25, 737.5]",13,15,-2
31014.0,2019-12-13,"(737.5, 1077.75]",6,11,-5
31014.0,2019-12-13,"(1077.75, 1418.0]",2,4,-2
31015.0,2019-12-13,"(302.946, 567.5]",10,13,-3
31015.0,2019-12-13,"(567.5, 831.0]",2,2,0
31015.0,2019-12-13,"(831.0, 1094.5]",2,4,-2
31015.0,2019-12-13,"(1094.5, 1358.0]",4,5,-1
31016.0,2019-12-13,"(443.271, 626.25]",2,4,-2
31017.0,2019-12-13,"(485.169, 693.75]",4,7,-3
31017.0,2019-12-13,"(901.5, 1109.25]",2,6,-4
31017.0,2019-12-13,"(1109.25, 1317.0]",1,3,-2
31018.0,2019-12-13,"(724.5, 884.25]",1,4,-3
31018.0,2019-12-13,"(884.25, 1044.0]",3,2,1
31019.0,2019-12-13,"(679.0, 900.0]",1,1,0
31019.0,2019-12-13,"(900.0, 1121.0]",3,2,1
,,,,2.0,
,,,,1.0,
,,,,1.0,
31021.0,2019-12-13,"(419.352, 582.0]",1,2,-1
31021.0,2019-12-13,"(906.0, 1068.0]",1,1,0
31022.0,2019-12-13,"(478.365, 637.75]",2,2,0
31023.0,2019-12-13,"(1115.0, 1240.5]",1,1,0
31024.0,2019-12-13,"(490.331, 658.25]",1,1,0
31024.0,2019-12-13,"(992.75, 1160.0]",4,1,3
,,,,1.0,
,,,,2.0,
31026.0,2019-12-13,"(1050.0, 1098.0]",1,1,0
31027.0,2019-12-13,"(894.5, 946.25]",1,1,0
31027.0,2019-12-13,"(946.25, 998.0]",1,1,0
31028.0,2019-12-13,"(475.08, 706.0]",2,2,0
31029.0,2019-12-13,"(608.5, 807.0]",1,4,-3
31029.0,2019-12-13,"(1005.5, 1204.0]",2,1,1
31030.0,2019-12-13,"(26.629, 370.75]",1,1,0
31030.0,2019-12-13,"(370.75, 713.5]",1,7,-6
31030.0,2019-12-13,"(1056.25, 1399.0]",3,3,0
31031.0,2019-12-13,"(20.987, 275.25]",1,1,0
31031.0,2019-12-13,"(781.75, 1035.0]",2,2,0
31032.0,2019-12-13,"(873.5, 1038.0]",1,1,0
31033.0,2019-12-13,"(536.514, 658.5]",1,1,0
31033.0,2019-12-13,"(901.5, 1023.0]",1,1,0
31034.0,2019-12-13,"(420.0, 560.0]",1,1,0
31035.0,2019-12-13,"(710.0, 888.5]",1,3,-2
31035.0,2019-12-13,"(888.5, 1067.0]",1,2,-1
31036.0,2019-12-13,"(826.0, 1043.0]",1,3,-2
31036.0,2019-12-13,"(1043.0, 1260.0]",1,1,0
31037.0,2019-12-13,"(389.121, 609.75]",14,16,-2
31037.0,2019-12-13,"(609.75, 829.5]",2,2,0
31037.0,2019-12-13,"(829.5, 1049.25]",4,7,-3
31038.0,2019-12-13,"(703.5, 809.0]",2,1,1
31039.0,2019-12-13,"(650.25, 812.5]",1,3,-2
31039.0,2019-12-13,"(974.75, 1137.0]",2,1,1
31040.0,2019-12-13,"(454.21, 652.5]",1,1,0
31040.0,2019-12-13,"(1047.5, 1245.0]",3,3,0
31041.0,2019-12-13,"(1061.5, 1119.75]",1,2,-1
31042.0,2019-12-13,"(440.39, 593.5]",7,8,-1
31042.0,2019-12-13,"(593.5, 746.0]",1,1,0
31043.0,2019-12-13,"(455.344, 620.0]",2,2,0
31044.0,2019-12-13,"(438.191, 641.25]",1,2,-1
31044.0,2019-12-13,"(843.5, 1045.75]",1,1,0
31045.0,2019-12-13,"(441.237, 632.75]",2,2,0
31045.0,2019-12-13,"(1014.25, 1205.0]",1,1,0
31046.0,2019-12-13,"(397.352, 560.0]",1,2,-1
31046.0,2019-12-13,"(884.0, 1046.0]",1,2,-1
31047.0,2019-12-13,"(348.089, 576.75]",6,12,-6
31047.0,2019-12-13,"(576.75, 804.5]",1,1,0
31047.0,2019-12-13,"(804.5, 1032.25]",2,6,-4
31047.0,2019-12-13,"(1032.25, 1260.0]",4,7,-3
31048.0,2019-12-13,"(352.074, 584.5]",2,3,-1
31048.0,2019-12-13,"(816.0, 1047.5]",1,1,0
31048.0,2019-12-13,"(1047.5, 1279.0]",1,3,-2
31049.0,2019-12-13,"(711.75, 949.0]",1,1,0
31050.0,2019-12-13,"(367.927, 386.25]",1,1,0
31051.0,2019-12-13,"(692.5, 888.25]",1,2,-1
31051.0,2019-12-13,"(888.25, 1084.0]",5,3,2
,,,,2.0,
,,,,2.0,
,,,,2.0,
31055.0,2019-12-13,"(491.374, 648.5]",1,2,-1
31055.0,2019-12-13,"(961.5, 1118.0]",1,1,0
31056.0,2019-12-13,"(74.003, 324.25]",1,1,0
31056.0,2019-12-13,"(822.75, 1072.0]",1,1,0
,,,,2.0,
,,,,2.0,
,,,,2.0,
31060.0,2019-12-13,"(849.0, 1111.0]",1,1,0
31061.0,2019-12-13,"(538.5, 718.0]",1,1,0
,,,,2.0,
,,,,2.0,
31064.0,2019-12-13,"(584.524, 704.0]",1,2,-1
31064.0,2019-12-13,"(942.0, 1061.0]",1,2,-1
,,,,1.0,
,,,,2.0,
,,,,1.0,
,,,,1.0,
31067.0,2019-12-13,"(271.75, 543.5]",1,1,0
31067.0,2019-12-13,"(815.25, 1087.0]",1,1,0
,,,,2.0,
31069.0,2019-12-13,"(838.0, 1057.0]",2,3,-1
31069.0,2019-12-13,"(1057.0, 1276.0]",1,2,-1
31070.0,2019-12-13,"(906.0, 1118.5]",2,1,1
31070.0,2019-12-13,"(1118.5, 1331.0]",1,4,-3
31071.0,2019-12-13,"(445.19, 648.5]",1,2,-1
31071.0,2019-12-13,"(648.5, 851.0]",1,1,0
31071.0,2019-12-13,"(851.0, 1053.5]",2,4,-2
31071.0,2019-12-13,"(1053.5, 1256.0]",2,3,-1
,,,,2.0,
,,,,2.0,
31074.0,2019-12-13,"(486.114, 708.5]",1,2,-1
31074.0,2019-12-13,"(930.0, 1151.5]",4,5,-1
31074.0,2019-12-13,"(1151.5, 1373.0]",1,2,-1
,,,,2.0,
31076.0,2019-12-13,"(791.25, 1055.0]",1,1,0
31077.0,2019-12-13,"(411.052, 649.0]",1,7,-6
31077.0,2019-12-13,"(649.0, 886.0]",1,2,-1
31077.0,2019-12-13,"(886.0, 1123.0]",1,2,-1
31077.0,2019-12-13,"(1123.0, 1360.0]",1,1,0
31078.0,2019-12-13,"(495.556, 607.0]",2,2,0
31079.0,2019-12-13,"(69.779, 376.25]",1,1,0
31079.0,2019-12-13,"(986.75, 1292.0]",1,3,-2
31080.0,2019-12-13,"(411.062, 646.5]",2,11,-9
31080.0,2019-12-13,"(881.0, 1115.5]",2,3,-1
31080.0,2019-12-13,"(1115.5, 1350.0]",3,3,0
31081.0,2019-12-13,"(907.25, 1089.0]",2,1,1
,,,,1.0,
,,,,1.0,
31083.0,2019-12-13,"(844.5, 968.0]",1,1,0
31084.0,2019-12-13,"(787.506, 911.5]",1,3,-2
31084.0,2019-12-13,"(911.5, 1035.0]",1,2,-1
31084.0,2019-12-13,"(1158.5, 1282.0]",1,2,-1
31085.0,2019-12-13,"(402.128, 621.0]",1,2,-1
31085.0,2019-12-13,"(1057.0, 1275.0]",1,1,0
31086.0,2019-12-13,"(74.805, 374.75]",1,1,0
31086.0,2019-12-13,"(374.75, 673.5]",1,3,-2
31086.0,2019-12-13,"(673.5, 972.25]",3,3,0
31087.0,2019-12-13,"(864.25, 1008.0]",1,2,-1
31088.0,2019-12-13,"(1000.5, 1202.0]",3,1,2
31089.0,2019-12-13,"(479.399, 630.25]",3,4,-1
31089.0,2019-12-13,"(630.25, 780.5]",1,2,-1
31089.0,2019-12-13,"(930.75, 1081.0]",1,1,0
,,,,1.0,
,,,,1.0,
31091.0,2019-12-13,"(805.5, 1012.75]",1,5,-4
,,,,2.0,
,,,,1.0,
,,,,1.0,
31094.0,2019-12-13,"(771.75, 1029.0]",1,1,0
,,,,2.0,
31096.0,2019-12-13,"(979.875, 1011.25]",1,2,-1
31096.0,2019-12-13,"(1073.75, 1105.0]",1,1,0
31097.0,2019-12-13,"(455.362, 615.5]",2,2,0
31097.0,2019-12-13,"(934.5, 1094.0]",2,3,-1
31098.0,2019-12-13,"(622.25, 810.5]",1,5,-4
31098.0,2019-12-13,"(998.75, 1187.0]",3,1,2
,,,,2.0,
31100.0,2019-12-13,"(384.0, 731.0]",4,2,2
31100.0,2019-12-13,"(731.0, 1078.0]",1,4,-3
31100.0,2019-12-13,"(1078.0, 1425.0]",3,4,-1
31101.0,2019-12-13,"(27.623, 373.25]",3,3,0
31101.0,2019-12-13,"(373.25, 717.5]",9,29,-20
31101.0,2019-12-13,"(717.5, 1061.75]",21,33,-12
31101.0,2019-12-13,"(1061.75, 1406.0]",16,25,-9
31102.0,2019-12-13,"(36.6, 388.0]",1,2,-1
31102.0,2019-12-13,"(388.0, 738.0]",2,14,-12
31102.0,2019-12-13,"(738.0, 1088.0]",2,11,-9
31102.0,2019-12-13,"(1088.0, 1438.0]",7,10,-3
31103.0,2019-12-13,"(702.0, 1053.0]",3,3,0
31103.0,2019-12-13,"(1053.0, 1404.0]",5,17,-12
31104.0,2019-12-13,"(0.567, 360.25]",1,3,-2
31104.0,2019-12-13,"(360.25, 718.5]",5,20,-15
31104.0,2019-12-13,"(718.5, 1076.75]",4,7,-3
31104.0,2019-12-13,"(1076.75, 1435.0]",11,18,-7
31105.0,2019-12-13,"(367.312, 540.0]",1,3,-2
31105.0,2019-12-13,"(712.0, 884.0]",1,1,0
31105.0,2019-12-13,"(884.0, 1056.0]",1,2,-1
31106.0,2019-12-13,"(1024.946, 1038.5]",1,2,-1
31106.0,2019-12-13,"(1038.5, 1052.0]",1,1,0
31106.0,2019-12-13,"(1065.5, 1079.0]",2,2,0
31107.0,2019-12-13,"(59.773, 367.75]",1,2,-1
31107.0,2019-12-13,"(367.75, 674.5]",2,21,-19
31107.0,2019-12-13,"(674.5, 981.25]",4,9,-5
31107.0,2019-12-13,"(981.25, 1288.0]",12,17,-5
31108.0,2019-12-13,"(384.02, 630.0]",3,20,-17
31108.0,2019-12-13,"(630.0, 875.0]",3,8,-5
31108.0,2019-12-13,"(875.0, 1120.0]",9,14,-5
31108.0,2019-12-13,"(1120.0, 1365.0]",7,10,-3
31109.0,2019-12-13,"(27.684, 358.0]",3,4,-1
31109.0,2019-12-13,"(358.0, 687.0]",2,9,-7
31109.0,2019-12-13,"(687.0, 1016.0]",12,29,-17
31109.0,2019-12-13,"(1016.0, 1345.0]",10,17,-7
31110.0,2019-12-13,"(333.909, 607.75]",9,26,-17
31110.0,2019-12-13,"(607.75, 880.5]",8,14,-6
31110.0,2019-12-13,"(880.5, 1153.25]",11,23,-12
31110.0,2019-12-13,"(1153.25, 1426.0]",5,9,-4
31111.0,2019-12-13,"(3.667, 338.25]",2,3,-1
31111.0,2019-12-13,"(338.25, 671.5]",9,22,-13
31111.0,2019-12-13,"(671.5, 1004.75]",3,6,-3
31111.0,2019-12-13,"(1004.75, 1338.0]",6,7,-1
31112.0,2019-12-13,"(498.342, 663.5]",1,3,-2
31112.0,2019-12-13,"(992.5, 1157.0]",3,4,-1
31113.0,2019-12-13,"(-0.407, 352.75]",1,3,-2
31113.0,2019-12-13,"(704.5, 1056.25]",5,12,-7
31113.0,2019-12-13,"(1056.25, 1408.0]",5,9,-4
31114.0,2019-12-13,"(337.25, 673.5]",1,2,-1
31114.0,2019-12-13,"(673.5, 1009.75]",5,17,-12
31114.0,2019-12-13,"(1009.75, 1346.0]",18,10,8
31115.0,2019-12-13,"(23.662, 359.5]",1,2,-1
31115.0,2019-12-13,"(359.5, 694.0]",2,18,-16
31115.0,2019-12-13,"(694.0, 1028.5]",2,6,-4
31115.0,2019-12-13,"(1028.5, 1363.0]",9,13,-4
31116.0,2019-12-13,"(347.941, 613.75]",4,20,-16
31116.0,2019-12-13,"(613.75, 878.5]",2,6,-4
31116.0,2019-12-13,"(878.5, 1143.25]",15,21,-6
31116.0,2019-12-13,"(1143.25, 1408.0]",7,12,-5
31117.0,2019-12-13,"(321.045, 560.75]",3,20,-17
31117.0,2019-12-13,"(799.5, 1038.25]",3,1,2
31117.0,2019-12-13,"(1038.25, 1277.0]",3,7,-4
31118.0,2019-12-13,"(677.75, 927.5]",1,10,-9
31118.0,2019-12-13,"(927.5, 1177.25]",8,1,7
31118.0,2019-12-13,"(1177.25, 1427.0]",3,11,-8
31119.0,2019-12-13,"(305.943, 571.25]",4,20,-16
31119.0,2019-12-13,"(571.25, 835.5]",2,2,0
31119.0,2019-12-13,"(835.5, 1099.75]",9,17,-8
31119.0,2019-12-13,"(1099.75, 1364.0]",10,19,-9
31120.0,2019-12-13,"(405.974, 663.5]",1,9,-8
31120.0,2019-12-13,"(663.5, 920.0]",1,1,0
31120.0,2019-12-13,"(920.0, 1176.5]",4,5,-1
31120.0,2019-12-13,"(1176.5, 1433.0]",5,7,-2
31121.0,2019-12-13,"(-0.261, 316.25]",1,1,0
31121.0,2019-12-13,"(316.25, 631.5]",13,20,-7
31121.0,2019-12-13,"(631.5, 946.75]",1,2,-1
31121.0,2019-12-13,"(946.75, 1262.0]",5,10,-5
31122.0,2019-12-13,"(72.638, 414.5]",1,1,0
31122.0,2019-12-13,"(414.5, 755.0]",1,10,-9
31122.0,2019-12-13,"(755.0, 1095.5]",1,5,-4
31122.0,2019-12-13,"(1095.5, 1436.0]",4,7,-3
31123.0,2019-12-13,"(66.742, 382.5]",3,4,-1
31123.0,2019-12-13,"(382.5, 697.0]",1,12,-11
31123.0,2019-12-13,"(1011.5, 1326.0]",3,3,0
31124.0,2019-12-13,"(6.624, 352.0]",2,3,-1
31124.0,2019-12-13,"(352.0, 696.0]",13,27,-14
31124.0,2019-12-13,"(696.0, 1040.0]",5,22,-17
31124.0,2019-12-13,"(1040.0, 1384.0]",9,36,-27
31125.0,2019-12-13,"(351.007, 600.25]",5,28,-23
31125.0,2019-12-13,"(600.25, 848.5]",2,3,-1
31125.0,2019-12-13,"(848.5, 1096.75]",11,17,-6
31125.0,2019-12-13,"(1096.75, 1345.0]",16,21,-5
31126.0,2019-12-13,"(3.569, 362.75]",2,2,0
31126.0,2019-12-13,"(362.75, 720.5]",2,22,-20
31126.0,2019-12-13,"(720.5, 1078.25]",9,17,-8
31126.0,2019-12-13,"(1078.25, 1436.0]",13,19,-6
,,,,2.0,
31128.0,2019-12-13,"(61.724, 382.0]",1,2,-1
31128.0,2019-12-13,"(382.0, 701.0]",15,22,-7
31128.0,2019-12-13,"(701.0, 1020.0]",10,16,-6
31128.0,2019-12-13,"(1020.0, 1339.0]",6,11,-5
31129.0,2019-12-13,"(495.348, 659.0]",4,5,-1
31129.0,2019-12-13,"(985.0, 1148.0]",2,1,1
31130.0,2019-12-13,"(350.064, 585.0]",4,13,-9
31130.0,2019-12-13,"(819.0, 1053.0]",4,2,2
31130.0,2019-12-13,"(1053.0, 1287.0]",10,7,3
31131.0,2019-12-13,"(779.5, 1083.75]",2,4,-2
31131.0,2019-12-13,"(1083.75, 1388.0]",1,2,-1
31200.0,2019-12-13,"(18.602, 369.5]",4,7,-3
31200.0,2019-12-13,"(369.5, 719.0]",27,34,-7
31200.0,2019-12-13,"(719.0, 1068.5]",12,23,-11
31200.0,2019-12-13,"(1068.5, 1418.0]",7,22,-15
31201.0,2019-12-13,"(302.892, 581.0]",10,24,-14
31201.0,2019-12-13,"(581.0, 858.0]",12,21,-9
31201.0,2019-12-13,"(858.0, 1135.0]",28,50,-22
31201.0,2019-12-13,"(1135.0, 1412.0]",20,37,-17
31202.0,2019-12-13,"(1.641, 342.75]",3,4,-1
31202.0,2019-12-13,"(342.75, 682.5]",7,27,-20
31202.0,2019-12-13,"(682.5, 1022.25]",16,22,-6
31202.0,2019-12-13,"(1022.25, 1362.0]",11,17,-6
31203.0,2019-12-13,"(7.636, 350.0]",3,5,-2
31203.0,2019-12-13,"(350.0, 691.0]",11,30,-19
31203.0,2019-12-13,"(691.0, 1032.0]",20,33,-13
31203.0,2019-12-13,"(1032.0, 1373.0]",15,30,-15
31204.0,2019-12-13,"(423.069, 656.75]",7,7,0
31204.0,2019-12-13,"(656.75, 889.5]",1,3,-2
31204.0,2019-12-13,"(889.5, 1122.25]",3,11,-8
31204.0,2019-12-13,"(1122.25, 1355.0]",1,2,-1
31205.0,2019-12-13,"(18.764, 329.0]",2,4,-2
31205.0,2019-12-13,"(329.0, 638.0]",4,8,-4
31205.0,2019-12-13,"(638.0, 947.0]",2,5,-3
31205.0,2019-12-13,"(947.0, 1256.0]",5,11,-6
31206.0,2019-12-13,"(556.496, 683.0]",2,2,0
31206.0,2019-12-13,"(935.0, 1061.0]",1,2,-1
31207.0,2019-12-13,"(1096.75, 1297.0]",1,3,-2
31208.0,2019-12-13,"(12.628, 357.0]",2,2,0
31208.0,2019-12-13,"(357.0, 700.0]",7,11,-4
31208.0,2019-12-13,"(1043.0, 1386.0]",3,3,0
31209.0,2019-12-13,"(485.132, 703.0]",1,4,-3
31209.0,2019-12-13,"(1137.0, 1354.0]",2,1,1
31211.0,2019-12-13,"(456.28, 637.0]",5,5,0
31211.0,2019-12-13,"(637.0, 817.0]",2,3,-1
31211.0,2019-12-13,"(817.0, 997.0]",1,3,-2
31211.0,2019-12-13,"(997.0, 1177.0]",2,3,-1
31212.0,2019-12-13,"(363.963, 624.25]",22,28,-6
31212.0,2019-12-13,"(883.5, 1142.75]",6,17,-11
31212.0,2019-12-13,"(1142.75, 1402.0]",6,13,-7
31213.0,2019-12-13,"(373.031, 616.25]",28,35,-7
31213.0,2019-12-13,"(616.25, 858.5]",3,6,-3
31213.0,2019-12-13,"(858.5, 1100.75]",3,6,-3
31213.0,2019-12-13,"(1100.75, 1343.0]",3,6,-3
31214.0,2019-12-13,"(400.5, 737.0]",7,3,4
31214.0,2019-12-13,"(737.0, 1073.5]",16,21,-5
31214.0,2019-12-13,"(1073.5, 1410.0]",11,24,-13
31215.0,2019-12-13,"(356.024, 601.0]",15,16,-1
31215.0,2019-12-13,"(845.0, 1089.0]",3,1,2
31216.0,2019-12-13,"(97.899, 374.25]",1,2,-1
31216.0,2019-12-13,"(374.25, 649.5]",15,15,0
31216.0,2019-12-13,"(649.5, 924.75]",5,11,-6
31216.0,2019-12-13,"(924.75, 1200.0]",4,14,-10
31217.0,2019-12-13,"(324.313, 496.75]",7,7,0
31217.0,2019-12-13,"(840.25, 1012.0]",2,1,1
31218.0,2019-12-13,"(367.246, 556.5]",8,22,-14
31218.0,2019-12-13,"(556.5, 745.0]",4,4,0
31218.0,2019-12-13,"(745.0, 933.5]",3,5,-2
31218.0,2019-12-13,"(933.5, 1122.0]",2,5,-3
31219.0,2019-12-13,"(431.156, 643.0]",8,8,0
31219.0,2019-12-13,"(1065.0, 1276.0]",1,1,0
31220.0,2019-12-13,"(298.229, 491.75]",5,6,-1
31220.0,2019-12-13,"(491.75, 684.5]",11,13,-2
31220.0,2019-12-13,"(684.5, 877.25]",1,2,-1
31221.0,2019-12-13,"(336.0, 671.0]",22,4,18
31221.0,2019-12-13,"(671.0, 1006.0]",3,23,-20
31221.0,2019-12-13,"(1006.0, 1341.0]",9,11,-2
31222.0,2019-12-13,"(407.302, 582.5]",10,12,-2
31222.0,2019-12-13,"(757.0, 931.5]",2,3,-1
31222.0,2019-12-13,"(931.5, 1106.0]",1,7,-6
31223.0,2019-12-13,"(2.634, 345.5]",3,5,-2
31223.0,2019-12-13,"(345.5, 687.0]",10,24,-14
31223.0,2019-12-13,"(687.0, 1028.5]",4,6,-2
31223.0,2019-12-13,"(1028.5, 1370.0]",12,22,-10
31224.0,2019-12-13,"(382.243, 572.25]",16,16,0
31224.0,2019-12-13,"(761.5, 950.75]",1,2,-1
31224.0,2019-12-13,"(950.75, 1140.0]",1,13,-12
31225.0,2019-12-13,"(395.111, 618.25]",4,8,-4
31225.0,2019-12-13,"(618.25, 840.5]",1,1,0
31225.0,2019-12-13,"(840.5, 1062.75]",4,9,-5
31225.0,2019-12-13,"(1062.75, 1285.0]",6,9,-3
31226.0,2019-12-13,"(53.84, 345.0]",1,1,0
31226.0,2019-12-13,"(345.0, 635.0]",3,4,-1
31226.0,2019-12-13,"(635.0, 925.0]",1,4,-3
31226.0,2019-12-13,"(925.0, 1215.0]",1,4,-3
31227.0,2019-12-13,"(345.5, 681.0]",24,1,23
31227.0,2019-12-13,"(681.0, 1016.5]",3,28,-25
31227.0,2019-12-13,"(1016.5, 1352.0]",6,7,-1
31228.0,2019-12-13,"(156.794, 459.5]",5,9,-4
31228.0,2019-12-13,"(459.5, 761.0]",11,15,-4
31228.0,2019-12-13,"(761.0, 1062.5]",9,21,-12
31228.0,2019-12-13,"(1062.5, 1364.0]",10,19,-9
31229.0,2019-12-13,"(34.598, 386.5]",2,4,-2
31229.0,2019-12-13,"(386.5, 737.0]",11,48,-37
31229.0,2019-12-13,"(737.0, 1087.5]",20,35,-15
31229.0,2019-12-13,"(1087.5, 1438.0]",18,33,-15
31230.0,2019-12-13,"(330.131, 548.25]",24,33,-9
31230.0,2019-12-13,"(548.25, 765.5]",2,3,-1
31230.0,2019-12-13,"(765.5, 982.75]",9,14,-5
31230.0,2019-12-13,"(982.75, 1200.0]",4,20,-16
31231.0,2019-12-13,"(388.973, 646.75]",12,16,-4
31231.0,2019-12-13,"(646.75, 903.5]",2,4,-2
31231.0,2019-12-13,"(903.5, 1160.25]",2,4,-2
31232.0,2019-12-13,"(319.75, 629.5]",14,1,13
31232.0,2019-12-13,"(629.5, 939.25]",7,16,-9
31232.0,2019-12-13,"(939.25, 1249.0]",9,12,-3
31233.0,2019-12-13,"(145.031, 388.25]",2,3,-1
31233.0,2019-12-13,"(388.25, 630.5]",27,30,-3
31233.0,2019-12-13,"(630.5, 872.75]",1,2,-1
31233.0,2019-12-13,"(872.75, 1115.0]",17,30,-13
31234.0,2019-12-13,"(45.809, 344.75]",1,3,-2
31234.0,2019-12-13,"(344.75, 642.5]",14,23,-9
31234.0,2019-12-13,"(642.5, 940.25]",9,16,-7
31234.0,2019-12-13,"(940.25, 1238.0]",9,24,-15
31235.0,2019-12-13,"(383.336, 550.0]",3,4,-1
31235.0,2019-12-13,"(882.0, 1048.0]",1,1,0
31236.0,2019-12-13,"(503.182, 708.5]",9,11,-2
31236.0,2019-12-13,"(708.5, 913.0]",6,7,-1
31236.0,2019-12-13,"(913.0, 1117.5]",6,17,-11
31236.0,2019-12-13,"(1117.5, 1322.0]",1,8,-7
31237.0,2019-12-13,"(315.25, 625.5]",6,1,5
31237.0,2019-12-13,"(625.5, 935.75]",4,13,-9
31237.0,2019-12-13,"(935.75, 1246.0]",10,7,3
31238.0,2019-12-13,"(52.918, 324.5]",1,1,0
31238.0,2019-12-13,"(324.5, 595.0]",12,16,-4
31238.0,2019-12-13,"(595.0, 865.5]",5,9,-4
31238.0,2019-12-13,"(865.5, 1136.0]",6,19,-13
31239.0,2019-12-13,"(451.026, 695.5]",25,28,-3
31239.0,2019-12-13,"(695.5, 939.0]",7,11,-4
31239.0,2019-12-13,"(939.0, 1182.5]",4,17,-13
31239.0,2019-12-13,"(1182.5, 1426.0]",2,4,-2
,,,,2.0,
31241.0,2019-12-13,"(121.814, 419.5]",1,2,-1
31241.0,2019-12-13,"(419.5, 716.0]",15,34,-19
31241.0,2019-12-13,"(716.0, 1012.5]",3,9,-6
31241.0,2019-12-13,"(1012.5, 1309.0]",17,33,-16
31242.0,2019-12-13,"(298.022, 543.5]",18,19,-1
31242.0,2019-12-13,"(543.5, 788.0]",6,7,-1
31242.0,2019-12-13,"(788.0, 1032.5]",3,8,-5
31242.0,2019-12-13,"(1032.5, 1277.0]",1,16,-15
31243.0,2019-12-13,"(374.178, 580.5]",16,18,-2
31243.0,2019-12-13,"(786.0, 991.5]",4,8,-4
31243.0,2019-12-13,"(991.5, 1197.0]",3,9,-6
31244.0,2019-12-13,"(419.094, 646.5]",4,11,-7
31244.0,2019-12-13,"(873.0, 1099.5]",5,11,-6
31244.0,2019-12-13,"(1099.5, 1326.0]",2,5,-3
31245.0,2019-12-13,"(-1.397, 349.25]",1,2,-1
31245.0,2019-12-13,"(349.25, 698.5]",12,21,-9
31245.0,2019-12-13,"(698.5, 1047.75]",13,27,-14
31245.0,2019-12-13,"(1047.75, 1397.0]",5,12,-7
31246.0,2019-12-13,"(109.781, 415.75]",1,1,0
31246.0,2019-12-13,"(415.75, 720.5]",9,13,-4
31246.0,2019-12-13,"(720.5, 1025.25]",5,8,-3
31246.0,2019-12-13,"(1025.25, 1330.0]",10,16,-6
31247.0,2019-12-13,"(470.343, 635.25]",5,7,-2
31247.0,2019-12-13,"(963.75, 1128.0]",5,1,4
31248.0,2019-12-13,"(389.206, 588.5]",5,11,-6
31248.0,2019-12-13,"(787.0, 985.5]",1,2,-1
31248.0,2019-12-13,"(985.5, 1184.0]",4,4,0
31249.0,2019-12-13,"(338.268, 522.0]",3,5,-2
31249.0,2019-12-13,"(705.0, 888.0]",1,2,-1
31249.0,2019-12-13,"(888.0, 1071.0]",2,4,-2
31250.0,2019-12-13,"(415.234, 607.5]",12,15,-3
31250.0,2019-12-13,"(607.5, 799.0]",2,2,0
31250.0,2019-12-13,"(799.0, 990.5]",2,5,-3
31250.0,2019-12-13,"(990.5, 1182.0]",1,10,-9
31251.0,2019-12-13,"(435.107, 659.25]",7,15,-8
31251.0,2019-12-13,"(659.25, 882.5]",3,5,-2
31251.0,2019-12-13,"(882.5, 1105.75]",4,15,-11
31251.0,2019-12-13,"(1105.75, 1329.0]",3,7,-4
31252.0,2019-12-13,"(350.0, 653.0]",12,2,10
31252.0,2019-12-13,"(653.0, 956.0]",5,12,-7
31252.0,2019-12-13,"(956.0, 1259.0]",2,9,-7
31253.0,2019-12-13,"(345.25, 690.5]",12,1,11
31253.0,2019-12-13,"(690.5, 1035.75]",4,15,-11
31253.0,2019-12-13,"(1035.75, 1381.0]",1,9,-8
31254.0,2019-12-13,"(426.096, 653.0]",17,21,-4
31254.0,2019-12-13,"(653.0, 879.0]",4,5,-1
31254.0,2019-12-13,"(879.0, 1105.0]",6,17,-11
31254.0,2019-12-13,"(1105.0, 1331.0]",2,5,-3
31255.0,2019-12-13,"(371.051, 609.25]",9,17,-8
31255.0,2019-12-13,"(609.25, 846.5]",2,3,-1
31255.0,2019-12-13,"(846.5, 1083.75]",3,5,-2
31255.0,2019-12-13,"(1083.75, 1321.0]",1,5,-4
31256.0,2019-12-13,"(272.838, 564.5]",6,6,0
31256.0,2019-12-13,"(564.5, 855.0]",1,2,-1
31256.0,2019-12-13,"(855.0, 1145.5]",4,12,-8
31256.0,2019-12-13,"(1145.5, 1436.0]",3,6,-3
31257.0,2019-12-13,"(341.0, 592.0]",14,18,-4
31257.0,2019-12-13,"(592.0, 842.0]",4,6,-2
31257.0,2019-12-13,"(842.0, 1092.0]",4,14,-10
31257.0,2019-12-13,"(1092.0, 1342.0]",7,16,-9
31258.0,2019-12-13,"(102.909, 376.75]",2,4,-2
31258.0,2019-12-13,"(376.75, 649.5]",3,4,-1
31258.0,2019-12-13,"(922.25, 1195.0]",2,5,-3
31259.0,2019-12-13,"(448.327, 617.25]",7,7,0
31259.0,2019-12-13,"(785.5, 953.75]",2,3,-1
31260.0,2019-12-13,"(377.091, 605.25]",11,14,-3
31260.0,2019-12-13,"(832.5, 1059.75]",2,1,1
31260.0,2019-12-13,"(1059.75, 1287.0]",1,5,-4
31261.0,2019-12-13,"(424.265, 608.75]",9,9,0
31261.0,2019-12-13,"(792.5, 976.25]",2,1,1
31261.0,2019-12-13,"(976.25, 1160.0]",1,5,-4
31262.0,2019-12-13,"(414.048, 653.0]",9,9,0
31262.0,2019-12-13,"(653.0, 891.0]",1,2,-1
31262.0,2019-12-13,"(891.0, 1129.0]",1,8,-7
31262.0,2019-12-13,"(1129.0, 1367.0]",4,9,-5
31263.0,2019-12-13,"(8.691, 337.25]",1,1,0
31263.0,2019-12-13,"(337.25, 664.5]",20,24,-4
31263.0,2019-12-13,"(664.5, 991.75]",4,9,-5
31263.0,2019-12-13,"(991.75, 1319.0]",10,25,-15
31264.0,2019-12-13,"(367.962, 628.5]",8,13,-5
31264.0,2019-12-13,"(628.5, 888.0]",3,4,-1
31264.0,2019-12-13,"(888.0, 1147.5]",3,9,-6
31264.0,2019-12-13,"(1147.5, 1407.0]",1,1,0
31265.0,2019-12-13,"(357.25, 714.5]",10,1,9
31265.0,2019-12-13,"(714.5, 1071.75]",11,24,-13
31265.0,2019-12-13,"(1071.75, 1429.0]",12,19,-7
31266.0,2019-12-13,"(152.719, 474.25]",2,13,-11
31266.0,2019-12-13,"(474.25, 794.5]",8,21,-13
31266.0,2019-12-13,"(794.5, 1114.75]",20,34,-14
31266.0,2019-12-13,"(1114.75, 1435.0]",9,18,-9
31267.0,2019-12-13,"(6.635, 349.25]",4,5,-1
31267.0,2019-12-13,"(349.25, 690.5]",16,32,-16
31267.0,2019-12-13,"(690.5, 1031.75]",6,13,-7
31267.0,2019-12-13,"(1031.75, 1373.0]",14,25,-11
31268.0,2019-12-13,"(104.67, 438.5]",3,4,-1
31268.0,2019-12-13,"(438.5, 771.0]",11,29,-18
31268.0,2019-12-13,"(771.0, 1103.5]",19,25,-6
31268.0,2019-12-13,"(1103.5, 1436.0]",12,26,-14
31269.0,2019-12-13,"(39.654, 377.5]",2,3,-1
31269.0,2019-12-13,"(377.5, 714.0]",9,14,-5
31269.0,2019-12-13,"(714.0, 1050.5]",4,12,-8
31269.0,2019-12-13,"(1050.5, 1387.0]",1,9,-8
31270.0,2019-12-13,"(399.161, 609.75]",9,13,-4
31270.0,2019-12-13,"(609.75, 819.5]",2,3,-1
31270.0,2019-12-13,"(819.5, 1029.25]",2,8,-6
31270.0,2019-12-13,"(1029.25, 1239.0]",4,8,-4
31271.0,2019-12-13,"(317.087, 546.25]",11,11,0
31271.0,2019-12-13,"(546.25, 774.5]",6,7,-1
31271.0,2019-12-13,"(1002.75, 1231.0]",4,1,3
31272.0,2019-12-13,"(12.698, 339.5]",1,2,-1
31272.0,2019-12-13,"(339.5, 665.0]",11,13,-2
31272.0,2019-12-13,"(665.0, 990.5]",1,2,-1
31272.0,2019-12-13,"(990.5, 1316.0]",4,9,-5
31273.0,2019-12-13,"(410.544, 525.0]",1,2,-1
31273.0,2019-12-13,"(753.0, 867.0]",1,1,0
31274.0,2019-12-13,"(364.0, 632.0]",7,2,5
31274.0,2019-12-13,"(632.0, 900.0]",3,9,-6
31274.0,2019-12-13,"(900.0, 1168.0]",2,4,-2
31275.0,2019-12-13,"(16.599, 368.25]",2,4,-2
31275.0,2019-12-13,"(368.25, 718.5]",9,15,-6
31275.0,2019-12-13,"(718.5, 1068.75]",12,24,-12
31275.0,2019-12-13,"(1068.75, 1419.0]",8,14,-6
31276.0,2019-12-13,"(481.125, 700.75]",6,7,-1
31276.0,2019-12-13,"(700.75, 919.5]",3,5,-2
31276.0,2019-12-13,"(919.5, 1138.25]",5,14,-9
31277.0,2019-12-13,"(420.167, 629.25]",21,24,-3
31277.0,2019-12-13,"(629.25, 837.5]",3,7,-4
31277.0,2019-12-13,"(837.5, 1045.75]",8,20,-12
31277.0,2019-12-13,"(1045.75, 1254.0]",2,14,-12
31278.0,2019-12-13,"(-0.413, 354.25]",4,5,-1
31278.0,2019-12-13,"(354.25, 707.5]",7,24,-17
31278.0,2019-12-13,"(707.5, 1060.75]",9,15,-6
31278.0,2019-12-13,"(1060.75, 1414.0]",16,25,-9
31279.0,2019-12-13,"(408.15, 621.5]",20,24,-4
31279.0,2019-12-13,"(621.5, 834.0]",2,4,-2
31279.0,2019-12-13,"(834.0, 1046.5]",1,9,-8
31279.0,2019-12-13,"(1046.5, 1259.0]",2,11,-9
31280.0,2019-12-13,"(114.683, 445.25]",2,5,-3
31280.0,2019-12-13,"(445.25, 774.5]",3,14,-11
31280.0,2019-12-13,"(774.5, 1103.75]",4,7,-3
31280.0,2019-12-13,"(1103.75, 1433.0]",9,12,-3
31000.0,2019-12-14,"(1013.853, 1050.75]",1,1,0
31001.0,2019-12-14,"(895.61, 993.5]",1,2,-1
31001.0,2019-12-14,"(1188.5, 1286.0]",1,2,-1
31002.0,2019-12-14,"(863.25, 932.5]",1,1,0
31003.0,2019-12-14,"(839.855, 876.25]",1,1,0
31003.0,2019-12-14,"(948.75, 985.0]",1,1,0
31004.0,2019-12-14,"(878.0, 1058.5]",1,1,0
31005.0,2019-12-14,"(907.626, 1001.5]",1,3,-2
31005.0,2019-12-14,"(1001.5, 1095.0]",2,2,0
31005.0,2019-12-14,"(1188.5, 1282.0]",1,2,-1
31006.0,2019-12-14,"(964.0, 1079.0]",2,2,0
31006.0,2019-12-14,"(1079.0, 1194.0]",2,3,-1
31007.0,2019-12-14,"(338.5, 672.0]",1,2,-1
31007.0,2019-12-14,"(672.0, 1005.5]",2,1,1
31007.0,2019-12-14,"(1005.5, 1339.0]",1,4,-3
31009.0,2019-12-14,"(832.75, 941.0]",1,1,0
31010.0,2019-12-14,"(749.382, 904.5]",2,5,-3
31010.0,2019-12-14,"(904.5, 1059.0]",2,2,0
31010.0,2019-12-14,"(1059.0, 1213.5]",1,5,-4
31011.0,2019-12-14,"(323.951, 587.25]",3,4,-1
31011.0,2019-12-14,"(587.25, 849.5]",2,4,-2
31011.0,2019-12-14,"(1111.75, 1374.0]",1,1,0
31012.0,2019-12-14,"(1009.5, 1346.0]",2,1,1
31013.0,2019-12-14,"(6.813, 304.75]",1,1,0
31013.0,2019-12-14,"(898.25, 1195.0]",4,1,3
31014.0,2019-12-14,"(308.09, 536.5]",4,5,-1
31014.0,2019-12-14,"(764.0, 991.5]",4,5,-1
31014.0,2019-12-14,"(991.5, 1219.0]",5,5,0
31015.0,2019-12-14,"(148.076, 380.0]",2,3,-1
31015.0,2019-12-14,"(380.0, 611.0]",1,3,-2
31015.0,2019-12-14,"(611.0, 842.0]",2,2,0
31015.0,2019-12-14,"(842.0, 1073.0]",2,4,-2
31016.0,2019-12-14,"(56.954, 319.5]",1,1,0
31016.0,2019-12-14,"(581.0, 842.5]",2,2,0
31016.0,2019-12-14,"(842.5, 1104.0]",2,6,-4
31017.0,2019-12-14,"(956.0, 1256.0]",1,1,0
31018.0,2019-12-14,"(992.0, 1029.0]",1,1,0
31019.0,2019-12-14,"(375.75, 643.5]",2,2,0
31019.0,2019-12-14,"(643.5, 911.25]",1,2,-1
31019.0,2019-12-14,"(911.25, 1179.0]",1,3,-2
,,,,1.0,
,,,,3.0,
31021.0,2019-12-14,"(775.35, 938.5]",3,6,-3
31021.0,2019-12-14,"(1101.0, 1263.5]",1,2,-1
31021.0,2019-12-14,"(1263.5, 1426.0]",1,2,-1
31022.0,2019-12-14,"(629.5, 881.25]",3,3,0
31022.0,2019-12-14,"(881.25, 1133.0]",2,3,-1
31023.0,2019-12-14,"(268.25, 522.5]",1,2,-1
31023.0,2019-12-14,"(522.5, 776.75]",1,1,0
31023.0,2019-12-14,"(776.75, 1031.0]",4,4,0
31024.0,2019-12-14,"(91.996, 344.0]",1,1,0
31024.0,2019-12-14,"(595.0, 846.0]",2,4,-2
31024.0,2019-12-14,"(846.0, 1097.0]",1,1,0
,,,,2.0,
31026.0,2019-12-14,"(296.344, 461.0]",1,2,-1
31026.0,2019-12-14,"(461.0, 625.0]",1,1,0
31026.0,2019-12-14,"(789.0, 953.0]",2,2,0
,,,,2.0,
,,,,1.0,
,,,,1.0,
31029.0,2019-12-14,"(776.0, 1030.5]",2,2,0
31029.0,2019-12-14,"(1030.5, 1285.0]",2,1,1
31030.0,2019-12-14,"(11.752, 325.0]",1,1,0
31030.0,2019-12-14,"(637.0, 949.0]",1,2,-1
31030.0,2019-12-14,"(949.0, 1261.0]",2,5,-3
31031.0,2019-12-14,"(114.988, 369.0]",1,1,0
31032.0,2019-12-14,"(614.945, 628.75]",1,2,-1
31032.0,2019-12-14,"(656.25, 670.0]",1,1,0
,,,,2.0,
31034.0,2019-12-14,"(850.75, 916.0]",2,1,1
31035.0,2019-12-14,"(858.525, 977.75]",3,4,-1
31035.0,2019-12-14,"(977.75, 1096.5]",1,2,-1
31035.0,2019-12-14,"(1215.25, 1334.0]",1,2,-1
31036.0,2019-12-14,"(958.95, 971.5]",1,1,0
31036.0,2019-12-14,"(996.5, 1009.0]",1,2,-1
31037.0,2019-12-14,"(334.75, 666.5]",2,1,1
31037.0,2019-12-14,"(666.5, 998.25]",2,3,-1
31037.0,2019-12-14,"(998.25, 1330.0]",2,7,-5
31038.0,2019-12-14,"(413.25, 551.0]",2,1,1
31039.0,2019-12-14,"(541.419, 687.25]",1,1,0
31039.0,2019-12-14,"(687.25, 832.5]",1,2,-1
31039.0,2019-12-14,"(832.5, 977.75]",1,2,-1
31039.0,2019-12-14,"(977.75, 1123.0]",1,1,0
31040.0,2019-12-14,"(635.662, 720.5]",1,1,0
31041.0,2019-12-14,"(575.236, 767.0]",2,3,-1
31042.0,2019-12-14,"(543.163, 753.25]",1,3,-2
31042.0,2019-12-14,"(753.25, 962.5]",1,3,-2
31042.0,2019-12-14,"(962.5, 1171.75]",1,1,0
31042.0,2019-12-14,"(1171.75, 1381.0]",1,2,-1
31043.0,2019-12-14,"(881.69, 959.5]",2,4,-2
31043.0,2019-12-14,"(1114.5, 1192.0]",1,3,-2
31044.0,2019-12-14,"(295.5, 591.0]",1,1,0
31044.0,2019-12-14,"(886.5, 1182.0]",1,1,0
31045.0,2019-12-14,"(512.25, 655.0]",1,2,-1
,,,,2.0,
31047.0,2019-12-14,"(379.75, 724.5]",2,1,1
31047.0,2019-12-14,"(724.5, 1069.25]",2,3,-1
31048.0,2019-12-14,"(711.647, 800.25]",1,2,-1
31049.0,2019-12-14,"(629.5, 660.0]",1,1,0
,,,,2.0,
,,,,1.0,
,,,,1.0,
,,,,1.0,
31052.0,2019-12-14,"(1132.924, 1152.0]",1,1,0
31053.0,2019-12-14,"(162.154, 374.5]",1,2,-1
,,,,1.0,
,,,,1.0,
31055.0,2019-12-14,"(682.5, 1023.75]",1,1,0
31055.0,2019-12-14,"(1023.75, 1365.0]",2,1,1
,,,,2.0,
31057.0,2019-12-14,"(582.421, 727.75]",1,1,0
31057.0,2019-12-14,"(872.5, 1017.25]",1,2,-1
,,,,2.0,
,,,,1.0,
31059.0,2019-12-14,"(1138.75, 1145.0]",1,1,0
31060.0,2019-12-14,"(699.561, 809.75]",1,1,0
31060.0,2019-12-14,"(1029.25, 1139.0]",1,2,-1
31061.0,2019-12-14,"(399.0, 532.0]",1,1,0
31062.0,2019-12-14,"(512.517, 633.75]",2,3,-1
31062.0,2019-12-14,"(875.25, 996.0]",2,3,-1
31063.0,2019-12-14,"(638.75, 641.0]",1,1,0
31064.0,2019-12-14,"(618.638, 709.5]",2,4,-2
31064.0,2019-12-14,"(800.0, 890.5]",1,2,-1
31064.0,2019-12-14,"(890.5, 981.0]",3,6,-3
,,,,1.0,
,,,,1.0,
,,,,2.0,
31067.0,2019-12-14,"(301.928, 571.0]",1,2,-1
31067.0,2019-12-14,"(1107.0, 1375.0]",1,1,0
31068.0,2019-12-14,"(552.75, 737.0]",1,1,0
31069.0,2019-12-14,"(1094.5, 1141.0]",1,1,0
31070.0,2019-12-14,"(552.135, 769.25]",1,3,-2
31070.0,2019-12-14,"(769.25, 985.5]",1,2,-1
31070.0,2019-12-14,"(985.5, 1201.75]",1,1,0
31071.0,2019-12-14,"(508.5, 698.0]",2,2,0
31071.0,2019-12-14,"(698.0, 887.5]",1,2,-1
31071.0,2019-12-14,"(887.5, 1077.0]",4,1,3
,,,,1.0,
,,,,1.0,
,,,,1.0,
,,,,1.0,
31074.0,2019-12-14,"(434.191, 637.25]",1,2,-1
31074.0,2019-12-14,"(1041.75, 1244.0]",3,4,-1
,,,,2.0,
,,,,2.0,
31077.0,2019-12-14,"(480.119, 701.25]",5,7,-2
31077.0,2019-12-14,"(701.25, 921.5]",1,2,-1
31077.0,2019-12-14,"(921.5, 1141.75]",1,1,0
31077.0,2019-12-14,"(1141.75, 1362.0]",1,1,0
,,,,2.0,
31079.0,2019-12-14,"(518.299, 694.25]",1,2,-1
31079.0,2019-12-14,"(869.5, 1044.75]",1,2,-1
31079.0,2019-12-14,"(1044.75, 1220.0]",3,5,-2
31080.0,2019-12-14,"(118.685, 448.75]",3,3,0
31080.0,2019-12-14,"(448.75, 777.5]",1,6,-5
31080.0,2019-12-14,"(1106.25, 1435.0]",1,2,-1
31081.0,2019-12-14,"(534.32, 705.0]",2,2,0
31081.0,2019-12-14,"(705.0, 875.0]",1,1,0
31081.0,2019-12-14,"(1045.0, 1215.0]",1,2,-1
31082.0,2019-12-14,"(814.5, 1086.0]",1,1,0
31083.0,2019-12-14,"(1077.5, 1188.0]",1,1,0
31084.0,2019-12-14,"(29.902, 305.5]",1,1,0
31084.0,2019-12-14,"(854.5, 1129.0]",1,1,0
31085.0,2019-12-14,"(934.5, 942.0]",1,1,0
31086.0,2019-12-14,"(684.0, 912.0]",1,1,0
,,,,1.0,
,,,,1.0,
,,,,1.0,
,,,,2.0,
31089.0,2019-12-14,"(4.577, 361.75]",1,2,-1
31089.0,2019-12-14,"(361.75, 717.5]",2,2,0
31089.0,2019-12-14,"(717.5, 1073.25]",2,4,-2
31089.0,2019-12-14,"(1073.25, 1429.0]",3,7,-4
31090.0,2019-12-14,"(913.881, 943.75]",1,1,0
31091.0,2019-12-14,"(960.0, 995.0]",1,1,0
31092.0,2019-12-14,"(1164.25, 1353.0]",1,1,0
31093.0,2019-12-14,"(863.715, 935.25]",1,2,-1
31094.0,2019-12-14,"(866.552, 979.0]",1,2,-1
31094.0,2019-12-14,"(1203.0, 1315.0]",1,2,-1
,,,,1.0,
,,,,1.0,
31096.0,2019-12-14,"(1065.75, 1421.0]",1,1,0
31097.0,2019-12-14,"(39.142, 254.5]",1,1,0
31097.0,2019-12-14,"(683.5, 898.0]",1,1,0
31098.0,2019-12-14,"(579.75, 773.0]",1,1,0
31099.0,2019-12-14,"(851.75, 919.0]",1,1,0
31100.0,2019-12-14,"(146.968, 406.0]",1,2,-1
31100.0,2019-12-14,"(406.0, 664.0]",1,2,-1
31100.0,2019-12-14,"(664.0, 922.0]",2,3,-1
31100.0,2019-12-14,"(922.0, 1180.0]",1,2,-1
31101.0,2019-12-14,"(364.25, 708.5]",20,4,16
31101.0,2019-12-14,"(708.5, 1052.75]",50,25,25
31101.0,2019-12-14,"(1052.75, 1397.0]",18,76,-58
31102.0,2019-12-14,"(71.636, 414.0]",1,3,-2
31102.0,2019-12-14,"(414.0, 755.0]",1,5,-4
31102.0,2019-12-14,"(755.0, 1096.0]",2,16,-14
31102.0,2019-12-14,"(1096.0, 1437.0]",1,10,-9
31103.0,2019-12-14,"(9.626, 354.5]",3,5,-2
31103.0,2019-12-14,"(354.5, 698.0]",2,8,-6
31103.0,2019-12-14,"(698.0, 1041.5]",7,25,-18
31103.0,2019-12-14,"(1041.5, 1385.0]",8,22,-14
31104.0,2019-12-14,"(143.707, 468.25]",1,3,-2
31104.0,2019-12-14,"(468.25, 791.5]",3,15,-12
31104.0,2019-12-14,"(791.5, 1114.75]",22,40,-18
31104.0,2019-12-14,"(1114.75, 1438.0]",14,29,-15
31105.0,2019-12-14,"(918.25, 1021.0]",2,2,0
31106.0,2019-12-14,"(783.25, 991.5]",2,2,0
31106.0,2019-12-14,"(991.5, 1199.75]",1,3,-2
31106.0,2019-12-14,"(1199.75, 1408.0]",2,3,-1
31107.0,2019-12-14,"(147.729, 466.75]",1,3,-2
31107.0,2019-12-14,"(466.75, 784.5]",5,16,-11
31107.0,2019-12-14,"(784.5, 1102.25]",8,22,-14
31107.0,2019-12-14,"(1102.25, 1420.0]",16,28,-12
31108.0,2019-12-14,"(9.579, 366.25]",1,2,-1
31108.0,2019-12-14,"(366.25, 721.5]",4,17,-13
31108.0,2019-12-14,"(721.5, 1076.75]",16,32,-16
31108.0,2019-12-14,"(1076.75, 1432.0]",9,18,-9
31109.0,2019-12-14,"(30.614, 378.5]",2,6,-4
31109.0,2019-12-14,"(378.5, 725.0]",7,15,-8
31109.0,2019-12-14,"(725.0, 1071.5]",19,30,-11
31109.0,2019-12-14,"(1071.5, 1418.0]",9,17,-8
31110.0,2019-12-14,"(339.905, 614.75]",6,13,-7
31110.0,2019-12-14,"(614.75, 888.5]",11,20,-9
31110.0,2019-12-14,"(888.5, 1162.25]",6,12,-6
31110.0,2019-12-14,"(1162.25, 1436.0]",5,8,-3
31111.0,2019-12-14,"(397.25, 731.5]",4,2,2
31111.0,2019-12-14,"(731.5, 1065.75]",5,6,-1
31111.0,2019-12-14,"(1065.75, 1400.0]",15,8,7
31112.0,2019-12-14,"(935.75, 1008.5]",1,1,0
31112.0,2019-12-14,"(1081.25, 1154.0]",1,1,0
31113.0,2019-12-14,"(75.661, 411.75]",2,3,-1
31113.0,2019-12-14,"(411.75, 746.5]",2,12,-10
31113.0,2019-12-14,"(746.5, 1081.25]",7,16,-9
31113.0,2019-12-14,"(1081.25, 1416.0]",5,17,-12
31114.0,2019-12-14,"(25.627, 370.25]",4,11,-7
31114.0,2019-12-14,"(370.25, 713.5]",6,11,-5
31114.0,2019-12-14,"(713.5, 1056.75]",13,22,-9
31114.0,2019-12-14,"(1056.75, 1400.0]",8,16,-8
31115.0,2019-12-14,"(366.5, 689.0]",2,2,0
31115.0,2019-12-14,"(689.0, 1011.5]",6,10,-4
31115.0,2019-12-14,"(1011.5, 1334.0]",10,18,-8
31116.0,2019-12-14,"(166.745, 481.75]",1,2,-1
31116.0,2019-12-14,"(481.75, 795.5]",12,21,-9
31116.0,2019-12-14,"(795.5, 1109.25]",15,36,-21
31116.0,2019-12-14,"(1109.25, 1423.0]",13,21,-8
31117.0,2019-12-14,"(355.75, 707.5]",2,1,1
31117.0,2019-12-14,"(707.5, 1059.25]",6,12,-6
31117.0,2019-12-14,"(1059.25, 1411.0]",8,17,-9
31118.0,2019-12-14,"(10.598, 362.5]",3,3,0
31118.0,2019-12-14,"(362.5, 713.0]",4,11,-7
31118.0,2019-12-14,"(713.0, 1063.5]",5,17,-12
31118.0,2019-12-14,"(1063.5, 1414.0]",6,13,-7
31119.0,2019-12-14,"(39.625, 384.75]",3,5,-2
31119.0,2019-12-14,"(384.75, 728.5]",13,24,-11
31119.0,2019-12-14,"(728.5, 1072.25]",9,23,-14
31119.0,2019-12-14,"(1072.25, 1416.0]",14,27,-13
31120.0,2019-12-14,"(97.693, 425.75]",2,3,-1
31120.0,2019-12-14,"(425.75, 752.5]",4,8,-4
31120.0,2019-12-14,"(752.5, 1079.25]",1,5,-4
31120.0,2019-12-14,"(1079.25, 1406.0]",5,9,-4
31121.0,2019-12-14,"(379.0, 652.0]",2,1,1
31121.0,2019-12-14,"(652.0, 925.0]",6,4,2
31121.0,2019-12-14,"(925.0, 1198.0]",7,8,-1
31122.0,2019-12-14,"(412.0, 736.0]",6,1,5
31122.0,2019-12-14,"(736.0, 1060.0]",8,11,-3
31122.0,2019-12-14,"(1060.0, 1384.0]",3,14,-11
31123.0,2019-12-14,"(33.615, 381.25]",1,2,-1
31123.0,2019-12-14,"(727.5, 1073.75]",2,5,-3
31123.0,2019-12-14,"(1073.75, 1420.0]",3,7,-4
31124.0,2019-12-14,"(35.603, 386.25]",1,3,-2
31124.0,2019-12-14,"(386.25, 735.5]",6,25,-19
31124.0,2019-12-14,"(735.5, 1084.75]",28,58,-30
31124.0,2019-12-14,"(1084.75, 1434.0]",18,44,-26
31125.0,2019-12-14,"(400.971, 659.25]",4,10,-6
31125.0,2019-12-14,"(659.25, 916.5]",5,9,-4
31125.0,2019-12-14,"(916.5, 1173.75]",13,24,-11
31125.0,2019-12-14,"(1173.75, 1431.0]",8,16,-8
31126.0,2019-12-14,"(132.717, 454.75]",2,3,-1
31126.0,2019-12-14,"(454.75, 775.5]",3,21,-18
31126.0,2019-12-14,"(775.5, 1096.25]",12,24,-12
31126.0,2019-12-14,"(1096.25, 1417.0]",16,23,-7
,,,,2.0,
31128.0,2019-12-14,"(171.757, 483.75]",1,2,-1
31128.0,2019-12-14,"(483.75, 794.5]",7,11,-4
31128.0,2019-12-14,"(794.5, 1105.25]",5,9,-4
31128.0,2019-12-14,"(1105.25, 1416.0]",5,8,-3
31129.0,2019-12-14,"(610.328, 779.0]",2,4,-2
31129.0,2019-12-14,"(779.0, 947.0]",6,7,-1
31129.0,2019-12-14,"(947.0, 1115.0]",9,9,0
31129.0,2019-12-14,"(1115.0, 1283.0]",2,4,-2
31130.0,2019-12-14,"(15.599, 367.25]",1,2,-1
31130.0,2019-12-14,"(367.25, 717.5]",1,3,-2
31130.0,2019-12-14,"(717.5, 1067.75]",2,7,-5
31130.0,2019-12-14,"(1067.75, 1418.0]",11,16,-5
31131.0,2019-12-14,"(34.68, 366.0]",2,2,0
31131.0,2019-12-14,"(696.0, 1026.0]",3,4,-1
31131.0,2019-12-14,"(1026.0, 1356.0]",3,8,-5
31200.0,2019-12-14,"(20.624, 366.0]",2,5,-3
31200.0,2019-12-14,"(366.0, 710.0]",4,6,-2
31200.0,2019-12-14,"(710.0, 1054.0]",23,32,-9
31200.0,2019-12-14,"(1054.0, 1398.0]",16,30,-14
31201.0,2019-12-14,"(39.611, 388.25]",1,8,-7
31201.0,2019-12-14,"(388.25, 735.5]",14,22,-8
31201.0,2019-12-14,"(735.5, 1082.75]",28,58,-30
31201.0,2019-12-14,"(1082.75, 1430.0]",7,20,-13
31202.0,2019-12-14,"(12.685, 342.75]",1,5,-4
31202.0,2019-12-14,"(342.75, 671.5]",11,14,-3
31202.0,2019-12-14,"(671.5, 1000.25]",27,38,-11
31202.0,2019-12-14,"(1000.25, 1329.0]",18,33,-15
31203.0,2019-12-14,"(61.634, 404.5]",3,3,0
31203.0,2019-12-14,"(404.5, 746.0]",17,25,-8
31203.0,2019-12-14,"(746.0, 1087.5]",16,28,-12
31203.0,2019-12-14,"(1087.5, 1429.0]",31,45,-14
31204.0,2019-12-14,"(549.324, 719.0]",1,2,-1
31204.0,2019-12-14,"(719.0, 888.0]",2,2,0
31204.0,2019-12-14,"(888.0, 1057.0]",5,9,-4
31204.0,2019-12-14,"(1057.0, 1226.0]",7,12,-5
31205.0,2019-12-14,"(416.14, 632.0]",5,5,0
31205.0,2019-12-14,"(632.0, 847.0]",1,4,-3
31205.0,2019-12-14,"(847.0, 1062.0]",2,12,-10
31205.0,2019-12-14,"(1062.0, 1277.0]",2,6,-4
,,,,2.0,
31207.0,2019-12-14,"(716.325, 885.75]",1,2,-1
31207.0,2019-12-14,"(885.75, 1054.5]",2,8,-6
31207.0,2019-12-14,"(1054.5, 1223.25]",1,2,-1
31207.0,2019-12-14,"(1223.25, 1392.0]",1,3,-2
31208.0,2019-12-14,"(508.348, 672.0]",1,2,-1
31208.0,2019-12-14,"(672.0, 835.0]",1,1,0
31208.0,2019-12-14,"(835.0, 998.0]",5,7,-2
31208.0,2019-12-14,"(998.0, 1161.0]",1,1,0
31209.0,2019-12-14,"(557.518, 678.5]",2,2,0
31209.0,2019-12-14,"(919.5, 1040.0]",3,1,2
31211.0,2019-12-14,"(958.5, 1057.0]",1,3,-2
31211.0,2019-12-14,"(1155.5, 1254.0]",1,1,0
31212.0,2019-12-14,"(6.885, 286.75]",1,2,-1
31212.0,2019-12-14,"(286.75, 565.5]",2,3,-1
31212.0,2019-12-14,"(565.5, 844.25]",5,9,-4
31212.0,2019-12-14,"(844.25, 1123.0]",8,14,-6
31213.0,2019-12-14,"(358.75, 655.5]",3,2,1
31213.0,2019-12-14,"(655.5, 952.25]",4,5,-1
31213.0,2019-12-14,"(952.25, 1249.0]",3,7,-4
31214.0,2019-12-14,"(72.661, 408.75]",1,4,-3
31214.0,2019-12-14,"(408.75, 743.5]",12,25,-13
31214.0,2019-12-14,"(743.5, 1078.25]",15,26,-11
31214.0,2019-12-14,"(1078.25, 1413.0]",13,25,-12
31215.0,2019-12-14,"(616.228, 810.0]",2,6,-4
31215.0,2019-12-14,"(810.0, 1003.0]",4,4,0
31215.0,2019-12-14,"(1003.0, 1196.0]",3,7,-4
31215.0,2019-12-14,"(1196.0, 1389.0]",3,7,-4
31216.0,2019-12-14,"(664.712, 737.0]",1,2,-1
31216.0,2019-12-14,"(737.0, 809.0]",4,4,0
31216.0,2019-12-14,"(809.0, 881.0]",2,2,0
31217.0,2019-12-14,"(847.5, 996.75]",1,1,0
31217.0,2019-12-14,"(996.75, 1146.0]",1,4,-3
31218.0,2019-12-14,"(618.0, 924.0]",1,1,0
31218.0,2019-12-14,"(924.0, 1230.0]",4,1,3
31219.0,2019-12-14,"(753.5, 879.0]",4,6,-2
31219.0,2019-12-14,"(879.0, 1004.0]",3,3,0
31219.0,2019-12-14,"(1129.0, 1254.0]",3,1,2
,,,,2.0,
31221.0,2019-12-14,"(352.055, 589.25]",4,5,-1
31221.0,2019-12-14,"(589.25, 825.5]",3,5,-2
31221.0,2019-12-14,"(825.5, 1061.75]",6,9,-3
31221.0,2019-12-14,"(1061.75, 1298.0]",2,5,-3
31222.0,2019-12-14,"(319.883, 600.25]",2,5,-3
31222.0,2019-12-14,"(1158.75, 1438.0]",2,3,-1
31223.0,2019-12-14,"(59.72, 381.0]",1,3,-2
31223.0,2019-12-14,"(381.0, 701.0]",7,15,-8
31223.0,2019-12-14,"(701.0, 1021.0]",6,13,-7
31223.0,2019-12-14,"(1021.0, 1341.0]",6,9,-3
31224.0,2019-12-14,"(614.183, 819.25]",1,3,-2
31224.0,2019-12-14,"(819.25, 1023.5]",3,4,-1
31224.0,2019-12-14,"(1023.5, 1227.75]",2,6,-4
31224.0,2019-12-14,"(1227.75, 1432.0]",2,2,0
31225.0,2019-12-14,"(413.013, 660.75]",1,1,0
31225.0,2019-12-14,"(660.75, 907.5]",3,6,-3
31225.0,2019-12-14,"(907.5, 1154.25]",4,8,-4
31225.0,2019-12-14,"(1154.25, 1401.0]",3,4,-1
31226.0,2019-12-14,"(538.282, 718.5]",1,4,-3
31226.0,2019-12-14,"(718.5, 898.0]",3,8,-5
31226.0,2019-12-14,"(898.0, 1077.5]",2,3,-1
31226.0,2019-12-14,"(1077.5, 1257.0]",2,5,-3
31227.0,2019-12-14,"(596.276, 778.0]",5,6,-1
31227.0,2019-12-14,"(778.0, 959.0]",2,6,-4
31227.0,2019-12-14,"(959.0, 1140.0]",3,6,-3
31227.0,2019-12-14,"(1140.0, 1321.0]",1,1,0
31228.0,2019-12-14,"(23.61, 372.5]",2,2,0
31228.0,2019-12-14,"(372.5, 720.0]",7,9,-2
31228.0,2019-12-14,"(720.0, 1067.5]",16,34,-18
31228.0,2019-12-14,"(1067.5, 1415.0]",15,25,-10
31229.0,2019-12-14,"(16.59, 370.5]",5,7,-2
31229.0,2019-12-14,"(370.5, 723.0]",11,33,-22
31229.0,2019-12-14,"(723.0, 1075.5]",22,37,-15
31229.0,2019-12-14,"(1075.5, 1428.0]",22,44,-22
31230.0,2019-12-14,"(339.046, 578.5]",2,3,-1
31230.0,2019-12-14,"(578.5, 817.0]",4,5,-1
31230.0,2019-12-14,"(817.0, 1055.5]",11,18,-7
31230.0,2019-12-14,"(1055.5, 1294.0]",10,16,-6
31231.0,2019-12-14,"(233.75, 467.5]",1,1,0
31231.0,2019-12-14,"(701.25, 935.0]",6,1,5
31232.0,2019-12-14,"(344.92, 616.0]",4,5,-1
31232.0,2019-12-14,"(616.0, 886.0]",7,11,-4
31232.0,2019-12-14,"(886.0, 1156.0]",17,26,-9
31232.0,2019-12-14,"(1156.0, 1426.0]",1,4,-3
31233.0,2019-12-14,"(376.25, 677.5]",1,1,0
31233.0,2019-12-14,"(677.5, 978.75]",1,1,0
31233.0,2019-12-14,"(978.75, 1280.0]",2,2,0
31234.0,2019-12-14,"(469.065, 703.75]",3,7,-4
31234.0,2019-12-14,"(703.75, 937.5]",3,4,-1
31234.0,2019-12-14,"(937.5, 1171.25]",8,19,-11
31234.0,2019-12-14,"(1171.25, 1405.0]",3,7,-4
,,,,1.0,
,,,,1.0,
31236.0,2019-12-14,"(420.75, 748.5]",10,1,9
31236.0,2019-12-14,"(748.5, 1076.25]",4,12,-8
31236.0,2019-12-14,"(1076.25, 1404.0]",4,13,-9
31237.0,2019-12-14,"(294.901, 570.75]",1,4,-3
31237.0,2019-12-14,"(570.75, 845.5]",3,5,-2
31237.0,2019-12-14,"(845.5, 1120.25]",9,18,-9
31237.0,2019-12-14,"(1120.25, 1395.0]",7,16,-9
31238.0,2019-12-14,"(67.0, 318.0]",1,1,0
31238.0,2019-12-14,"(568.0, 818.0]",1,2,-1
31238.0,2019-12-14,"(818.0, 1068.0]",10,2,8
31239.0,2019-12-14,"(277.087, 506.25]",1,2,-1
31239.0,2019-12-14,"(506.25, 734.5]",9,11,-2
31239.0,2019-12-14,"(734.5, 962.75]",2,5,-3
31239.0,2019-12-14,"(962.75, 1191.0]",2,6,-4
,,,,2.0,
31241.0,2019-12-14,"(91.682, 422.5]",2,4,-2
31241.0,2019-12-14,"(422.5, 752.0]",7,14,-7
31241.0,2019-12-14,"(752.0, 1081.5]",7,18,-11
31241.0,2019-12-14,"(1081.5, 1411.0]",13,21,-8
31242.0,2019-12-14,"(523.116, 745.0]",3,3,0
31242.0,2019-12-14,"(745.0, 966.0]",3,4,-1
31242.0,2019-12-14,"(1187.0, 1408.0]",3,1,2
31243.0,2019-12-14,"(889.498, 1015.5]",3,5,-2
31243.0,2019-12-14,"(1266.5, 1392.0]",1,1,0
31244.0,2019-12-14,"(322.116, 544.0]",1,3,-2
31244.0,2019-12-14,"(765.0, 986.0]",2,2,0
31244.0,2019-12-14,"(986.0, 1207.0]",2,5,-3
31245.0,2019-12-14,"(469.039, 710.25]",5,11,-6
31245.0,2019-12-14,"(710.25, 950.5]",5,14,-9
31245.0,2019-12-14,"(950.5, 1190.75]",8,13,-5
31245.0,2019-12-14,"(1190.75, 1431.0]",5,8,-3
31246.0,2019-12-14,"(490.088, 719.0]",8,11,-3
31246.0,2019-12-14,"(719.0, 947.0]",9,13,-4
31246.0,2019-12-14,"(947.0, 1175.0]",9,11,-2
31246.0,2019-12-14,"(1175.0, 1403.0]",7,12,-5
31247.0,2019-12-14,"(543.444, 683.0]",2,3,-1
31247.0,2019-12-14,"(683.0, 822.0]",1,3,-2
31247.0,2019-12-14,"(822.0, 961.0]",4,9,-5
31247.0,2019-12-14,"(961.0, 1100.0]",4,18,-14
31248.0,2019-12-14,"(575.288, 754.0]",3,4,-1
31248.0,2019-12-14,"(754.0, 932.0]",5,10,-5
31248.0,2019-12-14,"(932.0, 1110.0]",5,5,0
31248.0,2019-12-14,"(1110.0, 1288.0]",2,2,0
31249.0,2019-12-14,"(804.574, 911.5]",3,6,-3
31249.0,2019-12-14,"(911.5, 1018.0]",2,4,-2
31250.0,2019-12-14,"(830.518, 951.5]",2,3,-1
31250.0,2019-12-14,"(951.5, 1072.0]",2,4,-2
31250.0,2019-12-14,"(1192.5, 1313.0]",1,3,-2
31251.0,2019-12-14,"(17.814, 315.5]",1,1,0
31251.0,2019-12-14,"(315.5, 612.0]",1,4,-3
31251.0,2019-12-14,"(612.0, 908.5]",3,4,-1
31251.0,2019-12-14,"(908.5, 1205.0]",8,18,-10
31252.0,2019-12-14,"(887.458, 1023.5]",1,3,-2
31252.0,2019-12-14,"(1023.5, 1159.0]",1,1,0
31253.0,2019-12-14,"(498.38, 654.0]",3,4,-1
31253.0,2019-12-14,"(809.0, 964.0]",4,5,-1
31253.0,2019-12-14,"(964.0, 1119.0]",1,2,-1
31254.0,2019-12-14,"(582.24, 773.0]",2,4,-2
31254.0,2019-12-14,"(773.0, 963.0]",2,3,-1
31254.0,2019-12-14,"(963.0, 1153.0]",1,1,0
31254.0,2019-12-14,"(1153.0, 1343.0]",1,4,-3
31255.0,2019-12-14,"(562.24, 753.0]",2,4,-2
31255.0,2019-12-14,"(753.0, 943.0]",6,7,-1
31255.0,2019-12-14,"(1133.0, 1323.0]",1,3,-2
31256.0,2019-12-14,"(591.198, 792.5]",1,2,-1
31256.0,2019-12-14,"(792.5, 993.0]",5,6,-1
31257.0,2019-12-14,"(390.986, 645.5]",4,5,-1
31257.0,2019-12-14,"(645.5, 899.0]",4,6,-2
31257.0,2019-12-14,"(899.0, 1152.5]",3,8,-5
31257.0,2019-12-14,"(1152.5, 1406.0]",3,12,-9
31258.0,2019-12-14,"(452.045, 691.75]",2,5,-3
31258.0,2019-12-14,"(691.75, 930.5]",5,15,-10
31258.0,2019-12-14,"(1169.25, 1408.0]",1,4,-3
31259.0,2019-12-14,"(753.954, 765.5]",1,1,0
31260.0,2019-12-14,"(712.331, 880.25]",3,5,-2
31260.0,2019-12-14,"(880.25, 1047.5]",2,5,-3
31260.0,2019-12-14,"(1047.5, 1214.75]",2,2,0
31261.0,2019-12-14,"(1058.925, 1077.75]",4,4,0
31261.0,2019-12-14,"(1096.5, 1115.25]",1,1,0
31262.0,2019-12-14,"(433.061, 668.75]",3,4,-1
31262.0,2019-12-14,"(668.75, 903.5]",2,4,-2
31262.0,2019-12-14,"(903.5, 1138.25]",5,9,-4
31262.0,2019-12-14,"(1138.25, 1373.0]",2,5,-3
31263.0,2019-12-14,"(309.004, 559.0]",2,4,-2
31263.0,2019-12-14,"(559.0, 808.0]",5,9,-4
31263.0,2019-12-14,"(808.0, 1057.0]",3,15,-12
31263.0,2019-12-14,"(1057.0, 1306.0]",10,13,-3
31264.0,2019-12-14,"(579.182, 784.5]",3,5,-2
31264.0,2019-12-14,"(784.5, 989.0]",8,11,-3
31264.0,2019-12-14,"(989.0, 1193.5]",2,6,-4
31264.0,2019-12-14,"(1193.5, 1398.0]",1,2,-1
31265.0,2019-12-14,"(11.578, 368.5]",2,3,-1
31265.0,2019-12-14,"(368.5, 724.0]",7,10,-3
31265.0,2019-12-14,"(724.0, 1079.5]",8,13,-5
31265.0,2019-12-14,"(1079.5, 1435.0]",11,19,-8
31266.0,2019-12-14,"(27.601, 378.75]",3,6,-3
31266.0,2019-12-14,"(378.75, 728.5]",3,11,-8
31266.0,2019-12-14,"(728.5, 1078.25]",17,35,-18
31266.0,2019-12-14,"(1078.25, 1428.0]",12,20,-8
31267.0,2019-12-14,"(26.642, 367.5]",3,5,-2
31267.0,2019-12-14,"(367.5, 707.0]",3,7,-4
31267.0,2019-12-14,"(707.0, 1046.5]",10,18,-8
31267.0,2019-12-14,"(1046.5, 1386.0]",9,17,-8
31268.0,2019-12-14,"(47.633, 390.75]",2,3,-1
31268.0,2019-12-14,"(390.75, 732.5]",6,9,-3
31268.0,2019-12-14,"(732.5, 1074.25]",9,20,-11
31268.0,2019-12-14,"(1074.25, 1416.0]",4,15,-11
31269.0,2019-12-14,"(531.149, 744.75]",8,12,-4
31269.0,2019-12-14,"(744.75, 957.5]",5,10,-5
31269.0,2019-12-14,"(957.5, 1170.25]",2,5,-3
31269.0,2019-12-14,"(1170.25, 1383.0]",2,4,-2
31270.0,2019-12-14,"(21.623, 367.25]",1,2,-1
31270.0,2019-12-14,"(367.25, 711.5]",2,2,0
31270.0,2019-12-14,"(711.5, 1055.75]",5,13,-8
31270.0,2019-12-14,"(1055.75, 1400.0]",6,10,-4
31271.0,2019-12-14,"(463.304, 638.0]",1,4,-3
31271.0,2019-12-14,"(638.0, 812.0]",2,3,-1
31271.0,2019-12-14,"(812.0, 986.0]",9,13,-4
31271.0,2019-12-14,"(986.0, 1160.0]",2,6,-4
31272.0,2019-12-14,"(327.358, 488.5]",1,1,0
31272.0,2019-12-14,"(488.5, 649.0]",1,1,0
31272.0,2019-12-14,"(649.0, 809.5]",1,1,0
31272.0,2019-12-14,"(809.5, 970.0]",4,7,-3
31273.0,2019-12-14,"(873.729, 941.75]",1,2,-1
31273.0,2019-12-14,"(1009.5, 1077.25]",1,1,0
31274.0,2019-12-14,"(405.25, 729.5]",4,1,3
31274.0,2019-12-14,"(729.5, 1053.75]",2,5,-3
31274.0,2019-12-14,"(1053.75, 1378.0]",3,2,1
31275.0,2019-12-14,"(128.709, 452.75]",2,3,-1
31275.0,2019-12-14,"(452.75, 775.5]",2,3,-1
31275.0,2019-12-14,"(775.5, 1098.25]",4,8,-4
31275.0,2019-12-14,"(1098.25, 1421.0]",6,13,-7
31276.0,2019-12-14,"(705.0, 1015.0]",7,2,5
31276.0,2019-12-14,"(1015.0, 1325.0]",1,7,-6
31277.0,2019-12-14,"(324.036, 566.0]",2,2,0
31277.0,2019-12-14,"(566.0, 807.0]",3,6,-3
31277.0,2019-12-14,"(807.0, 1048.0]",4,5,-1
31277.0,2019-12-14,"(1048.0, 1289.0]",8,12,-4
31278.0,2019-12-14,"(4.571, 363.25]",1,8,-7
31278.0,2019-12-14,"(363.25, 720.5]",5,8,-3
31278.0,2019-12-14,"(720.5, 1077.75]",12,32,-20
31278.0,2019-12-14,"(1077.75, 1435.0]",9,15,-6
31279.0,2019-12-14,"(885.569, 993.75]",2,3,-1
31279.0,2019-12-14,"(1209.25, 1317.0]",2,3,-1
31280.0,2019-12-14,"(405.0, 738.0]",13,1,12
31280.0,2019-12-14,"(738.0, 1071.0]",6,28,-22
31280.0,2019-12-14,"(1071.0, 1404.0]",2,12,-10
,,,,1.0,
,,,,3.0,
31001.0,2019-12-15,"(999.0, 1118.0]",4,1,3
31002.0,2019-12-15,"(627.5, 831.0]",2,1,1
31003.0,2019-12-15,"(848.816, 895.0]",1,3,-2
31003.0,2019-12-15,"(895.0, 941.0]",1,1,0
31003.0,2019-12-15,"(987.0, 1033.0]",1,1,0
31004.0,2019-12-15,"(485.266, 669.5]",1,2,-1
31004.0,2019-12-15,"(669.5, 853.0]",1,1,0
31004.0,2019-12-15,"(853.0, 1036.5]",1,2,-1
31004.0,2019-12-15,"(1036.5, 1220.0]",1,1,0
31005.0,2019-12-15,"(588.32, 759.0]",4,6,-2
31005.0,2019-12-15,"(759.0, 929.0]",1,2,-1
31005.0,2019-12-15,"(1099.0, 1269.0]",1,1,0
31006.0,2019-12-15,"(589.5, 881.25]",3,1,2
31006.0,2019-12-15,"(881.25, 1173.0]",6,3,3
31007.0,2019-12-15,"(657.0, 983.5]",1,1,0
31007.0,2019-12-15,"(983.5, 1310.0]",5,8,-3
31009.0,2019-12-15,"(772.349, 935.75]",1,2,-1
31010.0,2019-12-15,"(622.779, 678.25]",1,1,0
31011.0,2019-12-15,"(446.25, 773.5]",3,1,2
31011.0,2019-12-15,"(1100.75, 1428.0]",1,5,-4
,,,,2.0,
31013.0,2019-12-15,"(3.826, 298.5]",2,2,0
31013.0,2019-12-15,"(592.0, 885.5]",1,2,-1
31013.0,2019-12-15,"(885.5, 1179.0]",2,3,-1
31014.0,2019-12-15,"(1.583, 357.25]",2,3,-1
31014.0,2019-12-15,"(357.25, 711.5]",4,7,-3
31014.0,2019-12-15,"(711.5, 1065.75]",15,27,-12
31014.0,2019-12-15,"(1065.75, 1420.0]",4,4,0
31015.0,2019-12-15,"(445.346, 609.5]",4,5,-1
31015.0,2019-12-15,"(609.5, 773.0]",3,3,0
31015.0,2019-12-15,"(773.0, 936.5]",2,2,0
31015.0,2019-12-15,"(936.5, 1100.0]",3,5,-2
31016.0,2019-12-15,"(597.318, 768.5]",1,5,-4
31016.0,2019-12-15,"(768.5, 939.0]",1,2,-1
31016.0,2019-12-15,"(939.0, 1109.5]",2,6,-4
31016.0,2019-12-15,"(1109.5, 1280.0]",1,3,-2
31017.0,2019-12-15,"(583.437, 724.75]",1,4,-3
31017.0,2019-12-15,"(724.75, 865.5]",1,2,-1
31017.0,2019-12-15,"(865.5, 1006.25]",1,2,-1
31018.0,2019-12-15,"(93.016, 340.0]",1,1,0
31019.0,2019-12-15,"(605.278, 786.5]",3,5,-2
31019.0,2019-12-15,"(786.5, 967.0]",3,10,-7
31019.0,2019-12-15,"(967.0, 1147.5]",1,5,-4
31019.0,2019-12-15,"(1147.5, 1328.0]",1,2,-1
31020.0,2019-12-15,"(580.534, 697.5]",1,1,0
31020.0,2019-12-15,"(697.5, 814.0]",1,1,0
31020.0,2019-12-15,"(814.0, 930.5]",1,1,0
31020.0,2019-12-15,"(930.5, 1047.0]",1,3,-2
31021.0,2019-12-15,"(789.698, 865.5]",1,2,-1
31021.0,2019-12-15,"(865.5, 941.0]",3,3,0
31021.0,2019-12-15,"(1016.5, 1092.0]",1,2,-1
31022.0,2019-12-15,"(607.295, 784.25]",2,3,-1
31022.0,2019-12-15,"(784.25, 960.5]",2,3,-1
31022.0,2019-12-15,"(960.5, 1136.75]",2,5,-3
31022.0,2019-12-15,"(1136.75, 1313.0]",1,6,-5
31023.0,2019-12-15,"(777.0, 1053.0]",4,1,3
31023.0,2019-12-15,"(1053.0, 1329.0]",2,1,1
31024.0,2019-12-15,"(746.75, 967.5]",2,2,0
31024.0,2019-12-15,"(967.5, 1188.25]",2,4,-2
31024.0,2019-12-15,"(1188.25, 1409.0]",1,4,-3
31025.0,2019-12-15,"(820.949, 833.75]",1,1,0
31025.0,2019-12-15,"(859.25, 872.0]",1,1,0
31026.0,2019-12-15,"(553.5, 813.25]",2,1,1
31026.0,2019-12-15,"(813.25, 1073.0]",1,3,-2
31027.0,2019-12-15,"(869.624, 964.0]",1,1,0
31027.0,2019-12-15,"(1058.0, 1152.0]",1,2,-1
31028.0,2019-12-15,"(686.369, 844.75]",2,5,-3
31028.0,2019-12-15,"(1002.5, 1160.25]",1,1,0
31028.0,2019-12-15,"(1160.25, 1318.0]",1,1,0
31029.0,2019-12-15,"(758.75, 936.5]",5,5,0
31029.0,2019-12-15,"(1114.25, 1292.0]",1,6,-5
31030.0,2019-12-15,"(662.513, 784.75]",1,3,-2
31030.0,2019-12-15,"(1028.25, 1150.0]",1,2,-1
31031.0,2019-12-15,"(229.089, 457.75]",1,3,-2
31031.0,2019-12-15,"(913.25, 1141.0]",1,1,0
31032.0,2019-12-15,"(684.5, 716.0]",1,1,0
31033.0,2019-12-15,"(504.0, 672.0]",1,1,0
31034.0,2019-12-15,"(530.447, 669.25]",1,1,0
31034.0,2019-12-15,"(945.75, 1084.0]",2,1,1
31035.0,2019-12-15,"(41.655, 379.25]",1,1,0
31035.0,2019-12-15,"(379.25, 715.5]",1,2,-1
31035.0,2019-12-15,"(715.5, 1051.75]",1,1,0
31035.0,2019-12-15,"(1051.75, 1388.0]",1,2,-1
31036.0,2019-12-15,"(684.633, 776.75]",1,2,-1
31036.0,2019-12-15,"(960.25, 1052.0]",4,6,-2
31037.0,2019-12-15,"(610.453, 747.75]",3,5,-2
31037.0,2019-12-15,"(884.5, 1021.25]",1,3,-2
31037.0,2019-12-15,"(1021.25, 1158.0]",1,2,-1
,,,,1.0,
,,,,2.0,
31039.0,2019-12-15,"(605.638, 696.5]",1,2,-1
31039.0,2019-12-15,"(787.0, 877.5]",1,1,0
31039.0,2019-12-15,"(877.5, 968.0]",1,3,-2
31040.0,2019-12-15,"(841.5, 1046.0]",1,1,0
31041.0,2019-12-15,"(636.468, 770.0]",6,7,-1
31041.0,2019-12-15,"(770.0, 903.0]",4,6,-2
31041.0,2019-12-15,"(903.0, 1036.0]",3,4,-1
31041.0,2019-12-15,"(1036.0, 1169.0]",1,1,0
31042.0,2019-12-15,"(584.533, 701.75]",1,1,0
31042.0,2019-12-15,"(701.75, 818.5]",1,5,-4
31042.0,2019-12-15,"(818.5, 935.25]",2,3,-1
31042.0,2019-12-15,"(935.25, 1052.0]",3,3,0
31043.0,2019-12-15,"(888.912, 911.0]",1,1,0
31044.0,2019-12-15,"(552.558, 663.5]",1,1,0
31044.0,2019-12-15,"(774.0, 884.5]",1,1,0
31045.0,2019-12-15,"(1311.75, 1437.0]",1,3,-2
31046.0,2019-12-15,"(849.0, 921.5]",1,1,0
31046.0,2019-12-15,"(921.5, 994.0]",1,1,0
31047.0,2019-12-15,"(532.441, 672.75]",1,4,-3
31047.0,2019-12-15,"(672.75, 812.5]",3,4,-1
31047.0,2019-12-15,"(952.25, 1092.0]",1,1,0
31048.0,2019-12-15,"(673.624, 768.0]",1,1,0
31048.0,2019-12-15,"(956.0, 1050.0]",1,1,0
31049.0,2019-12-15,"(705.25, 827.5]",1,5,-4
31049.0,2019-12-15,"(949.75, 1072.0]",1,1,0
31050.0,2019-12-15,"(1187.0, 1290.0]",2,1,1
31051.0,2019-12-15,"(93.71, 417.5]",1,2,-1
31051.0,2019-12-15,"(417.5, 740.0]",1,2,-1
31051.0,2019-12-15,"(740.0, 1062.5]",1,2,-1
31051.0,2019-12-15,"(1062.5, 1385.0]",2,2,0
31052.0,2019-12-15,"(270.188, 474.0]",1,2,-1
31052.0,2019-12-15,"(880.0, 1083.0]",2,5,-3
,,,,2.0,
,,,,1.0,
,,,,1.0,
31055.0,2019-12-15,"(653.25, 702.0]",1,1,0
31056.0,2019-12-15,"(666.238, 857.5]",1,4,-3
31056.0,2019-12-15,"(857.5, 1048.0]",1,2,-1
31056.0,2019-12-15,"(1238.5, 1429.0]",1,1,0
31057.0,2019-12-15,"(890.875, 922.25]",1,2,-1
31057.0,2019-12-15,"(984.75, 1016.0]",1,2,-1
,,,,2.0,
,,,,2.0,
31060.0,2019-12-15,"(897.5, 1071.0]",1,1,0
31061.0,2019-12-15,"(429.0, 572.0]",1,1,0
31062.0,2019-12-15,"(402.5, 588.0]",2,1,1
31062.0,2019-12-15,"(588.0, 773.5]",4,3,1
31062.0,2019-12-15,"(773.5, 959.0]",10,9,1
,,,,2.0,
31064.0,2019-12-15,"(409.108, 633.0]",4,8,-4
31064.0,2019-12-15,"(633.0, 856.0]",6,12,-6
31064.0,2019-12-15,"(856.0, 1079.0]",3,4,-1
31064.0,2019-12-15,"(1079.0, 1302.0]",1,2,-1
,,,,1.0,
,,,,2.0,
31066.0,2019-12-15,"(690.75, 921.0]",1,1,0
31067.0,2019-12-15,"(803.25, 895.5]",1,1,0
31067.0,2019-12-15,"(895.5, 987.75]",1,1,0
31067.0,2019-12-15,"(987.75, 1080.0]",1,2,-1
31068.0,2019-12-15,"(664.32, 835.0]",1,2,-1
31068.0,2019-12-15,"(835.0, 1005.0]",2,2,0
31068.0,2019-12-15,"(1175.0, 1345.0]",1,1,0
31069.0,2019-12-15,"(891.0, 947.0]",1,1,0
31070.0,2019-12-15,"(632.496, 759.0]",1,1,0
31070.0,2019-12-15,"(1011.0, 1137.0]",2,1,1
31071.0,2019-12-15,"(333.75, 594.5]",1,1,0
31071.0,2019-12-15,"(594.5, 855.25]",3,1,2
31071.0,2019-12-15,"(855.25, 1116.0]",6,7,-1
,,,,2.0,
31073.0,2019-12-15,"(735.537, 851.75]",3,6,-3
31073.0,2019-12-15,"(1083.25, 1199.0]",1,1,0
31074.0,2019-12-15,"(597.891, 625.25]",1,1,0
,,,,2.0,
,,,,1.0,
,,,,1.0,
31077.0,2019-12-15,"(715.662, 800.5]",5,9,-4
31077.0,2019-12-15,"(800.5, 885.0]",3,3,0
31077.0,2019-12-15,"(885.0, 969.5]",2,2,0
31077.0,2019-12-15,"(969.5, 1054.0]",1,3,-2
31078.0,2019-12-15,"(1018.0, 1028.0]",1,1,0
31079.0,2019-12-15,"(-0.252, 314.0]",2,4,-2
31079.0,2019-12-15,"(314.0, 627.0]",1,5,-4
31079.0,2019-12-15,"(627.0, 940.0]",3,9,-6
31079.0,2019-12-15,"(940.0, 1253.0]",5,5,0
31080.0,2019-12-15,"(23.614, 371.5]",1,1,0
31080.0,2019-12-15,"(718.0, 1064.5]",1,2,-1
31080.0,2019-12-15,"(1064.5, 1411.0]",2,5,-3
31081.0,2019-12-15,"(35.997, 287.75]",1,1,0
31081.0,2019-12-15,"(789.25, 1040.0]",2,1,1
31082.0,2019-12-15,"(1038.987, 1042.25]",1,1,0
,,,,2.0,
31084.0,2019-12-15,"(958.0, 991.0]",1,1,0
31084.0,2019-12-15,"(1024.0, 1057.0]",2,1,1
31085.0,2019-12-15,"(43.096, 270.0]",3,3,0
31085.0,2019-12-15,"(722.0, 948.0]",1,3,-2
31086.0,2019-12-15,"(39.058, 275.5]",2,2,0
31087.0,2019-12-15,"(555.47, 688.5]",1,2,-1
31087.0,2019-12-15,"(688.5, 821.0]",1,2,-1
31087.0,2019-12-15,"(821.0, 953.5]",2,2,0
31087.0,2019-12-15,"(953.5, 1086.0]",1,4,-3
,,,,1.0,
,,,,3.0,
31089.0,2019-12-15,"(5.625, 350.75]",1,2,-1
31089.0,2019-12-15,"(350.75, 694.5]",1,4,-3
31089.0,2019-12-15,"(694.5, 1038.25]",9,18,-9
31089.0,2019-12-15,"(1038.25, 1382.0]",3,9,-6
31090.0,2019-12-15,"(874.25, 911.5]",1,2,-1
31090.0,2019-12-15,"(911.5, 948.75]",1,1,0
31091.0,2019-12-15,"(25.755, 338.25]",1,1,0
31091.0,2019-12-15,"(649.5, 960.75]",3,1,2
31091.0,2019-12-15,"(960.75, 1272.0]",2,4,-2
31092.0,2019-12-15,"(10.697, 337.75]",1,2,-1
31092.0,2019-12-15,"(989.25, 1315.0]",1,1,0
31093.0,2019-12-15,"(822.0, 829.0]",1,1,0
31094.0,2019-12-15,"(863.0, 928.5]",1,1,0
31094.0,2019-12-15,"(928.5, 994.0]",1,1,0
31095.0,2019-12-15,"(516.843, 556.25]",1,1,0
,,,,1.0,
,,,,1.0,
,,,,1.0,
,,,,1.0,
31098.0,2019-12-15,"(546.519, 667.25]",1,2,-1
31098.0,2019-12-15,"(667.25, 787.5]",1,4,-3
31098.0,2019-12-15,"(907.75, 1028.0]",2,1,1
,,,,6.0,
,,,,3.0,
31100.0,2019-12-15,"(353.0, 685.0]",3,3,0
31100.0,2019-12-15,"(685.0, 1017.0]",2,3,-1
31100.0,2019-12-15,"(1017.0, 1349.0]",2,2,0
31101.0,2019-12-15,"(10.652, 349.0]",4,7,-3
31101.0,2019-12-15,"(349.0, 686.0]",11,20,-9
31101.0,2019-12-15,"(686.0, 1023.0]",43,68,-25
31101.0,2019-12-15,"(1023.0, 1360.0]",16,30,-14
31102.0,2019-12-15,"(7.58, 364.0]",1,4,-3
31102.0,2019-12-15,"(719.0, 1074.0]",6,9,-3
31102.0,2019-12-15,"(1074.0, 1429.0]",6,17,-11
31103.0,2019-12-15,"(61.685, 391.75]",2,8,-6
31103.0,2019-12-15,"(391.75, 720.5]",8,26,-18
31103.0,2019-12-15,"(720.5, 1049.25]",7,30,-23
31103.0,2019-12-15,"(1049.25, 1378.0]",4,12,-8
31104.0,2019-12-15,"(31.594, 384.5]",1,6,-5
31104.0,2019-12-15,"(384.5, 736.0]",11,19,-8
31104.0,2019-12-15,"(736.0, 1087.5]",19,44,-25
31104.0,2019-12-15,"(1087.5, 1439.0]",4,13,-9
31105.0,2019-12-15,"(37.932, 306.0]",2,2,0
31105.0,2019-12-15,"(573.0, 840.0]",2,1,1
31105.0,2019-12-15,"(840.0, 1107.0]",1,10,-9
31106.0,2019-12-15,"(9.675, 342.25]",2,4,-2
31106.0,2019-12-15,"(342.25, 673.5]",1,3,-2
31106.0,2019-12-15,"(673.5, 1004.75]",2,3,-1
31106.0,2019-12-15,"(1004.75, 1336.0]",1,1,0
31107.0,2019-12-15,"(62.737, 379.75]",4,5,-1
31107.0,2019-12-15,"(379.75, 695.5]",4,14,-10
31107.0,2019-12-15,"(695.5, 1011.25]",13,42,-29
31107.0,2019-12-15,"(1011.25, 1327.0]",9,17,-8
31108.0,2019-12-15,"(0.789, 304.75]",1,2,-1
31108.0,2019-12-15,"(304.75, 607.5]",4,10,-6
31108.0,2019-12-15,"(607.5, 910.25]",13,35,-22
31108.0,2019-12-15,"(910.25, 1213.0]",18,26,-8
31109.0,2019-12-15,"(23.618, 370.5]",4,13,-9
31109.0,2019-12-15,"(370.5, 716.0]",10,17,-7
31109.0,2019-12-15,"(716.0, 1061.5]",22,42,-20
31109.0,2019-12-15,"(1061.5, 1407.0]",4,15,-11
31110.0,2019-12-15,"(43.671, 377.25]",3,3,0
31110.0,2019-12-15,"(377.25, 709.5]",9,20,-11
31110.0,2019-12-15,"(709.5, 1041.75]",23,44,-21
31110.0,2019-12-15,"(1041.75, 1374.0]",9,17,-8
31111.0,2019-12-15,"(16.583, 372.25]",3,8,-5
31111.0,2019-12-15,"(726.5, 1080.75]",12,20,-8
31111.0,2019-12-15,"(1080.75, 1435.0]",9,16,-7
31112.0,2019-12-15,"(488.0, 704.0]",2,1,1
31112.0,2019-12-15,"(704.0, 920.0]",3,4,-1
31113.0,2019-12-15,"(23.594, 376.5]",5,6,-1
31113.0,2019-12-15,"(376.5, 728.0]",3,21,-18
31113.0,2019-12-15,"(728.0, 1079.5]",10,28,-18
31113.0,2019-12-15,"(1079.5, 1431.0]",4,9,-5
31114.0,2019-12-15,"(16.635, 359.25]",4,13,-9
31114.0,2019-12-15,"(359.25, 700.5]",4,12,-8
31114.0,2019-12-15,"(700.5, 1041.75]",9,20,-11
31114.0,2019-12-15,"(1041.75, 1383.0]",9,16,-7
31115.0,2019-12-15,"(24.658, 361.5]",3,3,0
31115.0,2019-12-15,"(361.5, 697.0]",3,15,-12
31115.0,2019-12-15,"(697.0, 1032.5]",4,13,-9
31115.0,2019-12-15,"(1032.5, 1368.0]",8,10,-2
31116.0,2019-12-15,"(9.681, 340.75]",1,3,-2
31116.0,2019-12-15,"(340.75, 670.5]",5,10,-5
31116.0,2019-12-15,"(670.5, 1000.25]",15,31,-16
31116.0,2019-12-15,"(1000.25, 1330.0]",12,17,-5
31117.0,2019-12-15,"(26.707, 351.25]",1,5,-4
31117.0,2019-12-15,"(351.25, 674.5]",2,17,-15
31117.0,2019-12-15,"(674.5, 997.75]",8,23,-15
31117.0,2019-12-15,"(997.75, 1321.0]",8,17,-9
31118.0,2019-12-15,"(38.758, 350.5]",6,7,-1
31118.0,2019-12-15,"(350.5, 661.0]",1,6,-5
31118.0,2019-12-15,"(661.0, 971.5]",5,14,-9
31118.0,2019-12-15,"(971.5, 1282.0]",7,9,-2
31119.0,2019-12-15,"(0.579, 357.25]",7,13,-6
31119.0,2019-12-15,"(357.25, 712.5]",12,27,-15
31119.0,2019-12-15,"(712.5, 1067.75]",17,36,-19
31119.0,2019-12-15,"(1067.75, 1423.0]",15,25,-10
31120.0,2019-12-15,"(79.708, 404.0]",1,1,0
31120.0,2019-12-15,"(404.0, 727.0]",2,6,-4
31120.0,2019-12-15,"(727.0, 1050.0]",7,11,-4
31120.0,2019-12-15,"(1050.0, 1373.0]",2,5,-3
31121.0,2019-12-15,"(326.75, 641.5]",1,1,0
31121.0,2019-12-15,"(641.5, 956.25]",7,8,-1
31121.0,2019-12-15,"(956.25, 1271.0]",7,16,-9
31122.0,2019-12-15,"(16.761, 327.75]",3,4,-1
31122.0,2019-12-15,"(327.75, 637.5]",2,6,-4
31122.0,2019-12-15,"(637.5, 947.25]",11,23,-12
31122.0,2019-12-15,"(947.25, 1257.0]",5,9,-4
31123.0,2019-12-15,"(610.5, 892.75]",3,1,2
31123.0,2019-12-15,"(892.75, 1175.0]",6,3,3
31124.0,2019-12-15,"(61.646, 401.5]",1,2,-1
31124.0,2019-12-15,"(401.5, 740.0]",10,29,-19
31124.0,2019-12-15,"(740.0, 1078.5]",23,68,-45
31124.0,2019-12-15,"(1078.5, 1417.0]",9,27,-18
31125.0,2019-12-15,"(70.667, 405.25]",1,1,0
31125.0,2019-12-15,"(405.25, 738.5]",12,37,-25
31125.0,2019-12-15,"(738.5, 1071.75]",24,44,-20
31125.0,2019-12-15,"(1071.75, 1405.0]",9,17,-8
31126.0,2019-12-15,"(14.658, 351.5]",2,5,-3
31126.0,2019-12-15,"(687.0, 1022.5]",20,12,8
31126.0,2019-12-15,"(1022.5, 1358.0]",12,45,-33
,,,,2.0,
31128.0,2019-12-15,"(-0.437, 360.25]",1,3,-2
31128.0,2019-12-15,"(360.25, 719.5]",12,16,-4
31128.0,2019-12-15,"(719.5, 1078.75]",12,25,-13
31128.0,2019-12-15,"(1078.75, 1438.0]",8,19,-11
31129.0,2019-12-15,"(566.224, 761.0]",10,12,-2
31129.0,2019-12-15,"(761.0, 955.0]",12,27,-15
31129.0,2019-12-15,"(955.0, 1149.0]",11,20,-9
31129.0,2019-12-15,"(1149.0, 1343.0]",2,6,-4
31130.0,2019-12-15,"(370.25, 660.5]",1,2,-1
31130.0,2019-12-15,"(660.5, 950.75]",8,7,1
31130.0,2019-12-15,"(950.75, 1241.0]",4,16,-12
31131.0,2019-12-15,"(34.62, 381.0]",2,5,-3
31131.0,2019-12-15,"(726.0, 1071.0]",2,3,-1
31131.0,2019-12-15,"(1071.0, 1416.0]",4,9,-5
31200.0,2019-12-15,"(353.75, 672.5]",33,1,32
31200.0,2019-12-15,"(672.5, 991.25]",43,47,-4
31200.0,2019-12-15,"(991.25, 1310.0]",11,69,-58
31201.0,2019-12-15,"(5.624, 351.0]",3,10,-7
31201.0,2019-12-15,"(351.0, 695.0]",25,36,-11
31201.0,2019-12-15,"(695.0, 1039.0]",42,85,-43
31201.0,2019-12-15,"(1039.0, 1383.0]",10,25,-15
31202.0,2019-12-15,"(29.627, 374.25]",3,8,-5
31202.0,2019-12-15,"(374.25, 717.5]",13,23,-10
31202.0,2019-12-15,"(717.5, 1060.75]",33,55,-22
31202.0,2019-12-15,"(1060.75, 1404.0]",5,14,-9
31203.0,2019-12-15,"(31.608, 381.0]",5,14,-9
31203.0,2019-12-15,"(381.0, 729.0]",12,18,-6
31203.0,2019-12-15,"(729.0, 1077.0]",42,70,-28
31203.0,2019-12-15,"(1077.0, 1425.0]",16,26,-10
31204.0,2019-12-15,"(193.898, 470.5]",1,2,-1
31204.0,2019-12-15,"(470.5, 746.0]",1,5,-4
31204.0,2019-12-15,"(746.0, 1021.5]",1,5,-4
31204.0,2019-12-15,"(1021.5, 1297.0]",8,10,-2
31205.0,2019-12-15,"(482.413, 629.75]",3,3,0
31205.0,2019-12-15,"(629.75, 776.5]",3,7,-4
31205.0,2019-12-15,"(776.5, 923.25]",9,13,-4
31205.0,2019-12-15,"(923.25, 1070.0]",3,13,-10
31206.0,2019-12-15,"(819.5, 845.0]",1,2,-1
31207.0,2019-12-15,"(695.0, 840.0]",1,1,0
31208.0,2019-12-15,"(596.263, 781.25]",4,7,-3
31208.0,2019-12-15,"(781.25, 965.5]",1,2,-1
31208.0,2019-12-15,"(1149.75, 1334.0]",1,1,0
31209.0,2019-12-15,"(708.378, 864.5]",2,5,-3
31209.0,2019-12-15,"(864.5, 1020.0]",4,6,-2
31209.0,2019-12-15,"(1175.5, 1331.0]",2,2,0
31211.0,2019-12-15,"(464.074, 696.5]",5,6,-1
31211.0,2019-12-15,"(696.5, 928.0]",1,8,-7
31211.0,2019-12-15,"(928.0, 1159.5]",3,5,-2
31211.0,2019-12-15,"(1159.5, 1391.0]",1,3,-2
31212.0,2019-12-15,"(10.618, 357.5]",1,3,-2
31212.0,2019-12-15,"(357.5, 703.0]",13,18,-5
31212.0,2019-12-15,"(703.0, 1048.5]",10,27,-17
31212.0,2019-12-15,"(1048.5, 1394.0]",9,15,-6
31213.0,2019-12-15,"(6.575, 364.25]",1,1,0
31213.0,2019-12-15,"(364.25, 720.5]",4,7,-3
31213.0,2019-12-15,"(720.5, 1076.75]",9,19,-10
31213.0,2019-12-15,"(1076.75, 1433.0]",4,9,-5
31214.0,2019-12-15,"(25.674, 358.5]",2,6,-4
31214.0,2019-12-15,"(358.5, 690.0]",16,26,-10
31214.0,2019-12-15,"(690.0, 1021.5]",22,44,-22
31214.0,2019-12-15,"(1021.5, 1353.0]",23,34,-11
31215.0,2019-12-15,"(27.999, 279.25]",1,2,-1
31215.0,2019-12-15,"(529.5, 779.75]",8,16,-8
31215.0,2019-12-15,"(779.75, 1030.0]",14,19,-5
31216.0,2019-12-15,"(314.137, 530.75]",2,3,-1
31216.0,2019-12-15,"(530.75, 746.5]",3,4,-1
31216.0,2019-12-15,"(746.5, 962.25]",1,4,-3
31216.0,2019-12-15,"(962.25, 1178.0]",2,3,-1
31217.0,2019-12-15,"(705.527, 824.25]",2,4,-2
31217.0,2019-12-15,"(1060.75, 1179.0]",2,1,1
31218.0,2019-12-15,"(19.636, 362.0]",1,1,0
31218.0,2019-12-15,"(362.0, 703.0]",1,2,-1
31218.0,2019-12-15,"(703.0, 1044.0]",2,2,0
31218.0,2019-12-15,"(1044.0, 1385.0]",2,4,-2
31219.0,2019-12-15,"(591.545, 705.75]",3,4,-1
31219.0,2019-12-15,"(705.75, 819.5]",3,5,-2
31219.0,2019-12-15,"(819.5, 933.25]",5,10,-5
31219.0,2019-12-15,"(933.25, 1047.0]",7,11,-4
,,,,2.0,
31221.0,2019-12-15,"(19.625, 364.75]",2,3,-1
31221.0,2019-12-15,"(364.75, 708.5]",5,7,-2
31221.0,2019-12-15,"(708.5, 1052.25]",10,19,-9
31221.0,2019-12-15,"(1052.25, 1396.0]",3,3,0
31222.0,2019-12-15,"(315.5, 593.0]",2,3,-1
31222.0,2019-12-15,"(593.0, 870.5]",10,2,8
31222.0,2019-12-15,"(870.5, 1148.0]",2,14,-12
31223.0,2019-12-15,"(45.732, 364.0]",2,5,-3
31223.0,2019-12-15,"(364.0, 681.0]",6,11,-5
31223.0,2019-12-15,"(681.0, 998.0]",10,22,-12
31223.0,2019-12-15,"(998.0, 1315.0]",11,21,-10
31224.0,2019-12-15,"(450.237, 641.75]",1,5,-4
31224.0,2019-12-15,"(641.75, 832.5]",1,3,-2
31224.0,2019-12-15,"(832.5, 1023.25]",2,6,-4
31224.0,2019-12-15,"(1023.25, 1214.0]",3,5,-2
31225.0,2019-12-15,"(468.036, 710.0]",6,8,-2
31225.0,2019-12-15,"(710.0, 951.0]",10,19,-9
31225.0,2019-12-15,"(951.0, 1192.0]",8,11,-3
31225.0,2019-12-15,"(1192.0, 1433.0]",3,3,0
31226.0,2019-12-15,"(34.626, 379.5]",1,2,-1
31226.0,2019-12-15,"(379.5, 723.0]",1,2,-1
31226.0,2019-12-15,"(723.0, 1066.5]",2,4,-2
31226.0,2019-12-15,"(1066.5, 1410.0]",1,2,-1
31227.0,2019-12-15,"(440.141, 655.75]",2,2,0
31227.0,2019-12-15,"(655.75, 870.5]",3,4,-1
31227.0,2019-12-15,"(870.5, 1085.25]",3,10,-7
31227.0,2019-12-15,"(1085.25, 1300.0]",5,7,-2
31228.0,2019-12-15,"(80.738, 397.5]",2,5,-3
31228.0,2019-12-15,"(397.5, 713.0]",11,15,-4
31228.0,2019-12-15,"(713.0, 1028.5]",20,25,-5
31228.0,2019-12-15,"(1028.5, 1344.0]",5,9,-4
31229.0,2019-12-15,"(52.638, 394.5]",2,5,-3
31229.0,2019-12-15,"(394.5, 735.0]",18,45,-27
31229.0,2019-12-15,"(735.0, 1075.5]",27,54,-27
31229.0,2019-12-15,"(1075.5, 1416.0]",15,28,-13
31230.0,2019-12-15,"(559.239, 750.25]",7,8,-1
31230.0,2019-12-15,"(750.25, 940.5]",12,16,-4
31230.0,2019-12-15,"(940.5, 1130.75]",4,6,-2
31230.0,2019-12-15,"(1130.75, 1321.0]",3,7,-4
31231.0,2019-12-15,"(677.558, 788.5]",3,3,0
31231.0,2019-12-15,"(1009.5, 1120.0]",3,1,2
31232.0,2019-12-15,"(377.0, 714.0]",5,3,2
31232.0,2019-12-15,"(714.0, 1051.0]",26,12,14
31232.0,2019-12-15,"(1051.0, 1388.0]",11,43,-32
31233.0,2019-12-15,"(345.0, 666.0]",2,1,1
31233.0,2019-12-15,"(666.0, 987.0]",5,3,2
31233.0,2019-12-15,"(987.0, 1308.0]",6,6,0
31234.0,2019-12-15,"(349.5, 632.0]",5,1,4
31234.0,2019-12-15,"(632.0, 914.5]",15,7,8
31234.0,2019-12-15,"(914.5, 1197.0]",11,31,-20
31235.0,2019-12-15,"(848.0, 968.0]",7,2,5
31236.0,2019-12-15,"(10.626, 355.5]",4,6,-2
31236.0,2019-12-15,"(355.5, 699.0]",9,12,-3
31236.0,2019-12-15,"(699.0, 1042.5]",14,27,-13
31236.0,2019-12-15,"(1042.5, 1386.0]",2,9,-7
31237.0,2019-12-15,"(13.727, 333.25]",1,1,0
31237.0,2019-12-15,"(333.25, 651.5]",8,15,-7
31237.0,2019-12-15,"(651.5, 969.75]",11,23,-12
31237.0,2019-12-15,"(969.75, 1288.0]",12,25,-13
31238.0,2019-12-15,"(55.722, 376.5]",1,2,-1
31238.0,2019-12-15,"(376.5, 696.0]",5,7,-2
31238.0,2019-12-15,"(696.0, 1015.5]",8,11,-3
31238.0,2019-12-15,"(1015.5, 1335.0]",1,6,-5
31239.0,2019-12-15,"(124.784, 430.0]",1,1,0
31239.0,2019-12-15,"(430.0, 734.0]",11,14,-3
31239.0,2019-12-15,"(734.0, 1038.0]",14,25,-11
31239.0,2019-12-15,"(1038.0, 1342.0]",7,8,-1
31240.0,2019-12-15,"(568.559, 679.25]",6,12,-6
31240.0,2019-12-15,"(789.5, 899.75]",6,2,4
31240.0,2019-12-15,"(899.75, 1010.0]",8,10,-2
31241.0,2019-12-15,"(16.623, 362.25]",2,5,-3
31241.0,2019-12-15,"(362.25, 706.5]",4,15,-11
31241.0,2019-12-15,"(706.5, 1050.75]",15,33,-18
31241.0,2019-12-15,"(1050.75, 1395.0]",14,24,-10
31242.0,2019-12-15,"(370.75, 692.5]",2,1,1
31242.0,2019-12-15,"(692.5, 1014.25]",1,2,-1
31242.0,2019-12-15,"(1014.25, 1336.0]",1,4,-3
31243.0,2019-12-15,"(436.195, 638.25]",2,3,-1
31243.0,2019-12-15,"(638.25, 839.5]",3,6,-3
31243.0,2019-12-15,"(839.5, 1040.75]",12,15,-3
31243.0,2019-12-15,"(1040.75, 1242.0]",4,5,-1
31244.0,2019-12-15,"(57.688, 387.0]",3,4,-1
31244.0,2019-12-15,"(387.0, 715.0]",5,8,-3
31244.0,2019-12-15,"(715.0, 1043.0]",8,19,-11
31244.0,2019-12-15,"(1043.0, 1371.0]",9,13,-4
31245.0,2019-12-15,"(14.65, 353.5]",3,10,-7
31245.0,2019-12-15,"(353.5, 691.0]",3,6,-3
31245.0,2019-12-15,"(691.0, 1028.5]",15,24,-9
31245.0,2019-12-15,"(1028.5, 1366.0]",4,10,-6
31246.0,2019-12-15,"(116.791, 420.25]",3,3,0
31246.0,2019-12-15,"(420.25, 722.5]",15,21,-6
31246.0,2019-12-15,"(722.5, 1024.75]",21,36,-15
31246.0,2019-12-15,"(1024.75, 1327.0]",9,10,-1
31247.0,2019-12-15,"(503.144, 718.0]",9,13,-4
31247.0,2019-12-15,"(718.0, 932.0]",28,42,-14
31247.0,2019-12-15,"(932.0, 1146.0]",9,14,-5
31247.0,2019-12-15,"(1146.0, 1360.0]",9,13,-4
31248.0,2019-12-15,"(233.018, 479.5]",5,5,0
31248.0,2019-12-15,"(479.5, 725.0]",12,28,-16
31248.0,2019-12-15,"(725.0, 970.5]",29,63,-34
31248.0,2019-12-15,"(970.5, 1216.0]",21,30,-9
31249.0,2019-12-15,"(417.126, 636.5]",5,8,-3
31249.0,2019-12-15,"(636.5, 855.0]",8,17,-9
31249.0,2019-12-15,"(855.0, 1073.5]",11,27,-16
31249.0,2019-12-15,"(1073.5, 1292.0]",1,2,-1
31250.0,2019-12-15,"(619.0, 892.0]",4,1,3
31250.0,2019-12-15,"(892.0, 1165.0]",1,5,-4
31251.0,2019-12-15,"(62.866, 347.5]",5,5,0
31251.0,2019-12-15,"(347.5, 631.0]",1,2,-1
31251.0,2019-12-15,"(631.0, 914.5]",13,26,-13
31251.0,2019-12-15,"(914.5, 1198.0]",5,6,-1
31252.0,2019-12-15,"(372.25, 710.5]",1,3,-2
31252.0,2019-12-15,"(710.5, 1048.75]",5,1,4
31252.0,2019-12-15,"(1048.75, 1387.0]",1,7,-6
31253.0,2019-12-15,"(33.751, 347.25]",1,2,-1
31253.0,2019-12-15,"(347.25, 659.5]",3,4,-1
31253.0,2019-12-15,"(659.5, 971.75]",5,9,-4
31253.0,2019-12-15,"(971.75, 1284.0]",1,5,-4
31254.0,2019-12-15,"(535.378, 691.5]",3,4,-1
31254.0,2019-12-15,"(691.5, 847.0]",1,1,0
31254.0,2019-12-15,"(847.0, 1002.5]",3,6,-3
31254.0,2019-12-15,"(1002.5, 1158.0]",4,5,-1
31255.0,2019-12-15,"(553.394, 705.5]",3,4,-1
31255.0,2019-12-15,"(705.5, 857.0]",1,3,-2
31255.0,2019-12-15,"(857.0, 1008.5]",2,6,-4
31255.0,2019-12-15,"(1008.5, 1160.0]",1,4,-3
31256.0,2019-12-15,"(549.115, 771.25]",2,7,-5
31256.0,2019-12-15,"(771.25, 992.5]",12,19,-7
31256.0,2019-12-15,"(992.5, 1213.75]",3,9,-6
31256.0,2019-12-15,"(1213.75, 1435.0]",1,3,-2
31257.0,2019-12-15,"(391.011, 639.25]",5,7,-2
31257.0,2019-12-15,"(639.25, 886.5]",10,17,-7
31257.0,2019-12-15,"(886.5, 1133.75]",7,11,-4
31257.0,2019-12-15,"(1133.75, 1381.0]",3,12,-9
31258.0,2019-12-15,"(421.0, 730.0]",14,1,13
31258.0,2019-12-15,"(730.0, 1039.0]",29,25,4
31258.0,2019-12-15,"(1039.0, 1348.0]",6,66,-60
31259.0,2019-12-15,"(899.5, 1023.75]",1,2,-1
31260.0,2019-12-15,"(137.814, 435.5]",3,3,0
31260.0,2019-12-15,"(435.5, 732.0]",2,3,-1
31260.0,2019-12-15,"(732.0, 1028.5]",7,12,-5
31260.0,2019-12-15,"(1028.5, 1325.0]",2,4,-2
31261.0,2019-12-15,"(790.75, 928.5]",2,2,0
31261.0,2019-12-15,"(928.5, 1066.25]",2,6,-4
31262.0,2019-12-15,"(586.472, 719.0]",1,1,0
31262.0,2019-12-15,"(719.0, 851.0]",6,7,-1
31262.0,2019-12-15,"(851.0, 983.0]",1,2,-1
31262.0,2019-12-15,"(983.0, 1115.0]",2,4,-2
31263.0,2019-12-15,"(380.999, 632.25]",2,5,-3
31263.0,2019-12-15,"(632.25, 882.5]",18,28,-10
31263.0,2019-12-15,"(882.5, 1132.75]",11,17,-6
31263.0,2019-12-15,"(1132.75, 1383.0]",3,5,-2
31264.0,2019-12-15,"(617.221, 812.75]",5,8,-3
31264.0,2019-12-15,"(812.75, 1007.5]",10,14,-4
31264.0,2019-12-15,"(1007.5, 1202.25]",1,7,-6
31264.0,2019-12-15,"(1202.25, 1397.0]",1,2,-1
31265.0,2019-12-15,"(55.671, 389.25]",1,3,-2
31265.0,2019-12-15,"(389.25, 721.5]",3,11,-8
31265.0,2019-12-15,"(721.5, 1053.75]",23,42,-19
31265.0,2019-12-15,"(1053.75, 1386.0]",6,16,-10
31266.0,2019-12-15,"(18.625, 363.75]",4,6,-2
31266.0,2019-12-15,"(363.75, 707.5]",6,23,-17
31266.0,2019-12-15,"(707.5, 1051.25]",27,49,-22
31266.0,2019-12-15,"(1051.25, 1395.0]",9,17,-8
31267.0,2019-12-15,"(58.642, 399.5]",2,4,-2
31267.0,2019-12-15,"(399.5, 739.0]",8,17,-9
31267.0,2019-12-15,"(739.0, 1078.5]",10,20,-10
31267.0,2019-12-15,"(1078.5, 1418.0]",8,20,-12
31268.0,2019-12-15,"(15.616, 363.0]",4,10,-6
31268.0,2019-12-15,"(363.0, 709.0]",12,20,-8
31268.0,2019-12-15,"(709.0, 1055.0]",20,30,-10
31268.0,2019-12-15,"(1055.0, 1401.0]",5,11,-6
31269.0,2019-12-15,"(471.25, 775.5]",10,1,9
31269.0,2019-12-15,"(775.5, 1079.75]",3,17,-14
31269.0,2019-12-15,"(1079.75, 1384.0]",2,8,-6
31270.0,2019-12-15,"(32.034, 274.5]",1,2,-1
31270.0,2019-12-15,"(274.5, 516.0]",1,1,0
31270.0,2019-12-15,"(516.0, 757.5]",4,11,-7
31270.0,2019-12-15,"(757.5, 999.0]",13,19,-6
31271.0,2019-12-15,"(702.478, 833.5]",11,20,-9
31271.0,2019-12-15,"(833.5, 964.0]",10,17,-7
31271.0,2019-12-15,"(964.0, 1094.5]",4,20,-16
31271.0,2019-12-15,"(1094.5, 1225.0]",4,9,-5
31272.0,2019-12-15,"(598.378, 754.5]",7,10,-3
31272.0,2019-12-15,"(754.5, 910.0]",7,13,-6
31272.0,2019-12-15,"(910.0, 1065.5]",6,10,-4
31272.0,2019-12-15,"(1065.5, 1221.0]",2,2,0
31273.0,2019-12-15,"(412.394, 564.5]",1,1,0
31273.0,2019-12-15,"(564.5, 716.0]",15,28,-13
31273.0,2019-12-15,"(716.0, 867.5]",1,6,-5
31273.0,2019-12-15,"(867.5, 1019.0]",5,10,-5
31274.0,2019-12-15,"(25.819, 322.25]",1,2,-1
31274.0,2019-12-15,"(322.25, 617.5]",1,2,-1
31274.0,2019-12-15,"(617.5, 912.75]",4,8,-4
31274.0,2019-12-15,"(912.75, 1208.0]",11,18,-7
31275.0,2019-12-15,"(24.632, 368.0]",2,2,0
31275.0,2019-12-15,"(368.0, 710.0]",8,14,-6
31275.0,2019-12-15,"(710.0, 1052.0]",8,20,-12
31275.0,2019-12-15,"(1052.0, 1394.0]",1,7,-6
31276.0,2019-12-15,"(631.396, 783.0]",2,3,-1
31276.0,2019-12-15,"(783.0, 934.0]",1,3,-2
31276.0,2019-12-15,"(934.0, 1085.0]",1,4,-3
31276.0,2019-12-15,"(1085.0, 1236.0]",1,4,-3
31277.0,2019-12-15,"(323.75, 583.5]",2,1,1
31277.0,2019-12-15,"(583.5, 843.25]",8,4,4
31277.0,2019-12-15,"(843.25, 1103.0]",6,10,-4
31278.0,2019-12-15,"(6.571, 365.25]",2,4,-2
31278.0,2019-12-15,"(365.25, 722.5]",3,10,-7
31278.0,2019-12-15,"(722.5, 1079.75]",14,33,-19
31278.0,2019-12-15,"(1079.75, 1437.0]",7,9,-2
31279.0,2019-12-15,"(706.578, 812.5]",1,2,-1
31279.0,2019-12-15,"(812.5, 918.0]",1,1,0
31279.0,2019-12-15,"(918.0, 1023.5]",1,3,-2
31279.0,2019-12-15,"(1023.5, 1129.0]",4,5,-1
31280.0,2019-12-15,"(684.0, 956.5]",11,1,10
31280.0,2019-12-15,"(956.5, 1229.0]",4,3,1
31000.0,2019-12-16,"(951.25, 1036.0]",1,1,0
,,,,2.0,
31002.0,2019-12-16,"(372.169, 580.75]",1,1,0
31002.0,2019-12-16,"(580.75, 788.5]",1,1,0
31002.0,2019-12-16,"(788.5, 996.25]",1,2,-1
31003.0,2019-12-16,"(921.25, 1087.0]",1,2,-1
31004.0,2019-12-16,"(987.0, 1153.0]",3,1,2
31005.0,2019-12-16,"(491.298, 667.5]",1,1,0
31005.0,2019-12-16,"(1018.5, 1194.0]",2,7,-5
31006.0,2019-12-16,"(1126.75, 1159.0]",1,2,-1
31007.0,2019-12-16,"(429.256, 616.0]",1,6,-5
31007.0,2019-12-16,"(988.0, 1174.0]",4,12,-8
31009.0,2019-12-16,"(433.337, 599.75]",2,2,0
31009.0,2019-12-16,"(599.75, 765.5]",1,1,0
,,,,2.0,
31011.0,2019-12-16,"(389.238, 580.5]",2,2,0
31011.0,2019-12-16,"(961.5, 1152.0]",1,1,0
31012.0,2019-12-16,"(428.371, 586.25]",1,1,0
31013.0,2019-12-16,"(1014.816, 1061.0]",1,1,0
31013.0,2019-12-16,"(1107.0, 1153.0]",1,2,-1
31013.0,2019-12-16,"(1153.0, 1199.0]",1,1,0
31014.0,2019-12-16,"(8.602, 359.5]",1,1,0
31014.0,2019-12-16,"(359.5, 709.0]",6,8,-2
31014.0,2019-12-16,"(709.0, 1058.5]",6,8,-2
31014.0,2019-12-16,"(1058.5, 1408.0]",5,10,-5
31015.0,2019-12-16,"(88.666, 423.5]",2,2,0
31015.0,2019-12-16,"(423.5, 757.0]",3,5,-2
31015.0,2019-12-16,"(757.0, 1090.5]",3,5,-2
31015.0,2019-12-16,"(1090.5, 1424.0]",1,1,0
31016.0,2019-12-16,"(20.727, 340.25]",1,2,-1
31016.0,2019-12-16,"(976.75, 1295.0]",3,2,1
31017.0,2019-12-16,"(510.108, 734.0]",3,5,-2
31018.0,2019-12-16,"(918.75, 985.5]",1,1,0
31018.0,2019-12-16,"(1052.25, 1119.0]",1,1,0
31019.0,2019-12-16,"(591.75, 789.0]",2,1,1
31020.0,2019-12-16,"(795.402, 945.5]",1,1,0
31021.0,2019-12-16,"(27.701, 353.75]",1,1,0
31021.0,2019-12-16,"(353.75, 678.5]",1,2,-1
31021.0,2019-12-16,"(678.5, 1003.25]",1,2,-1
31022.0,2019-12-16,"(644.257, 830.75]",1,1,0
31022.0,2019-12-16,"(1016.5, 1202.25]",1,2,-1
,,,,1.0,
,,,,1.0,
,,,,3.0,
31024.0,2019-12-16,"(941.75, 1046.5]",1,1,0
31024.0,2019-12-16,"(1046.5, 1151.25]",1,1,0
31024.0,2019-12-16,"(1151.25, 1256.0]",1,1,0
,,,,2.0,
,,,,1.0,
,,,,1.0,
,,,,1.0,
,,,,1.0,
,,,,2.0,
31029.0,2019-12-16,"(824.5, 959.75]",1,3,-2
31029.0,2019-12-16,"(959.75, 1095.0]",2,2,0
31030.0,2019-12-16,"(942.0, 1169.0]",2,2,0
31030.0,2019-12-16,"(1169.0, 1396.0]",2,1,1
,,,,1.0,
,,,,1.0,
,,,,1.0,
,,,,1.0,
,,,,1.0,
,,,,2.0,
,,,,1.0,
,,,,2.0,
31035.0,2019-12-16,"(946.5, 1117.0]",1,2,-1
31036.0,2019-12-16,"(442.048, 681.0]",1,4,-3
31036.0,2019-12-16,"(919.0, 1157.0]",4,4,0
31036.0,2019-12-16,"(1157.0, 1395.0]",2,2,0
31037.0,2019-12-16,"(367.978, 624.5]",3,5,-2
31037.0,2019-12-16,"(624.5, 880.0]",2,3,-1
31037.0,2019-12-16,"(880.0, 1135.5]",1,8,-7
31037.0,2019-12-16,"(1135.5, 1391.0]",1,4,-3
31038.0,2019-12-16,"(661.579, 767.25]",1,1,0
31039.0,2019-12-16,"(1158.875, 1190.25]",1,2,-1
,,,,1.0,
,,,,1.0,
,,,,2.0,
31042.0,2019-12-16,"(484.43, 627.5]",1,1,0
,,,,2.0,
,,,,1.0,
,,,,1.0,
31045.0,2019-12-16,"(-1.115, 278.75]",1,2,-1
31045.0,2019-12-16,"(836.25, 1115.0]",2,2,0
,,,,2.0,
31047.0,2019-12-16,"(407.256, 594.0]",3,3,0
31047.0,2019-12-16,"(966.0, 1152.0]",4,3,1
31048.0,2019-12-16,"(792.0, 924.0]",1,1,0
31048.0,2019-12-16,"(1056.0, 1188.0]",1,1,0
31049.0,2019-12-16,"(876.0, 1168.0]",1,1,0
31050.0,2019-12-16,"(678.5, 883.0]",1,2,-1
31050.0,2019-12-16,"(1087.5, 1292.0]",1,2,-1
31051.0,2019-12-16,"(704.5, 905.25]",1,2,-1
31051.0,2019-12-16,"(905.25, 1106.0]",3,1,2
31052.0,2019-12-16,"(341.0, 613.0]",1,1,0
31052.0,2019-12-16,"(885.0, 1157.0]",1,2,-1
31053.0,2019-12-16,"(1277.0, 1437.0]",1,1,0
,,,,2.0,
31055.0,2019-12-16,"(455.25, 607.0]",2,1,1
31056.0,2019-12-16,"(942.0, 1154.0]",1,2,-1
31056.0,2019-12-16,"(1154.0, 1366.0]",1,1,0
31057.0,2019-12-16,"(284.0, 568.0]",1,1,0
31057.0,2019-12-16,"(852.0, 1136.0]",1,1,0
,,,,2.0,
31059.0,2019-12-16,"(279.0, 558.0]",1,1,0
31059.0,2019-12-16,"(837.0, 1116.0]",1,1,0
,,,,1.0,
,,,,1.0,
,,,,2.0,
,,,,2.0,
,,,,2.0,
31064.0,2019-12-16,"(47.113, 269.75]",1,1,0
31064.0,2019-12-16,"(269.75, 491.5]",1,1,0
31064.0,2019-12-16,"(713.25, 935.0]",1,2,-1
31065.0,2019-12-16,"(744.0, 992.0]",1,1,0
,,,,2.0,
,,,,2.0,
31068.0,2019-12-16,"(1017.0, 1356.0]",1,1,0
31069.0,2019-12-16,"(771.5, 944.25]",2,1,1
31069.0,2019-12-16,"(944.25, 1117.0]",1,2,-1
31070.0,2019-12-16,"(975.0, 1192.5]",3,1,2
31070.0,2019-12-16,"(1192.5, 1410.0]",2,5,-3
31071.0,2019-12-16,"(924.698, 1000.5]",1,1,0
31071.0,2019-12-16,"(1000.5, 1076.0]",1,1,0
31071.0,2019-12-16,"(1076.0, 1151.5]",1,1,0
,,,,2.0,
31073.0,2019-12-16,"(1431.284, 1432.0]",1,2,-1
31074.0,2019-12-16,"(897.805, 946.75]",1,2,-1
31074.0,2019-12-16,"(1044.25, 1093.0]",1,1,0
,,,,2.0,
,,,,2.0,
31077.0,2019-12-16,"(534.179, 740.25]",1,4,-3
31077.0,2019-12-16,"(740.25, 945.5]",1,2,-1
31077.0,2019-12-16,"(945.5, 1150.75]",3,3,0
31077.0,2019-12-16,"(1150.75, 1356.0]",1,1,0
31078.0,2019-12-16,"(506.56, 617.0]",1,1,0
31078.0,2019-12-16,"(617.0, 727.0]",1,1,0
31079.0,2019-12-16,"(865.0, 1021.0]",1,1,0
31079.0,2019-12-16,"(1177.0, 1333.0]",2,3,-1
31080.0,2019-12-16,"(648.25, 894.5]",1,4,-3
31080.0,2019-12-16,"(1140.75, 1387.0]",2,1,1
,,,,1.0,
,,,,2.0,
,,,,1.0,
,,,,1.0,
31083.0,2019-12-16,"(702.596, 804.0]",1,1,0
31083.0,2019-12-16,"(804.0, 905.0]",1,1,0
31083.0,2019-12-16,"(905.0, 1006.0]",1,1,0
31083.0,2019-12-16,"(1006.0, 1107.0]",1,2,-1
31084.0,2019-12-16,"(663.488, 792.0]",1,1,0
,,,,2.0,
,,,,1.0,
,,,,1.0,
31087.0,2019-12-16,"(738.674, 820.5]",3,3,0
31087.0,2019-12-16,"(983.5, 1065.0]",3,1,2
31088.0,2019-12-16,"(879.0, 1172.0]",2,1,1
31089.0,2019-12-16,"(477.342, 642.5]",4,5,-1
31089.0,2019-12-16,"(807.0, 971.5]",1,1,0
31089.0,2019-12-16,"(971.5, 1136.0]",1,3,-2
,,,,2.0,
31091.0,2019-12-16,"(965.75, 1160.0]",1,1,0
,,,,2.0,
,,,,2.0,
31094.0,2019-12-16,"(782.25, 1043.0]",1,1,0
,,,,2.0,
31096.0,2019-12-16,"(1149.984, 1154.0]",1,1,0
31096.0,2019-12-16,"(1158.0, 1162.0]",1,1,0
31097.0,2019-12-16,"(736.593, 838.75]",1,1,0
31098.0,2019-12-16,"(489.397, 640.75]",1,1,0
31098.0,2019-12-16,"(942.25, 1093.0]",2,1,1
,,,,2.0,
31100.0,2019-12-16,"(315.917, 587.75]",6,7,-1
31100.0,2019-12-16,"(587.75, 858.5]",2,4,-2
31100.0,2019-12-16,"(858.5, 1129.25]",2,4,-2
31101.0,2019-12-16,"(8.585, 363.75]",1,4,-3
31101.0,2019-12-16,"(363.75, 717.5]",4,12,-8
31101.0,2019-12-16,"(717.5, 1071.25]",17,28,-11
31101.0,2019-12-16,"(1071.25, 1425.0]",15,26,-11
31102.0,2019-12-16,"(861.0, 1110.0]",3,9,-6
31102.0,2019-12-16,"(1110.0, 1359.0]",8,7,1
31103.0,2019-12-16,"(672.5, 891.0]",1,9,-8
31103.0,2019-12-16,"(891.0, 1109.5]",6,3,3
31103.0,2019-12-16,"(1109.5, 1328.0]",4,11,-7
31104.0,2019-12-16,"(385.974, 643.5]",2,9,-7
31104.0,2019-12-16,"(643.5, 900.0]",2,5,-3
31104.0,2019-12-16,"(900.0, 1156.5]",5,8,-3
31104.0,2019-12-16,"(1156.5, 1413.0]",2,8,-6
31105.0,2019-12-16,"(706.286, 885.5]",2,3,-1
31105.0,2019-12-16,"(885.5, 1064.0]",1,2,-1
31105.0,2019-12-16,"(1064.0, 1242.5]",2,2,0
,,,,1.0,
,,,,1.0,
31107.0,2019-12-16,"(438.188, 642.0]",2,11,-9
31107.0,2019-12-16,"(845.0, 1048.0]",5,2,3
31107.0,2019-12-16,"(1048.0, 1251.0]",4,6,-2
31108.0,2019-12-16,"(46.754, 359.5]",3,3,0
31108.0,2019-12-16,"(359.5, 671.0]",2,3,-1
31108.0,2019-12-16,"(671.0, 982.5]",7,17,-10
31108.0,2019-12-16,"(982.5, 1294.0]",11,18,-7
31109.0,2019-12-16,"(334.0, 661.0]",1,2,-1
31109.0,2019-12-16,"(988.0, 1315.0]",11,3,8
31110.0,2019-12-16,"(311.936, 579.0]",5,15,-10
31110.0,2019-12-16,"(579.0, 845.0]",2,6,-4
31110.0,2019-12-16,"(845.0, 1111.0]",8,13,-5
31110.0,2019-12-16,"(1111.0, 1377.0]",11,19,-8
31111.0,2019-12-16,"(335.989, 589.75]",1,7,-6
31111.0,2019-12-16,"(589.75, 842.5]",3,8,-5
31111.0,2019-12-16,"(842.5, 1095.25]",3,5,-2
31111.0,2019-12-16,"(1095.25, 1348.0]",9,13,-4
31112.0,2019-12-16,"(890.75, 1001.0]",1,1,0
31113.0,2019-12-16,"(580.75, 854.5]",2,4,-2
31113.0,2019-12-16,"(854.5, 1128.25]",2,10,-8
31113.0,2019-12-16,"(1128.25, 1402.0]",2,3,-1
31114.0,2019-12-16,"(20.705, 345.75]",1,1,0
31114.0,2019-12-16,"(345.75, 669.5]",4,11,-7
31114.0,2019-12-16,"(669.5, 993.25]",4,8,-4
31114.0,2019-12-16,"(993.25, 1317.0]",14,22,-8
31115.0,2019-12-16,"(468.152, 681.0]",2,9,-7
31115.0,2019-12-16,"(681.0, 893.0]",1,3,-2
31115.0,2019-12-16,"(1105.0, 1317.0]",4,2,2
31116.0,2019-12-16,"(639.75, 872.5]",4,7,-3
31116.0,2019-12-16,"(872.5, 1105.25]",4,8,-4
31116.0,2019-12-16,"(1105.25, 1338.0]",7,4,3
31117.0,2019-12-16,"(382.039, 623.25]",2,9,-7
31117.0,2019-12-16,"(623.25, 863.5]",2,6,-4
31117.0,2019-12-16,"(863.5, 1103.75]",1,3,-2
31117.0,2019-12-16,"(1103.75, 1344.0]",6,11,-5
31118.0,2019-12-16,"(665.25, 885.5]",1,4,-3
31118.0,2019-12-16,"(885.5, 1105.75]",4,2,2
31118.0,2019-12-16,"(1105.75, 1326.0]",6,6,0
31119.0,2019-12-16,"(2.647, 342.25]",2,3,-1
31119.0,2019-12-16,"(342.25, 680.5]",4,14,-10
31119.0,2019-12-16,"(680.5, 1018.75]",6,10,-4
31119.0,2019-12-16,"(1018.75, 1357.0]",12,19,-7
31120.0,2019-12-16,"(734.0, 953.0]",1,5,-4
31120.0,2019-12-16,"(953.0, 1172.0]",4,2,2
31120.0,2019-12-16,"(1172.0, 1391.0]",5,4,1
31121.0,2019-12-16,"(389.174, 596.5]",4,8,-4
31121.0,2019-12-16,"(596.5, 803.0]",1,3,-2
31121.0,2019-12-16,"(803.0, 1009.5]",1,3,-2
31121.0,2019-12-16,"(1009.5, 1216.0]",6,7,-1
31122.0,2019-12-16,"(581.186, 785.5]",1,4,-3
31122.0,2019-12-16,"(785.5, 989.0]",2,2,0
31122.0,2019-12-16,"(989.0, 1192.5]",1,3,-2
31122.0,2019-12-16,"(1192.5, 1396.0]",1,3,-2
31123.0,2019-12-16,"(798.5, 1006.75]",2,3,-1
31123.0,2019-12-16,"(1006.75, 1215.0]",5,4,1
31124.0,2019-12-16,"(305.905, 580.75]",6,11,-5
31124.0,2019-12-16,"(580.75, 854.5]",4,12,-8
31124.0,2019-12-16,"(854.5, 1128.25]",2,14,-12
31124.0,2019-12-16,"(1128.25, 1402.0]",8,26,-18
31125.0,2019-12-16,"(10.611, 359.25]",1,2,-1
31125.0,2019-12-16,"(359.25, 706.5]",5,17,-12
31125.0,2019-12-16,"(706.5, 1053.75]",4,6,-2
31125.0,2019-12-16,"(1053.75, 1401.0]",16,21,-5
31126.0,2019-12-16,"(301.885, 581.75]",2,13,-11
31126.0,2019-12-16,"(860.5, 1139.25]",9,3,6
31126.0,2019-12-16,"(1139.25, 1418.0]",7,14,-7
,,,,2.0,
31128.0,2019-12-16,"(54.743, 370.25]",1,3,-2
31128.0,2019-12-16,"(370.25, 684.5]",9,11,-2
31128.0,2019-12-16,"(684.5, 998.75]",9,17,-8
31128.0,2019-12-16,"(998.75, 1313.0]",4,9,-5
31129.0,2019-12-16,"(526.378, 682.5]",3,4,-1
31129.0,2019-12-16,"(682.5, 838.0]",3,5,-2
31129.0,2019-12-16,"(993.5, 1149.0]",1,1,0
31130.0,2019-12-16,"(682.5, 1006.75]",5,1,4
31130.0,2019-12-16,"(1006.75, 1331.0]",7,2,5
31131.0,2019-12-16,"(196.096, 423.0]",1,1,0
31131.0,2019-12-16,"(649.0, 875.0]",1,3,-2
31131.0,2019-12-16,"(875.0, 1101.0]",1,3,-2
31200.0,2019-12-16,"(336.947, 601.25]",6,8,-2
31200.0,2019-12-16,"(601.25, 864.5]",5,10,-5
31200.0,2019-12-16,"(864.5, 1127.75]",10,16,-6
31200.0,2019-12-16,"(1127.75, 1391.0]",7,16,-9
31201.0,2019-12-16,"(301.924, 572.0]",9,19,-10
31201.0,2019-12-16,"(572.0, 841.0]",12,17,-5
31201.0,2019-12-16,"(841.0, 1110.0]",16,27,-11
31201.0,2019-12-16,"(1110.0, 1379.0]",16,32,-16
31202.0,2019-12-16,"(353.936, 621.0]",5,11,-6
31202.0,2019-12-16,"(621.0, 887.0]",5,9,-4
31202.0,2019-12-16,"(887.0, 1153.0]",5,12,-7
31202.0,2019-12-16,"(1153.0, 1419.0]",5,11,-6
31203.0,2019-12-16,"(13.703, 339.25]",1,2,-1
31203.0,2019-12-16,"(339.25, 663.5]",1,7,-6
31203.0,2019-12-16,"(663.5, 987.75]",8,15,-7
31203.0,2019-12-16,"(987.75, 1312.0]",12,17,-5
31204.0,2019-12-16,"(344.951, 608.25]",4,5,-1
31204.0,2019-12-16,"(608.25, 870.5]",2,6,-4
31204.0,2019-12-16,"(1132.75, 1395.0]",2,3,-1
31205.0,2019-12-16,"(155.804, 456.0]",1,1,0
31205.0,2019-12-16,"(456.0, 755.0]",4,7,-3
31205.0,2019-12-16,"(755.0, 1054.0]",8,11,-3
31205.0,2019-12-16,"(1054.0, 1353.0]",5,14,-9
31206.0,2019-12-16,"(536.459, 672.25]",3,3,0
31206.0,2019-12-16,"(672.25, 807.5]",1,1,0
31206.0,2019-12-16,"(942.75, 1078.0]",1,3,-2
31207.0,2019-12-16,"(804.553, 916.75]",1,3,-2
31207.0,2019-12-16,"(1140.25, 1252.0]",2,1,1
31208.0,2019-12-16,"(399.362, 559.5]",4,4,0
31208.0,2019-12-16,"(559.5, 719.0]",1,1,0
31208.0,2019-12-16,"(878.5, 1038.0]",1,1,0
31209.0,2019-12-16,"(654.75, 849.0]",2,1,1
31211.0,2019-12-16,"(463.067, 697.25]",2,2,0
31211.0,2019-12-16,"(697.25, 930.5]",1,4,-3
31211.0,2019-12-16,"(930.5, 1163.75]",3,6,-3
31211.0,2019-12-16,"(1163.75, 1397.0]",2,4,-2
31212.0,2019-12-16,"(466.051, 704.25]",13,17,-4
31212.0,2019-12-16,"(704.25, 941.5]",6,10,-4
31212.0,2019-12-16,"(941.5, 1178.75]",7,16,-9
31212.0,2019-12-16,"(1178.75, 1416.0]",5,9,-4
31213.0,2019-12-16,"(375.009, 623.75]",12,15,-3
31213.0,2019-12-16,"(623.75, 871.5]",6,9,-3
31213.0,2019-12-16,"(871.5, 1119.25]",4,9,-5
31213.0,2019-12-16,"(1119.25, 1367.0]",3,9,-6
31214.0,2019-12-16,"(90.7, 417.0]",1,2,-1
31214.0,2019-12-16,"(417.0, 742.0]",5,14,-9
31214.0,2019-12-16,"(742.0, 1067.0]",6,12,-6
31214.0,2019-12-16,"(1067.0, 1392.0]",21,31,-10
31215.0,2019-12-16,"(413.027, 657.25]",8,10,-2
31215.0,2019-12-16,"(657.25, 900.5]",5,6,-1
31215.0,2019-12-16,"(900.5, 1143.75]",1,2,-1
31216.0,2019-12-16,"(528.189, 731.75]",7,8,-1
31216.0,2019-12-16,"(731.75, 934.5]",1,5,-4
31216.0,2019-12-16,"(1137.25, 1340.0]",2,5,-3
31217.0,2019-12-16,"(380.053, 617.75]",6,7,-1
31217.0,2019-12-16,"(617.75, 854.5]",1,1,0
31217.0,2019-12-16,"(854.5, 1091.25]",1,8,-7
31217.0,2019-12-16,"(1091.25, 1328.0]",1,2,-1
31218.0,2019-12-16,"(351.148, 565.0]",4,10,-6
31218.0,2019-12-16,"(565.0, 778.0]",2,2,0
31218.0,2019-12-16,"(778.0, 991.0]",1,4,-3
31218.0,2019-12-16,"(991.0, 1204.0]",2,6,-4
31219.0,2019-12-16,"(548.439, 689.25]",3,6,-3
31219.0,2019-12-16,"(689.25, 829.5]",2,2,0
31219.0,2019-12-16,"(969.75, 1110.0]",1,3,-2
31220.0,2019-12-16,"(287.238, 478.5]",5,5,0
31220.0,2019-12-16,"(478.5, 669.0]",3,4,-1
31220.0,2019-12-16,"(669.0, 859.5]",1,4,-3
31220.0,2019-12-16,"(859.5, 1050.0]",2,9,-7
31221.0,2019-12-16,"(489.203, 689.25]",12,12,0
31221.0,2019-12-16,"(689.25, 888.5]",5,11,-6
31221.0,2019-12-16,"(888.5, 1087.75]",1,8,-7
31221.0,2019-12-16,"(1087.75, 1287.0]",2,5,-3
31222.0,2019-12-16,"(92.984, 348.0]",1,2,-1
31222.0,2019-12-16,"(348.0, 602.0]",2,2,0
31222.0,2019-12-16,"(602.0, 856.0]",1,4,-3
31223.0,2019-12-16,"(65.716, 388.0]",2,3,-1
31223.0,2019-12-16,"(388.0, 709.0]",3,7,-4
31223.0,2019-12-16,"(709.0, 1030.0]",3,7,-4
31223.0,2019-12-16,"(1030.0, 1351.0]",12,19,-7
31224.0,2019-12-16,"(58.778, 365.5]",2,4,-2
31224.0,2019-12-16,"(365.5, 671.0]",3,4,-1
31224.0,2019-12-16,"(671.0, 976.5]",3,5,-2
31224.0,2019-12-16,"(976.5, 1282.0]",2,7,-5
31225.0,2019-12-16,"(431.147, 645.25]",1,2,-1
31225.0,2019-12-16,"(645.25, 858.5]",1,2,-1
31225.0,2019-12-16,"(858.5, 1071.75]",2,9,-7
31225.0,2019-12-16,"(1071.75, 1285.0]",4,8,-4
31226.0,2019-12-16,"(504.121, 724.75]",2,4,-2
31226.0,2019-12-16,"(724.75, 944.5]",1,1,0
31226.0,2019-12-16,"(944.5, 1164.25]",3,6,-3
31226.0,2019-12-16,"(1164.25, 1384.0]",1,1,0
31227.0,2019-12-16,"(448.246, 637.5]",13,14,-1
31227.0,2019-12-16,"(637.5, 826.0]",1,4,-3
31227.0,2019-12-16,"(826.0, 1014.5]",3,7,-4
31227.0,2019-12-16,"(1014.5, 1203.0]",2,11,-9
31228.0,2019-12-16,"(436.093, 663.75]",3,3,0
31228.0,2019-12-16,"(663.75, 890.5]",5,9,-4
31228.0,2019-12-16,"(890.5, 1117.25]",12,17,-5
31228.0,2019-12-16,"(1117.25, 1344.0]",2,8,-6
31229.0,2019-12-16,"(11.657, 348.75]",1,3,-2
31229.0,2019-12-16,"(348.75, 684.5]",7,21,-14
31229.0,2019-12-16,"(684.5, 1020.25]",8,16,-8
31229.0,2019-12-16,"(1020.25, 1356.0]",19,25,-6
31230.0,2019-12-16,"(300.88, 582.0]",14,18,-4
31230.0,2019-12-16,"(582.0, 862.0]",7,11,-4
31230.0,2019-12-16,"(862.0, 1142.0]",4,15,-11
31230.0,2019-12-16,"(1142.0, 1422.0]",4,9,-5
31231.0,2019-12-16,"(369.228, 563.0]",3,4,-1
31231.0,2019-12-16,"(563.0, 756.0]",4,4,0
31231.0,2019-12-16,"(756.0, 949.0]",3,8,-5
31231.0,2019-12-16,"(949.0, 1142.0]",3,12,-9
31232.0,2019-12-16,"(427.068, 661.0]",8,9,-1
31232.0,2019-12-16,"(661.0, 894.0]",4,5,-1
31232.0,2019-12-16,"(894.0, 1127.0]",3,8,-5
31232.0,2019-12-16,"(1127.0, 1360.0]",2,7,-5
31233.0,2019-12-16,"(358.923, 629.25]",8,12,-4
31233.0,2019-12-16,"(629.25, 898.5]",6,11,-5
31233.0,2019-12-16,"(898.5, 1167.75]",6,14,-8
31233.0,2019-12-16,"(1167.75, 1437.0]",2,5,-3
31234.0,2019-12-16,"(370.0, 699.0]",4,3,1
31234.0,2019-12-16,"(699.0, 1028.0]",8,12,-4
31234.0,2019-12-16,"(1028.0, 1357.0]",6,14,-8
31235.0,2019-12-16,"(590.418, 736.5]",1,1,0
31235.0,2019-12-16,"(736.5, 882.0]",1,1,0
31235.0,2019-12-16,"(1027.5, 1173.0]",1,4,-3
31236.0,2019-12-16,"(445.034, 687.5]",3,5,-2
31236.0,2019-12-16,"(687.5, 929.0]",1,4,-3
31236.0,2019-12-16,"(929.0, 1170.5]",2,8,-6
31236.0,2019-12-16,"(1170.5, 1412.0]",2,5,-3
31237.0,2019-12-16,"(317.915, 590.25]",2,2,0
31237.0,2019-12-16,"(590.25, 861.5]",4,6,-2
31237.0,2019-12-16,"(861.5, 1132.75]",3,6,-3
31237.0,2019-12-16,"(1132.75, 1404.0]",6,11,-5
31238.0,2019-12-16,"(102.808, 402.0]",1,1,0
31238.0,2019-12-16,"(402.0, 700.0]",5,6,-1
31238.0,2019-12-16,"(700.0, 998.0]",5,12,-7
31238.0,2019-12-16,"(998.0, 1296.0]",4,14,-10
31239.0,2019-12-16,"(252.873, 535.75]",4,5,-1
31239.0,2019-12-16,"(535.75, 817.5]",9,11,-2
31239.0,2019-12-16,"(817.5, 1099.25]",5,16,-11
31239.0,2019-12-16,"(1099.25, 1381.0]",3,11,-8
31240.0,2019-12-16,"(863.75, 895.0]",4,4,0
31241.0,2019-12-16,"(117.713, 440.75]",1,3,-2
31241.0,2019-12-16,"(440.75, 762.5]",7,17,-10
31241.0,2019-12-16,"(762.5, 1084.25]",5,15,-10
31241.0,2019-12-16,"(1084.25, 1406.0]",15,28,-13
31242.0,2019-12-16,"(402.0, 660.0]",7,1,6
31242.0,2019-12-16,"(660.0, 918.0]",7,7,0
31242.0,2019-12-16,"(918.0, 1176.0]",2,18,-16
31243.0,2019-12-16,"(380.039, 621.25]",2,3,-1
31243.0,2019-12-16,"(861.5, 1101.75]",1,3,-2
31243.0,2019-12-16,"(1101.75, 1342.0]",3,5,-2
31244.0,2019-12-16,"(410.097, 636.75]",3,7,-4
31244.0,2019-12-16,"(636.75, 862.5]",3,5,-2
31244.0,2019-12-16,"(862.5, 1088.25]",4,10,-6
31244.0,2019-12-16,"(1088.25, 1314.0]",2,4,-2
31245.0,2019-12-16,"(115.852, 404.0]",2,2,0
31245.0,2019-12-16,"(404.0, 691.0]",2,6,-4
31245.0,2019-12-16,"(691.0, 978.0]",4,7,-3
31245.0,2019-12-16,"(978.0, 1265.0]",7,16,-9
31246.0,2019-12-16,"(9.702, 335.5]",2,2,0
31246.0,2019-12-16,"(335.5, 660.0]",4,9,-5
31246.0,2019-12-16,"(660.0, 984.5]",8,11,-3
31246.0,2019-12-16,"(984.5, 1309.0]",5,15,-10
31247.0,2019-12-16,"(483.441, 623.75]",2,3,-1
31247.0,2019-12-16,"(623.75, 763.5]",6,9,-3
31247.0,2019-12-16,"(903.25, 1043.0]",3,2,1
31248.0,2019-12-16,"(357.108, 581.0]",1,2,-1
31248.0,2019-12-16,"(581.0, 804.0]",4,6,-2
31248.0,2019-12-16,"(804.0, 1027.0]",2,3,-1
31248.0,2019-12-16,"(1027.0, 1250.0]",1,3,-2
31249.0,2019-12-16,"(37.982, 293.5]",1,2,-1
31249.0,2019-12-16,"(548.0, 802.5]",5,10,-5
31249.0,2019-12-16,"(802.5, 1057.0]",2,4,-2
31250.0,2019-12-16,"(289.979, 546.25]",2,3,-1
31250.0,2019-12-16,"(546.25, 801.5]",3,5,-2
31250.0,2019-12-16,"(801.5, 1056.75]",1,5,-4
31250.0,2019-12-16,"(1056.75, 1312.0]",3,15,-12
31251.0,2019-12-16,"(451.146, 665.5]",4,10,-6
31251.0,2019-12-16,"(665.5, 879.0]",1,2,-1
31251.0,2019-12-16,"(879.0, 1092.5]",3,13,-10
31251.0,2019-12-16,"(1092.5, 1306.0]",5,14,-9
31252.0,2019-12-16,"(527.39, 680.5]",7,8,-1
31252.0,2019-12-16,"(680.5, 833.0]",1,1,0
31252.0,2019-12-16,"(833.0, 985.5]",1,3,-2
31253.0,2019-12-16,"(405.217, 601.75]",5,6,-1
31253.0,2019-12-16,"(601.75, 797.5]",3,6,-3
31253.0,2019-12-16,"(797.5, 993.25]",3,6,-3
31253.0,2019-12-16,"(993.25, 1189.0]",2,9,-7
31254.0,2019-12-16,"(390.25, 668.5]",6,1,5
31254.0,2019-12-16,"(668.5, 946.75]",2,7,-5
31254.0,2019-12-16,"(946.75, 1225.0]",6,4,2
31255.0,2019-12-16,"(362.034, 604.5]",6,8,-2
31255.0,2019-12-16,"(604.5, 846.0]",2,4,-2
31255.0,2019-12-16,"(846.0, 1087.5]",3,9,-6
31255.0,2019-12-16,"(1087.5, 1329.0]",1,3,-2
31256.0,2019-12-16,"(268.051, 506.25]",4,4,0
31256.0,2019-12-16,"(506.25, 743.5]",1,1,0
31256.0,2019-12-16,"(980.75, 1218.0]",3,6,-3
31257.0,2019-12-16,"(46.654, 384.5]",1,2,-1
31257.0,2019-12-16,"(384.5, 721.0]",5,9,-4
31257.0,2019-12-16,"(721.0, 1057.5]",11,19,-8
31257.0,2019-12-16,"(1057.5, 1394.0]",3,12,-9
31258.0,2019-12-16,"(508.399, 659.25]",1,6,-5
31258.0,2019-12-16,"(659.25, 809.5]",2,6,-4
31258.0,2019-12-16,"(959.75, 1110.0]",3,6,-3
31259.0,2019-12-16,"(452.337, 618.75]",3,4,-1
31260.0,2019-12-16,"(3.69, 332.5]",1,1,0
31260.0,2019-12-16,"(332.5, 660.0]",7,7,0
31260.0,2019-12-16,"(660.0, 987.5]",1,6,-5
31260.0,2019-12-16,"(987.5, 1315.0]",2,9,-7
31261.0,2019-12-16,"(424.268, 608.0]",2,2,0
31262.0,2019-12-16,"(449.183, 654.25]",3,3,0
31262.0,2019-12-16,"(654.25, 858.5]",1,2,-1
31262.0,2019-12-16,"(1062.75, 1267.0]",1,1,0
31263.0,2019-12-16,"(361.014, 608.5]",8,11,-3
31263.0,2019-12-16,"(608.5, 855.0]",4,8,-4
31263.0,2019-12-16,"(855.0, 1101.5]",4,13,-9
31263.0,2019-12-16,"(1101.5, 1348.0]",4,11,-7
31264.0,2019-12-16,"(334.947, 599.25]",6,7,-1
31264.0,2019-12-16,"(599.25, 862.5]",3,5,-2
31264.0,2019-12-16,"(862.5, 1125.75]",1,2,-1
31265.0,2019-12-16,"(366.5, 709.0]",5,2,3
31265.0,2019-12-16,"(709.0, 1051.5]",11,15,-4
31265.0,2019-12-16,"(1051.5, 1394.0]",11,17,-6
31266.0,2019-12-16,"(3.708, 328.0]",1,3,-2
31266.0,2019-12-16,"(328.0, 651.0]",1,7,-6
31266.0,2019-12-16,"(651.0, 974.0]",7,13,-6
31266.0,2019-12-16,"(974.0, 1297.0]",11,19,-8
31267.0,2019-12-16,"(407.25, 724.5]",7,2,5
31267.0,2019-12-16,"(724.5, 1041.75]",10,13,-3
31267.0,2019-12-16,"(1041.75, 1359.0]",14,16,-2
31268.0,2019-12-16,"(384.041, 624.75]",9,15,-6
31268.0,2019-12-16,"(624.75, 864.5]",2,5,-3
31268.0,2019-12-16,"(864.5, 1104.25]",4,5,-1
31268.0,2019-12-16,"(1104.25, 1344.0]",7,10,-3
31269.0,2019-12-16,"(565.5, 800.0]",3,1,2
31269.0,2019-12-16,"(800.0, 1034.5]",4,4,0
31269.0,2019-12-16,"(1034.5, 1269.0]",4,6,-2
31270.0,2019-12-16,"(373.114, 595.5]",3,6,-3
31270.0,2019-12-16,"(595.5, 817.0]",1,4,-3
31270.0,2019-12-16,"(817.0, 1038.5]",2,8,-6
31270.0,2019-12-16,"(1038.5, 1260.0]",8,16,-8
31271.0,2019-12-16,"(385.125, 604.75]",4,4,0
31271.0,2019-12-16,"(604.75, 823.5]",5,8,-3
31271.0,2019-12-16,"(823.5, 1042.25]",2,5,-3
31271.0,2019-12-16,"(1042.25, 1261.0]",1,6,-5
31272.0,2019-12-16,"(316.05, 554.5]",6,6,0
31272.0,2019-12-16,"(554.5, 792.0]",4,4,0
31272.0,2019-12-16,"(792.0, 1029.5]",1,7,-6
31272.0,2019-12-16,"(1029.5, 1267.0]",2,5,-3
31273.0,2019-12-16,"(887.0, 1066.0]",1,2,-1
31274.0,2019-12-16,"(138.785, 443.75]",1,1,0
31274.0,2019-12-16,"(443.75, 747.5]",3,3,0
31274.0,2019-12-16,"(747.5, 1051.25]",4,7,-3
31275.0,2019-12-16,"(274.918, 546.5]",6,10,-4
31275.0,2019-12-16,"(546.5, 817.0]",6,9,-3
31275.0,2019-12-16,"(817.0, 1087.5]",10,16,-6
31275.0,2019-12-16,"(1087.5, 1358.0]",2,8,-6
31276.0,2019-12-16,"(408.027, 652.25]",6,6,0
31276.0,2019-12-16,"(652.25, 895.5]",4,7,-3
31276.0,2019-12-16,"(895.5, 1138.75]",2,8,-6
31277.0,2019-12-16,"(406.122, 626.5]",7,11,-4
31277.0,2019-12-16,"(626.5, 846.0]",3,4,-1
31277.0,2019-12-16,"(846.0, 1065.5]",3,10,-7
31277.0,2019-12-16,"(1065.5, 1285.0]",2,10,-8
31278.0,2019-12-16,"(379.988, 634.0]",3,9,-6
31278.0,2019-12-16,"(634.0, 887.0]",4,7,-3
31278.0,2019-12-16,"(887.0, 1140.0]",6,11,-5
31278.0,2019-12-16,"(1140.0, 1393.0]",7,9,-2
31279.0,2019-12-16,"(450.073, 682.75]",9,10,-1
31279.0,2019-12-16,"(682.75, 914.5]",2,7,-5
31279.0,2019-12-16,"(914.5, 1146.25]",2,11,-9
31280.0,2019-12-16,"(358.005, 607.75]",2,6,-4
31280.0,2019-12-16,"(856.5, 1105.25]",2,2,0
31280.0,2019-12-16,"(1105.25, 1354.0]",7,7,0
,,,,2.0,
31001.0,2019-12-17,"(1087.25, 1197.0]",1,1,0
31002.0,2019-12-17,"(494.417, 640.75]",1,2,-1
31002.0,2019-12-17,"(640.75, 786.5]",1,1,0
31002.0,2019-12-17,"(932.25, 1078.0]",2,4,-2
31003.0,2019-12-17,"(352.233, 544.75]",1,4,-3
31003.0,2019-12-17,"(544.75, 736.5]",1,2,-1
31003.0,2019-12-17,"(736.5, 928.25]",2,3,-1
31003.0,2019-12-17,"(928.25, 1120.0]",6,9,-3
31004.0,2019-12-17,"(819.0, 1092.0]",1,1,0
31005.0,2019-12-17,"(357.068, 591.0]",4,4,0
31005.0,2019-12-17,"(824.0, 1057.0]",1,2,-1
31005.0,2019-12-17,"(1057.0, 1290.0]",1,5,-4
,,,,2.0,
31007.0,2019-12-17,"(21.635, 364.25]",1,2,-1
31007.0,2019-12-17,"(364.25, 705.5]",3,15,-12
31007.0,2019-12-17,"(705.5, 1046.75]",3,9,-6
31007.0,2019-12-17,"(1046.75, 1388.0]",3,8,-5
31009.0,2019-12-17,"(411.0, 548.0]",4,1,3
31010.0,2019-12-17,"(754.0, 1051.0]",2,1,1
31010.0,2019-12-17,"(1051.0, 1348.0]",1,1,0
31011.0,2019-12-17,"(163.885, 443.75]",2,3,-1
31011.0,2019-12-17,"(443.75, 722.5]",3,3,0
31011.0,2019-12-17,"(722.5, 1001.25]",3,4,-1
31011.0,2019-12-17,"(1001.25, 1280.0]",3,7,-4
31012.0,2019-12-17,"(356.365, 515.75]",5,5,0
31012.0,2019-12-17,"(515.75, 674.5]",1,1,0
31013.0,2019-12-17,"(578.315, 750.25]",1,2,-1
31013.0,2019-12-17,"(921.5, 1092.75]",1,1,0
31013.0,2019-12-17,"(1092.75, 1264.0]",1,2,-1
31014.0,2019-12-17,"(35.778, 342.5]",1,2,-1
31014.0,2019-12-17,"(342.5, 648.0]",17,23,-6
31014.0,2019-12-17,"(648.0, 953.5]",6,8,-2
31014.0,2019-12-17,"(953.5, 1259.0]",9,15,-6
31015.0,2019-12-17,"(302.038, 543.5]",7,8,-1
31015.0,2019-12-17,"(543.5, 784.0]",5,5,0
31015.0,2019-12-17,"(784.0, 1024.5]",2,5,-3
31015.0,2019-12-17,"(1024.5, 1265.0]",2,6,-4
31016.0,2019-12-17,"(444.132, 662.0]",3,6,-3
31016.0,2019-12-17,"(662.0, 879.0]",1,1,0
31016.0,2019-12-17,"(879.0, 1096.0]",3,6,-3
31016.0,2019-12-17,"(1096.0, 1313.0]",1,2,-1
31017.0,2019-12-17,"(508.292, 686.0]",4,6,-2
31017.0,2019-12-17,"(1040.0, 1217.0]",1,1,0
31018.0,2019-12-17,"(640.75, 876.5]",1,5,-4
31018.0,2019-12-17,"(876.5, 1112.25]",1,1,0
31018.0,2019-12-17,"(1112.25, 1348.0]",1,1,0
31019.0,2019-12-17,"(389.224, 584.0]",1,2,-1
31019.0,2019-12-17,"(778.0, 972.0]",1,1,0
31019.0,2019-12-17,"(972.0, 1166.0]",2,1,1
31020.0,2019-12-17,"(544.132, 762.0]",1,1,0
31020.0,2019-12-17,"(1196.0, 1413.0]",1,2,-1
31021.0,2019-12-17,"(362.997, 614.75]",1,3,-2
31021.0,2019-12-17,"(865.5, 1116.25]",2,1,1
31021.0,2019-12-17,"(1116.25, 1367.0]",1,7,-6
31022.0,2019-12-17,"(434.019, 680.25]",1,5,-4
31022.0,2019-12-17,"(680.25, 925.5]",1,1,0
31022.0,2019-12-17,"(1170.75, 1416.0]",1,5,-4
31023.0,2019-12-17,"(475.119, 696.25]",1,2,-1
31023.0,2019-12-17,"(1136.75, 1357.0]",1,1,0
31024.0,2019-12-17,"(428.321, 598.75]",4,5,-1
31024.0,2019-12-17,"(598.75, 768.5]",1,1,0
31024.0,2019-12-17,"(768.5, 938.25]",1,1,0
,,,,1.0,
,,,,2.0,
31026.0,2019-12-17,"(493.171, 701.25]",1,2,-1
31026.0,2019-12-17,"(701.25, 908.5]",1,1,0
31026.0,2019-12-17,"(1115.75, 1323.0]",2,1,1
31027.0,2019-12-17,"(976.5, 1178.25]",1,3,-2
31027.0,2019-12-17,"(1178.25, 1380.0]",2,1,1
31028.0,2019-12-17,"(455.114, 677.5]",1,1,0
31029.0,2019-12-17,"(483.264, 668.0]",1,4,-3
31029.0,2019-12-17,"(1036.0, 1220.0]",3,3,0
31030.0,2019-12-17,"(897.5, 1120.75]",5,8,-3
31030.0,2019-12-17,"(1120.75, 1344.0]",3,8,-5
31031.0,2019-12-17,"(795.5, 970.75]",2,2,0
31031.0,2019-12-17,"(970.75, 1146.0]",2,1,1
31032.0,2019-12-17,"(1091.0, 1121.0]",1,1,0
31033.0,2019-12-17,"(744.0, 992.0]",1,1,0
31034.0,2019-12-17,"(501.33, 669.5]",2,3,-1
31034.0,2019-12-17,"(1004.5, 1172.0]",2,1,1
31035.0,2019-12-17,"(803.5, 947.75]",1,1,0
31035.0,2019-12-17,"(947.75, 1092.0]",3,1,2
31036.0,2019-12-17,"(402.28, 583.0]",1,4,-3
31036.0,2019-12-17,"(583.0, 763.0]",2,2,0
31036.0,2019-12-17,"(943.0, 1123.0]",5,1,4
31037.0,2019-12-17,"(407.133, 624.75]",7,11,-4
31037.0,2019-12-17,"(624.75, 841.5]",3,4,-1
31037.0,2019-12-17,"(841.5, 1058.25]",5,10,-5
31037.0,2019-12-17,"(1058.25, 1275.0]",3,10,-7
31038.0,2019-12-17,"(548.0, 822.0]",1,1,0
31038.0,2019-12-17,"(822.0, 1096.0]",1,1,0
31039.0,2019-12-17,"(460.144, 675.0]",2,9,-7
31039.0,2019-12-17,"(675.0, 889.0]",1,2,-1
31039.0,2019-12-17,"(889.0, 1103.0]",3,6,-3
31039.0,2019-12-17,"(1103.0, 1317.0]",3,6,-3
31040.0,2019-12-17,"(452.182, 657.5]",3,3,0
31040.0,2019-12-17,"(657.5, 862.0]",1,2,-1
31040.0,2019-12-17,"(862.0, 1066.5]",1,2,-1
31041.0,2019-12-17,"(606.976, 613.0]",1,2,-1
31041.0,2019-12-17,"(625.0, 631.0]",1,2,-1
31042.0,2019-12-17,"(447.18, 653.0]",7,7,0
31042.0,2019-12-17,"(653.0, 858.0]",1,2,-1
31042.0,2019-12-17,"(858.0, 1063.0]",2,4,-2
31042.0,2019-12-17,"(1063.0, 1268.0]",1,2,-1
31043.0,2019-12-17,"(517.373, 674.75]",2,3,-1
31043.0,2019-12-17,"(988.25, 1145.0]",3,6,-3
31044.0,2019-12-17,"(539.416, 686.0]",3,3,0
31044.0,2019-12-17,"(978.0, 1124.0]",2,1,1
31045.0,2019-12-17,"(507.382, 662.5]",1,3,-2
31045.0,2019-12-17,"(817.0, 971.5]",1,2,-1
31045.0,2019-12-17,"(971.5, 1126.0]",2,2,0
31046.0,2019-12-17,"(663.0, 795.5]",1,2,-1
31046.0,2019-12-17,"(795.5, 928.0]",1,1,0
31047.0,2019-12-17,"(353.965, 613.75]",11,17,-6
31047.0,2019-12-17,"(613.75, 872.5]",1,1,0
31047.0,2019-12-17,"(872.5, 1131.25]",1,7,-6
31047.0,2019-12-17,"(1131.25, 1390.0]",2,6,-4
31048.0,2019-12-17,"(589.213, 786.75]",2,5,-3
31048.0,2019-12-17,"(786.75, 983.5]",1,1,0
31049.0,2019-12-17,"(485.733, 552.75]",2,3,-1
,,,,1.0,
,,,,1.0,
31051.0,2019-12-17,"(818.0, 1077.5]",3,4,-1
31051.0,2019-12-17,"(1077.5, 1337.0]",3,1,2
31052.0,2019-12-17,"(389.25, 519.0]",1,1,0
31053.0,2019-12-17,"(586.25, 776.0]",1,1,0
,,,,2.0,
31055.0,2019-12-17,"(981.0, 1308.0]",1,1,0
31056.0,2019-12-17,"(938.25, 1082.0]",1,2,-1
,,,,1.0,
,,,,1.0,
31058.0,2019-12-17,"(792.75, 1057.0]",2,1,1
31059.0,2019-12-17,"(739.0, 893.5]",1,1,0
31059.0,2019-12-17,"(893.5, 1048.0]",1,1,0
31060.0,2019-12-17,"(403.199, 604.25]",2,2,0
31060.0,2019-12-17,"(1004.75, 1205.0]",2,3,-1
31061.0,2019-12-17,"(471.75, 629.0]",1,1,0
31062.0,2019-12-17,"(587.589, 690.75]",1,2,-1
31062.0,2019-12-17,"(793.5, 896.25]",2,2,0
31062.0,2019-12-17,"(896.25, 999.0]",1,2,-1
31063.0,2019-12-17,"(1262.5, 1267.0]",1,1,0
31064.0,2019-12-17,"(377.811, 378.0]",1,2,-1
,,,,1.0,
,,,,1.0,
,,,,1.0,
31066.0,2019-12-17,"(991.0, 1153.0]",1,2,-1
31067.0,2019-12-17,"(1149.5, 1369.0]",1,2,-1
31068.0,2019-12-17,"(973.0, 1172.5]",1,1,0
31068.0,2019-12-17,"(1172.5, 1372.0]",1,1,0
31069.0,2019-12-17,"(788.0, 962.5]",1,6,-5
31069.0,2019-12-17,"(962.5, 1137.0]",4,1,3
31070.0,2019-12-17,"(999.0, 1082.5]",2,1,1
31070.0,2019-12-17,"(1082.5, 1166.0]",1,2,-1
31071.0,2019-12-17,"(326.097, 552.75]",3,4,-1
31071.0,2019-12-17,"(1004.25, 1230.0]",3,1,2
,,,,1.0,
,,,,1.0,
31073.0,2019-12-17,"(262.0, 524.0]",1,1,0
31073.0,2019-12-17,"(786.0, 1048.0]",2,1,1
31074.0,2019-12-17,"(494.445, 633.75]",1,1,0
31074.0,2019-12-17,"(911.25, 1050.0]",1,2,-1
,,,,1.0,
,,,,1.0,
31076.0,2019-12-17,"(327.75, 437.0]",1,1,0
31077.0,2019-12-17,"(842.0, 1054.5]",2,5,-3
31077.0,2019-12-17,"(1054.5, 1267.0]",4,1,3
31078.0,2019-12-17,"(438.46, 574.0]",5,5,0
31079.0,2019-12-17,"(14.821, 310.75]",1,1,0
31079.0,2019-12-17,"(310.75, 605.5]",1,6,-5
31079.0,2019-12-17,"(900.25, 1195.0]",1,1,0
31080.0,2019-12-17,"(604.0, 823.0]",1,5,-4
31080.0,2019-12-17,"(823.0, 1042.0]",1,1,0
31080.0,2019-12-17,"(1042.0, 1261.0]",2,2,0
31081.0,2019-12-17,"(469.327, 638.25]",2,2,0
,,,,2.0,
,,,,1.0,
,,,,3.0,
31084.0,2019-12-17,"(532.225, 726.75]",5,5,0
31084.0,2019-12-17,"(920.5, 1114.25]",2,5,-3
31084.0,2019-12-17,"(1114.25, 1308.0]",1,3,-2
31085.0,2019-12-17,"(698.75, 904.5]",1,2,-1
31085.0,2019-12-17,"(904.5, 1110.25]",1,1,0
31085.0,2019-12-17,"(1110.25, 1316.0]",2,1,1
31086.0,2019-12-17,"(1038.75, 1385.0]",1,1,0
31087.0,2019-12-17,"(887.25, 1039.0]",2,2,0
31088.0,2019-12-17,"(1005.5, 1165.0]",3,1,2
31089.0,2019-12-17,"(335.0, 659.0]",5,1,4
31089.0,2019-12-17,"(659.0, 983.0]",2,8,-6
31089.0,2019-12-17,"(983.0, 1307.0]",2,3,-1
31090.0,2019-12-17,"(888.0, 1044.0]",1,2,-1
31091.0,2019-12-17,"(915.5, 1155.25]",1,3,-2
31091.0,2019-12-17,"(1155.25, 1395.0]",1,1,0
31092.0,2019-12-17,"(1023.25, 1188.0]",2,3,-1
31093.0,2019-12-17,"(1208.0, 1281.0]",1,1,0
,,,,1.0,
,,,,1.0,
,,,,2.0,
31096.0,2019-12-17,"(1038.777, 1094.75]",1,2,-1
31096.0,2019-12-17,"(1206.25, 1262.0]",1,1,0
31097.0,2019-12-17,"(414.022, 659.5]",4,4,0
31097.0,2019-12-17,"(1148.5, 1393.0]",1,1,0
31098.0,2019-12-17,"(431.132, 649.0]",3,10,-7
31098.0,2019-12-17,"(866.0, 1083.0]",3,3,0
31098.0,2019-12-17,"(1083.0, 1300.0]",2,4,-2
,,,,1.0,
,,,,1.0,
31100.0,2019-12-17,"(457.1, 683.0]",12,14,-2
31100.0,2019-12-17,"(683.0, 908.0]",2,5,-3
31100.0,2019-12-17,"(908.0, 1133.0]",1,8,-7
31101.0,2019-12-17,"(11.619, 358.25]",1,3,-2
31101.0,2019-12-17,"(358.25, 703.5]",13,42,-29
31101.0,2019-12-17,"(703.5, 1048.75]",13,21,-8
31101.0,2019-12-17,"(1048.75, 1394.0]",28,40,-12
31102.0,2019-12-17,"(312.926, 582.5]",2,18,-16
31102.0,2019-12-17,"(582.5, 851.0]",1,5,-4
31102.0,2019-12-17,"(851.0, 1119.5]",4,9,-5
31102.0,2019-12-17,"(1119.5, 1388.0]",11,13,-2
31103.0,2019-12-17,"(611.5, 887.0]",1,26,-25
31103.0,2019-12-17,"(887.0, 1162.5]",8,6,2
31103.0,2019-12-17,"(1162.5, 1438.0]",3,14,-11
31104.0,2019-12-17,"(362.933, 630.75]",1,12,-11
31104.0,2019-12-17,"(630.75, 897.5]",1,5,-4
31104.0,2019-12-17,"(897.5, 1164.25]",13,24,-11
31104.0,2019-12-17,"(1164.25, 1431.0]",11,22,-11
31105.0,2019-12-17,"(342.997, 594.75]",2,15,-13
31105.0,2019-12-17,"(594.75, 845.5]",2,3,-1
31105.0,2019-12-17,"(845.5, 1096.25]",1,6,-5
31105.0,2019-12-17,"(1096.25, 1347.0]",1,5,-4
31106.0,2019-12-17,"(1019.5, 1209.0]",5,5,0
31107.0,2019-12-17,"(857.0, 1117.0]",10,17,-7
31107.0,2019-12-17,"(1117.0, 1377.0]",14,4,10
31108.0,2019-12-17,"(382.002, 632.5]",5,23,-18
31108.0,2019-12-17,"(632.5, 882.0]",2,6,-4
31108.0,2019-12-17,"(882.0, 1131.5]",12,18,-6
31108.0,2019-12-17,"(1131.5, 1381.0]",11,11,0
31109.0,2019-12-17,"(397.998, 649.5]",2,8,-6
31109.0,2019-12-17,"(649.5, 900.0]",3,6,-3
31109.0,2019-12-17,"(900.0, 1150.5]",13,17,-4
31109.0,2019-12-17,"(1150.5, 1401.0]",6,12,-6
31110.0,2019-12-17,"(324.028, 568.0]",16,33,-17
31110.0,2019-12-17,"(568.0, 811.0]",5,15,-10
31110.0,2019-12-17,"(811.0, 1054.0]",5,10,-5
31110.0,2019-12-17,"(1054.0, 1297.0]",14,22,-8
31111.0,2019-12-17,"(143.774, 451.5]",6,7,-1
31111.0,2019-12-17,"(451.5, 758.0]",3,18,-15
31111.0,2019-12-17,"(758.0, 1064.5]",4,9,-5
31111.0,2019-12-17,"(1064.5, 1371.0]",11,18,-7
31112.0,2019-12-17,"(359.185, 563.75]",1,4,-3
31112.0,2019-12-17,"(767.5, 971.25]",1,1,0
31112.0,2019-12-17,"(971.25, 1175.0]",4,1,3
31113.0,2019-12-17,"(110.782, 416.5]",1,1,0
31113.0,2019-12-17,"(416.5, 721.0]",1,13,-12
31113.0,2019-12-17,"(721.0, 1025.5]",2,4,-2
31113.0,2019-12-17,"(1025.5, 1330.0]",8,15,-7
31114.0,2019-12-17,"(16.689, 345.75]",1,2,-1
31114.0,2019-12-17,"(345.75, 673.5]",5,16,-11
31114.0,2019-12-17,"(673.5, 1001.25]",6,10,-4
31114.0,2019-12-17,"(1001.25, 1329.0]",21,33,-12
31115.0,2019-12-17,"(372.962, 633.5]",1,10,-9
31115.0,2019-12-17,"(633.5, 893.0]",1,9,-8
31115.0,2019-12-17,"(893.0, 1152.5]",4,8,-4
31115.0,2019-12-17,"(1152.5, 1412.0]",5,7,-2
31116.0,2019-12-17,"(30.614, 378.5]",5,6,-1
31116.0,2019-12-17,"(378.5, 725.0]",5,25,-20
31116.0,2019-12-17,"(725.0, 1071.5]",11,16,-5
31116.0,2019-12-17,"(1071.5, 1418.0]",9,15,-6
31117.0,2019-12-17,"(317.922, 588.5]",2,15,-13
31117.0,2019-12-17,"(588.5, 858.0]",2,4,-2
31117.0,2019-12-17,"(858.0, 1127.5]",11,19,-8
31117.0,2019-12-17,"(1127.5, 1397.0]",4,18,-14
31118.0,2019-12-17,"(364.955, 627.25]",2,13,-11
31118.0,2019-12-17,"(627.25, 888.5]",1,1,0
31118.0,2019-12-17,"(888.5, 1149.75]",8,9,-1
31118.0,2019-12-17,"(1149.75, 1411.0]",7,8,-1
31119.0,2019-12-17,"(249.859, 536.25]",8,24,-16
31119.0,2019-12-17,"(536.25, 821.5]",4,7,-3
31119.0,2019-12-17,"(821.5, 1106.75]",7,11,-4
31119.0,2019-12-17,"(1106.75, 1392.0]",7,16,-9
31120.0,2019-12-17,"(343.943, 609.25]",2,13,-11
31120.0,2019-12-17,"(873.5, 1137.75]",6,3,3
31120.0,2019-12-17,"(1137.75, 1402.0]",4,8,-4
31121.0,2019-12-17,"(384.996, 637.0]",15,21,-6
31121.0,2019-12-17,"(888.0, 1139.0]",7,1,6
31121.0,2019-12-17,"(1139.0, 1390.0]",6,17,-11
31122.0,2019-12-17,"(459.054, 696.5]",1,9,-8
31122.0,2019-12-17,"(696.5, 933.0]",2,3,-1
31122.0,2019-12-17,"(933.0, 1169.5]",3,7,-4
31122.0,2019-12-17,"(1169.5, 1406.0]",3,8,-5
31123.0,2019-12-17,"(872.0, 1121.5]",4,9,-5
31123.0,2019-12-17,"(1121.5, 1371.0]",6,2,4
31124.0,2019-12-17,"(301.931, 570.25]",10,27,-17
31124.0,2019-12-17,"(570.25, 837.5]",7,24,-17
31124.0,2019-12-17,"(837.5, 1104.75]",17,41,-24
31124.0,2019-12-17,"(1104.75, 1372.0]",13,45,-32
31125.0,2019-12-17,"(346.958, 608.5]",5,25,-20
31125.0,2019-12-17,"(608.5, 869.0]",5,7,-2
31125.0,2019-12-17,"(869.0, 1129.5]",17,20,-3
31125.0,2019-12-17,"(1129.5, 1390.0]",6,11,-5
31126.0,2019-12-17,"(-1.39, 347.5]",1,3,-2
31126.0,2019-12-17,"(347.5, 695.0]",3,18,-15
31126.0,2019-12-17,"(695.0, 1042.5]",9,15,-6
31126.0,2019-12-17,"(1042.5, 1390.0]",20,26,-6
,,,,2.0,
31128.0,2019-12-17,"(307.879, 589.25]",16,23,-7
31128.0,2019-12-17,"(589.25, 869.5]",13,27,-14
31128.0,2019-12-17,"(869.5, 1149.75]",10,18,-8
31128.0,2019-12-17,"(1149.75, 1430.0]",2,12,-10
31129.0,2019-12-17,"(424.098, 650.5]",7,8,-1
31129.0,2019-12-17,"(650.5, 876.0]",4,6,-2
31129.0,2019-12-17,"(876.0, 1101.5]",4,5,-1
31130.0,2019-12-17,"(347.041, 587.75]",3,17,-14
31130.0,2019-12-17,"(587.75, 827.5]",1,4,-3
31130.0,2019-12-17,"(827.5, 1067.25]",2,2,0
31130.0,2019-12-17,"(1067.25, 1307.0]",9,12,-3
31131.0,2019-12-17,"(367.042, 607.5]",1,6,-5
31131.0,2019-12-17,"(847.0, 1086.5]",2,1,1
31131.0,2019-12-17,"(1086.5, 1326.0]",5,4,1
31200.0,2019-12-17,"(371.985, 626.75]",19,26,-7
31200.0,2019-12-17,"(626.75, 880.5]",6,11,-5
31200.0,2019-12-17,"(880.5, 1134.25]",14,30,-16
31200.0,2019-12-17,"(1134.25, 1388.0]",5,21,-16
31201.0,2019-12-17,"(302.912, 576.0]",16,40,-24
31201.0,2019-12-17,"(576.0, 848.0]",14,28,-14
31201.0,2019-12-17,"(848.0, 1120.0]",29,45,-16
31201.0,2019-12-17,"(1120.0, 1392.0]",16,38,-22
31202.0,2019-12-17,"(350.937, 617.75]",10,26,-16
31202.0,2019-12-17,"(617.75, 883.5]",4,7,-3
31202.0,2019-12-17,"(883.5, 1149.25]",22,34,-12
31202.0,2019-12-17,"(1149.25, 1415.0]",10,24,-14
31203.0,2019-12-17,"(378.942, 644.5]",9,29,-20
31203.0,2019-12-17,"(644.5, 909.0]",5,14,-9
31203.0,2019-12-17,"(909.0, 1173.5]",21,31,-10
31203.0,2019-12-17,"(1173.5, 1438.0]",8,14,-6
31204.0,2019-12-17,"(444.128, 663.0]",8,9,-1
31204.0,2019-12-17,"(663.0, 881.0]",3,5,-2
31204.0,2019-12-17,"(1099.0, 1317.0]",2,7,-5
31205.0,2019-12-17,"(216.947, 481.25]",1,2,-1
31205.0,2019-12-17,"(481.25, 744.5]",25,32,-7
31205.0,2019-12-17,"(744.5, 1007.75]",5,9,-4
31205.0,2019-12-17,"(1007.75, 1271.0]",3,13,-10
31206.0,2019-12-17,"(387.357, 548.75]",3,3,0
31206.0,2019-12-17,"(709.5, 870.25]",1,1,0
31206.0,2019-12-17,"(870.25, 1031.0]",2,6,-4
31207.0,2019-12-17,"(593.0, 837.0]",2,4,-2
31207.0,2019-12-17,"(837.0, 1081.0]",1,3,-2
31207.0,2019-12-17,"(1081.0, 1325.0]",3,1,2
31208.0,2019-12-17,"(394.009, 642.75]",16,21,-5
31208.0,2019-12-17,"(642.75, 890.5]",2,2,0
31208.0,2019-12-17,"(890.5, 1138.25]",2,11,-9
31208.0,2019-12-17,"(1138.25, 1386.0]",3,4,-1
31209.0,2019-12-17,"(526.126, 745.5]",1,2,-1
31209.0,2019-12-17,"(964.0, 1182.5]",1,1,0
31211.0,2019-12-17,"(460.097, 686.75]",11,14,-3
31211.0,2019-12-17,"(686.75, 912.5]",2,2,0
31211.0,2019-12-17,"(912.5, 1138.25]",5,11,-6
31212.0,2019-12-17,"(331.9, 608.0]",19,24,-5
31212.0,2019-12-17,"(608.0, 883.0]",13,22,-9
31212.0,2019-12-17,"(883.0, 1158.0]",10,28,-18
31212.0,2019-12-17,"(1158.0, 1433.0]",9,14,-5
31213.0,2019-12-17,"(433.025, 677.75]",22,31,-9
31213.0,2019-12-17,"(677.75, 921.5]",11,18,-7
31213.0,2019-12-17,"(921.5, 1165.25]",8,27,-19
31213.0,2019-12-17,"(1165.25, 1409.0]",3,9,-6
31214.0,2019-12-17,"(29.61, 378.5]",1,1,0
31214.0,2019-12-17,"(378.5, 726.0]",6,22,-16
31214.0,2019-12-17,"(726.0, 1073.5]",20,35,-15
31214.0,2019-12-17,"(1073.5, 1421.0]",17,23,-6
31215.0,2019-12-17,"(407.161, 617.75]",16,16,0
31215.0,2019-12-17,"(617.75, 827.5]",1,6,-5
31215.0,2019-12-17,"(827.5, 1037.25]",4,7,-3
31215.0,2019-12-17,"(1037.25, 1247.0]",5,10,-5
31216.0,2019-12-17,"(469.185, 673.75]",12,14,-2
31216.0,2019-12-17,"(673.75, 877.5]",6,11,-5
31216.0,2019-12-17,"(877.5, 1081.25]",4,13,-9
31216.0,2019-12-17,"(1081.25, 1285.0]",1,9,-8
31217.0,2019-12-17,"(377.235, 569.25]",9,13,-4
31217.0,2019-12-17,"(569.25, 760.5]",2,4,-2
31217.0,2019-12-17,"(760.5, 951.75]",1,4,-3
31217.0,2019-12-17,"(951.75, 1143.0]",2,14,-12
31218.0,2019-12-17,"(326.952, 590.0]",13,28,-15
31218.0,2019-12-17,"(590.0, 852.0]",6,6,0
31218.0,2019-12-17,"(852.0, 1114.0]",8,17,-9
31218.0,2019-12-17,"(1114.0, 1376.0]",1,3,-2
31219.0,2019-12-17,"(363.163, 573.25]",10,10,0
31219.0,2019-12-17,"(573.25, 782.5]",4,7,-3
31219.0,2019-12-17,"(782.5, 991.75]",1,4,-3
31219.0,2019-12-17,"(991.75, 1201.0]",2,10,-8
31220.0,2019-12-17,"(300.248, 489.0]",8,13,-5
31220.0,2019-12-17,"(489.0, 677.0]",6,6,0
31220.0,2019-12-17,"(677.0, 865.0]",2,6,-4
31221.0,2019-12-17,"(419.117, 640.75]",28,33,-5
31221.0,2019-12-17,"(640.75, 861.5]",17,28,-11
31221.0,2019-12-17,"(861.5, 1082.25]",5,20,-15
31221.0,2019-12-17,"(1082.25, 1303.0]",3,9,-6
31222.0,2019-12-17,"(330.75, 609.5]",12,1,11
31222.0,2019-12-17,"(888.25, 1167.0]",3,13,-10
31223.0,2019-12-17,"(46.642, 387.5]",1,2,-1
31223.0,2019-12-17,"(387.5, 727.0]",9,27,-18
31223.0,2019-12-17,"(727.0, 1066.5]",6,16,-10
31223.0,2019-12-17,"(1066.5, 1406.0]",8,17,-9
31224.0,2019-12-17,"(382.042, 622.5]",15,15,0
31224.0,2019-12-17,"(622.5, 862.0]",4,7,-3
31224.0,2019-12-17,"(862.0, 1101.5]",5,15,-10
31224.0,2019-12-17,"(1101.5, 1341.0]",1,5,-4
31225.0,2019-12-17,"(397.154, 609.5]",10,17,-7
31225.0,2019-12-17,"(821.0, 1032.5]",3,2,1
31225.0,2019-12-17,"(1032.5, 1244.0]",5,8,-3
31226.0,2019-12-17,"(272.095, 499.25]",3,5,-2
31226.0,2019-12-17,"(499.25, 725.5]",1,5,-4
31226.0,2019-12-17,"(725.5, 951.75]",1,2,-1
31226.0,2019-12-17,"(951.75, 1178.0]",1,1,0
31227.0,2019-12-17,"(430.331, 598.25]",20,23,-3
31227.0,2019-12-17,"(598.25, 765.5]",6,11,-5
31227.0,2019-12-17,"(765.5, 932.75]",3,6,-3
31227.0,2019-12-17,"(932.75, 1100.0]",2,7,-5
31228.0,2019-12-17,"(119.723, 440.25]",7,7,0
31228.0,2019-12-17,"(440.25, 759.5]",17,28,-11
31228.0,2019-12-17,"(759.5, 1078.75]",18,31,-13
31228.0,2019-12-17,"(1078.75, 1398.0]",12,25,-13
31229.0,2019-12-17,"(362.0, 715.0]",8,6,2
31229.0,2019-12-17,"(715.0, 1068.0]",23,38,-15
31229.0,2019-12-17,"(1068.0, 1421.0]",22,40,-18
31230.0,2019-12-17,"(373.976, 631.0]",46,55,-9
31230.0,2019-12-17,"(631.0, 887.0]",8,15,-7
31230.0,2019-12-17,"(887.0, 1143.0]",10,23,-13
31230.0,2019-12-17,"(1143.0, 1399.0]",1,16,-15
31231.0,2019-12-17,"(324.958, 586.5]",17,21,-4
31231.0,2019-12-17,"(586.5, 847.0]",3,7,-4
31231.0,2019-12-17,"(847.0, 1107.5]",5,12,-7
31231.0,2019-12-17,"(1107.5, 1368.0]",2,3,-1
31232.0,2019-12-17,"(294.935, 562.25]",15,19,-4
31232.0,2019-12-17,"(562.25, 828.5]",10,13,-3
31232.0,2019-12-17,"(828.5, 1094.75]",7,13,-6
31232.0,2019-12-17,"(1094.75, 1361.0]",3,6,-3
31233.0,2019-12-17,"(312.876, 595.0]",23,27,-4
31233.0,2019-12-17,"(595.0, 876.0]",16,21,-5
31233.0,2019-12-17,"(876.0, 1157.0]",6,17,-11
31233.0,2019-12-17,"(1157.0, 1438.0]",4,6,-2
31234.0,2019-12-17,"(390.052, 628.0]",15,26,-11
31234.0,2019-12-17,"(628.0, 865.0]",7,15,-8
31234.0,2019-12-17,"(865.0, 1102.0]",13,16,-3
31234.0,2019-12-17,"(1102.0, 1339.0]",8,15,-7
31235.0,2019-12-17,"(502.422, 647.5]",5,5,0
31235.0,2019-12-17,"(792.0, 936.5]",3,4,-1
31235.0,2019-12-17,"(936.5, 1081.0]",2,5,-3
31236.0,2019-12-17,"(4.568, 364.0]",1,2,-1
31236.0,2019-12-17,"(364.0, 722.0]",9,14,-5
31236.0,2019-12-17,"(722.0, 1080.0]",5,13,-8
31236.0,2019-12-17,"(1080.0, 1438.0]",3,11,-8
31237.0,2019-12-17,"(219.782, 525.5]",6,10,-4
31237.0,2019-12-17,"(525.5, 830.0]",7,19,-12
31237.0,2019-12-17,"(830.0, 1134.5]",10,16,-6
31237.0,2019-12-17,"(1134.5, 1439.0]",3,8,-5
31238.0,2019-12-17,"(52.768, 362.0]",1,2,-1
31238.0,2019-12-17,"(362.0, 670.0]",11,14,-3
31238.0,2019-12-17,"(670.0, 978.0]",4,10,-6
31238.0,2019-12-17,"(978.0, 1286.0]",6,23,-17
31239.0,2019-12-17,"(356.936, 624.0]",22,26,-4
31239.0,2019-12-17,"(624.0, 890.0]",4,12,-8
31239.0,2019-12-17,"(890.0, 1156.0]",7,22,-15
31239.0,2019-12-17,"(1156.0, 1422.0]",2,3,-1
,,,,1.0,
,,,,2.0,
31241.0,2019-12-17,"(7.678, 339.5]",1,4,-3
31241.0,2019-12-17,"(339.5, 670.0]",27,47,-20
31241.0,2019-12-17,"(670.0, 1000.5]",11,22,-11
31241.0,2019-12-17,"(1000.5, 1331.0]",10,30,-20
31242.0,2019-12-17,"(403.051, 641.25]",21,25,-4
31242.0,2019-12-17,"(641.25, 878.5]",1,3,-2
31242.0,2019-12-17,"(878.5, 1115.75]",2,11,-9
31243.0,2019-12-17,"(375.012, 623.0]",22,26,-4
31243.0,2019-12-17,"(870.0, 1117.0]",5,1,4
31243.0,2019-12-17,"(1117.0, 1364.0]",1,16,-15
31244.0,2019-12-17,"(418.097, 644.75]",12,20,-8
31244.0,2019-12-17,"(644.75, 870.5]",2,3,-1
31244.0,2019-12-17,"(870.5, 1096.25]",6,17,-11
31244.0,2019-12-17,"(1096.25, 1322.0]",6,7,-1
31245.0,2019-12-17,"(332.932, 601.0]",11,25,-14
31245.0,2019-12-17,"(601.0, 868.0]",1,3,-2
31245.0,2019-12-17,"(868.0, 1135.0]",10,19,-9
31245.0,2019-12-17,"(1135.0, 1402.0]",6,18,-12
31246.0,2019-12-17,"(410.074, 642.5]",13,16,-3
31246.0,2019-12-17,"(642.5, 874.0]",6,10,-4
31246.0,2019-12-17,"(874.0, 1105.5]",7,19,-12
31246.0,2019-12-17,"(1105.5, 1337.0]",9,17,-8
31247.0,2019-12-17,"(421.148, 635.0]",6,8,-2
31247.0,2019-12-17,"(635.0, 848.0]",4,5,-1
31247.0,2019-12-17,"(848.0, 1061.0]",2,4,-2
31247.0,2019-12-17,"(1061.0, 1274.0]",2,5,-3
31248.0,2019-12-17,"(357.24, 548.0]",7,12,-5
31248.0,2019-12-17,"(548.0, 738.0]",3,4,-1
31248.0,2019-12-17,"(738.0, 928.0]",4,5,-1
31248.0,2019-12-17,"(928.0, 1118.0]",7,9,-2
31249.0,2019-12-17,"(410.233, 602.75]",5,8,-3
31249.0,2019-12-17,"(602.75, 794.5]",6,12,-6
31249.0,2019-12-17,"(986.25, 1178.0]",3,6,-3
31250.0,2019-12-17,"(415.077, 646.75]",19,20,-1
31250.0,2019-12-17,"(646.75, 877.5]",6,10,-4
31250.0,2019-12-17,"(877.5, 1108.25]",2,14,-12
31250.0,2019-12-17,"(1108.25, 1339.0]",3,7,-4
31251.0,2019-12-17,"(357.5, 706.0]",17,2,15
31251.0,2019-12-17,"(706.0, 1054.5]",16,32,-16
31251.0,2019-12-17,"(1054.5, 1403.0]",11,25,-14
31252.0,2019-12-17,"(477.12, 698.0]",19,19,0
31252.0,2019-12-17,"(698.0, 918.0]",1,3,-2
31252.0,2019-12-17,"(918.0, 1138.0]",3,17,-14
31252.0,2019-12-17,"(1138.0, 1358.0]",1,5,-4
31253.0,2019-12-17,"(382.095, 609.25]",18,22,-4
31253.0,2019-12-17,"(609.25, 835.5]",5,8,-3
31253.0,2019-12-17,"(835.5, 1061.75]",6,13,-7
31253.0,2019-12-17,"(1061.75, 1288.0]",3,11,-8
31254.0,2019-12-17,"(436.143, 651.25]",12,16,-4
31254.0,2019-12-17,"(651.25, 865.5]",3,5,-2
31254.0,2019-12-17,"(865.5, 1079.75]",2,14,-12
31254.0,2019-12-17,"(1079.75, 1294.0]",2,10,-8
31255.0,2019-12-17,"(362.927, 632.25]",22,31,-9
31255.0,2019-12-17,"(632.25, 900.5]",7,12,-5
31255.0,2019-12-17,"(900.5, 1168.75]",4,16,-12
31256.0,2019-12-17,"(270.031, 513.25]",4,4,0
31256.0,2019-12-17,"(513.25, 755.5]",7,11,-4
31256.0,2019-12-17,"(755.5, 997.75]",5,8,-3
31256.0,2019-12-17,"(997.75, 1240.0]",2,11,-9
31257.0,2019-12-17,"(3.63, 347.5]",1,2,-1
31257.0,2019-12-17,"(347.5, 690.0]",11,15,-4
31257.0,2019-12-17,"(690.0, 1032.5]",15,29,-14
31257.0,2019-12-17,"(1032.5, 1375.0]",8,24,-16
31258.0,2019-12-17,"(446.325, 615.75]",2,4,-2
31258.0,2019-12-17,"(784.5, 953.25]",2,10,-8
31258.0,2019-12-17,"(953.25, 1122.0]",3,4,-1
31259.0,2019-12-17,"(449.335, 616.25]",11,12,-1
31259.0,2019-12-17,"(616.25, 782.5]",5,5,0
31259.0,2019-12-17,"(948.75, 1115.0]",2,7,-5
31260.0,2019-12-17,"(404.078, 635.5]",11,14,-3
31260.0,2019-12-17,"(635.5, 866.0]",1,2,-1
31260.0,2019-12-17,"(866.0, 1096.5]",4,15,-11
31260.0,2019-12-17,"(1096.5, 1327.0]",4,8,-4
31261.0,2019-12-17,"(426.305, 600.75]",8,8,0
31261.0,2019-12-17,"(774.5, 948.25]",1,2,-1
31262.0,2019-12-17,"(444.059, 680.25]",10,10,0
31262.0,2019-12-17,"(680.25, 915.5]",4,5,-1
31262.0,2019-12-17,"(915.5, 1150.75]",2,10,-8
31263.0,2019-12-17,"(341.919, 613.25]",16,21,-5
31263.0,2019-12-17,"(613.25, 883.5]",8,12,-4
31263.0,2019-12-17,"(883.5, 1153.75]",8,21,-13
31263.0,2019-12-17,"(1153.75, 1424.0]",1,9,-8
31264.0,2019-12-17,"(503.29, 681.5]",9,15,-6
31264.0,2019-12-17,"(681.5, 859.0]",2,4,-2
31264.0,2019-12-17,"(1036.5, 1214.0]",3,5,-2
31265.0,2019-12-17,"(18.642, 359.5]",1,2,-1
31265.0,2019-12-17,"(359.5, 699.0]",8,25,-17
31265.0,2019-12-17,"(699.0, 1038.5]",12,16,-4
31265.0,2019-12-17,"(1038.5, 1378.0]",14,26,-12
31266.0,2019-12-17,"(115.771, 424.25]",1,9,-8
31266.0,2019-12-17,"(424.25, 731.5]",8,28,-20
31266.0,2019-12-17,"(731.5, 1038.75]",10,17,-7
31266.0,2019-12-17,"(1038.75, 1346.0]",14,24,-10
31267.0,2019-12-17,"(347.75, 689.5]",22,4,18
31267.0,2019-12-17,"(689.5, 1031.25]",12,41,-29
31267.0,2019-12-17,"(1031.25, 1373.0]",15,22,-7
31268.0,2019-12-17,"(49.632, 393.0]",1,3,-2
31268.0,2019-12-17,"(393.0, 735.0]",11,36,-25
31268.0,2019-12-17,"(735.0, 1077.0]",6,9,-3
31268.0,2019-12-17,"(1077.0, 1419.0]",17,26,-9
31269.0,2019-12-17,"(348.925, 618.75]",7,15,-8
31269.0,2019-12-17,"(618.75, 887.5]",2,3,-1
31269.0,2019-12-17,"(887.5, 1156.25]",7,11,-4
31270.0,2019-12-17,"(237.896, 515.0]",10,12,-2
31270.0,2019-12-17,"(515.0, 791.0]",8,14,-6
31270.0,2019-12-17,"(791.0, 1067.0]",8,17,-9
31270.0,2019-12-17,"(1067.0, 1343.0]",7,10,-3
31271.0,2019-12-17,"(462.242, 652.5]",15,17,-2
31271.0,2019-12-17,"(652.5, 842.0]",2,4,-2
31271.0,2019-12-17,"(842.0, 1031.5]",3,8,-5
31271.0,2019-12-17,"(1031.5, 1221.0]",3,11,-8
31272.0,2019-12-17,"(392.956, 655.0]",16,16,0
31272.0,2019-12-17,"(655.0, 916.0]",5,6,-1
31272.0,2019-12-17,"(916.0, 1177.0]",5,12,-7
31273.0,2019-12-17,"(540.537, 656.75]",1,3,-2
31273.0,2019-12-17,"(888.25, 1004.0]",3,3,0
31274.0,2019-12-17,"(395.093, 622.75]",15,17,-2
31274.0,2019-12-17,"(622.75, 849.5]",4,7,-3
31274.0,2019-12-17,"(849.5, 1076.25]",2,7,-5
31274.0,2019-12-17,"(1076.25, 1303.0]",1,5,-4
31275.0,2019-12-17,"(326.942, 592.5]",13,18,-5
31275.0,2019-12-17,"(592.5, 857.0]",8,16,-8
31275.0,2019-12-17,"(857.0, 1121.5]",8,15,-7
31275.0,2019-12-17,"(1121.5, 1386.0]",4,11,-7
31276.0,2019-12-17,"(439.114, 661.5]",17,18,-1
31276.0,2019-12-17,"(661.5, 883.0]",5,12,-7
31276.0,2019-12-17,"(883.0, 1104.5]",2,17,-15
31276.0,2019-12-17,"(1104.5, 1326.0]",1,9,-8
31277.0,2019-12-17,"(431.253, 618.75]",34,38,-4
31277.0,2019-12-17,"(618.75, 805.5]",7,13,-6
31277.0,2019-12-17,"(805.5, 992.25]",5,12,-7
31277.0,2019-12-17,"(992.25, 1179.0]",2,17,-15
31278.0,2019-12-17,"(45.664, 381.0]",1,1,0
31278.0,2019-12-17,"(381.0, 715.0]",3,29,-26
31278.0,2019-12-17,"(715.0, 1049.0]",8,13,-5
31278.0,2019-12-17,"(1049.0, 1383.0]",16,19,-3
31279.0,2019-12-17,"(398.033, 640.75]",16,20,-4
31279.0,2019-12-17,"(640.75, 882.5]",5,5,0
31279.0,2019-12-17,"(882.5, 1124.25]",4,18,-14
31280.0,2019-12-17,"(354.992, 608.0]",4,17,-13
31280.0,2019-12-17,"(860.0, 1112.0]",7,1,6
31280.0,2019-12-17,"(1112.0, 1364.0]",8,8,0
31000.0,2019-12-18,"(717.0, 956.0]",1,1,0
31001.0,2019-12-18,"(869.25, 1159.0]",1,1,0
31002.0,2019-12-18,"(454.396, 606.0]",4,7,-3
31002.0,2019-12-18,"(606.0, 757.0]",1,2,-1
31002.0,2019-12-18,"(757.0, 908.0]",1,3,-2
31002.0,2019-12-18,"(908.0, 1059.0]",7,10,-3
31003.0,2019-12-18,"(378.248, 567.0]",3,7,-4
31003.0,2019-12-18,"(567.0, 755.0]",3,4,-1
31003.0,2019-12-18,"(943.0, 1131.0]",3,2,1
31004.0,2019-12-18,"(493.164, 703.0]",1,4,-3
31004.0,2019-12-18,"(912.0, 1121.0]",2,2,0
31004.0,2019-12-18,"(1121.0, 1330.0]",1,1,0
31005.0,2019-12-18,"(439.278, 620.5]",3,3,0
31005.0,2019-12-18,"(801.0, 981.5]",1,2,-1
31006.0,2019-12-18,"(840.515, 962.25]",1,1,0
31006.0,2019-12-18,"(1204.75, 1326.0]",1,2,-1
31007.0,2019-12-18,"(353.179, 559.25]",4,9,-5
31007.0,2019-12-18,"(559.25, 764.5]",3,7,-4
31007.0,2019-12-18,"(764.5, 969.75]",3,7,-4
31007.0,2019-12-18,"(969.75, 1175.0]",7,16,-9
31009.0,2019-12-18,"(376.398, 527.5]",1,1,0
31009.0,2019-12-18,"(527.5, 678.0]",5,5,0
31009.0,2019-12-18,"(828.5, 979.0]",2,4,-2
31010.0,2019-12-18,"(706.0, 956.0]",3,1,2
31010.0,2019-12-18,"(956.0, 1206.0]",2,5,-3
31011.0,2019-12-18,"(211.12, 432.0]",2,2,0
31011.0,2019-12-18,"(432.0, 652.0]",2,4,-2
31011.0,2019-12-18,"(652.0, 872.0]",1,1,0
31011.0,2019-12-18,"(872.0, 1092.0]",3,6,-3
31012.0,2019-12-18,"(357.156, 569.0]",2,3,-1
31012.0,2019-12-18,"(569.0, 780.0]",1,3,-2
31012.0,2019-12-18,"(780.0, 991.0]",1,5,-4
31013.0,2019-12-18,"(774.75, 977.5]",1,1,0
31013.0,2019-12-18,"(977.5, 1180.25]",2,3,-1
31014.0,2019-12-18,"(12.697, 339.75]",1,1,0
31014.0,2019-12-18,"(339.75, 665.5]",22,28,-6
31014.0,2019-12-18,"(665.5, 991.25]",7,10,-3
31014.0,2019-12-18,"(991.25, 1317.0]",9,14,-5
31015.0,2019-12-18,"(306.081, 536.75]",9,9,0
31015.0,2019-12-18,"(536.75, 766.5]",7,7,0
31015.0,2019-12-18,"(996.25, 1226.0]",3,4,-1
31016.0,2019-12-18,"(419.104, 644.0]",5,9,-4
31016.0,2019-12-18,"(644.0, 868.0]",2,5,-3
31016.0,2019-12-18,"(868.0, 1092.0]",2,9,-7
31016.0,2019-12-18,"(1092.0, 1316.0]",2,3,-1
31017.0,2019-12-18,"(496.265, 680.75]",6,8,-2
31017.0,2019-12-18,"(680.75, 864.5]",2,3,-1
31017.0,2019-12-18,"(1048.25, 1232.0]",1,3,-2
31018.0,2019-12-18,"(871.5, 1126.25]",2,7,-5
31018.0,2019-12-18,"(1126.25, 1381.0]",2,3,-1
31019.0,2019-12-18,"(832.5, 1016.25]",1,1,0
31019.0,2019-12-18,"(1016.25, 1200.0]",3,1,2
31020.0,2019-12-18,"(447.213, 644.75]",3,6,-3
31020.0,2019-12-18,"(1038.25, 1235.0]",1,3,-2
31021.0,2019-12-18,"(304.047, 543.25]",1,6,-5
31021.0,2019-12-18,"(543.25, 781.5]",2,4,-2
31021.0,2019-12-18,"(1019.75, 1258.0]",2,2,0
31022.0,2019-12-18,"(443.13, 661.5]",4,9,-5
31022.0,2019-12-18,"(661.5, 879.0]",1,2,-1
31022.0,2019-12-18,"(879.0, 1096.5]",1,4,-3
31022.0,2019-12-18,"(1096.5, 1314.0]",2,7,-5
31023.0,2019-12-18,"(486.113, 708.75]",1,2,-1
31023.0,2019-12-18,"(708.75, 930.5]",1,1,0
31023.0,2019-12-18,"(930.5, 1152.25]",1,1,0
31023.0,2019-12-18,"(1152.25, 1374.0]",1,3,-2
31024.0,2019-12-18,"(428.05, 666.5]",5,8,-3
31024.0,2019-12-18,"(666.5, 904.0]",1,1,0
31024.0,2019-12-18,"(904.0, 1141.5]",3,10,-7
31025.0,2019-12-18,"(906.812, 954.0]",1,2,-1
31025.0,2019-12-18,"(1001.0, 1048.0]",1,1,0
31025.0,2019-12-18,"(1048.0, 1095.0]",1,1,0
31026.0,2019-12-18,"(906.0, 1096.0]",3,3,0
31027.0,2019-12-18,"(866.829, 909.75]",1,2,-1
31027.0,2019-12-18,"(952.5, 995.25]",1,1,0
31027.0,2019-12-18,"(995.25, 1038.0]",1,2,-1
31028.0,2019-12-18,"(566.247, 755.25]",1,1,0
31028.0,2019-12-18,"(755.25, 943.5]",1,1,0
31028.0,2019-12-18,"(1131.75, 1320.0]",1,3,-2
31029.0,2019-12-18,"(838.5, 1037.25]",2,6,-4
31029.0,2019-12-18,"(1037.25, 1236.0]",4,1,3
31030.0,2019-12-18,"(435.133, 652.75]",1,8,-7
31030.0,2019-12-18,"(652.75, 869.5]",1,3,-2
31030.0,2019-12-18,"(869.5, 1086.25]",4,4,0
31030.0,2019-12-18,"(1086.25, 1303.0]",4,5,-1
31031.0,2019-12-18,"(310.198, 511.5]",1,3,-2
31031.0,2019-12-18,"(912.5, 1113.0]",3,2,1
31032.0,2019-12-18,"(993.25, 1167.0]",2,2,0
31033.0,2019-12-18,"(945.589, 1048.75]",1,3,-2
31033.0,2019-12-18,"(1151.5, 1254.25]",1,1,0
31034.0,2019-12-18,"(497.245, 686.75]",1,4,-3
31034.0,2019-12-18,"(875.5, 1064.25]",1,1,0
31035.0,2019-12-18,"(496.059, 732.25]",1,3,-2
31035.0,2019-12-18,"(967.5, 1202.75]",1,1,0
31035.0,2019-12-18,"(1202.75, 1438.0]",2,3,-1
31036.0,2019-12-18,"(583.5, 733.0]",1,2,-1
31036.0,2019-12-18,"(882.5, 1032.0]",1,3,-2
31037.0,2019-12-18,"(416.062, 651.5]",10,15,-5
31037.0,2019-12-18,"(651.5, 886.0]",2,2,0
31037.0,2019-12-18,"(886.0, 1120.5]",3,10,-7
31037.0,2019-12-18,"(1120.5, 1355.0]",2,6,-4
,,,,1.0,
,,,,1.0,
,,,,1.0,
31039.0,2019-12-18,"(480.346, 644.5]",2,4,-2
31039.0,2019-12-18,"(644.5, 808.0]",1,3,-2
31039.0,2019-12-18,"(808.0, 971.5]",1,2,-1
31039.0,2019-12-18,"(971.5, 1135.0]",3,5,-2
31040.0,2019-12-18,"(450.108, 674.0]",3,3,0
31040.0,2019-12-18,"(674.0, 897.0]",1,1,0
31040.0,2019-12-18,"(897.0, 1120.0]",1,3,-2
31041.0,2019-12-18,"(473.499, 599.25]",2,2,0
31041.0,2019-12-18,"(599.25, 724.5]",1,1,0
31041.0,2019-12-18,"(724.5, 849.75]",1,2,-1
31042.0,2019-12-18,"(441.255, 628.25]",7,7,0
31042.0,2019-12-18,"(628.25, 814.5]",3,7,-4
31042.0,2019-12-18,"(814.5, 1000.75]",1,1,0
31042.0,2019-12-18,"(1000.75, 1187.0]",1,9,-8
31043.0,2019-12-18,"(511.301, 686.75]",1,1,0
31043.0,2019-12-18,"(686.75, 861.5]",1,1,0
31043.0,2019-12-18,"(861.5, 1036.25]",1,2,-1
31043.0,2019-12-18,"(1036.25, 1211.0]",1,2,-1
31044.0,2019-12-18,"(514.37, 672.5]",3,3,0
31044.0,2019-12-18,"(672.5, 830.0]",1,1,0
31044.0,2019-12-18,"(987.5, 1145.0]",1,1,0
31045.0,2019-12-18,"(618.291, 796.25]",1,3,-2
31045.0,2019-12-18,"(973.5, 1150.75]",3,2,1
31045.0,2019-12-18,"(1150.75, 1328.0]",1,4,-3
31046.0,2019-12-18,"(397.331, 565.25]",1,4,-3
31046.0,2019-12-18,"(899.75, 1067.0]",1,2,-1
31047.0,2019-12-18,"(372.176, 579.0]",11,20,-9
31047.0,2019-12-18,"(991.0, 1197.0]",6,2,4
31048.0,2019-12-18,"(406.077, 637.75]",3,6,-3
31048.0,2019-12-18,"(637.75, 868.5]",1,1,0
31048.0,2019-12-18,"(868.5, 1099.25]",4,7,-3
31049.0,2019-12-18,"(553.259, 739.25]",2,3,-1
31049.0,2019-12-18,"(739.25, 924.5]",1,2,-1
31049.0,2019-12-18,"(924.5, 1109.75]",1,1,0
31049.0,2019-12-18,"(1109.75, 1295.0]",1,2,-1
,,,,1.0,
,,,,1.0,
31051.0,2019-12-18,"(820.0, 1078.0]",4,5,-1
31051.0,2019-12-18,"(1078.0, 1336.0]",4,1,3
31052.0,2019-12-18,"(542.49, 670.5]",2,3,-1
31052.0,2019-12-18,"(798.0, 925.5]",1,1,0
31053.0,2019-12-18,"(965.75, 1081.0]",1,2,-1
,,,,2.0,
31055.0,2019-12-18,"(479.244, 669.0]",2,4,-2
31055.0,2019-12-18,"(669.0, 858.0]",1,1,0
31055.0,2019-12-18,"(858.0, 1047.0]",1,2,-1
31055.0,2019-12-18,"(1047.0, 1236.0]",1,2,-1
31056.0,2019-12-18,"(169.929, 438.75]",1,1,0
31056.0,2019-12-18,"(974.25, 1242.0]",2,2,0
31057.0,2019-12-18,"(989.75, 1050.0]",1,1,0
31058.0,2019-12-18,"(518.25, 691.0]",1,1,0
31059.0,2019-12-18,"(775.5, 953.25]",1,2,-1
31059.0,2019-12-18,"(953.25, 1131.0]",1,1,0
31060.0,2019-12-18,"(417.75, 674.5]",1,1,0
31060.0,2019-12-18,"(931.25, 1188.0]",1,2,-1
31061.0,2019-12-18,"(604.238, 795.5]",2,2,0
31061.0,2019-12-18,"(1176.5, 1367.0]",1,2,-1
31062.0,2019-12-18,"(554.543, 669.25]",1,3,-2
31062.0,2019-12-18,"(669.25, 783.5]",1,2,-1
31062.0,2019-12-18,"(783.5, 897.75]",1,2,-1
31062.0,2019-12-18,"(897.75, 1012.0]",3,5,-2
31063.0,2019-12-18,"(1035.0, 1380.0]",2,1,1
31064.0,2019-12-18,"(438.003, 688.25]",3,6,-3
31064.0,2019-12-18,"(688.25, 937.5]",1,1,0
31064.0,2019-12-18,"(937.5, 1186.75]",3,6,-3
31064.0,2019-12-18,"(1186.75, 1436.0]",1,1,0
31065.0,2019-12-18,"(834.25, 990.0]",2,2,0
31066.0,2019-12-18,"(844.25, 965.0]",2,2,0
31067.0,2019-12-18,"(799.0, 957.0]",1,3,-2
31067.0,2019-12-18,"(957.0, 1115.0]",3,1,2
31068.0,2019-12-18,"(561.213, 758.75]",2,4,-2
31068.0,2019-12-18,"(1152.25, 1349.0]",1,1,0
31069.0,2019-12-18,"(787.5, 970.75]",2,5,-3
31069.0,2019-12-18,"(970.75, 1154.0]",3,2,1
31070.0,2019-12-18,"(570.449, 708.75]",1,2,-1
31070.0,2019-12-18,"(984.25, 1122.0]",2,1,1
31071.0,2019-12-18,"(623.5, 769.0]",1,2,-1
31071.0,2019-12-18,"(769.0, 914.5]",1,1,0
31071.0,2019-12-18,"(914.5, 1060.0]",2,1,1
,,,,1.0,
,,,,1.0,
31073.0,2019-12-18,"(494.408, 643.0]",1,2,-1
31073.0,2019-12-18,"(791.0, 939.0]",2,1,1
31073.0,2019-12-18,"(939.0, 1087.0]",2,2,0
31074.0,2019-12-18,"(1000.902, 1025.5]",1,1,0
31074.0,2019-12-18,"(1074.5, 1099.0]",1,2,-1
31075.0,2019-12-18,"(972.5, 1117.0]",1,1,0
31076.0,2019-12-18,"(427.016, 674.0]",1,1,0
31076.0,2019-12-18,"(674.0, 920.0]",1,1,0
31076.0,2019-12-18,"(1166.0, 1412.0]",1,2,-1
31077.0,2019-12-18,"(354.286, 533.5]",1,1,0
31077.0,2019-12-18,"(712.0, 890.5]",1,4,-3
31077.0,2019-12-18,"(890.5, 1069.0]",2,2,0
31078.0,2019-12-18,"(447.353, 609.75]",3,4,-1
31078.0,2019-12-18,"(933.25, 1095.0]",1,5,-4
31079.0,2019-12-18,"(707.25, 924.5]",1,6,-5
31079.0,2019-12-18,"(924.5, 1141.75]",2,3,-1
31079.0,2019-12-18,"(1141.75, 1359.0]",3,3,0
31080.0,2019-12-18,"(388.21, 586.5]",2,10,-8
31080.0,2019-12-18,"(586.5, 784.0]",1,3,-2
31080.0,2019-12-18,"(981.5, 1179.0]",5,9,-4
31081.0,2019-12-18,"(473.222, 668.5]",2,3,-1
31081.0,2019-12-18,"(1057.5, 1252.0]",1,1,0
31082.0,2019-12-18,"(361.25, 362.0]",1,1,0
31083.0,2019-12-18,"(807.5, 1006.25]",2,3,-1
31083.0,2019-12-18,"(1006.25, 1205.0]",2,2,0
31084.0,2019-12-18,"(439.106, 663.5]",6,6,0
31084.0,2019-12-18,"(663.5, 887.0]",1,3,-2
31084.0,2019-12-18,"(1110.5, 1334.0]",1,5,-4
31085.0,2019-12-18,"(403.354, 565.5]",1,6,-5
31085.0,2019-12-18,"(888.5, 1050.0]",1,1,0
,,,,2.0,
31087.0,2019-12-18,"(926.25, 1078.0]",4,2,2
31088.0,2019-12-18,"(589.75, 786.5]",1,2,-1
31088.0,2019-12-18,"(786.5, 983.25]",1,1,0
31088.0,2019-12-18,"(983.25, 1180.0]",4,1,3
31089.0,2019-12-18,"(306.987, 561.25]",4,7,-3
31089.0,2019-12-18,"(561.25, 814.5]",3,6,-3
31089.0,2019-12-18,"(1067.75, 1321.0]",1,8,-7
31090.0,2019-12-18,"(889.0, 1044.0]",2,1,1
31091.0,2019-12-18,"(101.712, 425.0]",1,2,-1
31091.0,2019-12-18,"(747.0, 1069.0]",2,3,-1
31091.0,2019-12-18,"(1069.0, 1391.0]",2,2,0
31092.0,2019-12-18,"(894.25, 1031.0]",1,2,-1
,,,,1.0,
,,,,1.0,
,,,,1.0,
,,,,2.0,
31094.0,2019-12-18,"(500.947, 514.25]",1,1,0
,,,,2.0,
,,,,2.0,
31097.0,2019-12-18,"(530.211, 728.25]",3,4,-1
31097.0,2019-12-18,"(728.25, 925.5]",1,1,0
31098.0,2019-12-18,"(433.283, 613.25]",3,11,-8
31098.0,2019-12-18,"(613.25, 792.5]",3,3,0
31098.0,2019-12-18,"(971.75, 1151.0]",9,1,8
31099.0,2019-12-18,"(1057.75, 1250.0]",1,1,0
31100.0,2019-12-18,"(423.13, 641.5]",13,16,-3
31100.0,2019-12-18,"(641.5, 859.0]",1,2,-1
31100.0,2019-12-18,"(859.0, 1076.5]",5,13,-8
31100.0,2019-12-18,"(1076.5, 1294.0]",2,14,-12
31101.0,2019-12-18,"(90.706, 415.5]",3,5,-2
31101.0,2019-12-18,"(415.5, 739.0]",10,44,-34
31101.0,2019-12-18,"(739.0, 1062.5]",27,43,-16
31101.0,2019-12-18,"(1062.5, 1386.0]",24,42,-18
31102.0,2019-12-18,"(338.959, 600.25]",4,25,-21
31102.0,2019-12-18,"(600.25, 860.5]",1,7,-6
31102.0,2019-12-18,"(860.5, 1120.75]",3,6,-3
31102.0,2019-12-18,"(1120.75, 1381.0]",9,15,-6
31103.0,2019-12-18,"(328.75, 643.5]",2,2,0
31103.0,2019-12-18,"(643.5, 958.25]",2,31,-29
31103.0,2019-12-18,"(958.25, 1273.0]",9,9,0
31104.0,2019-12-18,"(366.0, 714.0]",2,1,1
31104.0,2019-12-18,"(714.0, 1062.0]",13,15,-2
31104.0,2019-12-18,"(1062.0, 1410.0]",17,22,-5
31105.0,2019-12-18,"(568.5, 801.0]",2,10,-8
31105.0,2019-12-18,"(801.0, 1033.5]",1,4,-3
31105.0,2019-12-18,"(1033.5, 1266.0]",3,4,-1
31106.0,2019-12-18,"(22.803, 323.25]",1,2,-1
31106.0,2019-12-18,"(622.5, 921.75]",1,4,-3
31106.0,2019-12-18,"(921.75, 1221.0]",5,5,0
31107.0,2019-12-18,"(343.907, 618.25]",5,27,-22
31107.0,2019-12-18,"(618.25, 891.5]",5,13,-8
31107.0,2019-12-18,"(891.5, 1164.75]",10,18,-8
31107.0,2019-12-18,"(1164.75, 1438.0]",6,8,-2
31108.0,2019-12-18,"(100.731, 419.25]",2,4,-2
31108.0,2019-12-18,"(419.25, 736.5]",10,31,-21
31108.0,2019-12-18,"(736.5, 1053.75]",14,21,-7
31108.0,2019-12-18,"(1053.75, 1371.0]",11,16,-5
31109.0,2019-12-18,"(334.004, 584.0]",6,15,-9
31109.0,2019-12-18,"(584.0, 833.0]",4,8,-4
31109.0,2019-12-18,"(833.0, 1082.0]",15,19,-4
31109.0,2019-12-18,"(1082.0, 1331.0]",9,17,-8
31110.0,2019-12-18,"(332.94, 599.0]",18,36,-18
31110.0,2019-12-18,"(599.0, 864.0]",10,21,-11
31110.0,2019-12-18,"(864.0, 1129.0]",9,20,-11
31110.0,2019-12-18,"(1129.0, 1394.0]",6,10,-4
31111.0,2019-12-18,"(31.629, 375.75]",4,4,0
31111.0,2019-12-18,"(375.75, 718.5]",12,30,-18
31111.0,2019-12-18,"(718.5, 1061.25]",6,11,-5
31111.0,2019-12-18,"(1061.25, 1404.0]",16,26,-10
31112.0,2019-12-18,"(356.228, 550.0]",1,2,-1
31112.0,2019-12-18,"(936.0, 1129.0]",3,2,1
31113.0,2019-12-18,"(620.0, 891.0]",2,18,-16
31113.0,2019-12-18,"(891.0, 1162.0]",6,10,-4
31113.0,2019-12-18,"(1162.0, 1433.0]",2,11,-9
31114.0,2019-12-18,"(311.879, 593.25]",3,23,-20
31114.0,2019-12-18,"(593.25, 873.5]",2,6,-4
31114.0,2019-12-18,"(873.5, 1153.75]",11,17,-6
31114.0,2019-12-18,"(1153.75, 1434.0]",14,16,-2
31115.0,2019-12-18,"(857.0, 1098.5]",6,19,-13
31115.0,2019-12-18,"(1098.5, 1340.0]",8,1,7
31116.0,2019-12-18,"(369.011, 617.25]",6,20,-14
31116.0,2019-12-18,"(617.25, 864.5]",5,8,-3
31116.0,2019-12-18,"(864.5, 1111.75]",12,17,-5
31116.0,2019-12-18,"(1111.75, 1359.0]",11,16,-5
31117.0,2019-12-18,"(361.972, 620.0]",2,26,-24
31117.0,2019-12-18,"(620.0, 877.0]",3,9,-6
31117.0,2019-12-18,"(877.0, 1134.0]",8,14,-6
31117.0,2019-12-18,"(1134.0, 1391.0]",7,12,-5
31118.0,2019-12-18,"(406.13, 624.5]",2,17,-15
31118.0,2019-12-18,"(624.5, 842.0]",2,3,-1
31118.0,2019-12-18,"(842.0, 1059.5]",3,8,-5
31118.0,2019-12-18,"(1059.5, 1277.0]",10,14,-4
31119.0,2019-12-18,"(17.657, 354.75]",6,9,-3
31119.0,2019-12-18,"(354.75, 690.5]",10,29,-19
31119.0,2019-12-18,"(690.5, 1026.25]",10,17,-7
31119.0,2019-12-18,"(1026.25, 1362.0]",16,28,-12
31120.0,2019-12-18,"(10.596, 363.0]",2,3,-1
31120.0,2019-12-18,"(363.0, 714.0]",3,14,-11
31120.0,2019-12-18,"(714.0, 1065.0]",5,12,-7
31120.0,2019-12-18,"(1065.0, 1416.0]",9,9,0
31121.0,2019-12-18,"(342.996, 595.0]",15,22,-7
31121.0,2019-12-18,"(595.0, 846.0]",5,6,-1
31121.0,2019-12-18,"(846.0, 1097.0]",9,19,-10
31121.0,2019-12-18,"(1097.0, 1348.0]",8,13,-5
31122.0,2019-12-18,"(369.982, 625.5]",3,13,-10
31122.0,2019-12-18,"(625.5, 880.0]",3,7,-4
31122.0,2019-12-18,"(880.0, 1134.5]",8,14,-6
31122.0,2019-12-18,"(1134.5, 1389.0]",5,8,-3
31123.0,2019-12-18,"(734.5, 1057.75]",3,3,0
31123.0,2019-12-18,"(1057.75, 1381.0]",9,11,-2
31124.0,2019-12-18,"(297.867, 582.25]",19,38,-19
31124.0,2019-12-18,"(582.25, 865.5]",9,29,-20
31124.0,2019-12-18,"(865.5, 1148.75]",13,47,-34
31124.0,2019-12-18,"(1148.75, 1432.0]",14,38,-24
31125.0,2019-12-18,"(4.594, 357.5]",1,2,-1
31125.0,2019-12-18,"(357.5, 709.0]",8,32,-24
31125.0,2019-12-18,"(709.0, 1060.5]",10,17,-7
31125.0,2019-12-18,"(1060.5, 1412.0]",23,32,-9
31126.0,2019-12-18,"(22.685, 352.75]",2,3,-1
31126.0,2019-12-18,"(352.75, 681.5]",4,37,-33
31126.0,2019-12-18,"(681.5, 1010.25]",7,17,-10
31126.0,2019-12-18,"(1010.25, 1339.0]",17,22,-5
,,,,2.0,
31128.0,2019-12-18,"(307.88, 589.0]",23,28,-5
31128.0,2019-12-18,"(589.0, 869.0]",16,27,-11
31128.0,2019-12-18,"(869.0, 1149.0]",13,28,-15
31128.0,2019-12-18,"(1149.0, 1429.0]",6,14,-8
31129.0,2019-12-18,"(424.139, 640.25]",9,17,-8
31129.0,2019-12-18,"(640.25, 855.5]",8,9,-1
31129.0,2019-12-18,"(855.5, 1070.75]",11,16,-5
31129.0,2019-12-18,"(1070.75, 1286.0]",4,5,-1
31130.0,2019-12-18,"(349.966, 609.5]",3,15,-12
31130.0,2019-12-18,"(609.5, 868.0]",3,8,-5
31130.0,2019-12-18,"(868.0, 1126.5]",4,7,-3
31130.0,2019-12-18,"(1126.5, 1385.0]",6,11,-5
31131.0,2019-12-18,"(907.0, 1145.0]",4,11,-7
31131.0,2019-12-18,"(1145.0, 1383.0]",2,1,1
31200.0,2019-12-18,"(325.5, 649.0]",28,1,27
31200.0,2019-12-18,"(649.0, 972.5]",21,40,-19
31200.0,2019-12-18,"(972.5, 1296.0]",23,35,-12
31201.0,2019-12-18,"(82.706, 407.5]",6,9,-3
31201.0,2019-12-18,"(407.5, 731.0]",28,52,-24
31201.0,2019-12-18,"(731.0, 1054.5]",28,48,-20
31201.0,2019-12-18,"(1054.5, 1378.0]",28,55,-27
31202.0,2019-12-18,"(16.639, 358.25]",1,5,-4
31202.0,2019-12-18,"(358.25, 698.5]",8,21,-13
31202.0,2019-12-18,"(698.5, 1038.75]",18,26,-8
31202.0,2019-12-18,"(1038.75, 1379.0]",12,28,-16
31203.0,2019-12-18,"(18.627, 363.25]",2,4,-2
31203.0,2019-12-18,"(363.25, 706.5]",7,23,-16
31203.0,2019-12-18,"(706.5, 1049.75]",16,37,-21
31203.0,2019-12-18,"(1049.75, 1393.0]",22,38,-16
31204.0,2019-12-18,"(38.631, 382.25]",1,2,-1
31204.0,2019-12-18,"(382.25, 724.5]",12,16,-4
31204.0,2019-12-18,"(724.5, 1066.75]",8,24,-16
31204.0,2019-12-18,"(1066.75, 1409.0]",3,5,-2
31205.0,2019-12-18,"(63.783, 369.25]",1,2,-1
31205.0,2019-12-18,"(369.25, 673.5]",12,14,-2
31205.0,2019-12-18,"(673.5, 977.75]",9,18,-9
31205.0,2019-12-18,"(977.75, 1282.0]",3,18,-15
31206.0,2019-12-18,"(391.269, 574.75]",7,9,-2
31206.0,2019-12-18,"(940.25, 1123.0]",4,1,3
31207.0,2019-12-18,"(929.75, 1234.0]",4,1,3
31208.0,2019-12-18,"(422.994, 675.5]",17,21,-4
31208.0,2019-12-18,"(675.5, 927.0]",2,3,-1
31208.0,2019-12-18,"(1178.5, 1430.0]",1,4,-3
31209.0,2019-12-18,"(689.25, 823.5]",2,1,1
31209.0,2019-12-18,"(823.5, 957.75]",3,3,0
31209.0,2019-12-18,"(957.75, 1092.0]",4,3,1
31211.0,2019-12-18,"(531.163, 741.25]",9,11,-2
31211.0,2019-12-18,"(741.25, 950.5]",3,4,-1
31211.0,2019-12-18,"(950.5, 1159.75]",6,15,-9
31211.0,2019-12-18,"(1159.75, 1369.0]",2,5,-3
31212.0,2019-12-18,"(60.649, 399.75]",3,6,-3
31212.0,2019-12-18,"(399.75, 737.5]",34,48,-14
31212.0,2019-12-18,"(737.5, 1075.25]",14,25,-11
31212.0,2019-12-18,"(1075.25, 1413.0]",9,21,-12
31213.0,2019-12-18,"(452.212, 650.0]",32,42,-10
31213.0,2019-12-18,"(650.0, 847.0]",4,8,-4
31213.0,2019-12-18,"(847.0, 1044.0]",6,12,-6
31213.0,2019-12-18,"(1044.0, 1241.0]",8,20,-12
31214.0,2019-12-18,"(112.751, 426.25]",1,5,-4
31214.0,2019-12-18,"(426.25, 738.5]",12,40,-28
31214.0,2019-12-18,"(738.5, 1050.75]",13,31,-18
31214.0,2019-12-18,"(1050.75, 1363.0]",22,31,-9
31215.0,2019-12-18,"(406.018, 652.5]",23,25,-2
31215.0,2019-12-18,"(652.5, 898.0]",3,4,-1
31215.0,2019-12-18,"(898.0, 1143.5]",12,22,-10
31215.0,2019-12-18,"(1143.5, 1389.0]",1,8,-7
31216.0,2019-12-18,"(447.132, 665.0]",23,26,-3
31216.0,2019-12-18,"(665.0, 882.0]",3,6,-3
31216.0,2019-12-18,"(882.0, 1099.0]",4,12,-8
31216.0,2019-12-18,"(1099.0, 1316.0]",4,11,-7
31217.0,2019-12-18,"(324.129, 542.75]",10,14,-4
31217.0,2019-12-18,"(542.75, 760.5]",10,16,-6
31217.0,2019-12-18,"(760.5, 978.25]",1,6,-5
31217.0,2019-12-18,"(978.25, 1196.0]",3,9,-6
31218.0,2019-12-18,"(386.291, 564.25]",13,24,-11
31218.0,2019-12-18,"(741.5, 918.75]",2,6,-4
31218.0,2019-12-18,"(918.75, 1096.0]",8,17,-9
31219.0,2019-12-18,"(440.331, 608.25]",12,13,-1
31219.0,2019-12-18,"(608.25, 775.5]",1,1,0
31219.0,2019-12-18,"(775.5, 942.75]",1,2,-1
31219.0,2019-12-18,"(942.75, 1110.0]",1,9,-8
31220.0,2019-12-18,"(280.286, 459.5]",4,5,-1
31220.0,2019-12-18,"(459.5, 638.0]",9,13,-4
31220.0,2019-12-18,"(638.0, 816.5]",6,8,-2
31220.0,2019-12-18,"(816.5, 995.0]",5,15,-10
31221.0,2019-12-18,"(382.98, 639.0]",31,33,-2
31221.0,2019-12-18,"(639.0, 894.0]",18,28,-10
31221.0,2019-12-18,"(894.0, 1149.0]",5,22,-17
31221.0,2019-12-18,"(1149.0, 1404.0]",5,10,-5
31222.0,2019-12-18,"(413.202, 613.5]",14,15,-1
31222.0,2019-12-18,"(613.5, 813.0]",2,5,-3
31222.0,2019-12-18,"(813.0, 1012.5]",2,4,-2
31222.0,2019-12-18,"(1012.5, 1212.0]",7,17,-10
31223.0,2019-12-18,"(46.638, 388.5]",1,2,-1
31223.0,2019-12-18,"(388.5, 729.0]",12,41,-29
31223.0,2019-12-18,"(729.0, 1069.5]",6,16,-10
31223.0,2019-12-18,"(1069.5, 1410.0]",8,17,-9
31224.0,2019-12-18,"(386.126, 605.5]",11,12,-1
31224.0,2019-12-18,"(605.5, 824.0]",5,8,-3
31224.0,2019-12-18,"(824.0, 1042.5]",7,14,-7
31224.0,2019-12-18,"(1042.5, 1261.0]",4,10,-6
31225.0,2019-12-18,"(350.936, 618.0]",8,12,-4
31225.0,2019-12-18,"(618.0, 884.0]",3,7,-4
31225.0,2019-12-18,"(884.0, 1150.0]",5,11,-6
31225.0,2019-12-18,"(1150.0, 1416.0]",3,6,-3
31226.0,2019-12-18,"(458.261, 643.75]",2,5,-3
31226.0,2019-12-18,"(643.75, 828.5]",1,1,0
31226.0,2019-12-18,"(828.5, 1013.25]",1,2,-1
31226.0,2019-12-18,"(1013.25, 1198.0]",3,8,-5
31227.0,2019-12-18,"(307.145, 521.75]",14,15,-1
31227.0,2019-12-18,"(521.75, 735.5]",25,32,-7
31227.0,2019-12-18,"(735.5, 949.25]",8,15,-7
31227.0,2019-12-18,"(949.25, 1163.0]",5,17,-12
31228.0,2019-12-18,"(49.741, 365.75]",3,3,0
31228.0,2019-12-18,"(365.75, 680.5]",26,36,-10
31228.0,2019-12-18,"(680.5, 995.25]",19,37,-18
31228.0,2019-12-18,"(995.25, 1310.0]",18,32,-14
31229.0,2019-12-18,"(354.25, 691.5]",18,3,15
31229.0,2019-12-18,"(691.5, 1028.75]",23,77,-54
31229.0,2019-12-18,"(1028.75, 1366.0]",19,48,-29
31230.0,2019-12-18,"(366.135, 583.25]",47,58,-11
31230.0,2019-12-18,"(583.25, 799.5]",11,17,-6
31230.0,2019-12-18,"(799.5, 1015.75]",15,27,-12
31230.0,2019-12-18,"(1015.75, 1232.0]",10,32,-22
31231.0,2019-12-18,"(410.295, 587.25]",17,22,-5
31231.0,2019-12-18,"(587.25, 763.5]",5,10,-5
31231.0,2019-12-18,"(763.5, 939.75]",5,11,-6
31231.0,2019-12-18,"(939.75, 1116.0]",5,17,-12
31232.0,2019-12-18,"(290.997, 542.75]",9,15,-6
31232.0,2019-12-18,"(542.75, 793.5]",11,15,-4
31232.0,2019-12-18,"(793.5, 1044.25]",11,16,-5
31232.0,2019-12-18,"(1044.25, 1295.0]",14,22,-8
31233.0,2019-12-18,"(364.93, 633.5]",32,36,-4
31233.0,2019-12-18,"(633.5, 901.0]",15,21,-6
31233.0,2019-12-18,"(901.0, 1168.5]",14,29,-15
31233.0,2019-12-18,"(1168.5, 1436.0]",1,4,-3
31234.0,2019-12-18,"(385.122, 605.5]",12,29,-17
31234.0,2019-12-18,"(605.5, 825.0]",4,7,-3
31234.0,2019-12-18,"(825.0, 1044.5]",11,17,-6
31234.0,2019-12-18,"(1044.5, 1264.0]",9,16,-7
31235.0,2019-12-18,"(473.426, 617.5]",5,5,0
31235.0,2019-12-18,"(617.5, 761.0]",1,1,0
31235.0,2019-12-18,"(761.0, 904.5]",3,3,0
31235.0,2019-12-18,"(904.5, 1048.0]",1,2,-1
31236.0,2019-12-18,"(512.323, 682.25]",9,9,0
31236.0,2019-12-18,"(682.25, 851.5]",4,10,-6
31236.0,2019-12-18,"(851.5, 1020.75]",5,10,-5
31236.0,2019-12-18,"(1020.75, 1190.0]",3,11,-8
31237.0,2019-12-18,"(372.984, 628.0]",4,13,-9
31237.0,2019-12-18,"(628.0, 882.0]",8,12,-4
31237.0,2019-12-18,"(882.0, 1136.0]",14,22,-8
31237.0,2019-12-18,"(1136.0, 1390.0]",3,7,-4
31238.0,2019-12-18,"(52.773, 360.75]",1,1,0
31238.0,2019-12-18,"(360.75, 667.5]",14,16,-2
31238.0,2019-12-18,"(667.5, 974.25]",11,24,-13
31238.0,2019-12-18,"(974.25, 1281.0]",6,30,-24
31239.0,2019-12-18,"(383.076, 615.0]",26,31,-5
31239.0,2019-12-18,"(615.0, 846.0]",9,12,-3
31239.0,2019-12-18,"(846.0, 1077.0]",8,15,-7
31239.0,2019-12-18,"(1077.0, 1308.0]",1,14,-13
31240.0,2019-12-18,"(875.25, 1011.0]",4,1,3
31241.0,2019-12-18,"(186.796, 489.0]",3,8,-5
31241.0,2019-12-18,"(489.0, 790.0]",27,52,-25
31241.0,2019-12-18,"(790.0, 1091.0]",9,29,-20
31241.0,2019-12-18,"(1091.0, 1392.0]",6,15,-9
31242.0,2019-12-18,"(419.996, 672.0]",27,29,-2
31242.0,2019-12-18,"(672.0, 923.0]",8,16,-8
31242.0,2019-12-18,"(923.0, 1174.0]",4,22,-18
31243.0,2019-12-18,"(375.021, 620.75]",24,29,-5
31243.0,2019-12-18,"(620.75, 865.5]",11,14,-3
31243.0,2019-12-18,"(865.5, 1110.25]",4,23,-19
31243.0,2019-12-18,"(1110.25, 1355.0]",2,5,-3
31244.0,2019-12-18,"(339.25, 620.5]",18,2,16
31244.0,2019-12-18,"(620.5, 901.75]",1,28,-27
31244.0,2019-12-18,"(901.75, 1183.0]",12,8,4
31245.0,2019-12-18,"(361.968, 621.0]",14,23,-9
31245.0,2019-12-18,"(621.0, 879.0]",4,8,-4
31245.0,2019-12-18,"(879.0, 1137.0]",7,15,-8
31245.0,2019-12-18,"(1137.0, 1395.0]",2,5,-3
31246.0,2019-12-18,"(158.887, 438.25]",3,3,0
31246.0,2019-12-18,"(438.25, 716.5]",18,24,-6
31246.0,2019-12-18,"(716.5, 994.75]",6,16,-10
31246.0,2019-12-18,"(994.75, 1273.0]",20,33,-13
31247.0,2019-12-18,"(405.318, 576.5]",11,20,-9
31247.0,2019-12-18,"(576.5, 747.0]",7,11,-4
31247.0,2019-12-18,"(917.5, 1088.0]",9,4,5
31248.0,2019-12-18,"(356.268, 540.0]",11,17,-6
31248.0,2019-12-18,"(540.0, 723.0]",1,4,-3
31248.0,2019-12-18,"(723.0, 906.0]",6,7,-1
31248.0,2019-12-18,"(906.0, 1089.0]",6,11,-5
31249.0,2019-12-18,"(431.321, 601.75]",7,12,-5
31249.0,2019-12-18,"(601.75, 771.5]",2,4,-2
31249.0,2019-12-18,"(771.5, 941.25]",3,6,-3
31249.0,2019-12-18,"(941.25, 1111.0]",3,6,-3
31250.0,2019-12-18,"(426.276, 608.0]",14,20,-6
31250.0,2019-12-18,"(608.0, 789.0]",7,11,-4
31250.0,2019-12-18,"(789.0, 970.0]",5,10,-5
31250.0,2019-12-18,"(970.0, 1151.0]",2,16,-14
31251.0,2019-12-18,"(33.652, 372.0]",1,2,-1
31251.0,2019-12-18,"(372.0, 709.0]",14,26,-12
31251.0,2019-12-18,"(709.0, 1046.0]",3,8,-5
31251.0,2019-12-18,"(1046.0, 1383.0]",16,31,-15
31252.0,2019-12-18,"(391.123, 611.25]",19,20,-1
31252.0,2019-12-18,"(611.25, 830.5]",3,8,-5
31252.0,2019-12-18,"(830.5, 1049.75]",1,10,-9
31252.0,2019-12-18,"(1049.75, 1269.0]",3,7,-4
31253.0,2019-12-18,"(420.115, 642.25]",18,18,0
31253.0,2019-12-18,"(642.25, 863.5]",5,14,-9
31253.0,2019-12-18,"(863.5, 1084.75]",5,17,-12
31253.0,2019-12-18,"(1084.75, 1306.0]",2,6,-4
31254.0,2019-12-18,"(432.16, 643.0]",15,18,-3
31254.0,2019-12-18,"(643.0, 853.0]",8,15,-7
31254.0,2019-12-18,"(853.0, 1063.0]",3,12,-9
31254.0,2019-12-18,"(1063.0, 1273.0]",5,9,-4
31255.0,2019-12-18,"(367.157, 578.75]",15,21,-6
31255.0,2019-12-18,"(578.75, 789.5]",4,9,-5
31255.0,2019-12-18,"(789.5, 1000.25]",5,12,-7
31255.0,2019-12-18,"(1000.25, 1211.0]",2,7,-5
31256.0,2019-12-18,"(281.0, 532.0]",8,9,-1
31256.0,2019-12-18,"(532.0, 782.0]",9,13,-4
31256.0,2019-12-18,"(782.0, 1032.0]",4,8,-4
31256.0,2019-12-18,"(1032.0, 1282.0]",5,13,-8
31257.0,2019-12-18,"(340.971, 599.25]",19,32,-13
31257.0,2019-12-18,"(599.25, 856.5]",7,15,-8
31257.0,2019-12-18,"(856.5, 1113.75]",14,28,-14
31257.0,2019-12-18,"(1113.75, 1371.0]",3,10,-7
31258.0,2019-12-18,"(77.862, 363.5]",3,4,-1
31258.0,2019-12-18,"(363.5, 648.0]",13,30,-17
31258.0,2019-12-18,"(648.0, 932.5]",3,5,-2
31258.0,2019-12-18,"(932.5, 1217.0]",7,11,-4
31259.0,2019-12-18,"(454.333, 621.75]",10,10,0
31259.0,2019-12-18,"(621.75, 788.5]",2,4,-2
31259.0,2019-12-18,"(788.5, 955.25]",1,2,-1
31260.0,2019-12-18,"(399.979, 656.25]",12,18,-6
31260.0,2019-12-18,"(656.25, 911.5]",3,6,-3
31260.0,2019-12-18,"(911.5, 1166.75]",6,21,-15
31260.0,2019-12-18,"(1166.75, 1422.0]",2,5,-3
31261.0,2019-12-18,"(424.206, 623.5]",7,7,0
31261.0,2019-12-18,"(822.0, 1020.5]",1,5,-4
31262.0,2019-12-18,"(411.115, 633.25]",6,6,0
31262.0,2019-12-18,"(633.25, 854.5]",5,7,-2
31262.0,2019-12-18,"(854.5, 1075.75]",9,13,-4
31262.0,2019-12-18,"(1075.75, 1297.0]",2,11,-9
31263.0,2019-12-18,"(365.962, 626.5]",21,30,-9
31263.0,2019-12-18,"(626.5, 886.0]",5,11,-6
31263.0,2019-12-18,"(886.0, 1145.5]",5,24,-19
31263.0,2019-12-18,"(1145.5, 1405.0]",5,13,-8
31264.0,2019-12-18,"(453.073, 685.75]",10,14,-4
31264.0,2019-12-18,"(685.75, 917.5]",12,20,-8
31264.0,2019-12-18,"(917.5, 1149.25]",5,14,-9
31264.0,2019-12-18,"(1149.25, 1381.0]",2,3,-1
31265.0,2019-12-18,"(16.666, 351.5]",1,4,-3
31265.0,2019-12-18,"(351.5, 685.0]",20,37,-17
31265.0,2019-12-18,"(685.0, 1018.5]",6,14,-8
31265.0,2019-12-18,"(1018.5, 1352.0]",22,43,-21
31266.0,2019-12-18,"(363.75, 682.5]",8,7,1
31266.0,2019-12-18,"(682.5, 1001.25]",12,27,-15
31266.0,2019-12-18,"(1001.25, 1320.0]",20,28,-8
31267.0,2019-12-18,"(346.25, 661.5]",19,1,18
31267.0,2019-12-18,"(661.5, 976.75]",14,40,-26
31267.0,2019-12-18,"(976.75, 1292.0]",8,23,-15
31268.0,2019-12-18,"(334.956, 597.0]",11,34,-23
31268.0,2019-12-18,"(597.0, 858.0]",3,10,-7
31268.0,2019-12-18,"(858.0, 1119.0]",12,17,-5
31268.0,2019-12-18,"(1119.0, 1380.0]",11,19,-8
31269.0,2019-12-18,"(348.972, 607.0]",11,18,-7
31269.0,2019-12-18,"(607.0, 864.0]",5,11,-6
31269.0,2019-12-18,"(864.0, 1121.0]",6,16,-10
31269.0,2019-12-18,"(1121.0, 1378.0]",2,3,-1
31270.0,2019-12-18,"(400.24, 591.0]",12,17,-5
31270.0,2019-12-18,"(591.0, 781.0]",7,9,-2
31270.0,2019-12-18,"(781.0, 971.0]",3,9,-6
31270.0,2019-12-18,"(971.0, 1161.0]",6,10,-4
31271.0,2019-12-18,"(378.028, 622.0]",17,23,-6
31271.0,2019-12-18,"(622.0, 865.0]",7,14,-7
31271.0,2019-12-18,"(865.0, 1108.0]",4,16,-12
31271.0,2019-12-18,"(1108.0, 1351.0]",2,4,-2
31272.0,2019-12-18,"(302.971, 561.25]",21,22,-1
31272.0,2019-12-18,"(561.25, 818.5]",4,6,-2
31272.0,2019-12-18,"(818.5, 1075.75]",9,19,-10
31272.0,2019-12-18,"(1075.75, 1333.0]",3,7,-4
31273.0,2019-12-18,"(410.391, 563.25]",3,6,-3
31273.0,2019-12-18,"(867.75, 1020.0]",3,1,2
31274.0,2019-12-18,"(395.155, 607.25]",14,17,-3
31274.0,2019-12-18,"(607.25, 818.5]",5,8,-3
31274.0,2019-12-18,"(818.5, 1029.75]",5,9,-4
31274.0,2019-12-18,"(1029.75, 1241.0]",5,10,-5
31275.0,2019-12-18,"(325.967, 585.25]",9,18,-9
31275.0,2019-12-18,"(585.25, 843.5]",5,11,-6
31275.0,2019-12-18,"(843.5, 1101.75]",14,23,-9
31275.0,2019-12-18,"(1101.75, 1360.0]",4,7,-3
31276.0,2019-12-18,"(427.102, 652.5]",24,28,-4
31276.0,2019-12-18,"(652.5, 877.0]",6,12,-6
31276.0,2019-12-18,"(877.0, 1101.5]",3,15,-12
31276.0,2019-12-18,"(1101.5, 1326.0]",2,12,-10
31277.0,2019-12-18,"(10.721, 331.75]",1,3,-2
31277.0,2019-12-18,"(331.75, 651.5]",33,38,-5
31277.0,2019-12-18,"(651.5, 971.25]",11,20,-9
31277.0,2019-12-18,"(971.25, 1291.0]",4,26,-22
31278.0,2019-12-18,"(397.025, 641.75]",10,37,-27
31278.0,2019-12-18,"(641.75, 885.5]",5,11,-6
31278.0,2019-12-18,"(885.5, 1129.25]",15,17,-2
31278.0,2019-12-18,"(1129.25, 1373.0]",14,17,-3
31279.0,2019-12-18,"(20.834, 313.5]",1,2,-1
31279.0,2019-12-18,"(313.5, 605.0]",19,23,-4
31279.0,2019-12-18,"(605.0, 896.5]",5,11,-6
31279.0,2019-12-18,"(896.5, 1188.0]",11,34,-23
31280.0,2019-12-18,"(30.626, 375.5]",2,4,-2
31280.0,2019-12-18,"(375.5, 719.0]",8,24,-16
31280.0,2019-12-18,"(719.0, 1062.5]",6,10,-4
31280.0,2019-12-18,"(1062.5, 1406.0]",7,9,-2
,,,,2.0,
31001.0,2019-12-19,"(282.75, 565.5]",1,1,0
31001.0,2019-12-19,"(848.25, 1131.0]",2,1,1
31002.0,2019-12-19,"(378.333, 545.75]",3,5,-2
31002.0,2019-12-19,"(545.75, 712.5]",1,2,-1
31002.0,2019-12-19,"(879.25, 1046.0]",2,4,-2
31003.0,2019-12-19,"(476.437, 617.75]",2,4,-2
31003.0,2019-12-19,"(758.5, 899.25]",1,1,0
31003.0,2019-12-19,"(899.25, 1040.0]",3,7,-4
31004.0,2019-12-19,"(955.75, 1103.0]",1,2,-1
31005.0,2019-12-19,"(9.895, 287.25]",1,1,0
31005.0,2019-12-19,"(287.25, 563.5]",3,4,-1
31005.0,2019-12-19,"(563.5, 839.75]",1,1,0
31005.0,2019-12-19,"(839.75, 1116.0]",2,6,-4
31006.0,2019-12-19,"(1112.5, 1113.75]",1,1,0
31007.0,2019-12-19,"(379.013, 626.75]",3,9,-6
31007.0,2019-12-19,"(626.75, 873.5]",2,3,-1
31007.0,2019-12-19,"(873.5, 1120.25]",4,7,-3
31007.0,2019-12-19,"(1120.25, 1367.0]",3,3,0
31009.0,2019-12-19,"(383.074, 615.5]",1,1,0
31009.0,2019-12-19,"(847.0, 1078.5]",2,3,-1
31010.0,2019-12-19,"(831.25, 905.5]",1,1,0
31010.0,2019-12-19,"(979.75, 1054.0]",1,2,-1
31011.0,2019-12-19,"(495.314, 667.5]",2,3,-1
31011.0,2019-12-19,"(1010.5, 1182.0]",1,2,-1
31012.0,2019-12-19,"(381.218, 577.5]",5,6,-1
31012.0,2019-12-19,"(773.0, 968.5]",1,4,-3
31013.0,2019-12-19,"(970.5, 1167.75]",1,2,-1
31013.0,2019-12-19,"(1167.75, 1365.0]",1,2,-1
31014.0,2019-12-19,"(101.724, 422.0]",4,4,0
31014.0,2019-12-19,"(422.0, 741.0]",12,16,-4
31014.0,2019-12-19,"(741.0, 1060.0]",4,6,-2
31014.0,2019-12-19,"(1060.0, 1379.0]",4,10,-6
31015.0,2019-12-19,"(-1.276, 319.0]",2,3,-1
31015.0,2019-12-19,"(319.0, 638.0]",10,12,-2
31015.0,2019-12-19,"(638.0, 957.0]",2,4,-2
31015.0,2019-12-19,"(957.0, 1276.0]",4,7,-3
31016.0,2019-12-19,"(280.25, 468.5]",1,2,-1
31016.0,2019-12-19,"(468.5, 656.0]",3,4,-1
31016.0,2019-12-19,"(656.0, 843.5]",1,2,-1
31016.0,2019-12-19,"(843.5, 1031.0]",3,6,-3
31017.0,2019-12-19,"(370.088, 599.0]",4,7,-3
31017.0,2019-12-19,"(599.0, 827.0]",1,4,-3
31018.0,2019-12-19,"(786.5, 960.25]",1,3,-2
31018.0,2019-12-19,"(960.25, 1134.0]",2,1,1
31019.0,2019-12-19,"(677.75, 894.5]",1,1,0
31019.0,2019-12-19,"(894.5, 1111.25]",1,2,-1
31019.0,2019-12-19,"(1111.25, 1328.0]",4,1,3
31020.0,2019-12-19,"(638.75, 865.5]",1,1,0
31021.0,2019-12-19,"(339.969, 598.75]",2,7,-5
31021.0,2019-12-19,"(598.75, 856.5]",1,2,-1
31022.0,2019-12-19,"(400.045, 639.75]",4,6,-2
31022.0,2019-12-19,"(639.75, 878.5]",1,2,-1
31022.0,2019-12-19,"(878.5, 1117.25]",1,4,-3
31023.0,2019-12-19,"(428.332, 596.0]",1,1,0
31023.0,2019-12-19,"(596.0, 763.0]",1,2,-1
31023.0,2019-12-19,"(930.0, 1097.0]",2,3,-1
31024.0,2019-12-19,"(405.141, 620.75]",6,9,-3
31024.0,2019-12-19,"(620.75, 835.5]",3,4,-1
31024.0,2019-12-19,"(1050.25, 1265.0]",5,6,-1
31025.0,2019-12-19,"(814.67, 897.5]",1,2,-1
31025.0,2019-12-19,"(897.5, 980.0]",1,1,0
31026.0,2019-12-19,"(865.53, 983.5]",1,3,-2
31026.0,2019-12-19,"(983.5, 1101.0]",2,4,-2
31026.0,2019-12-19,"(1101.0, 1218.5]",1,2,-1
31026.0,2019-12-19,"(1218.5, 1336.0]",1,2,-1
,,,,2.0,
31028.0,2019-12-19,"(482.071, 715.25]",1,1,0
31028.0,2019-12-19,"(947.5, 1179.75]",1,1,0
31029.0,2019-12-19,"(716.0, 911.0]",1,6,-5
31029.0,2019-12-19,"(911.0, 1106.0]",2,3,-1
31029.0,2019-12-19,"(1106.0, 1301.0]",2,2,0
31030.0,2019-12-19,"(334.138, 550.5]",1,7,-6
31030.0,2019-12-19,"(766.0, 981.5]",1,2,-1
31030.0,2019-12-19,"(981.5, 1197.0]",3,1,2
31031.0,2019-12-19,"(1003.5, 1152.25]",1,1,0
31031.0,2019-12-19,"(1152.25, 1301.0]",1,3,-2
31032.0,2019-12-19,"(823.0, 889.0]",1,1,0
31033.0,2019-12-19,"(1294.948, 1308.0]",1,1,0
31034.0,2019-12-19,"(555.27, 738.5]",2,5,-3
31034.0,2019-12-19,"(1103.5, 1286.0]",2,1,1
31035.0,2019-12-19,"(811.0, 1015.5]",1,5,-4
31035.0,2019-12-19,"(1015.5, 1220.0]",5,1,4
31036.0,2019-12-19,"(622.5, 827.0]",1,3,-2
31036.0,2019-12-19,"(827.0, 1031.5]",2,3,-1
31036.0,2019-12-19,"(1031.5, 1236.0]",1,4,-3
31037.0,2019-12-19,"(422.168, 631.0]",8,10,-2
31037.0,2019-12-19,"(631.0, 839.0]",4,10,-6
31037.0,2019-12-19,"(839.0, 1047.0]",3,6,-3
31037.0,2019-12-19,"(1047.0, 1255.0]",3,10,-7
31038.0,2019-12-19,"(939.25, 1063.0]",1,1,0
31039.0,2019-12-19,"(72.697, 399.75]",1,2,-1
31039.0,2019-12-19,"(399.75, 725.5]",4,8,-4
31039.0,2019-12-19,"(1051.25, 1377.0]",2,2,0
31040.0,2019-12-19,"(532.469, 665.75]",2,3,-1
31041.0,2019-12-19,"(258.5, 517.0]",1,1,0
31041.0,2019-12-19,"(517.0, 775.5]",1,1,0
31041.0,2019-12-19,"(775.5, 1034.0]",2,1,1
31042.0,2019-12-19,"(376.225, 570.75]",8,9,-1
31042.0,2019-12-19,"(958.25, 1152.0]",5,14,-9
31043.0,2019-12-19,"(517.466, 651.5]",1,1,0
31043.0,2019-12-19,"(785.0, 918.5]",1,1,0
31044.0,2019-12-19,"(503.269, 686.75]",2,3,-1
31044.0,2019-12-19,"(686.75, 869.5]",1,1,0
31044.0,2019-12-19,"(869.5, 1052.25]",1,2,-1
31044.0,2019-12-19,"(1052.25, 1235.0]",1,3,-2
31045.0,2019-12-19,"(533.123, 753.25]",2,3,-1
31045.0,2019-12-19,"(753.25, 972.5]",1,3,-2
31045.0,2019-12-19,"(1191.75, 1411.0]",1,2,-1
31046.0,2019-12-19,"(1172.0, 1430.0]",1,3,-2
31047.0,2019-12-19,"(448.179, 654.25]",7,18,-11
31047.0,2019-12-19,"(654.25, 859.5]",2,5,-3
31047.0,2019-12-19,"(859.5, 1064.75]",2,5,-3
31047.0,2019-12-19,"(1064.75, 1270.0]",4,13,-9
31048.0,2019-12-19,"(302.159, 513.25]",1,2,-1
31048.0,2019-12-19,"(933.75, 1144.0]",1,2,-1
,,,,1.0,
,,,,1.0,
31050.0,2019-12-19,"(1114.0, 1361.0]",2,1,1
31051.0,2019-12-19,"(826.5, 1088.75]",1,5,-4
31051.0,2019-12-19,"(1088.75, 1351.0]",3,1,2
31052.0,2019-12-19,"(283.75, 567.5]",2,1,1
31052.0,2019-12-19,"(851.25, 1135.0]",2,2,0
31053.0,2019-12-19,"(134.063, 369.25]",1,1,0
31053.0,2019-12-19,"(837.75, 1072.0]",1,1,0
,,,,2.0,
31055.0,2019-12-19,"(769.5, 1026.0]",1,1,0
31056.0,2019-12-19,"(876.5, 1017.25]",1,1,0
31056.0,2019-12-19,"(1017.25, 1158.0]",1,1,0
,,,,1.0,
,,,,1.0,
31058.0,2019-12-19,"(766.564, 876.0]",1,1,0
31058.0,2019-12-19,"(985.0, 1094.0]",1,1,0
31058.0,2019-12-19,"(1094.0, 1203.0]",1,2,-1
,,,,2.0,
31060.0,2019-12-19,"(807.0, 1076.0]",1,1,0
31061.0,2019-12-19,"(529.172, 737.0]",1,1,0
31061.0,2019-12-19,"(1151.0, 1358.0]",1,2,-1
,,,,2.0,
31063.0,2019-12-19,"(471.5, 707.25]",1,1,0
31063.0,2019-12-19,"(707.25, 943.0]",1,1,0
31064.0,2019-12-19,"(554.5, 823.25]",2,1,1
31064.0,2019-12-19,"(823.25, 1092.0]",3,4,-1
31065.0,2019-12-19,"(929.0, 970.0]",1,1,0
31066.0,2019-12-19,"(126.231, 319.25]",1,2,-1
31066.0,2019-12-19,"(703.75, 896.0]",2,3,-1
31067.0,2019-12-19,"(1098.0, 1109.0]",2,1,1
,,,,1.0,
,,,,1.0,
31069.0,2019-12-19,"(618.0, 798.0]",1,2,-1
31069.0,2019-12-19,"(798.0, 978.0]",2,1,1
31069.0,2019-12-19,"(978.0, 1158.0]",1,2,-1
31070.0,2019-12-19,"(831.0, 978.0]",1,1,0
31071.0,2019-12-19,"(1001.25, 1085.0]",2,1,1
,,,,1.0,
,,,,1.0,
31073.0,2019-12-19,"(493.451, 631.25]",1,1,0
31073.0,2019-12-19,"(768.5, 905.75]",1,2,-1
31073.0,2019-12-19,"(905.75, 1043.0]",1,1,0
,,,,1.0,
,,,,1.0,
31075.0,2019-12-19,"(972.25, 1117.0]",1,1,0
,,,,2.0,
31077.0,2019-12-19,"(822.0, 999.0]",1,1,0
31077.0,2019-12-19,"(999.0, 1176.0]",2,1,1
31078.0,2019-12-19,"(450.515, 572.25]",5,5,0
31078.0,2019-12-19,"(693.5, 814.75]",1,4,-3
31079.0,2019-12-19,"(782.0, 989.5]",1,5,-4
31079.0,2019-12-19,"(989.5, 1197.0]",3,1,2
31080.0,2019-12-19,"(610.25, 878.5]",1,2,-1
31080.0,2019-12-19,"(878.5, 1146.75]",1,1,0
31080.0,2019-12-19,"(1146.75, 1415.0]",3,2,1
31081.0,2019-12-19,"(431.309, 604.75]",2,3,-1
31081.0,2019-12-19,"(950.25, 1123.0]",1,4,-3
31082.0,2019-12-19,"(1152.5, 1282.25]",2,1,1
31083.0,2019-12-19,"(696.75, 929.0]",1,1,0
31084.0,2019-12-19,"(576.75, 853.5]",3,1,2
31084.0,2019-12-19,"(853.5, 1130.25]",1,3,-2
31084.0,2019-12-19,"(1130.25, 1407.0]",1,4,-3
31085.0,2019-12-19,"(403.141, 618.75]",2,4,-2
31085.0,2019-12-19,"(833.5, 1048.25]",1,1,0
31085.0,2019-12-19,"(1048.25, 1263.0]",1,2,-1
31086.0,2019-12-19,"(788.75, 912.0]",2,2,0
31087.0,2019-12-19,"(929.5, 1164.75]",3,2,1
31087.0,2019-12-19,"(1164.75, 1400.0]",1,3,-2
,,,,1.0,
,,,,1.0,
,,,,1.0,
31089.0,2019-12-19,"(452.288, 631.0]",6,9,-3
31089.0,2019-12-19,"(631.0, 809.0]",2,4,-2
31089.0,2019-12-19,"(809.0, 987.0]",2,6,-4
31090.0,2019-12-19,"(973.0, 1153.0]",1,1,0
31091.0,2019-12-19,"(953.75, 1127.0]",5,4,1
31092.0,2019-12-19,"(647.0, 800.0]",2,3,-1
31092.0,2019-12-19,"(953.0, 1106.0]",2,3,-1
,,,,1.0,
,,,,2.0,
31094.0,2019-12-19,"(940.5, 1254.0]",2,1,1
,,,,1.0,
,,,,1.0,
,,,,2.0,
31097.0,2019-12-19,"(478.258, 664.5]",5,5,0
31097.0,2019-12-19,"(664.5, 850.0]",1,1,0
31097.0,2019-12-19,"(1035.5, 1221.0]",2,1,1
31098.0,2019-12-19,"(437.089, 665.75]",4,11,-7
31098.0,2019-12-19,"(893.5, 1121.25]",6,9,-3
31098.0,2019-12-19,"(1121.25, 1349.0]",1,2,-1
31099.0,2019-12-19,"(842.5, 1036.75]",1,1,0
31099.0,2019-12-19,"(1036.75, 1231.0]",1,1,0
31100.0,2019-12-19,"(358.186, 562.5]",8,10,-2
31100.0,2019-12-19,"(562.5, 766.0]",6,6,0
31100.0,2019-12-19,"(766.0, 969.5]",3,5,-2
31100.0,2019-12-19,"(969.5, 1173.0]",3,15,-12
31101.0,2019-12-19,"(22.596, 375.0]",2,2,0
31101.0,2019-12-19,"(375.0, 726.0]",13,32,-19
31101.0,2019-12-19,"(726.0, 1077.0]",19,33,-14
31101.0,2019-12-19,"(1077.0, 1428.0]",16,27,-11
31102.0,2019-12-19,"(33.676, 366.0]",2,3,-1
31102.0,2019-12-19,"(366.0, 697.0]",1,22,-21
31102.0,2019-12-19,"(1028.0, 1359.0]",9,4,5
31103.0,2019-12-19,"(601.0, 851.0]",1,21,-20
31103.0,2019-12-19,"(851.0, 1101.0]",5,3,2
31103.0,2019-12-19,"(1101.0, 1351.0]",3,13,-10
31104.0,2019-12-19,"(412.978, 669.5]",2,12,-10
31104.0,2019-12-19,"(669.5, 925.0]",4,9,-5
31104.0,2019-12-19,"(925.0, 1180.5]",17,27,-10
31104.0,2019-12-19,"(1180.5, 1436.0]",3,12,-9
31105.0,2019-12-19,"(340.018, 586.5]",1,8,-7
31105.0,2019-12-19,"(832.0, 1077.5]",6,1,5
31106.0,2019-12-19,"(467.275, 649.25]",1,4,-3
31106.0,2019-12-19,"(830.5, 1011.75]",2,1,1
31106.0,2019-12-19,"(1011.75, 1193.0]",1,2,-1
31107.0,2019-12-19,"(320.984, 576.0]",5,26,-21
31107.0,2019-12-19,"(576.0, 830.0]",1,10,-9
31107.0,2019-12-19,"(830.0, 1084.0]",13,22,-9
31107.0,2019-12-19,"(1084.0, 1338.0]",8,12,-4
31108.0,2019-12-19,"(366.25, 675.5]",7,2,5
31108.0,2019-12-19,"(675.5, 984.75]",3,23,-20
31108.0,2019-12-19,"(984.75, 1294.0]",21,10,11
31109.0,2019-12-19,"(328.91, 602.5]",8,20,-12
31109.0,2019-12-19,"(602.5, 875.0]",4,9,-5
31109.0,2019-12-19,"(875.0, 1147.5]",12,22,-10
31109.0,2019-12-19,"(1147.5, 1420.0]",5,9,-4
31110.0,2019-12-19,"(337.954, 600.5]",11,19,-8
31110.0,2019-12-19,"(600.5, 862.0]",7,14,-7
31110.0,2019-12-19,"(862.0, 1123.5]",11,25,-14
31110.0,2019-12-19,"(1123.5, 1385.0]",4,10,-6
31111.0,2019-12-19,"(388.5, 728.0]",3,1,2
31111.0,2019-12-19,"(728.0, 1067.5]",6,13,-7
31111.0,2019-12-19,"(1067.5, 1407.0]",11,9,2
31112.0,2019-12-19,"(355.075, 587.25]",1,4,-3
31112.0,2019-12-19,"(587.25, 818.5]",1,2,-1
31112.0,2019-12-19,"(1049.75, 1281.0]",2,3,-1
31113.0,2019-12-19,"(345.75, 676.5]",4,1,3
31113.0,2019-12-19,"(676.5, 1007.25]",2,21,-19
31113.0,2019-12-19,"(1007.25, 1338.0]",6,8,-2
31114.0,2019-12-19,"(23.607, 373.25]",1,3,-2
31114.0,2019-12-19,"(373.25, 721.5]",2,19,-17
31114.0,2019-12-19,"(721.5, 1069.75]",11,15,-4
31114.0,2019-12-19,"(1069.75, 1418.0]",17,31,-14
31115.0,2019-12-19,"(246.844, 537.0]",1,9,-8
31115.0,2019-12-19,"(537.0, 826.0]",1,10,-9
31115.0,2019-12-19,"(826.0, 1115.0]",7,12,-5
31115.0,2019-12-19,"(1115.0, 1404.0]",6,7,-1
31116.0,2019-12-19,"(363.019, 609.25]",3,19,-16
31116.0,2019-12-19,"(609.25, 854.5]",11,16,-5
31116.0,2019-12-19,"(854.5, 1099.75]",9,13,-4
31116.0,2019-12-19,"(1099.75, 1345.0]",5,6,-1
31117.0,2019-12-19,"(308.903, 584.25]",3,20,-17
31117.0,2019-12-19,"(584.25, 858.5]",1,4,-3
31117.0,2019-12-19,"(858.5, 1132.75]",5,14,-9
31117.0,2019-12-19,"(1132.75, 1407.0]",9,15,-6
31118.0,2019-12-19,"(449.049, 687.75]",1,13,-12
31118.0,2019-12-19,"(687.75, 925.5]",2,3,-1
31118.0,2019-12-19,"(925.5, 1163.25]",7,8,-1
31118.0,2019-12-19,"(1163.25, 1401.0]",2,2,0
31119.0,2019-12-19,"(90.701, 416.75]",7,12,-5
31119.0,2019-12-19,"(416.75, 741.5]",7,20,-13
31119.0,2019-12-19,"(741.5, 1066.25]",8,16,-8
31119.0,2019-12-19,"(1066.25, 1391.0]",9,19,-10
31120.0,2019-12-19,"(408.066, 642.5]",3,12,-9
31120.0,2019-12-19,"(642.5, 876.0]",1,3,-2
31120.0,2019-12-19,"(876.0, 1109.5]",4,5,-1
31120.0,2019-12-19,"(1109.5, 1343.0]",6,9,-3
31121.0,2019-12-19,"(392.06, 628.0]",13,19,-6
31121.0,2019-12-19,"(863.0, 1098.0]",6,2,4
31121.0,2019-12-19,"(1098.0, 1333.0]",5,12,-7
31122.0,2019-12-19,"(643.75, 870.5]",2,7,-5
31122.0,2019-12-19,"(870.5, 1097.25]",3,5,-2
31122.0,2019-12-19,"(1097.25, 1324.0]",4,6,-2
31123.0,2019-12-19,"(362.968, 622.0]",3,21,-18
31123.0,2019-12-19,"(880.0, 1138.0]",7,3,4
31123.0,2019-12-19,"(1138.0, 1396.0]",3,12,-9
31124.0,2019-12-19,"(300.883, 581.25]",20,32,-12
31124.0,2019-12-19,"(581.25, 860.5]",6,16,-10
31124.0,2019-12-19,"(860.5, 1139.75]",15,41,-26
31124.0,2019-12-19,"(1139.75, 1419.0]",8,19,-11
31125.0,2019-12-19,"(35.74, 352.0]",1,1,0
31125.0,2019-12-19,"(352.0, 667.0]",5,26,-21
31125.0,2019-12-19,"(667.0, 982.0]",7,13,-6
31125.0,2019-12-19,"(982.0, 1297.0]",20,30,-10
31126.0,2019-12-19,"(295.927, 565.25]",2,16,-14
31126.0,2019-12-19,"(565.25, 833.5]",2,10,-8
31126.0,2019-12-19,"(833.5, 1101.75]",9,16,-7
31126.0,2019-12-19,"(1101.75, 1370.0]",16,18,-2
,,,,2.0,
31128.0,2019-12-19,"(58.632, 402.0]",3,5,-2
31128.0,2019-12-19,"(402.0, 744.0]",18,28,-10
31128.0,2019-12-19,"(744.0, 1086.0]",16,22,-6
31128.0,2019-12-19,"(1086.0, 1428.0]",5,12,-7
31129.0,2019-12-19,"(466.058, 702.5]",4,4,0
31129.0,2019-12-19,"(702.5, 938.0]",4,8,-4
31129.0,2019-12-19,"(938.0, 1173.5]",8,13,-5
31130.0,2019-12-19,"(344.952, 608.0]",3,10,-7
31130.0,2019-12-19,"(608.0, 870.0]",3,8,-5
31130.0,2019-12-19,"(870.0, 1132.0]",8,12,-4
31130.0,2019-12-19,"(1132.0, 1394.0]",3,5,-2
31131.0,2019-12-19,"(419.052, 657.0]",1,10,-9
31131.0,2019-12-19,"(894.0, 1131.0]",4,6,-2
31131.0,2019-12-19,"(1131.0, 1368.0]",2,4,-2
31200.0,2019-12-19,"(335.901, 611.75]",25,35,-10
31200.0,2019-12-19,"(611.75, 886.5]",12,19,-7
31200.0,2019-12-19,"(886.5, 1161.25]",18,37,-19
31200.0,2019-12-19,"(1161.25, 1436.0]",8,17,-9
31201.0,2019-12-19,"(32.64, 374.0]",3,5,-2
31201.0,2019-12-19,"(374.0, 714.0]",21,37,-16
31201.0,2019-12-19,"(714.0, 1054.0]",11,20,-9
31201.0,2019-12-19,"(1054.0, 1394.0]",14,32,-18
31202.0,2019-12-19,"(35.653, 373.75]",1,3,-2
31202.0,2019-12-19,"(373.75, 710.5]",6,16,-10
31202.0,2019-12-19,"(710.5, 1047.25]",17,27,-10
31202.0,2019-12-19,"(1047.25, 1384.0]",16,25,-9
31203.0,2019-12-19,"(361.75, 709.5]",9,1,8
31203.0,2019-12-19,"(709.5, 1057.25]",19,21,-2
31203.0,2019-12-19,"(1057.25, 1405.0]",17,31,-14
31204.0,2019-12-19,"(354.5, 672.0]",9,1,8
31204.0,2019-12-19,"(989.5, 1307.0]",3,10,-7
31205.0,2019-12-19,"(417.153, 629.75]",8,11,-3
31205.0,2019-12-19,"(629.75, 841.5]",3,5,-2
31205.0,2019-12-19,"(841.5, 1053.25]",6,10,-4
31205.0,2019-12-19,"(1053.25, 1265.0]",5,12,-7
31206.0,2019-12-19,"(460.412, 608.0]",3,3,0
31206.0,2019-12-19,"(608.0, 755.0]",1,6,-5
31206.0,2019-12-19,"(902.0, 1049.0]",3,7,-4
31207.0,2019-12-19,"(797.5, 1020.75]",2,3,-1
31207.0,2019-12-19,"(1020.75, 1244.0]",1,2,-1
31208.0,2019-12-19,"(386.169, 594.75]",7,9,-2
31208.0,2019-12-19,"(594.75, 802.5]",3,4,-1
31208.0,2019-12-19,"(802.5, 1010.25]",3,9,-6
31209.0,2019-12-19,"(908.25, 1211.0]",4,1,3
31211.0,2019-12-19,"(490.121, 710.75]",6,8,-2
31211.0,2019-12-19,"(710.75, 930.5]",2,5,-3
31211.0,2019-12-19,"(930.5, 1150.25]",7,9,-2
31211.0,2019-12-19,"(1150.25, 1370.0]",6,10,-4
31212.0,2019-12-19,"(337.955, 600.25]",19,23,-4
31212.0,2019-12-19,"(600.25, 861.5]",11,19,-8
31212.0,2019-12-19,"(861.5, 1122.75]",5,14,-9
31212.0,2019-12-19,"(1122.75, 1384.0]",6,7,-1
31213.0,2019-12-19,"(415.0, 666.0]",25,39,-14
31213.0,2019-12-19,"(666.0, 916.0]",1,3,-2
31213.0,2019-12-19,"(916.0, 1166.0]",9,20,-11
31213.0,2019-12-19,"(1166.0, 1416.0]",5,11,-6
31214.0,2019-12-19,"(14.814, 312.5]",1,1,0
31214.0,2019-12-19,"(312.5, 609.0]",6,28,-22
31214.0,2019-12-19,"(609.0, 905.5]",6,13,-7
31214.0,2019-12-19,"(905.5, 1202.0]",23,36,-13
31215.0,2019-12-19,"(445.024, 690.0]",19,21,-2
31215.0,2019-12-19,"(690.0, 934.0]",1,1,0
31215.0,2019-12-19,"(934.0, 1178.0]",6,11,-5
31215.0,2019-12-19,"(1178.0, 1422.0]",1,2,-1
31216.0,2019-12-19,"(320.971, 579.25]",16,18,-2
31216.0,2019-12-19,"(579.25, 836.5]",7,11,-4
31216.0,2019-12-19,"(836.5, 1093.75]",4,10,-6
31217.0,2019-12-19,"(324.213, 521.75]",8,9,-1
31217.0,2019-12-19,"(521.75, 718.5]",3,3,0
31217.0,2019-12-19,"(915.25, 1112.0]",2,3,-1
31218.0,2019-12-19,"(321.19, 524.5]",4,13,-9
31218.0,2019-12-19,"(524.5, 727.0]",4,8,-4
31218.0,2019-12-19,"(727.0, 929.5]",3,4,-1
31218.0,2019-12-19,"(929.5, 1132.0]",10,19,-9
31219.0,2019-12-19,"(363.252, 551.0]",9,9,0
31219.0,2019-12-19,"(551.0, 738.0]",7,7,0
31219.0,2019-12-19,"(738.0, 925.0]",2,3,-1
31219.0,2019-12-19,"(925.0, 1112.0]",4,10,-6
31220.0,2019-12-19,"(276.17, 484.5]",6,7,-1
31220.0,2019-12-19,"(484.5, 692.0]",11,13,-2
31220.0,2019-12-19,"(692.0, 899.5]",3,7,-4
31220.0,2019-12-19,"(899.5, 1107.0]",1,15,-14
31221.0,2019-12-19,"(384.039, 625.25]",24,28,-4
31221.0,2019-12-19,"(625.25, 865.5]",7,18,-11
31221.0,2019-12-19,"(865.5, 1105.75]",10,24,-14
31221.0,2019-12-19,"(1105.75, 1346.0]",2,5,-3
31222.0,2019-12-19,"(377.75, 729.5]",9,2,7
31222.0,2019-12-19,"(729.5, 1081.25]",2,12,-10
31222.0,2019-12-19,"(1081.25, 1433.0]",1,14,-13
31223.0,2019-12-19,"(34.616, 382.0]",3,4,-1
31223.0,2019-12-19,"(382.0, 728.0]",11,35,-24
31223.0,2019-12-19,"(728.0, 1074.0]",9,19,-10
31223.0,2019-12-19,"(1074.0, 1420.0]",7,20,-13
31224.0,2019-12-19,"(371.97, 630.5]",7,8,-1
31224.0,2019-12-19,"(630.5, 888.0]",2,7,-5
31224.0,2019-12-19,"(888.0, 1145.5]",8,20,-12
31225.0,2019-12-19,"(422.192, 625.0]",4,9,-5
31225.0,2019-12-19,"(827.0, 1029.0]",1,4,-3
31225.0,2019-12-19,"(1029.0, 1231.0]",8,16,-8
31226.0,2019-12-19,"(461.385, 615.75]",3,6,-3
31226.0,2019-12-19,"(615.75, 769.5]",1,1,0
31226.0,2019-12-19,"(769.5, 923.25]",3,5,-2
31226.0,2019-12-19,"(923.25, 1077.0]",1,5,-4
31227.0,2019-12-19,"(453.14, 669.0]",28,30,-2
31227.0,2019-12-19,"(669.0, 884.0]",7,15,-8
31227.0,2019-12-19,"(884.0, 1099.0]",7,15,-8
31227.0,2019-12-19,"(1099.0, 1314.0]",5,13,-8
31228.0,2019-12-19,"(44.622, 390.5]",5,6,-1
31228.0,2019-12-19,"(390.5, 735.0]",19,27,-8
31228.0,2019-12-19,"(735.0, 1079.5]",13,25,-12
31228.0,2019-12-19,"(1079.5, 1424.0]",14,24,-10
31229.0,2019-12-19,"(358.75, 705.5]",10,3,7
31229.0,2019-12-19,"(705.5, 1052.25]",13,38,-25
31229.0,2019-12-19,"(1052.25, 1399.0]",23,35,-12
31230.0,2019-12-19,"(100.755, 413.25]",2,4,-2
31230.0,2019-12-19,"(413.25, 724.5]",32,43,-11
31230.0,2019-12-19,"(724.5, 1035.75]",10,18,-8
31230.0,2019-12-19,"(1035.75, 1347.0]",5,21,-16
31231.0,2019-12-19,"(324.911, 598.25]",15,22,-7
31231.0,2019-12-19,"(598.25, 870.5]",5,8,-3
31231.0,2019-12-19,"(870.5, 1142.75]",6,18,-12
31232.0,2019-12-19,"(98.739, 415.25]",2,4,-2
31232.0,2019-12-19,"(415.25, 730.5]",14,19,-5
31232.0,2019-12-19,"(730.5, 1045.75]",3,9,-6
31232.0,2019-12-19,"(1045.75, 1361.0]",10,17,-7
31233.0,2019-12-19,"(365.93, 634.5]",22,25,-3
31233.0,2019-12-19,"(634.5, 902.0]",7,11,-4
31233.0,2019-12-19,"(902.0, 1169.5]",9,21,-12
31233.0,2019-12-19,"(1169.5, 1437.0]",2,6,-4
31234.0,2019-12-19,"(389.083, 619.25]",12,26,-14
31234.0,2019-12-19,"(619.25, 848.5]",8,10,-2
31234.0,2019-12-19,"(848.5, 1077.75]",7,18,-11
31234.0,2019-12-19,"(1077.75, 1307.0]",7,15,-8
31235.0,2019-12-19,"(500.337, 666.75]",2,2,0
31235.0,2019-12-19,"(666.75, 832.5]",1,3,-2
31235.0,2019-12-19,"(998.25, 1164.0]",1,1,0
31236.0,2019-12-19,"(345.0, 688.0]",6,1,5
31236.0,2019-12-19,"(688.0, 1031.0]",6,7,-1
31236.0,2019-12-19,"(1031.0, 1374.0]",3,12,-9
31237.0,2019-12-19,"(372.966, 632.5]",4,12,-8
31237.0,2019-12-19,"(632.5, 891.0]",4,11,-7
31237.0,2019-12-19,"(891.0, 1149.5]",7,10,-3
31237.0,2019-12-19,"(1149.5, 1408.0]",2,5,-3
31238.0,2019-12-19,"(54.711, 378.25]",1,2,-1
31238.0,2019-12-19,"(378.25, 700.5]",17,19,-2
31238.0,2019-12-19,"(700.5, 1022.75]",5,18,-13
31238.0,2019-12-19,"(1022.75, 1345.0]",3,10,-7
31239.0,2019-12-19,"(384.974, 642.5]",23,26,-3
31239.0,2019-12-19,"(642.5, 899.0]",10,16,-6
31239.0,2019-12-19,"(899.0, 1155.5]",13,33,-20
31239.0,2019-12-19,"(1155.5, 1412.0]",2,4,-2
31240.0,2019-12-19,"(616.611, 714.25]",1,2,-1
31240.0,2019-12-19,"(811.5, 908.75]",2,4,-2
31241.0,2019-12-19,"(21.677, 353.75]",1,3,-2
31241.0,2019-12-19,"(353.75, 684.5]",21,39,-18
31241.0,2019-12-19,"(684.5, 1015.25]",13,26,-13
31241.0,2019-12-19,"(1015.25, 1346.0]",13,33,-20
31242.0,2019-12-19,"(342.088, 571.0]",10,11,-1
31242.0,2019-12-19,"(571.0, 799.0]",11,14,-3
31242.0,2019-12-19,"(799.0, 1027.0]",4,10,-6
31243.0,2019-12-19,"(377.963, 638.25]",21,25,-4
31243.0,2019-12-19,"(638.25, 897.5]",2,3,-1
31243.0,2019-12-19,"(897.5, 1156.75]",4,14,-10
31243.0,2019-12-19,"(1156.75, 1416.0]",3,7,-4
31244.0,2019-12-19,"(421.161, 631.75]",11,18,-7
31244.0,2019-12-19,"(631.75, 841.5]",3,6,-3
31244.0,2019-12-19,"(841.5, 1051.25]",4,12,-8
31244.0,2019-12-19,"(1051.25, 1261.0]",7,13,-6
31245.0,2019-12-19,"(469.069, 702.75]",10,13,-3
31245.0,2019-12-19,"(702.75, 935.5]",1,2,-1
31245.0,2019-12-19,"(935.5, 1168.25]",7,18,-11
31245.0,2019-12-19,"(1168.25, 1401.0]",5,7,-2
31246.0,2019-12-19,"(147.778, 454.5]",2,3,-1
31246.0,2019-12-19,"(454.5, 760.0]",8,15,-7
31246.0,2019-12-19,"(760.0, 1065.5]",10,18,-8
31246.0,2019-12-19,"(1065.5, 1371.0]",8,19,-11
31247.0,2019-12-19,"(419.33, 587.5]",9,12,-3
31247.0,2019-12-19,"(587.5, 755.0]",5,5,0
31247.0,2019-12-19,"(755.0, 922.5]",6,9,-3
31247.0,2019-12-19,"(922.5, 1090.0]",5,10,-5
31248.0,2019-12-19,"(335.137, 551.75]",2,6,-4
31248.0,2019-12-19,"(551.75, 767.5]",3,3,0
31248.0,2019-12-19,"(767.5, 983.25]",5,11,-6
31248.0,2019-12-19,"(983.25, 1199.0]",8,12,-4
31249.0,2019-12-19,"(29.002, 279.5]",2,3,-1
31249.0,2019-12-19,"(279.5, 529.0]",1,1,0
31249.0,2019-12-19,"(529.0, 778.5]",4,8,-4
31249.0,2019-12-19,"(778.5, 1028.0]",6,11,-5
31250.0,2019-12-19,"(410.147, 624.25]",14,17,-3
31250.0,2019-12-19,"(624.25, 837.5]",5,7,-2
31250.0,2019-12-19,"(837.5, 1050.75]",2,12,-10
31250.0,2019-12-19,"(1050.75, 1264.0]",3,10,-7
31251.0,2019-12-19,"(367.018, 613.5]",12,26,-14
31251.0,2019-12-19,"(613.5, 859.0]",5,11,-6
31251.0,2019-12-19,"(859.0, 1104.5]",8,16,-8
31251.0,2019-12-19,"(1104.5, 1350.0]",5,9,-4
31252.0,2019-12-19,"(452.015, 699.25]",18,20,-2
31252.0,2019-12-19,"(699.25, 945.5]",2,4,-2
31252.0,2019-12-19,"(1191.75, 1438.0]",1,10,-9
31253.0,2019-12-19,"(374.08, 605.0]",11,11,0
31253.0,2019-12-19,"(605.0, 835.0]",3,6,-3
31253.0,2019-12-19,"(835.0, 1065.0]",4,15,-11
31253.0,2019-12-19,"(1065.0, 1295.0]",2,9,-7
31254.0,2019-12-19,"(461.051, 699.25]",21,24,-3
31254.0,2019-12-19,"(936.5, 1173.75]",6,2,4
31254.0,2019-12-19,"(1173.75, 1411.0]",2,16,-14
31255.0,2019-12-19,"(428.236, 620.0]",11,15,-4
31255.0,2019-12-19,"(620.0, 811.0]",4,5,-1
31255.0,2019-12-19,"(811.0, 1002.0]",5,12,-7
31255.0,2019-12-19,"(1002.0, 1193.0]",4,8,-4
31256.0,2019-12-19,"(275.127, 494.25]",2,2,0
31256.0,2019-12-19,"(494.25, 712.5]",12,13,-1
31256.0,2019-12-19,"(712.5, 930.75]",1,3,-2
31256.0,2019-12-19,"(930.75, 1149.0]",2,7,-5
31257.0,2019-12-19,"(292.859, 579.25]",9,16,-7
31257.0,2019-12-19,"(579.25, 864.5]",11,21,-10
31257.0,2019-12-19,"(864.5, 1149.75]",14,26,-12
31257.0,2019-12-19,"(1149.75, 1435.0]",1,7,-6
31258.0,2019-12-19,"(818.421, 963.75]",4,12,-8
31258.0,2019-12-19,"(963.75, 1108.5]",2,6,-4
31258.0,2019-12-19,"(1253.25, 1398.0]",5,8,-3
31259.0,2019-12-19,"(482.32, 653.0]",5,6,-1
31259.0,2019-12-19,"(653.0, 823.0]",3,3,0
31259.0,2019-12-19,"(823.0, 993.0]",1,3,-2
31259.0,2019-12-19,"(993.0, 1163.0]",1,4,-3
31260.0,2019-12-19,"(391.968, 651.0]",12,12,0
31260.0,2019-12-19,"(651.0, 909.0]",2,8,-6
31260.0,2019-12-19,"(909.0, 1167.0]",1,10,-9
31260.0,2019-12-19,"(1167.0, 1425.0]",2,2,0
31261.0,2019-12-19,"(405.323, 575.25]",7,7,0
31261.0,2019-12-19,"(575.25, 744.5]",1,2,-1
31262.0,2019-12-19,"(418.066, 652.5]",7,9,-2
31262.0,2019-12-19,"(652.5, 886.0]",1,2,-1
31262.0,2019-12-19,"(886.0, 1119.5]",3,7,-4
31262.0,2019-12-19,"(1119.5, 1353.0]",2,4,-2
31263.0,2019-12-19,"(365.168, 574.0]",16,21,-5
31263.0,2019-12-19,"(574.0, 782.0]",7,12,-5
31263.0,2019-12-19,"(782.0, 990.0]",3,5,-2
31263.0,2019-12-19,"(990.0, 1198.0]",7,15,-8
31264.0,2019-12-19,"(451.06, 687.0]",10,15,-5
31264.0,2019-12-19,"(687.0, 922.0]",3,5,-2
31264.0,2019-12-19,"(922.0, 1157.0]",7,14,-7
31264.0,2019-12-19,"(1157.0, 1392.0]",5,10,-5
31265.0,2019-12-19,"(352.916, 625.0]",12,27,-15
31265.0,2019-12-19,"(625.0, 896.0]",5,10,-5
31265.0,2019-12-19,"(896.0, 1167.0]",19,30,-11
31265.0,2019-12-19,"(1167.0, 1438.0]",7,14,-7
31266.0,2019-12-19,"(345.75, 670.5]",2,4,-2
31266.0,2019-12-19,"(670.5, 995.25]",10,16,-6
31266.0,2019-12-19,"(995.25, 1320.0]",11,23,-12
31267.0,2019-12-19,"(362.974, 620.5]",16,30,-14
31267.0,2019-12-19,"(620.5, 877.0]",7,13,-6
31267.0,2019-12-19,"(877.0, 1133.5]",9,18,-9
31267.0,2019-12-19,"(1133.5, 1390.0]",3,4,-1
31268.0,2019-12-19,"(326.911, 600.25]",17,37,-20
31268.0,2019-12-19,"(600.25, 872.5]",6,10,-4
31268.0,2019-12-19,"(872.5, 1144.75]",11,13,-2
31268.0,2019-12-19,"(1144.75, 1417.0]",8,12,-4
31269.0,2019-12-19,"(378.13, 596.5]",6,10,-4
31269.0,2019-12-19,"(596.5, 814.0]",8,14,-6
31269.0,2019-12-19,"(814.0, 1031.5]",3,9,-6
31269.0,2019-12-19,"(1031.5, 1249.0]",2,11,-9
31270.0,2019-12-19,"(326.901, 602.75]",4,6,-2
31270.0,2019-12-19,"(602.75, 877.5]",1,3,-2
31270.0,2019-12-19,"(877.5, 1152.25]",5,11,-6
31270.0,2019-12-19,"(1152.25, 1427.0]",2,5,-3
31271.0,2019-12-19,"(382.963, 643.25]",10,11,-1
31271.0,2019-12-19,"(643.25, 902.5]",2,7,-5
31271.0,2019-12-19,"(902.5, 1161.75]",4,13,-9
31271.0,2019-12-19,"(1161.75, 1421.0]",3,8,-5
31272.0,2019-12-19,"(365.194, 567.5]",17,18,-1
31272.0,2019-12-19,"(567.5, 769.0]",7,8,-1
31272.0,2019-12-19,"(769.0, 970.5]",4,15,-11
31272.0,2019-12-19,"(970.5, 1172.0]",3,15,-12
31273.0,2019-12-19,"(819.0, 969.5]",2,2,0
31273.0,2019-12-19,"(969.5, 1120.0]",1,4,-3
31274.0,2019-12-19,"(481.087, 710.25]",9,10,-1
31274.0,2019-12-19,"(710.25, 938.5]",3,6,-3
31274.0,2019-12-19,"(938.5, 1166.75]",3,11,-8
31275.0,2019-12-19,"(428.003, 678.25]",9,24,-15
31275.0,2019-12-19,"(678.25, 927.5]",2,6,-4
31275.0,2019-12-19,"(927.5, 1176.75]",8,18,-10
31275.0,2019-12-19,"(1176.75, 1426.0]",3,3,0
31276.0,2019-12-19,"(442.048, 681.0]",16,18,-2
31276.0,2019-12-19,"(681.0, 919.0]",5,10,-5
31276.0,2019-12-19,"(919.0, 1157.0]",4,20,-16
31276.0,2019-12-19,"(1157.0, 1395.0]",1,6,-5
31277.0,2019-12-19,"(258.991, 512.25]",12,14,-2
31277.0,2019-12-19,"(512.25, 764.5]",15,17,-2
31277.0,2019-12-19,"(764.5, 1016.75]",6,14,-8
31277.0,2019-12-19,"(1016.75, 1269.0]",2,14,-12
31278.0,2019-12-19,"(363.007, 612.25]",14,29,-15
31278.0,2019-12-19,"(612.25, 860.5]",7,11,-4
31278.0,2019-12-19,"(860.5, 1108.75]",3,9,-6
31278.0,2019-12-19,"(1108.75, 1357.0]",9,15,-6
31279.0,2019-12-19,"(447.183, 652.25]",12,16,-4
31279.0,2019-12-19,"(652.25, 856.5]",3,5,-2
31279.0,2019-12-19,"(856.5, 1060.75]",3,14,-11
31279.0,2019-12-19,"(1060.75, 1265.0]",2,13,-11
31280.0,2019-12-19,"(404.0, 749.0]",5,2,3
31280.0,2019-12-19,"(749.0, 1094.0]",11,16,-5
31280.0,2019-12-19,"(1094.0, 1439.0]",4,14,-10
,,,,2.0,
,,,,2.0,
31002.0,2019-12-20,"(401.206, 600.5]",2,4,-2
31002.0,2019-12-20,"(600.5, 799.0]",1,1,0
31002.0,2019-12-20,"(799.0, 997.5]",1,1,0
31003.0,2019-12-20,"(418.348, 582.0]",2,2,0
31003.0,2019-12-20,"(582.0, 745.0]",1,3,-2
31003.0,2019-12-20,"(745.0, 908.0]",1,2,-1
31003.0,2019-12-20,"(908.0, 1071.0]",2,5,-3
31004.0,2019-12-20,"(923.0, 1066.0]",2,1,1
31005.0,2019-12-20,"(438.224, 633.0]",3,3,0
31005.0,2019-12-20,"(633.0, 827.0]",2,2,0
31006.0,2019-12-20,"(888.869, 921.75]",1,2,-1
31006.0,2019-12-20,"(921.75, 954.5]",1,1,0
31006.0,2019-12-20,"(987.25, 1020.0]",1,1,0
31007.0,2019-12-20,"(404.252, 592.0]",3,10,-7
31007.0,2019-12-20,"(592.0, 779.0]",2,4,-2
31007.0,2019-12-20,"(779.0, 966.0]",3,9,-6
31007.0,2019-12-20,"(966.0, 1153.0]",3,7,-4
31009.0,2019-12-20,"(445.454, 582.5]",3,3,0
31010.0,2019-12-20,"(477.5, 716.25]",1,1,0
31010.0,2019-12-20,"(716.25, 955.0]",2,1,1
31011.0,2019-12-20,"(123.016, 370.0]",1,1,0
31011.0,2019-12-20,"(370.0, 616.0]",4,5,-1
31011.0,2019-12-20,"(616.0, 862.0]",3,5,-2
31011.0,2019-12-20,"(862.0, 1108.0]",1,4,-3
31012.0,2019-12-20,"(404.377, 560.75]",3,3,0
31012.0,2019-12-20,"(560.75, 716.5]",1,1,0
31013.0,2019-12-20,"(412.121, 632.75]",1,2,-1
31013.0,2019-12-20,"(632.75, 852.5]",1,2,-1
31013.0,2019-12-20,"(852.5, 1072.25]",2,3,-1
31013.0,2019-12-20,"(1072.25, 1292.0]",2,3,-1
31014.0,2019-12-20,"(509.081, 739.75]",10,14,-4
31014.0,2019-12-20,"(739.75, 969.5]",5,12,-7
31014.0,2019-12-20,"(969.5, 1199.25]",6,8,-2
31014.0,2019-12-20,"(1199.25, 1429.0]",2,2,0
31015.0,2019-12-20,"(301.047, 540.25]",6,8,-2
31015.0,2019-12-20,"(540.25, 778.5]",8,9,-1
31015.0,2019-12-20,"(778.5, 1016.75]",1,4,-3
31015.0,2019-12-20,"(1016.75, 1255.0]",5,7,-2
31016.0,2019-12-20,"(435.159, 646.25]",3,8,-5
31016.0,2019-12-20,"(646.25, 856.5]",1,2,-1
31016.0,2019-12-20,"(1066.75, 1277.0]",4,1,3
31017.0,2019-12-20,"(518.314, 690.5]",2,3,-1
31018.0,2019-12-20,"(955.25, 1129.0]",2,2,0
31019.0,2019-12-20,"(918.915, 940.25]",1,1,0
31019.0,2019-12-20,"(982.75, 1004.0]",1,1,0
31020.0,2019-12-20,"(401.0, 601.5]",1,1,0
31020.0,2019-12-20,"(601.5, 802.0]",1,1,0
31021.0,2019-12-20,"(391.331, 559.25]",2,4,-2
31021.0,2019-12-20,"(726.5, 893.75]",1,1,0
31021.0,2019-12-20,"(893.75, 1061.0]",2,1,1
31022.0,2019-12-20,"(440.11, 663.5]",2,4,-2
31022.0,2019-12-20,"(886.0, 1108.5]",1,2,-1
31022.0,2019-12-20,"(1108.5, 1331.0]",2,4,-2
31023.0,2019-12-20,"(439.133, 656.75]",3,5,-2
31023.0,2019-12-20,"(656.75, 873.5]",1,2,-1
31023.0,2019-12-20,"(873.5, 1090.25]",3,5,-2
31024.0,2019-12-20,"(472.367, 631.25]",2,4,-2
31024.0,2019-12-20,"(789.5, 947.75]",3,2,1
31024.0,2019-12-20,"(947.75, 1106.0]",3,3,0
31025.0,2019-12-20,"(719.69, 797.5]",1,3,-2
31025.0,2019-12-20,"(797.5, 875.0]",1,1,0
31025.0,2019-12-20,"(875.0, 952.5]",3,6,-3
31025.0,2019-12-20,"(952.5, 1030.0]",1,2,-1
31026.0,2019-12-20,"(658.0, 981.5]",1,1,0
31026.0,2019-12-20,"(981.5, 1305.0]",3,1,2
31027.0,2019-12-20,"(1019.0, 1102.0]",1,1,0
31028.0,2019-12-20,"(457.118, 678.5]",2,2,0
31028.0,2019-12-20,"(899.0, 1119.5]",1,3,-2
31029.0,2019-12-20,"(1030.75, 1260.0]",4,3,1
31030.0,2019-12-20,"(892.0, 1089.5]",3,5,-2
31030.0,2019-12-20,"(1089.5, 1287.0]",3,1,2
,,,,1.0,
,,,,1.0,
,,,,2.0,
31032.0,2019-12-20,"(709.25, 943.5]",1,2,-1
31032.0,2019-12-20,"(943.5, 1177.75]",1,1,0
31032.0,2019-12-20,"(1177.75, 1412.0]",1,1,0
,,,,2.0,
31034.0,2019-12-20,"(552.479, 683.25]",2,4,-2
31034.0,2019-12-20,"(943.75, 1074.0]",3,3,0
31035.0,2019-12-20,"(511.201, 711.75]",1,2,-1
31035.0,2019-12-20,"(1111.25, 1311.0]",1,1,0
31036.0,2019-12-20,"(878.25, 1028.0]",2,2,0
31037.0,2019-12-20,"(419.116, 641.0]",5,5,0
31037.0,2019-12-20,"(641.0, 862.0]",1,2,-1
31037.0,2019-12-20,"(862.0, 1083.0]",2,9,-7
31037.0,2019-12-20,"(1083.0, 1304.0]",1,3,-2
,,,,1.0,
,,,,2.0,
31039.0,2019-12-20,"(392.285, 571.75]",2,4,-2
31039.0,2019-12-20,"(571.75, 750.5]",2,2,0
31039.0,2019-12-20,"(750.5, 929.25]",3,7,-4
31039.0,2019-12-20,"(929.25, 1108.0]",1,3,-2
31040.0,2019-12-20,"(388.133, 605.75]",2,3,-1
31041.0,2019-12-20,"(539.323, 709.25]",2,3,-1
31042.0,2019-12-20,"(416.216, 613.0]",7,9,-2
31042.0,2019-12-20,"(809.0, 1005.0]",2,1,1
31042.0,2019-12-20,"(1005.0, 1201.0]",1,7,-6
31043.0,2019-12-20,"(517.478, 648.5]",2,2,0
31043.0,2019-12-20,"(779.0, 909.5]",2,3,-1
31044.0,2019-12-20,"(446.072, 679.0]",4,6,-2
31044.0,2019-12-20,"(679.0, 911.0]",1,2,-1
31044.0,2019-12-20,"(1143.0, 1375.0]",1,1,0
31045.0,2019-12-20,"(528.382, 683.5]",1,4,-3
31045.0,2019-12-20,"(683.5, 838.0]",3,3,0
31045.0,2019-12-20,"(838.0, 992.5]",1,1,0
31045.0,2019-12-20,"(992.5, 1147.0]",1,2,-1
31046.0,2019-12-20,"(393.355, 555.25]",1,2,-1
31046.0,2019-12-20,"(877.75, 1039.0]",3,1,2
31047.0,2019-12-20,"(354.145, 568.75]",4,8,-4
31047.0,2019-12-20,"(568.75, 782.5]",2,6,-4
31047.0,2019-12-20,"(782.5, 996.25]",3,4,-1
31047.0,2019-12-20,"(996.25, 1210.0]",2,6,-4
31048.0,2019-12-20,"(1179.5, 1404.0]",1,1,0
,,,,1.0,
,,,,1.0,
31050.0,2019-12-20,"(866.5, 985.0]",1,1,0
31051.0,2019-12-20,"(917.5, 1124.0]",4,2,2
31052.0,2019-12-20,"(502.363, 662.25]",1,1,0
31052.0,2019-12-20,"(980.75, 1140.0]",2,1,1
31053.0,2019-12-20,"(1009.5, 1144.0]",2,1,1
31054.0,2019-12-20,"(835.5, 1114.0]",3,1,2
31055.0,2019-12-20,"(438.623, 533.25]",1,1,0
31056.0,2019-12-20,"(1030.0, 1228.0]",1,2,-1
,,,,1.0,
,,,,1.0,
,,,,1.0,
31058.0,2019-12-20,"(16.5, 22.0]",1,1,0
31059.0,2019-12-20,"(848.25, 852.0]",1,1,0
31060.0,2019-12-20,"(589.648, 678.0]",1,2,-1
31060.0,2019-12-20,"(854.0, 942.0]",1,1,0
31061.0,2019-12-20,"(520.492, 648.0]",1,1,0
31062.0,2019-12-20,"(608.577, 714.75]",3,4,-1
31062.0,2019-12-20,"(926.25, 1032.0]",2,2,0
31063.0,2019-12-20,"(821.75, 945.0]",1,1,0
31064.0,2019-12-20,"(484.511, 607.25]",1,2,-1
31064.0,2019-12-20,"(607.25, 729.5]",1,2,-1
31064.0,2019-12-20,"(729.5, 851.75]",1,2,-1
31064.0,2019-12-20,"(851.75, 974.0]",1,2,-1
31065.0,2019-12-20,"(897.0, 1152.5]",1,1,0
31066.0,2019-12-20,"(933.5, 1065.0]",1,1,0
31067.0,2019-12-20,"(780.0, 1040.0]",2,1,1
,,,,1.0,
,,,,1.0,
31069.0,2019-12-20,"(693.5, 822.25]",2,2,0
31069.0,2019-12-20,"(822.25, 951.0]",2,3,-1
31070.0,2019-12-20,"(1229.5, 1316.0]",1,1,0
31071.0,2019-12-20,"(491.204, 691.0]",1,3,-2
31071.0,2019-12-20,"(691.0, 890.0]",2,4,-2
31071.0,2019-12-20,"(890.0, 1089.0]",2,2,0
31071.0,2019-12-20,"(1089.0, 1288.0]",2,3,-1
,,,,2.0,
,,,,2.0,
31074.0,2019-12-20,"(921.75, 1038.0]",1,1,0
31075.0,2019-12-20,"(681.0, 824.0]",1,1,0
31075.0,2019-12-20,"(967.0, 1110.0]",1,2,-1
31076.0,2019-12-20,"(293.25, 586.5]",1,1,0
31076.0,2019-12-20,"(586.5, 879.75]",1,1,0
31076.0,2019-12-20,"(879.75, 1173.0]",1,1,0
31077.0,2019-12-20,"(523.359, 684.25]",1,5,-4
31077.0,2019-12-20,"(844.5, 1004.75]",3,3,0
31077.0,2019-12-20,"(1004.75, 1165.0]",2,3,-1
31078.0,2019-12-20,"(482.506, 606.5]",2,2,0
31078.0,2019-12-20,"(730.0, 853.5]",1,1,0
31079.0,2019-12-20,"(455.112, 678.0]",1,6,-5
31079.0,2019-12-20,"(678.0, 900.0]",1,3,-2
31079.0,2019-12-20,"(900.0, 1122.0]",2,4,-2
31079.0,2019-12-20,"(1122.0, 1344.0]",1,1,0
31080.0,2019-12-20,"(890.5, 1128.75]",2,5,-3
31080.0,2019-12-20,"(1128.75, 1367.0]",3,6,-3
31081.0,2019-12-20,"(553.562, 663.5]",2,2,0
31082.0,2019-12-20,"(612.542, 727.5]",2,3,-1
31082.0,2019-12-20,"(956.5, 1071.0]",1,1,0
31083.0,2019-12-20,"(727.0, 881.0]",1,1,0
31083.0,2019-12-20,"(881.0, 1035.0]",1,1,0
31084.0,2019-12-20,"(611.213, 808.75]",3,3,0
31084.0,2019-12-20,"(808.75, 1005.5]",1,4,-3
31084.0,2019-12-20,"(1005.5, 1202.25]",2,3,-1
31084.0,2019-12-20,"(1202.25, 1399.0]",1,4,-3
31085.0,2019-12-20,"(402.259, 588.25]",1,3,-2
31085.0,2019-12-20,"(958.75, 1144.0]",1,1,0
31086.0,2019-12-20,"(615.25, 784.0]",2,1,1
,,,,2.0,
31088.0,2019-12-20,"(757.5, 941.25]",1,2,-1
31088.0,2019-12-20,"(941.25, 1125.0]",2,3,-1
31089.0,2019-12-20,"(445.148, 659.0]",8,9,-1
31089.0,2019-12-20,"(659.0, 872.0]",1,4,-3
31089.0,2019-12-20,"(872.0, 1085.0]",1,7,-6
31089.0,2019-12-20,"(1085.0, 1298.0]",1,7,-6
31090.0,2019-12-20,"(885.25, 1042.0]",1,1,0
31091.0,2019-12-20,"(89.911, 363.25]",1,1,0
31091.0,2019-12-20,"(907.75, 1180.0]",4,6,-2
,,,,2.0,
31093.0,2019-12-20,"(843.0, 920.0]",1,1,0
31094.0,2019-12-20,"(699.75, 933.0]",1,1,0
,,,,1.0,
,,,,1.0,
31096.0,2019-12-20,"(885.75, 1181.0]",1,1,0
31097.0,2019-12-20,"(387.468, 521.0]",2,2,0
31097.0,2019-12-20,"(521.0, 654.0]",1,3,-2
31097.0,2019-12-20,"(654.0, 787.0]",1,2,-1
31097.0,2019-12-20,"(787.0, 920.0]",1,3,-2
31098.0,2019-12-20,"(408.042, 648.5]",2,9,-7
31098.0,2019-12-20,"(888.0, 1127.5]",3,1,2
31098.0,2019-12-20,"(1127.5, 1367.0]",1,3,-2
31099.0,2019-12-20,"(570.25, 743.5]",1,4,-3
31099.0,2019-12-20,"(743.5, 916.75]",1,3,-2
31099.0,2019-12-20,"(916.75, 1090.0]",1,1,0
31100.0,2019-12-20,"(392.237, 583.75]",6,7,-1
31100.0,2019-12-20,"(583.75, 774.5]",4,8,-4
31100.0,2019-12-20,"(774.5, 965.25]",3,6,-3
31100.0,2019-12-20,"(965.25, 1156.0]",4,12,-8
31101.0,2019-12-20,"(70.653, 408.75]",1,2,-1
31101.0,2019-12-20,"(408.75, 745.5]",15,46,-31
31101.0,2019-12-20,"(745.5, 1082.25]",33,49,-16
31101.0,2019-12-20,"(1082.25, 1419.0]",13,22,-9
31102.0,2019-12-20,"(98.688, 428.0]",2,3,-1
31102.0,2019-12-20,"(428.0, 756.0]",2,12,-10
31102.0,2019-12-20,"(1084.0, 1412.0]",5,3,2
31103.0,2019-12-20,"(357.064, 592.0]",1,22,-21
31103.0,2019-12-20,"(592.0, 826.0]",3,17,-14
31103.0,2019-12-20,"(826.0, 1060.0]",6,15,-9
31103.0,2019-12-20,"(1060.0, 1294.0]",3,13,-10
31104.0,2019-12-20,"(2.565, 362.75]",3,6,-3
31104.0,2019-12-20,"(362.75, 721.5]",4,9,-5
31104.0,2019-12-20,"(721.5, 1080.25]",16,31,-15
31104.0,2019-12-20,"(1080.25, 1439.0]",11,18,-7
31105.0,2019-12-20,"(1148.25, 1409.0]",1,6,-5
31106.0,2019-12-20,"(453.214, 650.5]",1,8,-7
31106.0,2019-12-20,"(650.5, 847.0]",2,2,0
31106.0,2019-12-20,"(847.0, 1043.5]",2,2,0
31106.0,2019-12-20,"(1043.5, 1240.0]",3,3,0
31107.0,2019-12-20,"(109.726, 429.5]",1,2,-1
31107.0,2019-12-20,"(429.5, 748.0]",3,23,-20
31107.0,2019-12-20,"(748.0, 1066.5]",13,22,-9
31107.0,2019-12-20,"(1066.5, 1385.0]",9,16,-7
31108.0,2019-12-20,"(98.742, 414.5]",2,4,-2
31108.0,2019-12-20,"(414.5, 729.0]",11,21,-10
31108.0,2019-12-20,"(729.0, 1043.5]",14,32,-18
31108.0,2019-12-20,"(1043.5, 1358.0]",10,12,-2
31109.0,2019-12-20,"(87.654, 425.5]",2,5,-3
31109.0,2019-12-20,"(425.5, 762.0]",6,19,-13
31109.0,2019-12-20,"(762.0, 1098.5]",15,28,-13
31109.0,2019-12-20,"(1098.5, 1435.0]",6,10,-4
31110.0,2019-12-20,"(331.904, 607.0]",8,20,-12
31110.0,2019-12-20,"(607.0, 881.0]",5,12,-7
31110.0,2019-12-20,"(881.0, 1155.0]",13,24,-11
31110.0,2019-12-20,"(1155.0, 1429.0]",2,7,-5
31111.0,2019-12-20,"(389.25, 731.5]",5,1,4
31111.0,2019-12-20,"(731.5, 1073.75]",10,15,-5
31111.0,2019-12-20,"(1073.75, 1416.0]",6,17,-11
31112.0,2019-12-20,"(359.104, 584.0]",2,4,-2
31112.0,2019-12-20,"(584.0, 808.0]",1,1,0
31112.0,2019-12-20,"(808.0, 1032.0]",2,2,0
31112.0,2019-12-20,"(1032.0, 1256.0]",1,4,-3
31113.0,2019-12-20,"(368.052, 606.0]",1,17,-16
31113.0,2019-12-20,"(606.0, 843.0]",1,8,-7
31113.0,2019-12-20,"(843.0, 1080.0]",5,8,-3
31113.0,2019-12-20,"(1080.0, 1317.0]",3,6,-3
31114.0,2019-12-20,"(25.632, 369.0]",3,4,-1
31114.0,2019-12-20,"(369.0, 711.0]",3,25,-22
31114.0,2019-12-20,"(711.0, 1053.0]",12,18,-6
31114.0,2019-12-20,"(1053.0, 1395.0]",12,18,-6
31115.0,2019-12-20,"(894.0, 1154.0]",5,11,-6
31115.0,2019-12-20,"(1154.0, 1414.0]",2,5,-3
31116.0,2019-12-20,"(329.986, 584.5]",3,18,-15
31116.0,2019-12-20,"(584.5, 838.0]",3,9,-6
31116.0,2019-12-20,"(838.0, 1091.5]",17,20,-3
31116.0,2019-12-20,"(1091.5, 1345.0]",7,15,-8
31117.0,2019-12-20,"(358.077, 589.75]",1,10,-9
31117.0,2019-12-20,"(820.5, 1051.25]",4,5,-1
31117.0,2019-12-20,"(1051.25, 1282.0]",8,15,-7
31118.0,2019-12-20,"(422.067, 656.25]",2,12,-10
31118.0,2019-12-20,"(889.5, 1122.75]",11,2,9
31118.0,2019-12-20,"(1122.75, 1356.0]",3,16,-13
31119.0,2019-12-20,"(249.857, 536.75]",6,14,-8
31119.0,2019-12-20,"(822.5, 1108.25]",5,4,1
31119.0,2019-12-20,"(1108.25, 1394.0]",10,15,-5
31120.0,2019-12-20,"(657.75, 898.5]",1,5,-4
31120.0,2019-12-20,"(898.5, 1139.25]",5,2,3
31120.0,2019-12-20,"(1139.25, 1380.0]",5,8,-3
31121.0,2019-12-20,"(27.702, 353.5]",1,2,-1
31121.0,2019-12-20,"(353.5, 678.0]",15,20,-5
31121.0,2019-12-20,"(678.0, 1002.5]",2,8,-6
31121.0,2019-12-20,"(1002.5, 1327.0]",15,24,-9
31122.0,2019-12-20,"(6.645, 346.75]",1,1,0
31122.0,2019-12-20,"(685.5, 1024.25]",4,6,-2
31122.0,2019-12-20,"(1024.25, 1363.0]",4,6,-2
31123.0,2019-12-20,"(624.0, 875.0]",1,14,-13
31123.0,2019-12-20,"(875.0, 1126.0]",2,2,0
31123.0,2019-12-20,"(1126.0, 1377.0]",1,6,-5
31124.0,2019-12-20,"(407.5, 749.0]",5,2,3
31124.0,2019-12-20,"(749.0, 1090.5]",17,16,1
31124.0,2019-12-20,"(1090.5, 1432.0]",13,49,-36
31125.0,2019-12-20,"(143.715, 466.25]",3,6,-3
31125.0,2019-12-20,"(466.25, 787.5]",4,18,-14
31125.0,2019-12-20,"(787.5, 1108.75]",28,42,-14
31125.0,2019-12-20,"(1108.75, 1430.0]",7,11,-4
31126.0,2019-12-20,"(388.027, 632.25]",2,19,-17
31126.0,2019-12-20,"(632.25, 875.5]",4,10,-6
31126.0,2019-12-20,"(875.5, 1118.75]",10,20,-10
31126.0,2019-12-20,"(1118.75, 1362.0]",8,14,-6
,,,,2.0,
31128.0,2019-12-20,"(11.611, 360.25]",1,1,0
31128.0,2019-12-20,"(360.25, 707.5]",15,23,-8
31128.0,2019-12-20,"(707.5, 1054.75]",15,28,-13
31128.0,2019-12-20,"(1054.75, 1402.0]",7,19,-12
31129.0,2019-12-20,"(487.341, 652.75]",3,5,-2
31129.0,2019-12-20,"(652.75, 817.5]",7,13,-6
31129.0,2019-12-20,"(817.5, 982.25]",8,13,-5
31129.0,2019-12-20,"(982.25, 1147.0]",7,12,-5
31130.0,2019-12-20,"(356.964, 617.0]",3,11,-8
31130.0,2019-12-20,"(617.0, 876.0]",3,6,-3
31130.0,2019-12-20,"(876.0, 1135.0]",4,9,-5
31130.0,2019-12-20,"(1135.0, 1394.0]",3,3,0
31131.0,2019-12-20,"(65.766, 375.5]",1,2,-1
31131.0,2019-12-20,"(375.5, 684.0]",2,14,-12
31131.0,2019-12-20,"(684.0, 992.5]",2,5,-3
31131.0,2019-12-20,"(992.5, 1301.0]",8,12,-4
31200.0,2019-12-20,"(422.025, 666.75]",26,33,-7
31200.0,2019-12-20,"(666.75, 910.5]",15,30,-15
31200.0,2019-12-20,"(910.5, 1154.25]",20,39,-19
31200.0,2019-12-20,"(1154.25, 1398.0]",1,5,-4
31201.0,2019-12-20,"(-1.407, 351.75]",5,8,-3
31201.0,2019-12-20,"(351.75, 703.5]",18,41,-23
31201.0,2019-12-20,"(703.5, 1055.25]",37,73,-36
31201.0,2019-12-20,"(1055.25, 1407.0]",24,45,-21
31202.0,2019-12-20,"(67.652, 406.0]",1,3,-2
31202.0,2019-12-20,"(406.0, 743.0]",13,23,-10
31202.0,2019-12-20,"(743.0, 1080.0]",21,43,-22
31202.0,2019-12-20,"(1080.0, 1417.0]",11,19,-8
31203.0,2019-12-20,"(-0.32, 331.0]",2,2,0
31203.0,2019-12-20,"(331.0, 661.0]",3,17,-14
31203.0,2019-12-20,"(661.0, 991.0]",14,27,-13
31203.0,2019-12-20,"(991.0, 1321.0]",30,47,-17
31204.0,2019-12-20,"(386.5, 687.0]",8,1,7
31204.0,2019-12-20,"(687.0, 987.5]",2,10,-8
31204.0,2019-12-20,"(987.5, 1288.0]",7,7,0
31205.0,2019-12-20,"(253.959, 515.25]",5,7,-2
31205.0,2019-12-20,"(515.25, 775.5]",8,11,-3
31205.0,2019-12-20,"(775.5, 1035.75]",4,10,-6
31205.0,2019-12-20,"(1035.75, 1296.0]",3,14,-11
31206.0,2019-12-20,"(460.368, 619.0]",5,5,0
31206.0,2019-12-20,"(619.0, 777.0]",1,3,-2
31207.0,2019-12-20,"(759.5, 961.75]",2,3,-1
31208.0,2019-12-20,"(417.316, 589.0]",6,7,-1
31208.0,2019-12-20,"(760.0, 931.0]",2,3,-1
31208.0,2019-12-20,"(931.0, 1102.0]",5,7,-2
31209.0,2019-12-20,"(521.292, 699.0]",3,3,0
31209.0,2019-12-20,"(699.0, 876.0]",1,1,0
31209.0,2019-12-20,"(876.0, 1053.0]",1,2,-1
31209.0,2019-12-20,"(1053.0, 1230.0]",4,4,0
31211.0,2019-12-20,"(452.097, 678.75]",3,4,-1
31211.0,2019-12-20,"(678.75, 904.5]",3,5,-2
31211.0,2019-12-20,"(904.5, 1130.25]",4,6,-2
31211.0,2019-12-20,"(1130.25, 1356.0]",4,8,-4
31212.0,2019-12-20,"(405.141, 620.75]",19,25,-6
31212.0,2019-12-20,"(620.75, 835.5]",4,8,-4
31212.0,2019-12-20,"(835.5, 1050.25]",9,17,-8
31212.0,2019-12-20,"(1050.25, 1265.0]",10,23,-13
31213.0,2019-12-20,"(393.085, 622.75]",26,40,-14
31213.0,2019-12-20,"(622.75, 851.5]",11,18,-7
31213.0,2019-12-20,"(851.5, 1080.25]",11,20,-9
31213.0,2019-12-20,"(1080.25, 1309.0]",2,6,-4
31214.0,2019-12-20,"(358.011, 606.25]",6,25,-19
31214.0,2019-12-20,"(606.25, 853.5]",10,23,-13
31214.0,2019-12-20,"(853.5, 1100.75]",14,26,-12
31214.0,2019-12-20,"(1100.75, 1348.0]",12,18,-6
31215.0,2019-12-20,"(508.157, 719.75]",9,9,0
31215.0,2019-12-20,"(719.75, 930.5]",5,10,-5
31215.0,2019-12-20,"(930.5, 1141.25]",14,24,-10
31215.0,2019-12-20,"(1141.25, 1352.0]",1,3,-2
31216.0,2019-12-20,"(473.125, 692.75]",11,14,-3
31216.0,2019-12-20,"(692.75, 911.5]",5,13,-8
31216.0,2019-12-20,"(911.5, 1130.25]",1,12,-11
31216.0,2019-12-20,"(1130.25, 1349.0]",3,6,-3
31217.0,2019-12-20,"(353.262, 538.5]",4,4,0
31217.0,2019-12-20,"(538.5, 723.0]",4,6,-2
31217.0,2019-12-20,"(723.0, 907.5]",2,3,-1
31218.0,2019-12-20,"(330.171, 538.25]",4,12,-8
31218.0,2019-12-20,"(745.5, 952.75]",8,4,4
31218.0,2019-12-20,"(952.75, 1160.0]",7,10,-3
31219.0,2019-12-20,"(370.174, 577.5]",6,6,0
31219.0,2019-12-20,"(577.5, 784.0]",12,17,-5
31219.0,2019-12-20,"(784.0, 990.5]",5,11,-6
31219.0,2019-12-20,"(990.5, 1197.0]",3,3,0
31220.0,2019-12-20,"(273.183, 478.25]",6,6,0
31220.0,2019-12-20,"(478.25, 682.5]",9,9,0
31220.0,2019-12-20,"(682.5, 886.75]",3,7,-4
31220.0,2019-12-20,"(886.75, 1091.0]",3,18,-15
31221.0,2019-12-20,"(431.204, 631.0]",25,34,-9
31221.0,2019-12-20,"(631.0, 830.0]",10,18,-8
31221.0,2019-12-20,"(830.0, 1029.0]",5,15,-10
31221.0,2019-12-20,"(1029.0, 1228.0]",4,15,-11
31222.0,2019-12-20,"(328.92, 600.0]",9,12,-3
31222.0,2019-12-20,"(600.0, 870.0]",7,14,-7
31222.0,2019-12-20,"(870.0, 1140.0]",7,15,-8
31222.0,2019-12-20,"(1140.0, 1410.0]",2,4,-2
31223.0,2019-12-20,"(32.636, 375.0]",3,4,-1
31223.0,2019-12-20,"(375.0, 716.0]",11,30,-19
31223.0,2019-12-20,"(716.0, 1057.0]",12,21,-9
31223.0,2019-12-20,"(1057.0, 1398.0]",10,21,-11
31224.0,2019-12-20,"(10.851, 299.25]",1,1,0
31224.0,2019-12-20,"(299.25, 586.5]",6,7,-1
31224.0,2019-12-20,"(586.5, 873.75]",6,10,-4
31224.0,2019-12-20,"(873.75, 1161.0]",7,18,-11
31225.0,2019-12-20,"(354.046, 593.5]",7,9,-2
31225.0,2019-12-20,"(593.5, 832.0]",6,11,-5
31225.0,2019-12-20,"(832.0, 1070.5]",6,10,-4
31225.0,2019-12-20,"(1070.5, 1309.0]",8,10,-2
31226.0,2019-12-20,"(268.0, 519.0]",2,3,-1
31226.0,2019-12-20,"(769.0, 1019.0]",2,3,-1
31226.0,2019-12-20,"(1019.0, 1269.0]",2,5,-3
31227.0,2019-12-20,"(458.098, 684.5]",22,24,-2
31227.0,2019-12-20,"(684.5, 910.0]",9,16,-7
31227.0,2019-12-20,"(910.0, 1135.5]",3,9,-6
31227.0,2019-12-20,"(1135.5, 1361.0]",2,5,-3
31228.0,2019-12-20,"(46.641, 387.75]",2,3,-1
31228.0,2019-12-20,"(387.75, 727.5]",16,24,-8
31228.0,2019-12-20,"(727.5, 1067.25]",23,45,-22
31228.0,2019-12-20,"(1067.25, 1407.0]",6,11,-5
31229.0,2019-12-20,"(3.6, 355.0]",2,4,-2
31229.0,2019-12-20,"(355.0, 705.0]",10,49,-39
31229.0,2019-12-20,"(705.0, 1055.0]",25,46,-21
31229.0,2019-12-20,"(1055.0, 1405.0]",18,29,-11
31230.0,2019-12-20,"(191.94, 458.0]",3,6,-3
31230.0,2019-12-20,"(458.0, 723.0]",35,42,-7
31230.0,2019-12-20,"(723.0, 988.0]",14,30,-16
31230.0,2019-12-20,"(988.0, 1253.0]",8,29,-21
31231.0,2019-12-20,"(325.912, 599.0]",14,18,-4
31231.0,2019-12-20,"(599.0, 871.0]",5,10,-5
31231.0,2019-12-20,"(871.0, 1143.0]",2,10,-8
31231.0,2019-12-20,"(1143.0, 1415.0]",1,5,-4
31232.0,2019-12-20,"(291.87, 575.5]",16,19,-3
31232.0,2019-12-20,"(575.5, 858.0]",11,18,-7
31232.0,2019-12-20,"(858.0, 1140.5]",13,23,-10
31232.0,2019-12-20,"(1140.5, 1423.0]",3,6,-3
31233.0,2019-12-20,"(406.083, 636.25]",16,18,-2
31233.0,2019-12-20,"(636.25, 865.5]",12,21,-9
31233.0,2019-12-20,"(865.5, 1094.75]",14,25,-11
31233.0,2019-12-20,"(1094.75, 1324.0]",6,13,-7
31234.0,2019-12-20,"(147.921, 418.75]",2,2,0
31234.0,2019-12-20,"(418.75, 688.5]",11,22,-11
31234.0,2019-12-20,"(688.5, 958.25]",10,26,-16
31234.0,2019-12-20,"(958.25, 1228.0]",14,17,-3
31235.0,2019-12-20,"(474.24, 665.0]",1,2,-1
31235.0,2019-12-20,"(665.0, 855.0]",1,3,-2
31235.0,2019-12-20,"(855.0, 1045.0]",4,11,-7
31235.0,2019-12-20,"(1045.0, 1235.0]",1,3,-2
31236.0,2019-12-20,"(389.97, 648.5]",6,6,0
31236.0,2019-12-20,"(648.5, 906.0]",1,5,-4
31236.0,2019-12-20,"(906.0, 1163.5]",5,13,-8
31237.0,2019-12-20,"(98.744, 414.0]",1,2,-1
31237.0,2019-12-20,"(414.0, 728.0]",3,11,-8
31237.0,2019-12-20,"(728.0, 1042.0]",13,22,-9
31237.0,2019-12-20,"(1042.0, 1356.0]",5,8,-3
31238.0,2019-12-20,"(77.706, 402.5]",2,2,0
31238.0,2019-12-20,"(402.5, 726.0]",17,21,-4
31238.0,2019-12-20,"(726.0, 1049.5]",11,22,-11
31238.0,2019-12-20,"(1049.5, 1373.0]",3,14,-11
31239.0,2019-12-20,"(377.972, 636.0]",23,26,-3
31239.0,2019-12-20,"(636.0, 893.0]",2,6,-4
31239.0,2019-12-20,"(893.0, 1150.0]",10,21,-11
31239.0,2019-12-20,"(1150.0, 1407.0]",1,1,0
,,,,2.0,
31241.0,2019-12-20,"(64.664, 400.0]",1,4,-3
31241.0,2019-12-20,"(400.0, 734.0]",18,39,-21
31241.0,2019-12-20,"(734.0, 1068.0]",9,30,-21
31241.0,2019-12-20,"(1068.0, 1402.0]",11,18,-7
31242.0,2019-12-20,"(457.214, 654.5]",11,15,-4
31242.0,2019-12-20,"(654.5, 851.0]",6,10,-4
31242.0,2019-12-20,"(851.0, 1047.5]",5,18,-13
31242.0,2019-12-20,"(1047.5, 1244.0]",2,8,-6
31243.0,2019-12-20,"(155.794, 458.5]",5,7,-2
31243.0,2019-12-20,"(458.5, 760.0]",13,14,-1
31243.0,2019-12-20,"(760.0, 1061.5]",14,24,-10
31243.0,2019-12-20,"(1061.5, 1363.0]",6,15,-9
31244.0,2019-12-20,"(336.5, 629.0]",9,1,8
31244.0,2019-12-20,"(629.0, 921.5]",4,12,-8
31244.0,2019-12-20,"(921.5, 1214.0]",10,9,1
31245.0,2019-12-20,"(450.114, 672.5]",6,16,-10
31245.0,2019-12-20,"(672.5, 894.0]",6,16,-10
31245.0,2019-12-20,"(894.0, 1115.5]",8,13,-5
31245.0,2019-12-20,"(1115.5, 1337.0]",5,8,-3
31246.0,2019-12-20,"(73.677, 405.75]",3,5,-2
31246.0,2019-12-20,"(405.75, 736.5]",11,20,-9
31246.0,2019-12-20,"(736.5, 1067.25]",25,37,-12
31246.0,2019-12-20,"(1067.25, 1398.0]",8,17,-9
31247.0,2019-12-20,"(428.291, 606.25]",1,1,0
31247.0,2019-12-20,"(606.25, 783.5]",2,10,-8
31247.0,2019-12-20,"(783.5, 960.75]",2,6,-4
31247.0,2019-12-20,"(960.75, 1138.0]",3,7,-4
31248.0,2019-12-20,"(418.322, 588.5]",2,4,-2
31248.0,2019-12-20,"(588.5, 758.0]",3,9,-6
31248.0,2019-12-20,"(758.0, 927.5]",6,14,-8
31248.0,2019-12-20,"(927.5, 1097.0]",4,7,-3
31249.0,2019-12-20,"(438.312, 611.0]",2,3,-1
31249.0,2019-12-20,"(611.0, 783.0]",5,9,-4
31249.0,2019-12-20,"(783.0, 955.0]",5,10,-5
31249.0,2019-12-20,"(955.0, 1127.0]",4,7,-3
31250.0,2019-12-20,"(419.122, 639.5]",15,18,-3
31250.0,2019-12-20,"(639.5, 859.0]",5,10,-5
31250.0,2019-12-20,"(859.0, 1078.5]",5,15,-10
31250.0,2019-12-20,"(1078.5, 1298.0]",1,3,-2
31251.0,2019-12-20,"(364.955, 627.25]",12,17,-5
31251.0,2019-12-20,"(627.25, 888.5]",4,8,-4
31251.0,2019-12-20,"(888.5, 1149.75]",2,14,-12
31251.0,2019-12-20,"(1149.75, 1411.0]",1,3,-2
31252.0,2019-12-20,"(490.244, 680.0]",9,10,-1
31252.0,2019-12-20,"(680.0, 869.0]",3,6,-3
31252.0,2019-12-20,"(869.0, 1058.0]",3,9,-6
31252.0,2019-12-20,"(1058.0, 1247.0]",2,6,-4
31253.0,2019-12-20,"(398.044, 638.0]",13,14,-1
31253.0,2019-12-20,"(638.0, 877.0]",2,5,-3
31253.0,2019-12-20,"(877.0, 1116.0]",7,23,-16
31253.0,2019-12-20,"(1116.0, 1355.0]",1,4,-3
31254.0,2019-12-20,"(344.5, 672.0]",10,2,8
31254.0,2019-12-20,"(672.0, 999.5]",9,13,-4
31254.0,2019-12-20,"(999.5, 1327.0]",7,19,-12
31255.0,2019-12-20,"(428.324, 598.0]",14,17,-3
31255.0,2019-12-20,"(767.0, 936.0]",4,2,2
31255.0,2019-12-20,"(936.0, 1105.0]",3,6,-3
31256.0,2019-12-20,"(268.034, 510.5]",5,6,-1
31256.0,2019-12-20,"(510.5, 752.0]",9,11,-2
31256.0,2019-12-20,"(752.0, 993.5]",5,9,-4
31256.0,2019-12-20,"(993.5, 1235.0]",7,11,-4
31257.0,2019-12-20,"(8.627, 353.25]",1,3,-2
31257.0,2019-12-20,"(353.25, 696.5]",13,24,-11
31257.0,2019-12-20,"(696.5, 1039.75]",11,21,-10
31257.0,2019-12-20,"(1039.75, 1383.0]",8,18,-10
31258.0,2019-12-20,"(62.015, 309.25]",1,2,-1
31258.0,2019-12-20,"(309.25, 555.5]",1,2,-1
31258.0,2019-12-20,"(555.5, 801.75]",5,12,-7
31258.0,2019-12-20,"(801.75, 1048.0]",25,38,-13
31259.0,2019-12-20,"(487.441, 627.75]",8,8,0
31259.0,2019-12-20,"(627.75, 767.5]",1,1,0
31259.0,2019-12-20,"(767.5, 907.25]",1,1,0
31259.0,2019-12-20,"(907.25, 1047.0]",1,6,-5
31260.0,2019-12-20,"(334.988, 589.0]",10,11,-1
31260.0,2019-12-20,"(589.0, 842.0]",4,9,-5
31260.0,2019-12-20,"(842.0, 1095.0]",1,5,-4
31261.0,2019-12-20,"(431.434, 573.5]",7,7,0
31261.0,2019-12-20,"(715.0, 856.5]",1,4,-3
31261.0,2019-12-20,"(856.5, 998.0]",1,3,-2
31262.0,2019-12-20,"(332.138, 548.5]",5,8,-3
31262.0,2019-12-20,"(548.5, 764.0]",1,7,-6
31262.0,2019-12-20,"(764.0, 979.5]",3,4,-1
31262.0,2019-12-20,"(979.5, 1195.0]",4,8,-4
31263.0,2019-12-20,"(351.96, 613.0]",14,20,-6
31263.0,2019-12-20,"(613.0, 873.0]",6,11,-5
31263.0,2019-12-20,"(873.0, 1133.0]",4,20,-16
31263.0,2019-12-20,"(1133.0, 1393.0]",1,4,-3
31264.0,2019-12-20,"(356.967, 616.25]",13,21,-8
31264.0,2019-12-20,"(616.25, 874.5]",5,7,-2
31264.0,2019-12-20,"(874.5, 1132.75]",8,19,-11
31265.0,2019-12-20,"(15.578, 372.5]",1,3,-2
31265.0,2019-12-20,"(372.5, 728.0]",14,28,-14
31265.0,2019-12-20,"(728.0, 1083.5]",19,32,-13
31265.0,2019-12-20,"(1083.5, 1439.0]",9,15,-6
31266.0,2019-12-20,"(2.632, 346.0]",1,5,-4
31266.0,2019-12-20,"(346.0, 688.0]",7,22,-15
31266.0,2019-12-20,"(688.0, 1030.0]",19,30,-11
31266.0,2019-12-20,"(1030.0, 1372.0]",14,25,-11
31267.0,2019-12-20,"(412.09, 640.5]",16,27,-11
31267.0,2019-12-20,"(640.5, 868.0]",7,18,-11
31267.0,2019-12-20,"(868.0, 1095.5]",6,13,-7
31267.0,2019-12-20,"(1095.5, 1323.0]",7,13,-6
31268.0,2019-12-20,"(335.948, 600.0]",15,30,-15
31268.0,2019-12-20,"(600.0, 863.0]",9,14,-5
31268.0,2019-12-20,"(863.0, 1126.0]",17,22,-5
31268.0,2019-12-20,"(1126.0, 1389.0]",9,17,-8
31269.0,2019-12-20,"(382.972, 641.0]",9,13,-4
31269.0,2019-12-20,"(641.0, 898.0]",5,12,-7
31269.0,2019-12-20,"(898.0, 1155.0]",9,12,-3
31269.0,2019-12-20,"(1155.0, 1412.0]",2,7,-5
31270.0,2019-12-20,"(334.934, 602.5]",8,13,-5
31270.0,2019-12-20,"(602.5, 869.0]",6,13,-7
31270.0,2019-12-20,"(869.0, 1135.5]",8,15,-7
31271.0,2019-12-20,"(462.273, 644.75]",12,15,-3
31271.0,2019-12-20,"(644.75, 826.5]",5,12,-7
31271.0,2019-12-20,"(826.5, 1008.25]",6,15,-9
31271.0,2019-12-20,"(1008.25, 1190.0]",1,8,-7
31272.0,2019-12-20,"(309.084, 539.0]",12,13,-1
31272.0,2019-12-20,"(539.0, 768.0]",8,9,-1
31272.0,2019-12-20,"(768.0, 997.0]",14,28,-14
31272.0,2019-12-20,"(997.0, 1226.0]",2,9,-7
31273.0,2019-12-20,"(516.416, 663.0]",1,5,-4
31273.0,2019-12-20,"(809.0, 955.0]",1,1,0
31273.0,2019-12-20,"(955.0, 1101.0]",2,3,-1
31274.0,2019-12-20,"(467.066, 701.5]",11,13,-2
31274.0,2019-12-20,"(701.5, 935.0]",7,11,-4
31274.0,2019-12-20,"(935.0, 1168.5]",4,8,-4
31274.0,2019-12-20,"(1168.5, 1402.0]",2,9,-7
31275.0,2019-12-20,"(346.943, 612.25]",11,19,-8
31275.0,2019-12-20,"(612.25, 876.5]",3,6,-3
31275.0,2019-12-20,"(876.5, 1140.75]",10,19,-9
31275.0,2019-12-20,"(1140.75, 1405.0]",7,13,-6
31276.0,2019-12-20,"(408.179, 614.25]",15,17,-2
31276.0,2019-12-20,"(614.25, 819.5]",4,7,-3
31276.0,2019-12-20,"(819.5, 1024.75]",2,13,-11
31276.0,2019-12-20,"(1024.75, 1230.0]",7,14,-7
31277.0,2019-12-20,"(405.11, 628.5]",21,24,-3
31277.0,2019-12-20,"(628.5, 851.0]",8,10,-2
31277.0,2019-12-20,"(851.0, 1073.5]",3,9,-6
31277.0,2019-12-20,"(1073.5, 1296.0]",2,4,-2
31278.0,2019-12-20,"(400.101, 625.75]",3,11,-8
31278.0,2019-12-20,"(625.75, 850.5]",12,20,-8
31278.0,2019-12-20,"(850.5, 1075.25]",7,19,-12
31278.0,2019-12-20,"(1075.25, 1300.0]",7,11,-4
31279.0,2019-12-20,"(14.925, 284.75]",2,2,0
31279.0,2019-12-20,"(284.75, 553.5]",10,12,-2
31279.0,2019-12-20,"(553.5, 822.25]",7,9,-2
31279.0,2019-12-20,"(822.25, 1091.0]",7,28,-21
31280.0,2019-12-20,"(102.675, 435.25]",1,4,-3
31280.0,2019-12-20,"(435.25, 766.5]",4,16,-12
31280.0,2019-12-20,"(766.5, 1097.75]",6,10,-4
31280.0,2019-12-20,"(1097.75, 1429.0]",5,7,-2
31000.0,2019-12-21,"(960.25, 1244.0]",1,1,0
31001.0,2019-12-21,"(919.75, 949.0]",1,1,0
,,,,1.0,
,,,,1.0,
31003.0,2019-12-21,"(813.0, 950.0]",1,1,0
31004.0,2019-12-21,"(1200.25, 1331.0]",2,2,0
31005.0,2019-12-21,"(664.337, 830.75]",2,4,-2
31005.0,2019-12-21,"(830.75, 996.5]",6,10,-4
31005.0,2019-12-21,"(996.5, 1162.25]",2,6,-4
31006.0,2019-12-21,"(595.338, 761.5]",1,1,0
31006.0,2019-12-21,"(761.5, 927.0]",2,3,-1
31006.0,2019-12-21,"(927.0, 1092.5]",2,2,0
31007.0,2019-12-21,"(712.274, 894.5]",3,4,-1
31007.0,2019-12-21,"(894.5, 1076.0]",1,1,0
31009.0,2019-12-21,"(876.75, 1169.0]",1,1,0
31010.0,2019-12-21,"(860.486, 989.5]",2,3,-1
31010.0,2019-12-21,"(1246.5, 1375.0]",1,1,0
31011.0,2019-12-21,"(905.938, 921.5]",2,3,-1
31011.0,2019-12-21,"(952.5, 968.0]",1,1,0
31012.0,2019-12-21,"(116.97, 124.5]",1,1,0
31013.0,2019-12-21,"(560.294, 737.5]",1,1,0
31013.0,2019-12-21,"(914.0, 1090.5]",2,1,1
31013.0,2019-12-21,"(1090.5, 1267.0]",1,3,-2
31014.0,2019-12-21,"(635.214, 832.5]",4,5,-1
31014.0,2019-12-21,"(832.5, 1029.0]",5,7,-2
31014.0,2019-12-21,"(1029.0, 1225.5]",1,2,-1
31014.0,2019-12-21,"(1225.5, 1422.0]",1,1,0
31015.0,2019-12-21,"(267.25, 496.5]",2,1,1
31015.0,2019-12-21,"(496.5, 725.75]",1,2,-1
31015.0,2019-12-21,"(725.75, 955.0]",1,1,0
31016.0,2019-12-21,"(827.75, 873.5]",1,2,-1
31017.0,2019-12-21,"(481.5, 642.0]",1,1,0
31018.0,2019-12-21,"(-0.541, 135.25]",2,3,-1
31018.0,2019-12-21,"(405.75, 541.0]",1,1,0
31019.0,2019-12-21,"(632.5, 696.0]",1,1,0
31019.0,2019-12-21,"(759.5, 823.0]",1,1,0
31020.0,2019-12-21,"(513.471, 646.25]",1,1,0
31021.0,2019-12-21,"(625.259, 811.25]",1,3,-2
31021.0,2019-12-21,"(811.25, 996.5]",2,5,-3
31022.0,2019-12-21,"(415.75, 704.5]",3,1,2
31022.0,2019-12-21,"(704.5, 993.25]",1,3,-2
31022.0,2019-12-21,"(993.25, 1282.0]",2,3,-1
31023.0,2019-12-21,"(550.5, 751.25]",4,1,3
31024.0,2019-12-21,"(503.093, 730.75]",1,2,-1
31024.0,2019-12-21,"(730.75, 957.5]",1,2,-1
31025.0,2019-12-21,"(813.714, 885.5]",1,2,-1
31025.0,2019-12-21,"(1028.5, 1100.0]",1,2,-1
,,,,1.0,
,,,,2.0,
31027.0,2019-12-21,"(669.75, 687.0]",1,1,0
31028.0,2019-12-21,"(901.0, 1070.5]",1,1,0
31029.0,2019-12-21,"(638.387, 792.25]",2,6,-4
31029.0,2019-12-21,"(792.25, 945.5]",2,3,-1
31030.0,2019-12-21,"(812.0, 962.0]",1,2,-1
31031.0,2019-12-21,"(593.32, 764.0]",1,2,-1
,,,,1.0,
,,,,1.0,
31033.0,2019-12-21,"(529.872, 562.0]",1,1,0
31033.0,2019-12-21,"(626.0, 658.0]",2,1,1
31034.0,2019-12-21,"(152.296, 329.0]",1,1,0
31035.0,2019-12-21,"(448.588, 552.0]",1,1,0
31035.0,2019-12-21,"(655.0, 758.0]",1,2,-1
,,,,1.0,
,,,,2.0,
31037.0,2019-12-21,"(556.385, 710.75]",4,4,0
31037.0,2019-12-21,"(710.75, 864.5]",2,3,-1
31037.0,2019-12-21,"(864.5, 1018.25]",4,7,-3
31037.0,2019-12-21,"(1018.25, 1172.0]",2,3,-1
,,,,1.0,
,,,,2.0,
31039.0,2019-12-21,"(477.505, 601.75]",1,2,-1
31039.0,2019-12-21,"(601.75, 725.5]",1,1,0
31039.0,2019-12-21,"(725.5, 849.25]",1,3,-2
31039.0,2019-12-21,"(849.25, 973.0]",2,5,-3
,,,,2.0,
31041.0,2019-12-21,"(656.25, 875.0]",1,1,0
31042.0,2019-12-21,"(694.417, 840.75]",5,5,0
31042.0,2019-12-21,"(840.75, 986.5]",1,2,-1
31042.0,2019-12-21,"(986.5, 1132.25]",1,1,0
31042.0,2019-12-21,"(1132.25, 1278.0]",3,4,-1
,,,,1.0,
,,,,2.0,
31044.0,2019-12-21,"(549.66, 635.0]",1,1,0
31044.0,2019-12-21,"(635.0, 720.0]",2,2,0
31044.0,2019-12-21,"(720.0, 805.0]",1,1,0
31045.0,2019-12-21,"(777.75, 898.5]",1,1,0
31045.0,2019-12-21,"(1019.25, 1140.0]",2,1,1
31046.0,2019-12-21,"(841.0, 970.0]",2,1,1
31047.0,2019-12-21,"(847.0, 1025.0]",2,1,1
,,,,1.0,
,,,,1.0,
,,,,1.0,
31049.0,2019-12-21,"(633.75, 792.5]",2,1,1
31050.0,2019-12-21,"(909.0, 981.0]",1,1,0
31051.0,2019-12-21,"(1053.0, 1262.0]",1,1,0
31052.0,2019-12-21,"(828.0, 889.0]",1,2,-1
,,,,2.0,
,,,,1.0,
,,,,2.0,
31055.0,2019-12-21,"(756.646, 845.5]",1,2,-1
31055.0,2019-12-21,"(1022.5, 1111.0]",2,3,-1
31056.0,2019-12-21,"(835.5, 1058.0]",1,1,0
31057.0,2019-12-21,"(547.5, 821.25]",1,1,0
31057.0,2019-12-21,"(821.25, 1095.0]",1,1,0
,,,,2.0,
,,,,2.0,
31060.0,2019-12-21,"(558.504, 683.0]",3,5,-2
31060.0,2019-12-21,"(931.0, 1055.0]",1,1,0
31061.0,2019-12-21,"(455.25, 607.0]",1,1,0
31062.0,2019-12-21,"(870.75, 969.0]",2,2,0
31063.0,2019-12-21,"(630.25, 684.5]",1,1,0
31063.0,2019-12-21,"(738.75, 793.0]",1,1,0
31064.0,2019-12-21,"(655.699, 731.25]",1,1,0
31064.0,2019-12-21,"(806.5, 881.75]",1,2,-1
31064.0,2019-12-21,"(881.75, 957.0]",6,10,-4
,,,,1.0,
,,,,1.0,
,,,,2.0,
,,,,2.0,
31068.0,2019-12-21,"(785.25, 1047.0]",1,1,0
31069.0,2019-12-21,"(884.75, 1014.0]",1,1,0
31070.0,2019-12-21,"(673.5, 705.0]",2,2,0
31071.0,2019-12-21,"(404.366, 563.5]",1,1,0
31071.0,2019-12-21,"(722.0, 880.5]",1,1,0
31071.0,2019-12-21,"(880.5, 1039.0]",2,1,1
,,,,2.0,
31073.0,2019-12-21,"(1016.938, 1032.5]",1,2,-1
31073.0,2019-12-21,"(1063.5, 1079.0]",1,1,0
,,,,2.0,
31075.0,2019-12-21,"(120.469, 253.75]",1,1,0
31075.0,2019-12-21,"(519.25, 652.0]",1,2,-1
,,,,2.0,
31077.0,2019-12-21,"(38.666, 373.5]",1,1,0
31077.0,2019-12-21,"(707.0, 1040.5]",6,2,4
31077.0,2019-12-21,"(1040.5, 1374.0]",6,20,-14
,,,,2.0,
31079.0,2019-12-21,"(949.0, 1019.0]",1,1,0
31080.0,2019-12-21,"(525.151, 738.25]",1,3,-2
31080.0,2019-12-21,"(950.5, 1162.75]",1,2,-1
31080.0,2019-12-21,"(1162.75, 1375.0]",2,2,0
31081.0,2019-12-21,"(1066.0, 1254.0]",1,1,0
31082.0,2019-12-21,"(504.653, 591.75]",1,1,0
31082.0,2019-12-21,"(765.25, 852.0]",1,2,-1
,,,,2.0,
31084.0,2019-12-21,"(175.83, 469.5]",1,1,0
31084.0,2019-12-21,"(469.5, 762.0]",1,1,0
31084.0,2019-12-21,"(762.0, 1054.5]",1,1,0
31084.0,2019-12-21,"(1054.5, 1347.0]",1,3,-2
,,,,1.0,
,,,,1.0,
,,,,2.0,
31086.0,2019-12-21,"(715.99, 718.5]",1,1,0
,,,,1.0,
,,,,1.0,
31088.0,2019-12-21,"(505.415, 652.25]",2,2,0
31088.0,2019-12-21,"(944.75, 1091.0]",2,2,0
31089.0,2019-12-21,"(331.5, 641.0]",1,2,-1
31089.0,2019-12-21,"(641.0, 950.5]",2,3,-1
31089.0,2019-12-21,"(950.5, 1260.0]",3,6,-3
,,,,2.0,
31091.0,2019-12-21,"(175.903, 451.25]",1,1,0
31091.0,2019-12-21,"(725.5, 999.75]",1,4,-3
31091.0,2019-12-21,"(999.75, 1274.0]",1,2,-1
31092.0,2019-12-21,"(934.5, 1053.0]",1,1,0
31093.0,2019-12-21,"(885.0, 1053.5]",1,1,0
31093.0,2019-12-21,"(1053.5, 1222.0]",1,3,-2
,,,,2.0,
,,,,2.0,
31096.0,2019-12-21,"(565.5, 754.0]",1,1,0
31097.0,2019-12-21,"(919.713, 991.75]",1,2,-1
31097.0,2019-12-21,"(1135.25, 1207.0]",1,1,0
,,,,1.0,
,,,,1.0,
,,,,1.0,
31099.0,2019-12-21,"(1102.5, 1175.0]",1,2,-1
31100.0,2019-12-21,"(771.75, 962.5]",3,4,-1
31101.0,2019-12-21,"(18.586, 373.5]",4,4,0
31101.0,2019-12-21,"(373.5, 727.0]",28,34,-6
31101.0,2019-12-21,"(727.0, 1080.5]",44,65,-21
31101.0,2019-12-21,"(1080.5, 1434.0]",15,28,-13
31102.0,2019-12-21,"(44.611, 393.25]",1,3,-2
31102.0,2019-12-21,"(393.25, 740.5]",1,6,-5
31102.0,2019-12-21,"(740.5, 1087.75]",3,13,-10
31102.0,2019-12-21,"(1087.75, 1435.0]",5,11,-6
31103.0,2019-12-21,"(60.77, 369.5]",2,3,-1
31103.0,2019-12-21,"(369.5, 677.0]",3,12,-9
31103.0,2019-12-21,"(677.0, 984.5]",5,14,-9
31103.0,2019-12-21,"(984.5, 1292.0]",4,8,-4
31104.0,2019-12-21,"(383.5, 729.0]",8,8,0
31104.0,2019-12-21,"(729.0, 1074.5]",11,20,-9
31104.0,2019-12-21,"(1074.5, 1420.0]",4,22,-18
31105.0,2019-12-21,"(679.0, 910.0]",1,2,-1
31105.0,2019-12-21,"(910.0, 1141.0]",1,1,0
31106.0,2019-12-21,"(706.608, 805.0]",1,3,-2
31106.0,2019-12-21,"(1001.0, 1099.0]",1,2,-1
31107.0,2019-12-21,"(0.616, 348.0]",2,4,-2
31107.0,2019-12-21,"(348.0, 694.0]",3,11,-8
31107.0,2019-12-21,"(694.0, 1040.0]",11,25,-14
31107.0,2019-12-21,"(1040.0, 1386.0]",10,16,-6
31108.0,2019-12-21,"(6.581, 362.75]",1,4,-3
31108.0,2019-12-21,"(362.75, 717.5]",3,7,-4
31108.0,2019-12-21,"(717.5, 1072.25]",10,20,-10
31108.0,2019-12-21,"(1072.25, 1427.0]",4,6,-2
31109.0,2019-12-21,"(-0.423, 356.75]",2,3,-1
31109.0,2019-12-21,"(356.75, 712.5]",4,9,-5
31109.0,2019-12-21,"(712.5, 1068.25]",13,26,-13
31109.0,2019-12-21,"(1068.25, 1424.0]",10,17,-7
31110.0,2019-12-21,"(138.874, 421.5]",2,3,-1
31110.0,2019-12-21,"(421.5, 703.0]",6,10,-4
31110.0,2019-12-21,"(703.0, 984.5]",9,22,-13
31110.0,2019-12-21,"(984.5, 1266.0]",5,10,-5
31111.0,2019-12-21,"(63.63, 407.5]",2,3,-1
31111.0,2019-12-21,"(407.5, 750.0]",6,8,-2
31111.0,2019-12-21,"(750.0, 1092.5]",11,20,-9
31111.0,2019-12-21,"(1092.5, 1435.0]",6,10,-4
31112.0,2019-12-21,"(542.405, 691.75]",3,6,-3
31112.0,2019-12-21,"(989.25, 1138.0]",1,1,0
31113.0,2019-12-21,"(6.613, 354.75]",3,4,-1
31113.0,2019-12-21,"(354.75, 701.5]",3,8,-5
31113.0,2019-12-21,"(701.5, 1048.25]",4,12,-8
31113.0,2019-12-21,"(1048.25, 1395.0]",3,7,-4
31114.0,2019-12-21,"(14.634, 357.5]",1,6,-5
31114.0,2019-12-21,"(357.5, 699.0]",5,14,-9
31114.0,2019-12-21,"(699.0, 1040.5]",16,27,-11
31114.0,2019-12-21,"(1040.5, 1382.0]",5,14,-9
31115.0,2019-12-21,"(8.714, 331.5]",1,3,-2
31115.0,2019-12-21,"(331.5, 653.0]",1,6,-5
31115.0,2019-12-21,"(653.0, 974.5]",5,12,-7
31115.0,2019-12-21,"(974.5, 1296.0]",5,10,-5
31116.0,2019-12-21,"(113.744, 429.0]",1,1,0
31116.0,2019-12-21,"(429.0, 743.0]",6,14,-8
31116.0,2019-12-21,"(743.0, 1057.0]",14,27,-13
31116.0,2019-12-21,"(1057.0, 1371.0]",6,7,-1
31117.0,2019-12-21,"(38.641, 379.75]",2,3,-1
31117.0,2019-12-21,"(379.75, 719.5]",1,14,-13
31117.0,2019-12-21,"(719.5, 1059.25]",5,16,-11
31117.0,2019-12-21,"(1059.25, 1399.0]",5,10,-5
31118.0,2019-12-21,"(694.25, 895.5]",3,3,0
31118.0,2019-12-21,"(895.5, 1096.75]",4,7,-3
31118.0,2019-12-21,"(1096.75, 1298.0]",1,7,-6
31119.0,2019-12-21,"(250.939, 517.25]",2,6,-4
31119.0,2019-12-21,"(517.25, 782.5]",8,15,-7
31119.0,2019-12-21,"(782.5, 1047.75]",4,9,-5
31119.0,2019-12-21,"(1047.75, 1313.0]",9,14,-5
31120.0,2019-12-21,"(55.679, 387.25]",2,4,-2
31120.0,2019-12-21,"(387.25, 717.5]",1,5,-4
31120.0,2019-12-21,"(717.5, 1047.75]",6,10,-4
31120.0,2019-12-21,"(1047.75, 1378.0]",7,9,-2
31121.0,2019-12-21,"(35.612, 384.0]",3,4,-1
31121.0,2019-12-21,"(384.0, 731.0]",4,11,-7
31121.0,2019-12-21,"(731.0, 1078.0]",6,12,-6
31121.0,2019-12-21,"(1078.0, 1425.0]",6,8,-2
31122.0,2019-12-21,"(81.814, 379.5]",2,2,0
31122.0,2019-12-21,"(379.5, 676.0]",2,6,-4
31122.0,2019-12-21,"(676.0, 972.5]",2,4,-2
31122.0,2019-12-21,"(972.5, 1269.0]",3,8,-5
31123.0,2019-12-21,"(2.638, 344.5]",1,2,-1
31123.0,2019-12-21,"(344.5, 685.0]",2,10,-8
31123.0,2019-12-21,"(685.0, 1025.5]",3,10,-7
31123.0,2019-12-21,"(1025.5, 1366.0]",3,9,-6
31124.0,2019-12-21,"(1.564, 362.0]",3,6,-3
31124.0,2019-12-21,"(362.0, 721.0]",6,25,-19
31124.0,2019-12-21,"(721.0, 1080.0]",18,41,-23
31124.0,2019-12-21,"(1080.0, 1439.0]",3,19,-16
31125.0,2019-12-21,"(44.729, 363.75]",1,2,-1
31125.0,2019-12-21,"(363.75, 681.5]",1,4,-3
31125.0,2019-12-21,"(681.5, 999.25]",12,29,-17
31125.0,2019-12-21,"(999.25, 1317.0]",10,13,-3
31126.0,2019-12-21,"(88.66, 425.0]",2,2,0
31126.0,2019-12-21,"(425.0, 760.0]",3,18,-15
31126.0,2019-12-21,"(760.0, 1095.0]",8,18,-10
31126.0,2019-12-21,"(1095.0, 1430.0]",3,11,-8
,,,,2.0,
31128.0,2019-12-21,"(349.948, 614.0]",4,8,-4
31128.0,2019-12-21,"(614.0, 877.0]",5,9,-4
31128.0,2019-12-21,"(877.0, 1140.0]",7,12,-5
31128.0,2019-12-21,"(1140.0, 1403.0]",4,7,-3
31129.0,2019-12-21,"(521.227, 715.25]",2,6,-4
31129.0,2019-12-21,"(715.25, 908.5]",4,5,-1
31129.0,2019-12-21,"(908.5, 1101.75]",5,6,-1
31129.0,2019-12-21,"(1101.75, 1295.0]",6,7,-1
31130.0,2019-12-21,"(546.151, 759.25]",3,6,-3
31130.0,2019-12-21,"(759.25, 971.5]",2,4,-2
31130.0,2019-12-21,"(971.5, 1183.75]",2,3,-1
31130.0,2019-12-21,"(1183.75, 1396.0]",3,4,-1
31131.0,2019-12-21,"(191.147, 405.25]",1,1,0
31131.0,2019-12-21,"(405.25, 618.5]",1,2,-1
31131.0,2019-12-21,"(831.75, 1045.0]",2,6,-4
31200.0,2019-12-21,"(35.646, 375.5]",4,6,-2
31200.0,2019-12-21,"(375.5, 714.0]",17,21,-4
31200.0,2019-12-21,"(714.0, 1052.5]",24,39,-15
31200.0,2019-12-21,"(1052.5, 1391.0]",3,7,-4
31201.0,2019-12-21,"(358.25, 707.5]",17,1,16
31201.0,2019-12-21,"(707.5, 1056.75]",37,29,8
31201.0,2019-12-21,"(1056.75, 1406.0]",4,70,-66
31202.0,2019-12-21,"(359.0, 715.0]",4,2,2
31202.0,2019-12-21,"(715.0, 1071.0]",21,9,12
31202.0,2019-12-21,"(1071.0, 1427.0]",8,34,-26
31203.0,2019-12-21,"(84.662, 420.5]",1,2,-1
31203.0,2019-12-21,"(420.5, 755.0]",12,20,-8
31203.0,2019-12-21,"(755.0, 1089.5]",17,33,-16
31203.0,2019-12-21,"(1089.5, 1424.0]",22,40,-18
31204.0,2019-12-21,"(108.835, 401.25]",1,1,0
31204.0,2019-12-21,"(401.25, 692.5]",1,4,-3
31204.0,2019-12-21,"(692.5, 983.75]",5,9,-4
31204.0,2019-12-21,"(983.75, 1275.0]",4,8,-4
31205.0,2019-12-21,"(416.035, 658.25]",3,3,0
31205.0,2019-12-21,"(658.25, 899.5]",1,3,-2
31205.0,2019-12-21,"(899.5, 1140.75]",2,6,-4
31205.0,2019-12-21,"(1140.75, 1382.0]",1,4,-3
,,,,2.0,
31207.0,2019-12-21,"(518.75, 787.5]",1,1,0
31207.0,2019-12-21,"(787.5, 1056.25]",2,3,-1
31207.0,2019-12-21,"(1056.25, 1325.0]",1,4,-3
31208.0,2019-12-21,"(491.156, 703.0]",1,2,-1
31208.0,2019-12-21,"(703.0, 914.0]",1,1,0
31208.0,2019-12-21,"(914.0, 1125.0]",2,2,0
31208.0,2019-12-21,"(1125.0, 1336.0]",1,1,0
31209.0,2019-12-21,"(559.417, 705.75]",3,5,-2
31209.0,2019-12-21,"(705.75, 851.5]",1,2,-1
31209.0,2019-12-21,"(851.5, 997.25]",2,3,-1
31209.0,2019-12-21,"(997.25, 1143.0]",2,2,0
31211.0,2019-12-21,"(570.0, 855.0]",1,1,0
31211.0,2019-12-21,"(855.0, 1140.0]",3,1,2
31212.0,2019-12-21,"(377.25, 704.5]",5,1,4
31212.0,2019-12-21,"(704.5, 1031.75]",11,9,2
31212.0,2019-12-21,"(1031.75, 1359.0]",3,18,-15
31213.0,2019-12-21,"(514.246, 703.5]",3,4,-1
31213.0,2019-12-21,"(892.0, 1080.5]",2,1,1
31213.0,2019-12-21,"(1080.5, 1269.0]",2,3,-1
31214.0,2019-12-21,"(47.618, 394.5]",1,1,0
31214.0,2019-12-21,"(394.5, 740.0]",6,18,-12
31214.0,2019-12-21,"(740.0, 1085.5]",20,33,-13
31214.0,2019-12-21,"(1085.5, 1431.0]",10,14,-4
31215.0,2019-12-21,"(559.49, 687.5]",1,1,0
31215.0,2019-12-21,"(687.5, 815.0]",3,4,-1
31215.0,2019-12-21,"(815.0, 942.5]",1,1,0
31215.0,2019-12-21,"(942.5, 1070.0]",5,6,-1
,,,,1.0,
,,,,1.0,
,,,,1.0,
31217.0,2019-12-21,"(13.877, 295.75]",1,1,0
31217.0,2019-12-21,"(857.25, 1138.0]",2,1,1
31218.0,2019-12-21,"(652.651, 740.25]",2,2,0
31218.0,2019-12-21,"(740.25, 827.5]",4,6,-2
31218.0,2019-12-21,"(827.5, 914.75]",1,2,-1
31218.0,2019-12-21,"(914.75, 1002.0]",3,4,-1
31219.0,2019-12-21,"(130.896, 408.0]",1,1,0
31219.0,2019-12-21,"(684.0, 960.0]",2,3,-1
31219.0,2019-12-21,"(960.0, 1236.0]",2,8,-6
31220.0,2019-12-21,"(1011.0, 1348.0]",1,1,0
31221.0,2019-12-21,"(354.998, 606.5]",3,4,-1
31221.0,2019-12-21,"(606.5, 857.0]",3,6,-3
31221.0,2019-12-21,"(857.0, 1107.5]",9,14,-5
31221.0,2019-12-21,"(1107.5, 1358.0]",2,4,-2
31222.0,2019-12-21,"(584.166, 793.5]",4,5,-1
31222.0,2019-12-21,"(793.5, 1002.0]",3,3,0
31222.0,2019-12-21,"(1002.0, 1210.5]",2,3,-1
31223.0,2019-12-21,"(45.663, 381.25]",2,3,-1
31223.0,2019-12-21,"(381.25, 715.5]",10,16,-6
31223.0,2019-12-21,"(715.5, 1049.75]",6,20,-14
31223.0,2019-12-21,"(1049.75, 1384.0]",1,6,-5
31224.0,2019-12-21,"(417.987, 672.25]",3,5,-2
31224.0,2019-12-21,"(925.5, 1178.75]",1,2,-1
31224.0,2019-12-21,"(1178.75, 1432.0]",1,1,0
31225.0,2019-12-21,"(539.327, 708.25]",3,3,0
31225.0,2019-12-21,"(708.25, 876.5]",3,4,-1
31225.0,2019-12-21,"(876.5, 1044.75]",2,3,-1
31225.0,2019-12-21,"(1044.75, 1213.0]",2,2,0
31226.0,2019-12-21,"(635.433, 777.75]",2,4,-2
31226.0,2019-12-21,"(919.5, 1061.25]",1,2,-1
31226.0,2019-12-21,"(1061.25, 1203.0]",1,2,-1
31227.0,2019-12-21,"(610.25, 879.5]",2,2,0
31227.0,2019-12-21,"(879.5, 1148.75]",2,6,-4
31227.0,2019-12-21,"(1148.75, 1418.0]",3,4,-1
31228.0,2019-12-21,"(49.689, 378.75]",1,5,-4
31228.0,2019-12-21,"(378.75, 706.5]",13,18,-5
31228.0,2019-12-21,"(706.5, 1034.25]",15,26,-11
31228.0,2019-12-21,"(1034.25, 1362.0]",10,21,-11
31229.0,2019-12-21,"(36.599, 388.25]",2,4,-2
31229.0,2019-12-21,"(388.25, 738.5]",15,33,-18
31229.0,2019-12-21,"(738.5, 1088.75]",22,40,-18
31229.0,2019-12-21,"(1088.75, 1439.0]",8,18,-10
31230.0,2019-12-21,"(312.91, 586.5]",1,4,-3
31230.0,2019-12-21,"(586.5, 859.0]",4,11,-7
31230.0,2019-12-21,"(859.0, 1131.5]",10,17,-7
31230.0,2019-12-21,"(1131.5, 1404.0]",4,7,-3
31231.0,2019-12-21,"(769.796, 821.0]",1,2,-1
31231.0,2019-12-21,"(872.0, 923.0]",1,1,0
31231.0,2019-12-21,"(923.0, 974.0]",1,3,-2
31232.0,2019-12-21,"(398.5, 742.0]",6,1,5
31232.0,2019-12-21,"(742.0, 1085.5]",22,8,14
31232.0,2019-12-21,"(1085.5, 1429.0]",5,29,-24
31233.0,2019-12-21,"(508.102, 733.5]",4,6,-2
31233.0,2019-12-21,"(733.5, 958.0]",7,8,-1
31233.0,2019-12-21,"(958.0, 1182.5]",3,5,-2
31233.0,2019-12-21,"(1182.5, 1407.0]",4,10,-6
31234.0,2019-12-21,"(563.16, 774.0]",1,2,-1
31234.0,2019-12-21,"(774.0, 984.0]",3,9,-6
31234.0,2019-12-21,"(984.0, 1194.0]",2,4,-2
31235.0,2019-12-21,"(853.5, 964.75]",2,3,-1
31235.0,2019-12-21,"(964.75, 1076.0]",1,2,-1
31236.0,2019-12-21,"(555.0, 832.0]",1,1,0
31236.0,2019-12-21,"(832.0, 1109.0]",4,3,1
31237.0,2019-12-21,"(472.348, 636.0]",3,5,-2
31237.0,2019-12-21,"(636.0, 799.0]",2,6,-4
31237.0,2019-12-21,"(799.0, 962.0]",4,9,-5
31237.0,2019-12-21,"(962.0, 1125.0]",3,5,-2
31238.0,2019-12-21,"(52.682, 383.5]",1,1,0
31238.0,2019-12-21,"(383.5, 713.0]",1,2,-1
31239.0,2019-12-21,"(352.75, 668.5]",4,1,3
31239.0,2019-12-21,"(668.5, 984.25]",8,4,4
31239.0,2019-12-21,"(984.25, 1300.0]",7,13,-6
31240.0,2019-12-21,"(568.552, 681.0]",5,10,-5
31240.0,2019-12-21,"(793.0, 905.0]",1,1,0
31240.0,2019-12-21,"(905.0, 1017.0]",2,6,-4
31241.0,2019-12-21,"(82.673, 415.75]",2,6,-4
31241.0,2019-12-21,"(415.75, 747.5]",5,15,-10
31241.0,2019-12-21,"(747.5, 1079.25]",6,15,-9
31241.0,2019-12-21,"(1079.25, 1411.0]",2,5,-3
31242.0,2019-12-21,"(300.317, 471.75]",2,2,0
31242.0,2019-12-21,"(471.75, 642.5]",2,2,0
31242.0,2019-12-21,"(642.5, 813.25]",1,2,-1
31242.0,2019-12-21,"(813.25, 984.0]",1,2,-1
31243.0,2019-12-21,"(652.5, 811.0]",4,2,2
31243.0,2019-12-21,"(969.5, 1128.0]",8,6,2
31244.0,2019-12-21,"(572.365, 731.75]",1,2,-1
31244.0,2019-12-21,"(1049.25, 1208.0]",1,1,0
31245.0,2019-12-21,"(51.857, 338.75]",1,3,-2
31245.0,2019-12-21,"(624.5, 910.25]",7,2,5
31245.0,2019-12-21,"(910.25, 1196.0]",5,18,-13
31246.0,2019-12-21,"(433.049, 671.75]",7,8,-1
31246.0,2019-12-21,"(671.75, 909.5]",12,20,-8
31246.0,2019-12-21,"(909.5, 1147.25]",9,17,-8
31246.0,2019-12-21,"(1147.25, 1385.0]",2,7,-5
31247.0,2019-12-21,"(533.147, 747.25]",11,16,-5
31247.0,2019-12-21,"(747.25, 960.5]",10,21,-11
31247.0,2019-12-21,"(960.5, 1173.75]",9,17,-8
31247.0,2019-12-21,"(1173.75, 1387.0]",2,5,-3
31248.0,2019-12-21,"(482.049, 720.75]",5,9,-4
31248.0,2019-12-21,"(720.75, 958.5]",4,8,-4
31248.0,2019-12-21,"(958.5, 1196.25]",3,10,-7
31248.0,2019-12-21,"(1196.25, 1434.0]",4,6,-2
31249.0,2019-12-21,"(773.0, 956.0]",5,2,3
31249.0,2019-12-21,"(956.0, 1139.0]",5,9,-4
31249.0,2019-12-21,"(1139.0, 1322.0]",6,9,-3
31250.0,2019-12-21,"(585.732, 653.0]",3,4,-1
31250.0,2019-12-21,"(653.0, 720.0]",1,2,-1
31250.0,2019-12-21,"(720.0, 787.0]",3,5,-2
31250.0,2019-12-21,"(787.0, 854.0]",1,2,-1
31251.0,2019-12-21,"(85.794, 388.5]",3,4,-1
31251.0,2019-12-21,"(388.5, 690.0]",2,7,-5
31251.0,2019-12-21,"(690.0, 991.5]",5,12,-7
31251.0,2019-12-21,"(991.5, 1293.0]",9,15,-6
31252.0,2019-12-21,"(807.565, 916.75]",1,2,-1
31252.0,2019-12-21,"(1025.5, 1134.25]",1,2,-1
31253.0,2019-12-21,"(494.342, 659.5]",2,2,0
31253.0,2019-12-21,"(659.5, 824.0]",1,2,-1
31253.0,2019-12-21,"(988.5, 1153.0]",1,1,0
31254.0,2019-12-21,"(501.064, 736.0]",2,4,-2
31254.0,2019-12-21,"(736.0, 970.0]",2,3,-1
31254.0,2019-12-21,"(970.0, 1204.0]",1,1,0
31254.0,2019-12-21,"(1204.0, 1438.0]",4,6,-2
31255.0,2019-12-21,"(512.573, 619.75]",1,3,-2
31255.0,2019-12-21,"(619.75, 726.5]",2,2,0
31255.0,2019-12-21,"(833.25, 940.0]",1,1,0
31256.0,2019-12-21,"(827.42, 973.0]",1,2,-1
31256.0,2019-12-21,"(973.0, 1118.0]",1,1,0
31257.0,2019-12-21,"(398.967, 658.25]",1,2,-1
31257.0,2019-12-21,"(916.5, 1174.75]",3,2,1
31257.0,2019-12-21,"(1174.75, 1433.0]",1,6,-5
31258.0,2019-12-21,"(571.164, 781.0]",6,19,-13
31258.0,2019-12-21,"(781.0, 990.0]",5,15,-10
31258.0,2019-12-21,"(990.0, 1199.0]",2,3,-1
31258.0,2019-12-21,"(1199.0, 1408.0]",6,13,-7
,,,,1.0,
,,,,5.0,
31260.0,2019-12-21,"(-0.11, 278.5]",1,2,-1
31260.0,2019-12-21,"(556.0, 833.5]",1,2,-1
31261.0,2019-12-21,"(647.641, 737.75]",3,3,0
31261.0,2019-12-21,"(737.75, 827.5]",6,7,-1
31262.0,2019-12-21,"(623.197, 824.75]",3,3,0
31262.0,2019-12-21,"(824.75, 1025.5]",10,11,-1
31262.0,2019-12-21,"(1025.5, 1226.25]",2,3,-1
31263.0,2019-12-21,"(557.133, 774.75]",4,8,-4
31263.0,2019-12-21,"(774.75, 991.5]",5,7,-2
31263.0,2019-12-21,"(991.5, 1208.25]",6,11,-5
31263.0,2019-12-21,"(1208.25, 1425.0]",9,9,0
31264.0,2019-12-21,"(617.225, 811.75]",7,9,-2
31264.0,2019-12-21,"(811.75, 1005.5]",6,6,0
31264.0,2019-12-21,"(1005.5, 1199.25]",2,2,0
31264.0,2019-12-21,"(1199.25, 1393.0]",1,2,-1
31265.0,2019-12-21,"(27.649, 366.75]",1,3,-2
31265.0,2019-12-21,"(366.75, 704.5]",5,7,-2
31265.0,2019-12-21,"(704.5, 1042.25]",2,10,-8
31265.0,2019-12-21,"(1042.25, 1380.0]",9,12,-3
31266.0,2019-12-21,"(123.721, 444.75]",1,4,-3
31266.0,2019-12-21,"(444.75, 764.5]",7,21,-14
31266.0,2019-12-21,"(764.5, 1084.25]",10,20,-10
31266.0,2019-12-21,"(1084.25, 1404.0]",8,14,-6
31267.0,2019-12-21,"(5.751, 319.25]",1,2,-1
31267.0,2019-12-21,"(319.25, 631.5]",3,5,-2
31267.0,2019-12-21,"(631.5, 943.75]",4,9,-5
31267.0,2019-12-21,"(943.75, 1256.0]",4,11,-7
31268.0,2019-12-21,"(96.71, 420.5]",1,3,-2
31268.0,2019-12-21,"(420.5, 743.0]",8,11,-3
31268.0,2019-12-21,"(743.0, 1065.5]",10,16,-6
31268.0,2019-12-21,"(1065.5, 1388.0]",6,9,-3
31269.0,2019-12-21,"(63.868, 348.0]",1,1,0
31269.0,2019-12-21,"(348.0, 631.0]",1,1,0
31269.0,2019-12-21,"(631.0, 914.0]",5,7,-2
31269.0,2019-12-21,"(914.0, 1197.0]",4,11,-7
31270.0,2019-12-21,"(568.26, 754.0]",3,4,-1
31270.0,2019-12-21,"(754.0, 939.0]",3,7,-4
31270.0,2019-12-21,"(1124.0, 1309.0]",4,3,1
31271.0,2019-12-21,"(725.415, 872.25]",2,9,-7
31271.0,2019-12-21,"(872.25, 1018.5]",8,17,-9
31271.0,2019-12-21,"(1018.5, 1164.75]",2,3,-1
31272.0,2019-12-21,"(673.464, 808.0]",4,5,-1
31272.0,2019-12-21,"(808.0, 942.0]",2,2,0
31272.0,2019-12-21,"(942.0, 1076.0]",2,5,-3
31272.0,2019-12-21,"(1076.0, 1210.0]",4,6,-2
31273.0,2019-12-21,"(577.734, 644.5]",8,16,-8
31273.0,2019-12-21,"(644.5, 711.0]",2,4,-2
31273.0,2019-12-21,"(777.5, 844.0]",2,3,-1
31274.0,2019-12-21,"(539.467, 673.25]",3,4,-1
31274.0,2019-12-21,"(673.25, 806.5]",5,5,0
31274.0,2019-12-21,"(806.5, 939.75]",3,4,-1
31274.0,2019-12-21,"(939.75, 1073.0]",3,4,-1
31275.0,2019-12-21,"(4.672, 338.0]",2,3,-1
31275.0,2019-12-21,"(338.0, 670.0]",3,5,-2
31275.0,2019-12-21,"(670.0, 1002.0]",4,12,-8
31275.0,2019-12-21,"(1002.0, 1334.0]",6,10,-4
31276.0,2019-12-21,"(514.081, 744.75]",2,2,0
31276.0,2019-12-21,"(744.75, 974.5]",2,2,0
31276.0,2019-12-21,"(974.5, 1204.25]",11,14,-3
31277.0,2019-12-21,"(503.0, 751.5]",3,1,2
31277.0,2019-12-21,"(751.5, 1000.0]",3,6,-3
31278.0,2019-12-21,"(173.786, 478.5]",1,1,0
31278.0,2019-12-21,"(478.5, 782.0]",10,18,-8
31278.0,2019-12-21,"(782.0, 1085.5]",7,14,-7
31278.0,2019-12-21,"(1085.5, 1389.0]",5,10,-5
31279.0,2019-12-21,"(663.0, 884.0]",1,1,0
31280.0,2019-12-21,"(427.0, 722.0]",5,1,4
31280.0,2019-12-21,"(722.0, 1017.0]",1,11,-10
31280.0,2019-12-21,"(1017.0, 1312.0]",2,3,-1
,,,,1.0,
,,,,1.0,
31001.0,2019-12-22,"(1002.924, 1022.0]",1,2,-1
31001.0,2019-12-22,"(1060.0, 1079.0]",1,1,0
31002.0,2019-12-22,"(675.841, 715.75]",1,1,0
31003.0,2019-12-22,"(651.412, 799.0]",2,3,-1
31003.0,2019-12-22,"(799.0, 946.0]",1,2,-1
,,,,1.0,
,,,,1.0,
31005.0,2019-12-22,"(637.213, 834.75]",3,5,-2
31005.0,2019-12-22,"(834.75, 1031.5]",2,2,0
31005.0,2019-12-22,"(1228.25, 1425.0]",2,1,1
31006.0,2019-12-22,"(606.0, 909.0]",1,1,0
31006.0,2019-12-22,"(909.0, 1212.0]",3,1,2
31007.0,2019-12-22,"(1236.0, 1362.0]",1,1,0
31009.0,2019-12-22,"(609.75, 813.0]",1,1,0
31010.0,2019-12-22,"(713.5, 898.0]",1,1,0
31010.0,2019-12-22,"(898.0, 1082.5]",2,2,0
31010.0,2019-12-22,"(1082.5, 1267.0]",2,4,-2
31011.0,2019-12-22,"(449.452, 587.0]",1,2,-1
31011.0,2019-12-22,"(587.0, 724.0]",1,2,-1
31011.0,2019-12-22,"(724.0, 861.0]",2,2,0
31011.0,2019-12-22,"(861.0, 998.0]",1,2,-1
,,,,2.0,
31013.0,2019-12-22,"(1024.25, 1162.0]",2,1,1
31014.0,2019-12-22,"(462.126, 681.5]",3,4,-1
31014.0,2019-12-22,"(681.5, 900.0]",4,8,-4
31014.0,2019-12-22,"(900.0, 1118.5]",5,6,-1
31014.0,2019-12-22,"(1118.5, 1337.0]",1,1,0
31015.0,2019-12-22,"(813.25, 949.5]",1,2,-1
31015.0,2019-12-22,"(949.5, 1085.75]",1,1,0
31016.0,2019-12-22,"(737.996, 739.0]",1,1,0
31017.0,2019-12-22,"(909.925, 928.75]",1,1,0
,,,,1.0,
,,,,1.0,
31019.0,2019-12-22,"(344.25, 649.5]",1,1,0
31019.0,2019-12-22,"(649.5, 954.75]",2,1,1
31019.0,2019-12-22,"(954.75, 1260.0]",1,3,-2
31020.0,2019-12-22,"(610.5, 681.75]",1,1,0
31021.0,2019-12-22,"(648.391, 801.25]",1,2,-1
31021.0,2019-12-22,"(801.25, 953.5]",1,2,-1
31022.0,2019-12-22,"(471.34, 637.0]",2,2,0
31022.0,2019-12-22,"(637.0, 802.0]",1,2,-1
31022.0,2019-12-22,"(802.0, 967.0]",1,4,-3
31023.0,2019-12-22,"(618.262, 803.5]",3,4,-1
31023.0,2019-12-22,"(803.5, 988.0]",1,3,-2
31024.0,2019-12-22,"(600.182, 805.5]",1,2,-1
31024.0,2019-12-22,"(805.5, 1010.0]",1,2,-1
31025.0,2019-12-22,"(798.554, 910.5]",1,2,-1
31026.0,2019-12-22,"(550.489, 678.75]",1,2,-1
,,,,2.0,
31028.0,2019-12-22,"(575.618, 671.5]",1,1,0
31028.0,2019-12-22,"(671.5, 767.0]",1,1,0
31029.0,2019-12-22,"(751.5, 835.0]",1,1,0
31029.0,2019-12-22,"(918.5, 1002.0]",2,2,0
31030.0,2019-12-22,"(674.486, 803.5]",1,3,-2
31030.0,2019-12-22,"(803.5, 932.0]",1,1,0
31030.0,2019-12-22,"(1060.5, 1189.0]",1,1,0
31031.0,2019-12-22,"(705.567, 814.25]",1,2,-1
31031.0,2019-12-22,"(1030.75, 1139.0]",1,1,0
31032.0,2019-12-22,"(796.5, 1046.0]",2,1,1
,,,,1.0,
,,,,1.0,
31034.0,2019-12-22,"(815.5, 929.0]",2,2,0
,,,,1.0,
,,,,1.0,
,,,,2.0,
,,,,1.0,
,,,,2.0,
31037.0,2019-12-22,"(556.308, 730.0]",2,3,-1
31037.0,2019-12-22,"(730.0, 903.0]",1,2,-1
31037.0,2019-12-22,"(1076.0, 1249.0]",3,3,0
,,,,2.0,
31039.0,2019-12-22,"(586.395, 738.25]",2,4,-2
31039.0,2019-12-22,"(889.5, 1040.75]",1,4,-3
31039.0,2019-12-22,"(1040.75, 1192.0]",1,1,0
31040.0,2019-12-22,"(595.464, 730.0]",1,1,0
31040.0,2019-12-22,"(730.0, 864.0]",1,1,0
31040.0,2019-12-22,"(864.0, 998.0]",1,1,0
31040.0,2019-12-22,"(998.0, 1132.0]",1,3,-2
31041.0,2019-12-22,"(863.812, 911.0]",2,2,0
31041.0,2019-12-22,"(911.0, 958.0]",2,3,-1
31041.0,2019-12-22,"(958.0, 1005.0]",1,1,0
31042.0,2019-12-22,"(531.218, 727.5]",2,3,-1
31042.0,2019-12-22,"(727.5, 923.0]",3,4,-1
31042.0,2019-12-22,"(923.0, 1118.5]",1,3,-2
31042.0,2019-12-22,"(1118.5, 1314.0]",2,3,-1
31043.0,2019-12-22,"(735.947, 749.25]",1,1,0
31044.0,2019-12-22,"(805.5, 881.0]",1,1,0
31044.0,2019-12-22,"(881.0, 956.5]",3,2,1
31044.0,2019-12-22,"(956.5, 1032.0]",1,3,-2
,,,,1.0,
,,,,1.0,
31046.0,2019-12-22,"(738.5, 950.0]",1,1,0
31046.0,2019-12-22,"(950.0, 1161.5]",2,2,0
31046.0,2019-12-22,"(1161.5, 1373.0]",2,3,-1
,,,,1.0,
,,,,4.0,
31048.0,2019-12-22,"(344.0, 516.0]",1,1,0
31048.0,2019-12-22,"(516.0, 688.0]",1,1,0
,,,,2.0,
31050.0,2019-12-22,"(777.5, 798.0]",1,1,0
31051.0,2019-12-22,"(860.634, 952.5]",1,3,-2
31051.0,2019-12-22,"(1135.5, 1227.0]",1,1,0
31052.0,2019-12-22,"(651.0, 868.0]",1,1,0
,,,,1.0,
,,,,3.0,
,,,,2.0,
31055.0,2019-12-22,"(683.715, 755.25]",2,4,-2
31055.0,2019-12-22,"(755.25, 826.5]",1,1,0
31055.0,2019-12-22,"(897.75, 969.0]",1,1,0
31056.0,2019-12-22,"(680.527, 799.25]",2,4,-2
31056.0,2019-12-22,"(799.25, 917.5]",1,2,-1
31056.0,2019-12-22,"(1035.75, 1154.0]",1,1,0
,,,,2.0,
31058.0,2019-12-22,"(65.006, 314.5]",1,1,0
31058.0,2019-12-22,"(811.5, 1060.0]",1,1,0
,,,,2.0,
31060.0,2019-12-22,"(742.5, 990.0]",1,1,0
31061.0,2019-12-22,"(414.75, 553.0]",1,1,0
31062.0,2019-12-22,"(958.0, 989.0]",1,1,0
,,,,2.0,
31064.0,2019-12-22,"(499.478, 630.5]",1,2,-1
31064.0,2019-12-22,"(761.0, 891.5]",5,13,-8
31064.0,2019-12-22,"(891.5, 1022.0]",5,8,-3
31065.0,2019-12-22,"(454.029, 697.75]",1,2,-1
31065.0,2019-12-22,"(697.75, 940.5]",2,4,-2
,,,,1.0,
,,,,1.0,
,,,,2.0,
31068.0,2019-12-22,"(858.75, 1145.0]",1,1,0
31069.0,2019-12-22,"(608.181, 813.75]",1,2,-1
31069.0,2019-12-22,"(813.75, 1018.5]",1,1,0
31069.0,2019-12-22,"(1223.25, 1428.0]",1,1,0
31070.0,2019-12-22,"(963.5, 1070.0]",2,1,1
31071.0,2019-12-22,"(443.016, 690.0]",2,3,-1
31071.0,2019-12-22,"(936.0, 1182.0]",1,3,-2
31071.0,2019-12-22,"(1182.0, 1428.0]",2,2,0
,,,,2.0,
,,,,2.0,
31074.0,2019-12-22,"(691.565, 800.75]",1,1,0
31074.0,2019-12-22,"(1018.25, 1127.0]",1,1,0
,,,,2.0,
31076.0,2019-12-22,"(834.495, 961.25]",1,1,0
31076.0,2019-12-22,"(1087.5, 1213.75]",1,1,0
31077.0,2019-12-22,"(45.709, 369.75]",1,1,0
31077.0,2019-12-22,"(692.5, 1015.25]",10,7,3
31077.0,2019-12-22,"(1015.25, 1338.0]",2,11,-9
,,,,2.0,
31079.0,2019-12-22,"(43.789, 347.75]",1,2,-1
31079.0,2019-12-22,"(650.5, 953.25]",1,2,-1
31079.0,2019-12-22,"(953.25, 1256.0]",1,2,-1
31080.0,2019-12-22,"(820.0, 879.0]",1,1,0
31080.0,2019-12-22,"(879.0, 938.0]",1,2,-1
31081.0,2019-12-22,"(1042.75, 1107.0]",1,1,0
31082.0,2019-12-22,"(666.75, 889.0]",1,1,0
,,,,2.0,
31084.0,2019-12-22,"(704.25, 906.5]",1,1,0
31084.0,2019-12-22,"(1108.75, 1311.0]",1,1,0
,,,,2.0,
31086.0,2019-12-22,"(779.823, 824.25]",2,2,0
31086.0,2019-12-22,"(912.75, 957.0]",1,1,0
31087.0,2019-12-22,"(551.589, 654.75]",1,1,0
31087.0,2019-12-22,"(860.25, 963.0]",1,1,0
31088.0,2019-12-22,"(986.25, 1315.0]",1,1,0
31089.0,2019-12-22,"(854.594, 956.5]",2,4,-2
31089.0,2019-12-22,"(956.5, 1058.0]",2,3,-1
31089.0,2019-12-22,"(1159.5, 1261.0]",1,1,0
31090.0,2019-12-22,"(621.0, 828.0]",1,1,0
31091.0,2019-12-22,"(1204.5, 1394.0]",2,1,1
,,,,2.0,
,,,,1.0,
,,,,1.0,
,,,,1.0,
31094.0,2019-12-22,"(1069.25, 1159.0]",1,1,0
,,,,2.0,
31096.0,2019-12-22,"(934.813, 981.75]",1,1,0
31096.0,2019-12-22,"(1028.5, 1075.25]",1,1,0
31097.0,2019-12-22,"(586.219, 782.25]",2,3,-1
31097.0,2019-12-22,"(782.25, 977.5]",3,5,-2
31097.0,2019-12-22,"(977.5, 1172.75]",1,2,-1
31098.0,2019-12-22,"(917.5, 1042.0]",2,1,1
31099.0,2019-12-22,"(770.466, 904.5]",1,2,-1
31099.0,2019-12-22,"(904.5, 1038.0]",1,1,0
31100.0,2019-12-22,"(831.75, 1109.0]",2,1,1
31101.0,2019-12-22,"(14.711, 338.25]",4,8,-4
31101.0,2019-12-22,"(338.25, 660.5]",3,6,-3
31101.0,2019-12-22,"(660.5, 982.75]",22,30,-8
31101.0,2019-12-22,"(982.75, 1305.0]",8,20,-12
31102.0,2019-12-22,"(104.105, 328.75]",1,2,-1
31102.0,2019-12-22,"(552.5, 776.25]",1,1,0
31103.0,2019-12-22,"(565.212, 763.0]",3,9,-6
31103.0,2019-12-22,"(763.0, 960.0]",3,12,-9
31103.0,2019-12-22,"(1157.0, 1354.0]",5,3,2
31104.0,2019-12-22,"(39.727, 359.25]",3,9,-6
31104.0,2019-12-22,"(359.25, 677.5]",2,4,-2
31104.0,2019-12-22,"(677.5, 995.75]",9,25,-16
31104.0,2019-12-22,"(995.75, 1314.0]",10,21,-11
31105.0,2019-12-22,"(781.488, 910.0]",1,2,-1
31105.0,2019-12-22,"(1038.0, 1166.0]",1,1,0
31106.0,2019-12-22,"(636.739, 702.25]",1,1,0
31107.0,2019-12-22,"(588.231, 781.25]",3,13,-10
31107.0,2019-12-22,"(781.25, 973.5]",2,8,-6
31107.0,2019-12-22,"(973.5, 1165.75]",4,9,-5
31107.0,2019-12-22,"(1165.75, 1358.0]",4,7,-3
31108.0,2019-12-22,"(29.697, 356.75]",2,3,-1
31108.0,2019-12-22,"(356.75, 682.5]",4,7,-3
31108.0,2019-12-22,"(682.5, 1008.25]",17,31,-14
31108.0,2019-12-22,"(1008.25, 1334.0]",4,15,-11
31109.0,2019-12-22,"(16.665, 351.75]",1,3,-2
31109.0,2019-12-22,"(351.75, 685.5]",3,11,-8
31109.0,2019-12-22,"(685.5, 1019.25]",8,12,-4
31109.0,2019-12-22,"(1019.25, 1353.0]",8,12,-4
31110.0,2019-12-22,"(273.066, 507.5]",2,3,-1
31110.0,2019-12-22,"(507.5, 741.0]",9,17,-8
31110.0,2019-12-22,"(741.0, 974.5]",7,20,-13
31110.0,2019-12-22,"(974.5, 1208.0]",6,9,-3
31111.0,2019-12-22,"(83.716, 406.0]",1,2,-1
31111.0,2019-12-22,"(406.0, 727.0]",3,6,-3
31111.0,2019-12-22,"(727.0, 1048.0]",5,16,-11
31111.0,2019-12-22,"(1048.0, 1369.0]",3,4,-1
31112.0,2019-12-22,"(98.108, 322.0]",1,1,0
31112.0,2019-12-22,"(545.0, 768.0]",2,3,-1
31112.0,2019-12-22,"(768.0, 991.0]",5,6,-1
31113.0,2019-12-22,"(12.782, 318.5]",1,1,0
31113.0,2019-12-22,"(318.5, 623.0]",2,4,-2
31113.0,2019-12-22,"(623.0, 927.5]",2,11,-9
31113.0,2019-12-22,"(927.5, 1232.0]",3,6,-3
31114.0,2019-12-22,"(171.899, 448.25]",1,2,-1
31114.0,2019-12-22,"(448.25, 723.5]",2,7,-5
31114.0,2019-12-22,"(723.5, 998.75]",8,13,-5
31114.0,2019-12-22,"(998.75, 1274.0]",8,18,-10
31115.0,2019-12-22,"(711.5, 1033.75]",3,1,2
31115.0,2019-12-22,"(1033.75, 1356.0]",4,2,2
31116.0,2019-12-22,"(12.741, 328.75]",2,3,-1
31116.0,2019-12-22,"(328.75, 643.5]",2,4,-2
31116.0,2019-12-22,"(643.5, 958.25]",8,12,-4
31116.0,2019-12-22,"(958.25, 1273.0]",8,17,-9
31117.0,2019-12-22,"(36.628, 381.0]",1,2,-1
31117.0,2019-12-22,"(724.0, 1067.0]",7,8,-1
31118.0,2019-12-22,"(396.001, 646.75]",1,2,-1
31118.0,2019-12-22,"(646.75, 896.5]",4,10,-6
31118.0,2019-12-22,"(896.5, 1146.25]",8,12,-4
31118.0,2019-12-22,"(1146.25, 1396.0]",2,4,-2
31119.0,2019-12-22,"(22.693, 350.75]",1,4,-3
31119.0,2019-12-22,"(350.75, 677.5]",4,9,-5
31119.0,2019-12-22,"(677.5, 1004.25]",6,19,-13
31119.0,2019-12-22,"(1004.25, 1331.0]",1,4,-3
31120.0,2019-12-22,"(107.875, 390.25]",2,2,0
31120.0,2019-12-22,"(671.5, 952.75]",4,11,-7
31120.0,2019-12-22,"(952.75, 1234.0]",6,11,-5
31121.0,2019-12-22,"(629.5, 859.0]",5,2,3
31121.0,2019-12-22,"(859.0, 1088.5]",1,9,-8
31121.0,2019-12-22,"(1088.5, 1318.0]",1,6,-5
31122.0,2019-12-22,"(112.914, 385.5]",1,1,0
31122.0,2019-12-22,"(385.5, 657.0]",3,4,-1
31122.0,2019-12-22,"(657.0, 928.5]",1,10,-9
31122.0,2019-12-22,"(928.5, 1200.0]",4,9,-5
31123.0,2019-12-22,"(86.667, 421.25]",1,2,-1
31123.0,2019-12-22,"(421.25, 754.5]",1,8,-7
31123.0,2019-12-22,"(754.5, 1087.75]",4,14,-10
31123.0,2019-12-22,"(1087.75, 1421.0]",4,6,-2
31124.0,2019-12-22,"(379.0, 726.0]",7,3,4
31124.0,2019-12-22,"(726.0, 1073.0]",17,18,-1
31124.0,2019-12-22,"(1073.0, 1420.0]",9,33,-24
31125.0,2019-12-22,"(399.0, 735.0]",5,1,4
31125.0,2019-12-22,"(735.0, 1071.0]",17,13,4
31125.0,2019-12-22,"(1071.0, 1407.0]",11,38,-27
31126.0,2019-12-22,"(83.702, 409.5]",4,4,0
31126.0,2019-12-22,"(409.5, 734.0]",1,13,-12
31126.0,2019-12-22,"(734.0, 1058.5]",3,10,-7
31126.0,2019-12-22,"(1058.5, 1383.0]",8,12,-4
,,,,2.0,
31128.0,2019-12-22,"(362.75, 670.5]",3,2,1
31128.0,2019-12-22,"(670.5, 978.25]",5,5,0
31128.0,2019-12-22,"(978.25, 1286.0]",2,9,-7
31129.0,2019-12-22,"(622.39, 775.5]",6,14,-8
31129.0,2019-12-22,"(775.5, 928.0]",4,10,-6
31129.0,2019-12-22,"(928.0, 1080.5]",17,27,-10
31129.0,2019-12-22,"(1080.5, 1233.0]",5,11,-6
31130.0,2019-12-22,"(627.0, 875.5]",5,1,4
31130.0,2019-12-22,"(875.5, 1124.0]",1,2,-1
31131.0,2019-12-22,"(88.732, 407.0]",1,1,0
31131.0,2019-12-22,"(724.0, 1041.0]",7,2,5
31131.0,2019-12-22,"(1041.0, 1358.0]",1,14,-13
31200.0,2019-12-22,"(404.042, 644.5]",15,20,-5
31200.0,2019-12-22,"(644.5, 884.0]",41,65,-24
31200.0,2019-12-22,"(884.0, 1123.5]",14,28,-14
31200.0,2019-12-22,"(1123.5, 1363.0]",3,7,-4
31201.0,2019-12-22,"(8.575, 366.25]",4,6,-2
31201.0,2019-12-22,"(366.25, 722.5]",13,20,-7
31201.0,2019-12-22,"(722.5, 1078.75]",28,51,-23
31201.0,2019-12-22,"(1078.75, 1435.0]",7,17,-10
31202.0,2019-12-22,"(532.181, 737.75]",15,20,-5
31202.0,2019-12-22,"(737.75, 942.5]",13,22,-9
31202.0,2019-12-22,"(942.5, 1147.25]",10,20,-10
31202.0,2019-12-22,"(1147.25, 1352.0]",5,10,-5
31203.0,2019-12-22,"(20.66, 357.0]",2,6,-4
31203.0,2019-12-22,"(357.0, 692.0]",7,10,-3
31203.0,2019-12-22,"(692.0, 1027.0]",20,35,-15
31203.0,2019-12-22,"(1027.0, 1362.0]",15,33,-18
31204.0,2019-12-22,"(583.16, 794.0]",1,1,0
31204.0,2019-12-22,"(1214.0, 1424.0]",1,2,-1
31205.0,2019-12-22,"(659.5, 723.75]",3,1,2
,,,,1.0,
,,,,2.0,
31207.0,2019-12-22,"(55.938, 322.5]",1,2,-1
31207.0,2019-12-22,"(588.0, 853.5]",2,5,-3
31207.0,2019-12-22,"(853.5, 1119.0]",3,7,-4
31208.0,2019-12-22,"(942.0, 1043.5]",1,1,0
31208.0,2019-12-22,"(1043.5, 1145.0]",3,2,1
31209.0,2019-12-22,"(570.357, 731.75]",2,3,-1
31209.0,2019-12-22,"(892.5, 1053.25]",3,8,-5
31209.0,2019-12-22,"(1053.25, 1214.0]",1,5,-4
31211.0,2019-12-22,"(513.154, 725.5]",2,4,-2
31211.0,2019-12-22,"(725.5, 937.0]",2,6,-4
31211.0,2019-12-22,"(937.0, 1148.5]",1,2,-1
31212.0,2019-12-22,"(3.796, 306.0]",1,2,-1
31212.0,2019-12-22,"(306.0, 607.0]",5,5,0
31212.0,2019-12-22,"(607.0, 908.0]",9,18,-9
31212.0,2019-12-22,"(908.0, 1209.0]",9,20,-11
31213.0,2019-12-22,"(11.865, 296.75]",1,2,-1
31213.0,2019-12-22,"(864.25, 1148.0]",3,2,1
31214.0,2019-12-22,"(363.5, 718.0]",9,2,7
31214.0,2019-12-22,"(718.0, 1072.5]",15,14,1
31214.0,2019-12-22,"(1072.5, 1427.0]",3,35,-32
31215.0,2019-12-22,"(472.21, 670.5]",1,1,0
31215.0,2019-12-22,"(670.5, 868.0]",3,4,-1
31215.0,2019-12-22,"(868.0, 1065.5]",12,17,-5
31215.0,2019-12-22,"(1065.5, 1263.0]",5,5,0
31216.0,2019-12-22,"(836.685, 915.75]",3,5,-2
31216.0,2019-12-22,"(915.75, 994.5]",1,1,0
31216.0,2019-12-22,"(994.5, 1073.25]",1,1,0
31216.0,2019-12-22,"(1073.25, 1152.0]",1,1,0
31217.0,2019-12-22,"(921.97, 929.5]",1,1,0
31218.0,2019-12-22,"(18.074, 250.5]",1,1,0
31218.0,2019-12-22,"(713.5, 945.0]",4,11,-7
31219.0,2019-12-22,"(415.0, 681.0]",5,1,4
31219.0,2019-12-22,"(681.0, 947.0]",12,5,7
31219.0,2019-12-22,"(947.0, 1213.0]",11,22,-11
31220.0,2019-12-22,"(1189.75, 1281.0]",2,1,1
31221.0,2019-12-22,"(92.83, 386.5]",2,3,-1
31221.0,2019-12-22,"(386.5, 679.0]",4,7,-3
31221.0,2019-12-22,"(679.0, 971.5]",2,2,0
31221.0,2019-12-22,"(971.5, 1264.0]",4,8,-4
31222.0,2019-12-22,"(460.419, 606.25]",1,1,0
31222.0,2019-12-22,"(751.5, 896.75]",4,6,-2
31222.0,2019-12-22,"(896.75, 1042.0]",5,4,1
31223.0,2019-12-22,"(-0.365, 342.25]",1,2,-1
31223.0,2019-12-22,"(342.25, 683.5]",4,12,-8
31223.0,2019-12-22,"(683.5, 1024.75]",13,28,-15
31223.0,2019-12-22,"(1024.75, 1366.0]",5,11,-6
31224.0,2019-12-22,"(533.414, 680.5]",1,2,-1
31224.0,2019-12-22,"(680.5, 827.0]",2,2,0
31224.0,2019-12-22,"(827.0, 973.5]",1,2,-1
31224.0,2019-12-22,"(973.5, 1120.0]",1,2,-1
31225.0,2019-12-22,"(467.201, 667.75]",1,3,-2
31225.0,2019-12-22,"(667.75, 867.5]",4,4,0
31225.0,2019-12-22,"(867.5, 1067.25]",1,3,-2
31225.0,2019-12-22,"(1067.25, 1267.0]",1,3,-2
31226.0,2019-12-22,"(752.698, 828.5]",1,3,-2
31226.0,2019-12-22,"(828.5, 904.0]",1,1,0
31227.0,2019-12-22,"(442.242, 632.5]",2,3,-1
31227.0,2019-12-22,"(632.5, 822.0]",3,4,-1
31227.0,2019-12-22,"(822.0, 1011.5]",6,14,-8
31227.0,2019-12-22,"(1011.5, 1201.0]",5,6,-1
31228.0,2019-12-22,"(193.76, 505.0]",1,1,0
31228.0,2019-12-22,"(505.0, 815.0]",29,35,-6
31228.0,2019-12-22,"(815.0, 1125.0]",24,45,-21
31228.0,2019-12-22,"(1125.0, 1435.0]",10,16,-6
31229.0,2019-12-22,"(15.578, 372.5]",2,6,-4
31229.0,2019-12-22,"(372.5, 728.0]",13,33,-20
31229.0,2019-12-22,"(728.0, 1083.5]",19,38,-19
31229.0,2019-12-22,"(1083.5, 1439.0]",10,19,-9
31230.0,2019-12-22,"(566.2, 767.0]",2,10,-8
31230.0,2019-12-22,"(767.0, 967.0]",13,19,-6
31230.0,2019-12-22,"(967.0, 1167.0]",13,19,-6
31230.0,2019-12-22,"(1167.0, 1367.0]",1,4,-3
31231.0,2019-12-22,"(739.497, 865.75]",3,4,-1
31232.0,2019-12-22,"(595.238, 786.5]",1,2,-1
31232.0,2019-12-22,"(786.5, 977.0]",19,33,-14
31232.0,2019-12-22,"(977.0, 1167.5]",7,16,-9
31232.0,2019-12-22,"(1167.5, 1358.0]",2,3,-1
31233.0,2019-12-22,"(509.275, 691.25]",1,2,-1
31233.0,2019-12-22,"(691.25, 872.5]",3,4,-1
31233.0,2019-12-22,"(872.5, 1053.75]",3,3,0
31233.0,2019-12-22,"(1053.75, 1235.0]",1,4,-3
31234.0,2019-12-22,"(567.135, 784.25]",5,10,-5
31234.0,2019-12-22,"(784.25, 1000.5]",4,11,-7
31234.0,2019-12-22,"(1000.5, 1216.75]",3,4,-1
31235.0,2019-12-22,"(824.525, 943.75]",5,6,-1
31235.0,2019-12-22,"(943.75, 1062.5]",2,3,-1
31235.0,2019-12-22,"(1181.25, 1300.0]",2,3,-1
31236.0,2019-12-22,"(71.005, 320.75]",1,2,-1
31236.0,2019-12-22,"(569.5, 818.25]",2,3,-1
31236.0,2019-12-22,"(818.25, 1067.0]",4,8,-4
31237.0,2019-12-22,"(643.237, 834.75]",8,14,-6
31237.0,2019-12-22,"(834.75, 1025.5]",6,8,-2
31237.0,2019-12-22,"(1025.5, 1216.25]",2,6,-4
31237.0,2019-12-22,"(1216.25, 1407.0]",3,4,-1
31238.0,2019-12-22,"(53.902, 329.5]",1,1,0
31238.0,2019-12-22,"(604.0, 878.5]",2,1,1
31238.0,2019-12-22,"(878.5, 1153.0]",9,3,6
31239.0,2019-12-22,"(461.25, 755.5]",6,1,5
31239.0,2019-12-22,"(755.5, 1049.75]",6,7,-1
31239.0,2019-12-22,"(1049.75, 1344.0]",3,12,-9
31240.0,2019-12-22,"(938.0, 1041.0]",5,2,3
31240.0,2019-12-22,"(1041.0, 1144.0]",5,6,-1
31241.0,2019-12-22,"(61.662, 397.5]",2,4,-2
31241.0,2019-12-22,"(397.5, 732.0]",3,10,-7
31241.0,2019-12-22,"(732.0, 1066.5]",2,10,-8
31241.0,2019-12-22,"(1066.5, 1401.0]",9,11,-2
31242.0,2019-12-22,"(715.5, 865.0]",1,3,-2
31242.0,2019-12-22,"(1014.5, 1164.0]",2,4,-2
31243.0,2019-12-22,"(446.305, 620.75]",1,5,-4
31243.0,2019-12-22,"(620.75, 794.5]",3,3,0
31243.0,2019-12-22,"(794.5, 968.25]",10,13,-3
31243.0,2019-12-22,"(968.25, 1142.0]",3,7,-4
31244.0,2019-12-22,"(539.256, 726.0]",2,4,-2
31244.0,2019-12-22,"(726.0, 912.0]",4,10,-6
31244.0,2019-12-22,"(912.0, 1098.0]",1,1,0
31244.0,2019-12-22,"(1098.0, 1284.0]",3,4,-1
31245.0,2019-12-22,"(63.699, 390.25]",2,2,0
31245.0,2019-12-22,"(390.25, 715.5]",3,4,-1
31245.0,2019-12-22,"(715.5, 1040.75]",7,13,-6
31245.0,2019-12-22,"(1040.75, 1366.0]",3,10,-7
31246.0,2019-12-22,"(24.837, 316.75]",1,4,-3
31246.0,2019-12-22,"(316.75, 607.5]",1,2,-1
31246.0,2019-12-22,"(607.5, 898.25]",15,28,-13
31246.0,2019-12-22,"(898.25, 1189.0]",22,34,-12
31247.0,2019-12-22,"(566.227, 760.25]",2,5,-3
31247.0,2019-12-22,"(760.25, 953.5]",10,20,-10
31247.0,2019-12-22,"(953.5, 1146.75]",12,14,-2
31247.0,2019-12-22,"(1146.75, 1340.0]",2,5,-3
31248.0,2019-12-22,"(569.544, 684.0]",3,5,-2
31248.0,2019-12-22,"(684.0, 798.0]",4,4,0
31248.0,2019-12-22,"(912.0, 1026.0]",6,12,-6
31249.0,2019-12-22,"(516.501, 641.75]",2,3,-1
31249.0,2019-12-22,"(766.5, 891.25]",6,12,-6
31249.0,2019-12-22,"(891.25, 1016.0]",2,7,-5
31250.0,2019-12-22,"(486.0, 729.0]",1,1,0
31250.0,2019-12-22,"(729.0, 972.0]",3,1,2
31251.0,2019-12-22,"(449.0, 776.0]",3,1,2
31251.0,2019-12-22,"(776.0, 1103.0]",3,7,-4
31251.0,2019-12-22,"(1103.0, 1430.0]",1,8,-7
31252.0,2019-12-22,"(97.013, 344.75]",1,1,0
31252.0,2019-12-22,"(838.25, 1085.0]",2,5,-3
31253.0,2019-12-22,"(833.758, 894.5]",1,1,0
31253.0,2019-12-22,"(1015.5, 1076.0]",2,3,-1
31254.0,2019-12-22,"(349.5, 696.0]",1,1,0
31254.0,2019-12-22,"(696.0, 1042.5]",2,1,1
31255.0,2019-12-22,"(517.113, 739.75]",2,5,-3
31255.0,2019-12-22,"(961.5, 1183.25]",5,3,2
31255.0,2019-12-22,"(1183.25, 1405.0]",2,10,-8
31256.0,2019-12-22,"(622.25, 794.5]",2,1,1
31256.0,2019-12-22,"(794.5, 966.75]",3,2,1
31256.0,2019-12-22,"(966.75, 1139.0]",1,4,-3
31257.0,2019-12-22,"(80.044, 320.0]",1,1,0
31257.0,2019-12-22,"(559.0, 798.0]",2,4,-2
31257.0,2019-12-22,"(798.0, 1037.0]",4,10,-6
31258.0,2019-12-22,"(17.652, 356.0]",1,1,0
31258.0,2019-12-22,"(693.0, 1030.0]",18,6,12
31258.0,2019-12-22,"(1030.0, 1367.0]",6,52,-46
,,,,2.0,
31260.0,2019-12-22,"(690.331, 858.25]",4,6,-2
31260.0,2019-12-22,"(858.25, 1025.5]",1,1,0
31260.0,2019-12-22,"(1192.75, 1360.0]",3,1,2
31261.0,2019-12-22,"(21.999, 273.25]",4,5,-1
31262.0,2019-12-22,"(672.464, 807.0]",1,2,-1
31262.0,2019-12-22,"(807.0, 941.0]",2,4,-2
31262.0,2019-12-22,"(941.0, 1075.0]",2,3,-1
31262.0,2019-12-22,"(1075.0, 1209.0]",1,4,-3
31263.0,2019-12-22,"(380.08, 611.0]",2,5,-3
31263.0,2019-12-22,"(611.0, 841.0]",5,9,-4
31263.0,2019-12-22,"(841.0, 1071.0]",4,7,-3
31263.0,2019-12-22,"(1071.0, 1301.0]",6,11,-5
31264.0,2019-12-22,"(667.268, 851.0]",5,7,-2
31264.0,2019-12-22,"(851.0, 1034.0]",4,7,-3
31264.0,2019-12-22,"(1034.0, 1217.0]",2,2,0
31265.0,2019-12-22,"(505.24, 696.0]",2,11,-9
31265.0,2019-12-22,"(696.0, 886.0]",4,8,-4
31265.0,2019-12-22,"(886.0, 1076.0]",8,9,-1
31265.0,2019-12-22,"(1076.0, 1266.0]",4,13,-9
31266.0,2019-12-22,"(2.635, 345.25]",2,6,-4
31266.0,2019-12-22,"(345.25, 686.5]",1,6,-5
31266.0,2019-12-22,"(686.5, 1027.75]",12,30,-18
31266.0,2019-12-22,"(1027.75, 1369.0]",10,17,-7
31267.0,2019-12-22,"(121.706, 446.5]",1,1,0
31267.0,2019-12-22,"(446.5, 770.0]",6,8,-2
31267.0,2019-12-22,"(770.0, 1093.5]",5,15,-10
31267.0,2019-12-22,"(1093.5, 1417.0]",5,9,-4
31268.0,2019-12-22,"(130.757, 442.75]",2,5,-3
31268.0,2019-12-22,"(442.75, 753.5]",6,12,-6
31268.0,2019-12-22,"(753.5, 1064.25]",6,10,-4
31268.0,2019-12-22,"(1064.25, 1375.0]",4,8,-4
31269.0,2019-12-22,"(496.137, 712.75]",3,4,-1
31269.0,2019-12-22,"(928.5, 1144.25]",1,4,-3
31269.0,2019-12-22,"(1144.25, 1360.0]",2,3,-1
31270.0,2019-12-22,"(566.482, 696.5]",6,6,0
31270.0,2019-12-22,"(696.5, 826.0]",1,2,-1
31270.0,2019-12-22,"(826.0, 955.5]",1,1,0
31270.0,2019-12-22,"(955.5, 1085.0]",8,13,-5
31271.0,2019-12-22,"(762.658, 848.5]",1,2,-1
31271.0,2019-12-22,"(848.5, 934.0]",1,5,-4
31271.0,2019-12-22,"(934.0, 1019.5]",1,3,-2
31271.0,2019-12-22,"(1019.5, 1105.0]",1,5,-4
31272.0,2019-12-22,"(664.689, 742.75]",2,2,0
31272.0,2019-12-22,"(742.75, 820.5]",1,4,-3
31272.0,2019-12-22,"(820.5, 898.25]",6,6,0
31272.0,2019-12-22,"(898.25, 976.0]",6,7,-1
31273.0,2019-12-22,"(663.677, 744.75]",2,4,-2
31273.0,2019-12-22,"(906.25, 987.0]",3,1,2
31274.0,2019-12-22,"(178.984, 434.0]",1,1,0
31274.0,2019-12-22,"(434.0, 688.0]",4,6,-2
31274.0,2019-12-22,"(688.0, 942.0]",11,11,0
31274.0,2019-12-22,"(942.0, 1196.0]",4,7,-3
31275.0,2019-12-22,"(99.915, 372.25]",2,3,-1
31275.0,2019-12-22,"(372.25, 643.5]",2,4,-2
31275.0,2019-12-22,"(643.5, 914.75]",9,12,-3
31275.0,2019-12-22,"(914.75, 1186.0]",7,10,-3
31276.0,2019-12-22,"(876.821, 921.75]",1,1,0
31276.0,2019-12-22,"(921.75, 966.5]",2,4,-2
31276.0,2019-12-22,"(1011.25, 1056.0]",1,1,0
31277.0,2019-12-22,"(786.55, 899.5]",8,11,-3
31277.0,2019-12-22,"(899.5, 1012.0]",9,14,-5
31277.0,2019-12-22,"(1012.0, 1124.5]",1,3,-2
31277.0,2019-12-22,"(1124.5, 1237.0]",3,6,-3
31278.0,2019-12-22,"(448.0, 759.0]",7,1,6
31278.0,2019-12-22,"(759.0, 1070.0]",7,9,-2
31278.0,2019-12-22,"(1070.0, 1381.0]",2,13,-11
31279.0,2019-12-22,"(868.869, 901.75]",1,1,0
31279.0,2019-12-22,"(967.25, 1000.0]",2,3,-1
31280.0,2019-12-22,"(294.0, 561.0]",2,1,1
31280.0,2019-12-22,"(561.0, 828.0]",4,4,0
31280.0,2019-12-22,"(828.0, 1095.0]",2,9,-7
31000.0,2019-12-23,"(308.25, 411.0]",1,1,0
31001.0,2019-12-23,"(941.812, 989.0]",1,2,-1
31001.0,2019-12-23,"(989.0, 1036.0]",2,4,-2
31001.0,2019-12-23,"(1083.0, 1130.0]",1,1,0
31002.0,2019-12-23,"(531.471, 664.25]",2,5,-3
31002.0,2019-12-23,"(664.25, 796.5]",1,1,0
31002.0,2019-12-23,"(928.75, 1061.0]",3,3,0
31003.0,2019-12-23,"(420.276, 602.0]",2,2,0
31004.0,2019-12-23,"(867.836, 909.0]",1,2,-1
31004.0,2019-12-23,"(991.0, 1032.0]",2,3,-1
31005.0,2019-12-23,"(439.441, 579.75]",1,1,0
31005.0,2019-12-23,"(579.75, 719.5]",1,1,0
31005.0,2019-12-23,"(719.5, 859.25]",3,6,-3
31005.0,2019-12-23,"(859.25, 999.0]",4,5,-1
31006.0,2019-12-23,"(1003.675, 1085.25]",2,4,-2
31007.0,2019-12-23,"(369.116, 591.0]",1,7,-6
31007.0,2019-12-23,"(591.0, 812.0]",4,6,-2
31007.0,2019-12-23,"(812.0, 1033.0]",2,7,-5
31007.0,2019-12-23,"(1033.0, 1254.0]",3,6,-3
31009.0,2019-12-23,"(373.115, 595.25]",3,3,0
31009.0,2019-12-23,"(595.25, 816.5]",1,3,-2
31009.0,2019-12-23,"(816.5, 1037.75]",1,4,-3
31009.0,2019-12-23,"(1037.75, 1259.0]",1,1,0
31010.0,2019-12-23,"(423.452, 561.0]",1,1,0
31010.0,2019-12-23,"(561.0, 698.0]",1,2,-1
31010.0,2019-12-23,"(835.0, 972.0]",1,1,0
31011.0,2019-12-23,"(552.442, 692.5]",1,3,-2
31011.0,2019-12-23,"(971.5, 1111.0]",1,1,0
31012.0,2019-12-23,"(506.39, 659.5]",4,5,-1
31013.0,2019-12-23,"(1145.0, 1336.0]",2,1,1
31014.0,2019-12-23,"(401.233, 593.75]",5,7,-2
31014.0,2019-12-23,"(593.75, 785.5]",1,3,-2
31014.0,2019-12-23,"(785.5, 977.25]",3,5,-2
31014.0,2019-12-23,"(977.25, 1169.0]",7,8,-1
31015.0,2019-12-23,"(303.194, 505.5]",3,3,0
31015.0,2019-12-23,"(505.5, 707.0]",3,3,0
31015.0,2019-12-23,"(908.5, 1110.0]",6,12,-6
31016.0,2019-12-23,"(503.415, 650.25]",2,7,-5
31016.0,2019-12-23,"(650.25, 796.5]",3,3,0
31016.0,2019-12-23,"(942.75, 1089.0]",4,1,3
31017.0,2019-12-23,"(324.5, 643.0]",1,1,0
31017.0,2019-12-23,"(961.5, 1280.0]",1,1,0
31018.0,2019-12-23,"(936.0, 1055.0]",2,1,1
31019.0,2019-12-23,"(458.409, 606.75]",1,2,-1
31019.0,2019-12-23,"(606.75, 754.5]",1,1,0
31019.0,2019-12-23,"(902.25, 1050.0]",2,5,-3
31020.0,2019-12-23,"(878.5, 1134.75]",2,2,0
31021.0,2019-12-23,"(588.264, 773.0]",1,2,-1
31021.0,2019-12-23,"(773.0, 957.0]",1,2,-1
31021.0,2019-12-23,"(957.0, 1141.0]",3,4,-1
31022.0,2019-12-23,"(844.57, 952.5]",1,1,0
31022.0,2019-12-23,"(952.5, 1060.0]",1,1,0
31022.0,2019-12-23,"(1167.5, 1275.0]",1,1,0
31023.0,2019-12-23,"(746.0, 949.0]",2,1,1
31023.0,2019-12-23,"(949.0, 1152.0]",1,4,-3
,,,,1.0,
,,,,2.0,
31025.0,2019-12-23,"(655.532, 773.0]",1,1,0
31025.0,2019-12-23,"(773.0, 890.0]",1,2,-1
31025.0,2019-12-23,"(890.0, 1007.0]",1,1,0
,,,,1.0,
,,,,1.0,
31027.0,2019-12-23,"(795.75, 1061.0]",1,1,0
31028.0,2019-12-23,"(462.281, 642.75]",1,2,-1
31029.0,2019-12-23,"(838.0, 1011.0]",2,1,1
31029.0,2019-12-23,"(1011.0, 1184.0]",1,3,-2
31030.0,2019-12-23,"(918.0, 1156.0]",2,5,-3
31030.0,2019-12-23,"(1156.0, 1394.0]",3,1,2
31031.0,2019-12-23,"(917.5, 1124.25]",1,1,0
31031.0,2019-12-23,"(1124.25, 1331.0]",1,2,-1
,,,,1.0,
,,,,1.0,
31033.0,2019-12-23,"(560.789, 613.75]",1,1,0
31034.0,2019-12-23,"(561.488, 690.0]",1,2,-1
31034.0,2019-12-23,"(818.0, 946.0]",2,3,-1
31035.0,2019-12-23,"(14.724, 335.0]",1,1,0
31035.0,2019-12-23,"(654.0, 973.0]",1,2,-1
31035.0,2019-12-23,"(973.0, 1292.0]",2,2,0
31036.0,2019-12-23,"(603.602, 703.5]",1,2,-1
31036.0,2019-12-23,"(803.0, 902.5]",1,2,-1
31036.0,2019-12-23,"(902.5, 1002.0]",1,1,0
31037.0,2019-12-23,"(416.114, 638.5]",4,5,-1
31037.0,2019-12-23,"(860.0, 1081.5]",3,1,2
31038.0,2019-12-23,"(715.911, 738.25]",1,1,0
31039.0,2019-12-23,"(418.469, 551.75]",2,4,-2
31039.0,2019-12-23,"(551.75, 684.5]",2,2,0
31039.0,2019-12-23,"(684.5, 817.25]",2,2,0
31040.0,2019-12-23,"(450.155, 662.25]",1,1,0
31040.0,2019-12-23,"(873.5, 1084.75]",2,4,-2
31040.0,2019-12-23,"(1084.75, 1296.0]",1,2,-1
31041.0,2019-12-23,"(471.321, 641.75]",2,2,0
31041.0,2019-12-23,"(641.75, 811.5]",2,2,0
31041.0,2019-12-23,"(981.25, 1151.0]",2,1,1
31042.0,2019-12-23,"(441.093, 668.75]",8,10,-2
31042.0,2019-12-23,"(668.75, 895.5]",2,4,-2
31043.0,2019-12-23,"(605.453, 742.75]",1,2,-1
31043.0,2019-12-23,"(879.5, 1016.25]",1,1,0
31043.0,2019-12-23,"(1016.25, 1153.0]",2,4,-2
31044.0,2019-12-23,"(495.447, 634.25]",1,1,0
31045.0,2019-12-23,"(823.559, 934.25]",1,1,0
31045.0,2019-12-23,"(934.25, 1044.5]",1,1,0
31045.0,2019-12-23,"(1154.75, 1265.0]",1,1,0
31046.0,2019-12-23,"(451.25, 469.0]",1,1,0
31047.0,2019-12-23,"(407.149, 620.75]",4,6,-2
31047.0,2019-12-23,"(620.75, 833.5]",1,2,-1
31047.0,2019-12-23,"(833.5, 1046.25]",1,5,-4
31047.0,2019-12-23,"(1046.25, 1259.0]",4,5,-1
31048.0,2019-12-23,"(743.61, 841.5]",1,2,-1
31048.0,2019-12-23,"(1036.5, 1134.0]",1,2,-1
31049.0,2019-12-23,"(579.54, 695.0]",1,1,0
31049.0,2019-12-23,"(925.0, 1040.0]",1,3,-2
31050.0,2019-12-23,"(834.5, 946.0]",2,2,0
31051.0,2019-12-23,"(817.0, 1075.0]",2,2,0
31051.0,2019-12-23,"(1075.0, 1333.0]",2,4,-2
31052.0,2019-12-23,"(524.404, 674.0]",2,2,0
31052.0,2019-12-23,"(674.0, 823.0]",1,2,-1
31052.0,2019-12-23,"(972.0, 1121.0]",2,5,-3
31053.0,2019-12-23,"(-0.86, 215.0]",1,2,-1
31053.0,2019-12-23,"(645.0, 860.0]",1,1,0
31054.0,2019-12-23,"(822.75, 1097.0]",2,1,1
,,,,2.0,
,,,,1.0,
,,,,1.0,
31057.0,2019-12-23,"(585.0, 780.0]",1,1,0
31058.0,2019-12-23,"(576.75, 769.0]",1,1,0
31059.0,2019-12-23,"(892.554, 893.0]",1,2,-1
31060.0,2019-12-23,"(842.75, 980.0]",1,1,0
,,,,2.0,
31062.0,2019-12-23,"(822.925, 841.75]",2,2,0
31062.0,2019-12-23,"(879.25, 898.0]",2,2,0
,,,,2.0,
31064.0,2019-12-23,"(457.294, 634.5]",1,2,-1
31064.0,2019-12-23,"(811.0, 987.5]",4,1,3
31064.0,2019-12-23,"(987.5, 1164.0]",5,9,-4
31065.0,2019-12-23,"(923.5, 1083.0]",1,2,-1
31066.0,2019-12-23,"(764.25, 871.0]",2,1,1
31067.0,2019-12-23,"(920.25, 932.0]",1,1,0
31068.0,2019-12-23,"(573.202, 773.5]",1,2,-1
31068.0,2019-12-23,"(973.0, 1172.5]",1,1,0
31068.0,2019-12-23,"(1172.5, 1372.0]",1,1,0
31069.0,2019-12-23,"(904.25, 1048.0]",1,1,0
31070.0,2019-12-23,"(908.0, 939.0]",1,1,0
31071.0,2019-12-23,"(804.5, 968.75]",1,1,0
31071.0,2019-12-23,"(968.75, 1133.0]",2,3,-1
,,,,1.0,
,,,,1.0,
,,,,2.0,
31074.0,2019-12-23,"(838.5, 915.0]",1,1,0
31075.0,2019-12-23,"(965.0, 1108.0]",1,1,0
31076.0,2019-12-23,"(772.5, 1030.0]",1,1,0
31077.0,2019-12-23,"(617.5, 765.0]",1,3,-2
31077.0,2019-12-23,"(765.0, 912.5]",5,3,2
31077.0,2019-12-23,"(912.5, 1060.0]",3,7,-4
31078.0,2019-12-23,"(804.0, 1072.0]",1,1,0
31079.0,2019-12-23,"(918.25, 984.0]",1,1,0
31080.0,2019-12-23,"(56.912, 330.0]",1,1,0
31080.0,2019-12-23,"(330.0, 602.0]",1,6,-5
31080.0,2019-12-23,"(874.0, 1146.0]",9,2,7
31081.0,2019-12-23,"(821.56, 932.0]",2,4,-2
31081.0,2019-12-23,"(1152.0, 1262.0]",1,1,0
31082.0,2019-12-23,"(825.696, 902.0]",1,2,-1
31082.0,2019-12-23,"(1054.0, 1130.0]",1,1,0
31083.0,2019-12-23,"(589.75, 772.5]",1,1,0
31083.0,2019-12-23,"(955.25, 1138.0]",3,2,1
31084.0,2019-12-23,"(566.329, 734.75]",1,1,0
31084.0,2019-12-23,"(734.75, 902.5]",1,1,0
31085.0,2019-12-23,"(402.168, 611.0]",1,4,-3
31085.0,2019-12-23,"(1027.0, 1235.0]",1,1,0
31086.0,2019-12-23,"(273.064, 508.0]",1,2,-1
31086.0,2019-12-23,"(976.0, 1210.0]",2,3,-1
31087.0,2019-12-23,"(1034.784, 1089.0]",1,1,0
31088.0,2019-12-23,"(889.5, 962.75]",1,1,0
31088.0,2019-12-23,"(962.75, 1036.0]",1,1,0
31089.0,2019-12-23,"(473.339, 639.25]",3,4,-1
31089.0,2019-12-23,"(804.5, 969.75]",1,2,-1
31089.0,2019-12-23,"(969.75, 1135.0]",2,5,-3
31090.0,2019-12-23,"(584.0, 734.0]",1,1,0
31090.0,2019-12-23,"(884.0, 1034.0]",1,2,-1
31091.0,2019-12-23,"(786.5, 960.75]",1,2,-1
31091.0,2019-12-23,"(960.75, 1135.0]",1,2,-1
31092.0,2019-12-23,"(373.326, 542.5]",1,1,0
31092.0,2019-12-23,"(879.5, 1048.0]",2,2,0
31093.0,2019-12-23,"(902.25, 926.5]",1,1,0
,,,,2.0,
,,,,2.0,
31096.0,2019-12-23,"(894.865, 928.75]",1,2,-1
31096.0,2019-12-23,"(962.5, 996.25]",1,1,0
31096.0,2019-12-23,"(996.25, 1030.0]",1,2,-1
31097.0,2019-12-23,"(452.532, 570.0]",1,1,0
31097.0,2019-12-23,"(570.0, 687.0]",1,2,-1
31097.0,2019-12-23,"(804.0, 921.0]",1,3,-2
31098.0,2019-12-23,"(977.0, 1156.0]",4,5,-1
31099.0,2019-12-23,"(625.807, 674.25]",1,2,-1
31100.0,2019-12-23,"(452.088, 681.0]",8,10,-2
31100.0,2019-12-23,"(681.0, 909.0]",1,1,0
31100.0,2019-12-23,"(909.0, 1137.0]",2,5,-3
31100.0,2019-12-23,"(1137.0, 1365.0]",6,8,-2
31101.0,2019-12-23,"(275.01, 523.5]",3,7,-4
31101.0,2019-12-23,"(523.5, 771.0]",8,18,-10
31101.0,2019-12-23,"(771.0, 1018.5]",20,32,-12
31101.0,2019-12-23,"(1018.5, 1266.0]",12,21,-9
31102.0,2019-12-23,"(377.036, 619.0]",1,5,-4
31102.0,2019-12-23,"(619.0, 860.0]",2,5,-3
31102.0,2019-12-23,"(1101.0, 1342.0]",9,2,7
31103.0,2019-12-23,"(641.0, 864.0]",2,8,-6
31103.0,2019-12-23,"(864.0, 1087.0]",2,6,-4
31103.0,2019-12-23,"(1087.0, 1310.0]",3,10,-7
31104.0,2019-12-23,"(373.044, 613.0]",1,9,-8
31104.0,2019-12-23,"(613.0, 852.0]",6,11,-5
31104.0,2019-12-23,"(852.0, 1091.0]",10,17,-7
31104.0,2019-12-23,"(1091.0, 1330.0]",4,8,-4
31105.0,2019-12-23,"(110.743, 426.25]",1,1,0
31105.0,2019-12-23,"(740.5, 1054.75]",1,1,0
31105.0,2019-12-23,"(1054.75, 1369.0]",2,2,0
31106.0,2019-12-23,"(503.454, 640.5]",1,2,-1
31106.0,2019-12-23,"(913.5, 1050.0]",1,1,0
31107.0,2019-12-23,"(387.0, 725.0]",4,1,3
31107.0,2019-12-23,"(725.0, 1063.0]",3,13,-10
31107.0,2019-12-23,"(1063.0, 1401.0]",7,13,-6
31108.0,2019-12-23,"(7.639, 349.25]",2,3,-1
31108.0,2019-12-23,"(349.25, 689.5]",8,18,-10
31108.0,2019-12-23,"(689.5, 1029.75]",19,42,-23
31108.0,2019-12-23,"(1029.75, 1370.0]",13,18,-5
31109.0,2019-12-23,"(385.114, 607.5]",5,11,-6
31109.0,2019-12-23,"(607.5, 829.0]",1,4,-3
31109.0,2019-12-23,"(829.0, 1050.5]",11,21,-10
31109.0,2019-12-23,"(1050.5, 1272.0]",4,6,-2
31110.0,2019-12-23,"(475.076, 707.0]",6,12,-6
31110.0,2019-12-23,"(707.0, 938.0]",2,4,-2
31110.0,2019-12-23,"(938.0, 1169.0]",7,14,-7
31110.0,2019-12-23,"(1169.0, 1400.0]",1,4,-3
31111.0,2019-12-23,"(380.027, 624.25]",4,7,-3
31111.0,2019-12-23,"(867.5, 1110.75]",7,4,3
31111.0,2019-12-23,"(1110.75, 1354.0]",5,12,-7
31112.0,2019-12-23,"(503.157, 714.75]",2,3,-1
31112.0,2019-12-23,"(714.75, 925.5]",2,2,0
31112.0,2019-12-23,"(925.5, 1136.25]",2,4,-2
31112.0,2019-12-23,"(1136.25, 1347.0]",3,4,-1
31113.0,2019-12-23,"(839.0, 1104.0]",4,6,-2
31113.0,2019-12-23,"(1104.0, 1369.0]",2,6,-4
31114.0,2019-12-23,"(17.792, 321.0]",1,2,-1
31114.0,2019-12-23,"(321.0, 623.0]",2,10,-8
31114.0,2019-12-23,"(623.0, 925.0]",3,10,-7
31114.0,2019-12-23,"(925.0, 1227.0]",9,16,-7
31115.0,2019-12-23,"(684.75, 917.5]",1,5,-4
31115.0,2019-12-23,"(917.5, 1150.25]",6,4,2
31115.0,2019-12-23,"(1150.25, 1383.0]",2,13,-11
31116.0,2019-12-23,"(472.179, 678.25]",3,9,-6
31116.0,2019-12-23,"(678.25, 883.5]",4,9,-5
31116.0,2019-12-23,"(883.5, 1088.75]",8,10,-2
31116.0,2019-12-23,"(1088.75, 1294.0]",3,6,-3
31117.0,2019-12-23,"(284.93, 553.5]",4,15,-11
31117.0,2019-12-23,"(821.0, 1088.5]",9,10,-1
31117.0,2019-12-23,"(1088.5, 1356.0]",2,16,-14
31118.0,2019-12-23,"(676.5, 914.0]",3,7,-4
31118.0,2019-12-23,"(914.0, 1151.5]",3,5,-2
31118.0,2019-12-23,"(1151.5, 1389.0]",3,3,0
31119.0,2019-12-23,"(349.938, 616.5]",3,11,-8
31119.0,2019-12-23,"(616.5, 882.0]",4,8,-4
31119.0,2019-12-23,"(882.0, 1147.5]",8,13,-5
31119.0,2019-12-23,"(1147.5, 1413.0]",3,7,-4
31120.0,2019-12-23,"(721.25, 930.5]",4,3,1
31120.0,2019-12-23,"(930.5, 1139.75]",1,7,-6
31120.0,2019-12-23,"(1139.75, 1349.0]",3,3,0
31121.0,2019-12-23,"(428.095, 655.25]",8,10,-2
31121.0,2019-12-23,"(655.25, 881.5]",3,6,-3
31121.0,2019-12-23,"(881.5, 1107.75]",5,8,-3
31121.0,2019-12-23,"(1107.75, 1334.0]",3,4,-1
31122.0,2019-12-23,"(441.15, 654.5]",2,8,-6
31122.0,2019-12-23,"(654.5, 867.0]",3,4,-1
31122.0,2019-12-23,"(867.0, 1079.5]",4,9,-5
31122.0,2019-12-23,"(1079.5, 1292.0]",1,3,-2
31123.0,2019-12-23,"(346.142, 561.5]",1,7,-6
31123.0,2019-12-23,"(776.0, 990.5]",2,4,-2
31123.0,2019-12-23,"(990.5, 1205.0]",1,6,-5
31124.0,2019-12-23,"(41.618, 388.5]",1,1,0
31124.0,2019-12-23,"(388.5, 734.0]",12,25,-13
31124.0,2019-12-23,"(734.0, 1079.5]",10,36,-26
31124.0,2019-12-23,"(1079.5, 1425.0]",11,30,-19
31125.0,2019-12-23,"(399.975, 657.25]",4,14,-10
31125.0,2019-12-23,"(657.25, 913.5]",8,17,-9
31125.0,2019-12-23,"(913.5, 1169.75]",7,15,-8
31125.0,2019-12-23,"(1169.75, 1426.0]",8,11,-3
31126.0,2019-12-23,"(631.0, 867.0]",2,12,-10
31126.0,2019-12-23,"(867.0, 1103.0]",6,4,2
31126.0,2019-12-23,"(1103.0, 1339.0]",7,9,-2
,,,,2.0,
31128.0,2019-12-23,"(328.25, 642.5]",11,1,10
31128.0,2019-12-23,"(642.5, 956.75]",15,14,1
31128.0,2019-12-23,"(956.75, 1271.0]",7,32,-25
31129.0,2019-12-23,"(-1.405, 351.25]",1,1,0
31129.0,2019-12-23,"(351.25, 702.5]",5,8,-3
31129.0,2019-12-23,"(702.5, 1053.75]",11,23,-12
31129.0,2019-12-23,"(1053.75, 1405.0]",5,10,-5
31130.0,2019-12-23,"(593.25, 808.5]",1,5,-4
31130.0,2019-12-23,"(808.5, 1023.75]",6,3,3
31130.0,2019-12-23,"(1023.75, 1239.0]",2,11,-9
31131.0,2019-12-23,"(433.147, 647.25]",1,4,-3
31131.0,2019-12-23,"(647.25, 860.5]",3,5,-2
31131.0,2019-12-23,"(860.5, 1073.75]",1,3,-2
31131.0,2019-12-23,"(1073.75, 1287.0]",1,1,0
31200.0,2019-12-23,"(336.915, 609.25]",12,16,-4
31200.0,2019-12-23,"(609.25, 880.5]",8,13,-5
31200.0,2019-12-23,"(880.5, 1151.75]",18,34,-16
31200.0,2019-12-23,"(1151.75, 1423.0]",6,17,-11
31201.0,2019-12-23,"(296.923, 567.25]",10,18,-8
31201.0,2019-12-23,"(567.25, 836.5]",16,28,-12
31201.0,2019-12-23,"(836.5, 1105.75]",28,46,-18
31201.0,2019-12-23,"(1105.75, 1375.0]",12,24,-12
31202.0,2019-12-23,"(359.001, 609.75]",4,13,-9
31202.0,2019-12-23,"(609.75, 859.5]",11,20,-9
31202.0,2019-12-23,"(859.5, 1109.25]",15,21,-6
31202.0,2019-12-23,"(1109.25, 1359.0]",3,11,-8
31203.0,2019-12-23,"(280.875, 563.25]",4,9,-5
31203.0,2019-12-23,"(563.25, 844.5]",3,8,-5
31203.0,2019-12-23,"(844.5, 1125.75]",27,36,-9
31203.0,2019-12-23,"(1125.75, 1407.0]",7,15,-8
31204.0,2019-12-23,"(90.717, 412.75]",2,3,-1
31204.0,2019-12-23,"(412.75, 733.5]",6,7,-1
31204.0,2019-12-23,"(1054.25, 1375.0]",2,9,-7
31205.0,2019-12-23,"(476.153, 688.75]",1,4,-3
31205.0,2019-12-23,"(688.75, 900.5]",5,7,-2
31205.0,2019-12-23,"(900.5, 1112.25]",2,6,-4
31205.0,2019-12-23,"(1112.25, 1324.0]",4,7,-3
31206.0,2019-12-23,"(525.507, 649.25]",2,2,0
31206.0,2019-12-23,"(895.75, 1019.0]",2,5,-3
31207.0,2019-12-23,"(808.5, 1014.25]",1,2,-1
31208.0,2019-12-23,"(382.992, 636.0]",3,4,-1
31208.0,2019-12-23,"(636.0, 888.0]",4,5,-1
31208.0,2019-12-23,"(888.0, 1140.0]",4,9,-5
31208.0,2019-12-23,"(1140.0, 1392.0]",2,4,-2
31209.0,2019-12-23,"(609.393, 761.75]",1,2,-1
31209.0,2019-12-23,"(761.75, 913.5]",1,1,0
31209.0,2019-12-23,"(913.5, 1065.25]",4,6,-2
31209.0,2019-12-23,"(1065.25, 1217.0]",3,4,-1
31211.0,2019-12-23,"(490.11, 713.5]",8,9,-1
31211.0,2019-12-23,"(713.5, 936.0]",3,4,-1
31211.0,2019-12-23,"(936.0, 1158.5]",4,5,-1
31212.0,2019-12-23,"(360.948, 625.0]",13,17,-4
31212.0,2019-12-23,"(625.0, 888.0]",6,15,-9
31212.0,2019-12-23,"(888.0, 1151.0]",6,16,-10
31212.0,2019-12-23,"(1151.0, 1414.0]",7,11,-4
31213.0,2019-12-23,"(413.224, 608.0]",10,16,-6
31213.0,2019-12-23,"(608.0, 802.0]",12,17,-5
31213.0,2019-12-23,"(802.0, 996.0]",8,13,-5
31213.0,2019-12-23,"(996.0, 1190.0]",6,11,-5
31214.0,2019-12-23,"(318.942, 584.5]",8,24,-16
31214.0,2019-12-23,"(584.5, 849.0]",8,21,-13
31214.0,2019-12-23,"(849.0, 1113.5]",21,32,-11
31214.0,2019-12-23,"(1113.5, 1378.0]",13,19,-6
31215.0,2019-12-23,"(36.623, 382.25]",1,2,-1
31215.0,2019-12-23,"(382.25, 726.5]",3,3,0
31215.0,2019-12-23,"(726.5, 1070.75]",10,16,-6
31215.0,2019-12-23,"(1070.75, 1415.0]",2,4,-2
31216.0,2019-12-23,"(448.15, 661.5]",14,15,-1
31216.0,2019-12-23,"(661.5, 874.0]",4,8,-4
31216.0,2019-12-23,"(874.0, 1086.5]",2,9,-7
31216.0,2019-12-23,"(1086.5, 1299.0]",1,5,-4
31217.0,2019-12-23,"(360.218, 556.5]",4,5,-1
31217.0,2019-12-23,"(556.5, 752.0]",1,4,-3
31217.0,2019-12-23,"(752.0, 947.5]",3,4,-1
31217.0,2019-12-23,"(947.5, 1143.0]",1,10,-9
31218.0,2019-12-23,"(372.027, 616.25]",3,10,-7
31218.0,2019-12-23,"(616.25, 859.5]",1,1,0
31218.0,2019-12-23,"(859.5, 1102.75]",10,20,-10
31219.0,2019-12-23,"(410.115, 632.25]",7,8,-1
31219.0,2019-12-23,"(632.25, 853.5]",5,6,-1
31219.0,2019-12-23,"(853.5, 1074.75]",1,8,-7
31220.0,2019-12-23,"(289.162, 499.5]",4,4,0
31220.0,2019-12-23,"(499.5, 709.0]",4,6,-2
31220.0,2019-12-23,"(709.0, 918.5]",2,8,-6
31220.0,2019-12-23,"(918.5, 1128.0]",4,13,-9
31221.0,2019-12-23,"(330.75, 621.5]",11,1,10
31221.0,2019-12-23,"(621.5, 912.25]",6,11,-5
31221.0,2019-12-23,"(912.25, 1203.0]",8,17,-9
31222.0,2019-12-23,"(527.207, 726.25]",6,10,-4
31222.0,2019-12-23,"(726.25, 924.5]",8,12,-4
31222.0,2019-12-23,"(924.5, 1122.75]",3,10,-7
31222.0,2019-12-23,"(1122.75, 1321.0]",3,6,-3
31223.0,2019-12-23,"(26.69, 355.5]",1,2,-1
31223.0,2019-12-23,"(355.5, 683.0]",8,19,-11
31223.0,2019-12-23,"(683.0, 1010.5]",3,14,-11
31223.0,2019-12-23,"(1010.5, 1338.0]",10,18,-8
31224.0,2019-12-23,"(384.255, 571.25]",6,7,-1
31224.0,2019-12-23,"(571.25, 757.5]",1,6,-5
31224.0,2019-12-23,"(757.5, 943.75]",2,5,-3
31224.0,2019-12-23,"(943.75, 1130.0]",3,6,-3
31225.0,2019-12-23,"(421.1, 647.0]",2,5,-3
31225.0,2019-12-23,"(647.0, 872.0]",2,2,0
31225.0,2019-12-23,"(872.0, 1097.0]",4,9,-5
31225.0,2019-12-23,"(1097.0, 1322.0]",4,9,-5
31226.0,2019-12-23,"(266.994, 519.5]",1,2,-1
31226.0,2019-12-23,"(771.0, 1022.5]",1,2,-1
31226.0,2019-12-23,"(1022.5, 1274.0]",2,3,-1
31227.0,2019-12-23,"(437.109, 660.75]",15,16,-1
31227.0,2019-12-23,"(660.75, 883.5]",4,9,-5
31227.0,2019-12-23,"(883.5, 1106.25]",2,10,-8
31227.0,2019-12-23,"(1106.25, 1329.0]",1,5,-4
31228.0,2019-12-23,"(7.695, 335.25]",2,3,-1
31228.0,2019-12-23,"(335.25, 661.5]",13,17,-4
31228.0,2019-12-23,"(661.5, 987.75]",20,34,-14
31228.0,2019-12-23,"(987.75, 1314.0]",7,17,-10
31229.0,2019-12-23,"(1.611, 350.25]",2,4,-2
31229.0,2019-12-23,"(350.25, 697.5]",7,38,-31
31229.0,2019-12-23,"(697.5, 1044.75]",25,42,-17
31229.0,2019-12-23,"(1044.75, 1392.0]",11,24,-13
31230.0,2019-12-23,"(358.014, 605.5]",11,15,-4
31230.0,2019-12-23,"(605.5, 852.0]",9,20,-11
31230.0,2019-12-23,"(852.0, 1098.5]",18,28,-10
31230.0,2019-12-23,"(1098.5, 1345.0]",15,24,-9
31231.0,2019-12-23,"(50.054, 287.5]",1,1,0
31231.0,2019-12-23,"(287.5, 524.0]",3,3,0
31231.0,2019-12-23,"(524.0, 760.5]",8,9,-1
31231.0,2019-12-23,"(760.5, 997.0]",8,18,-10
31232.0,2019-12-23,"(328.971, 587.25]",5,9,-4
31232.0,2019-12-23,"(587.25, 844.5]",8,15,-7
31232.0,2019-12-23,"(844.5, 1101.75]",17,27,-10
31232.0,2019-12-23,"(1101.75, 1359.0]",6,9,-3
31233.0,2019-12-23,"(492.258, 678.5]",16,17,-1
31233.0,2019-12-23,"(678.5, 864.0]",8,15,-7
31233.0,2019-12-23,"(864.0, 1049.5]",12,22,-10
31233.0,2019-12-23,"(1049.5, 1235.0]",3,8,-5
31234.0,2019-12-23,"(386.074, 618.5]",4,12,-8
31234.0,2019-12-23,"(618.5, 850.0]",8,13,-5
31234.0,2019-12-23,"(850.0, 1081.5]",10,14,-4
31234.0,2019-12-23,"(1081.5, 1313.0]",4,9,-5
31235.0,2019-12-23,"(535.407, 684.25]",1,1,0
31235.0,2019-12-23,"(832.5, 980.75]",4,10,-6
31235.0,2019-12-23,"(980.75, 1129.0]",8,14,-6
31236.0,2019-12-23,"(475.047, 714.25]",1,2,-1
31236.0,2019-12-23,"(714.25, 952.5]",3,6,-3
31236.0,2019-12-23,"(952.5, 1190.75]",1,4,-3
31237.0,2019-12-23,"(466.051, 704.25]",4,12,-8
31237.0,2019-12-23,"(704.25, 941.5]",4,6,-2
31237.0,2019-12-23,"(941.5, 1178.75]",6,15,-9
31237.0,2019-12-23,"(1178.75, 1416.0]",1,2,-1
31238.0,2019-12-23,"(84.729, 403.75]",1,2,-1
31238.0,2019-12-23,"(403.75, 721.5]",9,12,-3
31238.0,2019-12-23,"(721.5, 1039.25]",8,25,-17
31238.0,2019-12-23,"(1039.25, 1357.0]",1,12,-11
31239.0,2019-12-23,"(413.017, 659.75]",5,9,-4
31239.0,2019-12-23,"(659.75, 905.5]",4,9,-5
31239.0,2019-12-23,"(905.5, 1151.25]",3,10,-7
31239.0,2019-12-23,"(1151.25, 1397.0]",3,4,-1
31240.0,2019-12-23,"(698.688, 777.0]",8,11,-3
31240.0,2019-12-23,"(777.0, 855.0]",1,1,0
31240.0,2019-12-23,"(933.0, 1011.0]",3,4,-1
31241.0,2019-12-23,"(43.689, 372.75]",2,3,-1
31241.0,2019-12-23,"(372.75, 700.5]",3,15,-12
31241.0,2019-12-23,"(700.5, 1028.25]",6,16,-10
31241.0,2019-12-23,"(1028.25, 1356.0]",6,15,-9
31242.0,2019-12-23,"(375.053, 612.75]",12,17,-5
31242.0,2019-12-23,"(612.75, 849.5]",3,6,-3
31242.0,2019-12-23,"(849.5, 1086.25]",3,13,-10
31243.0,2019-12-23,"(349.011, 597.25]",16,21,-5
31243.0,2019-12-23,"(597.25, 844.5]",5,9,-4
31243.0,2019-12-23,"(844.5, 1091.75]",12,28,-16
31243.0,2019-12-23,"(1091.75, 1339.0]",2,5,-3
31244.0,2019-12-23,"(431.159, 642.25]",8,15,-7
31244.0,2019-12-23,"(642.25, 852.5]",1,3,-2
31244.0,2019-12-23,"(852.5, 1062.75]",5,14,-9
31244.0,2019-12-23,"(1062.75, 1273.0]",4,5,-1
31245.0,2019-12-23,"(445.189, 648.75]",2,5,-3
31245.0,2019-12-23,"(648.75, 851.5]",1,6,-5
31245.0,2019-12-23,"(851.5, 1054.25]",4,7,-3
31245.0,2019-12-23,"(1054.25, 1257.0]",2,9,-7
31246.0,2019-12-23,"(25.747, 340.25]",1,2,-1
31246.0,2019-12-23,"(340.25, 653.5]",4,6,-2
31246.0,2019-12-23,"(653.5, 966.75]",10,21,-11
31246.0,2019-12-23,"(966.75, 1280.0]",10,24,-14
31247.0,2019-12-23,"(20.649, 359.75]",2,4,-2
31247.0,2019-12-23,"(359.75, 697.5]",18,19,-1
31247.0,2019-12-23,"(697.5, 1035.25]",22,36,-14
31247.0,2019-12-23,"(1035.25, 1373.0]",11,24,-13
31248.0,2019-12-23,"(497.105, 721.75]",3,9,-6
31248.0,2019-12-23,"(721.75, 945.5]",10,26,-16
31248.0,2019-12-23,"(945.5, 1169.25]",7,12,-5
31248.0,2019-12-23,"(1169.25, 1393.0]",4,8,-4
31249.0,2019-12-23,"(402.319, 573.25]",2,3,-1
31249.0,2019-12-23,"(573.25, 743.5]",3,6,-3
31249.0,2019-12-23,"(743.5, 913.75]",4,12,-8
31249.0,2019-12-23,"(913.75, 1084.0]",3,7,-4
31250.0,2019-12-23,"(468.167, 677.25]",11,15,-4
31250.0,2019-12-23,"(677.25, 885.5]",6,8,-2
31250.0,2019-12-23,"(885.5, 1093.75]",9,22,-13
31251.0,2019-12-23,"(367.966, 627.5]",11,17,-6
31251.0,2019-12-23,"(627.5, 886.0]",3,9,-6
31251.0,2019-12-23,"(886.0, 1144.5]",10,21,-11
31251.0,2019-12-23,"(1144.5, 1403.0]",5,9,-4
31252.0,2019-12-23,"(491.138, 707.5]",6,8,-2
31252.0,2019-12-23,"(707.5, 923.0]",1,3,-2
31252.0,2019-12-23,"(923.0, 1138.5]",2,6,-4
31252.0,2019-12-23,"(1138.5, 1354.0]",2,3,-1
31253.0,2019-12-23,"(421.178, 627.5]",8,10,-2
31253.0,2019-12-23,"(627.5, 833.0]",3,4,-1
31253.0,2019-12-23,"(833.0, 1038.5]",2,7,-5
31253.0,2019-12-23,"(1038.5, 1244.0]",1,5,-4
31254.0,2019-12-23,"(406.242, 596.5]",5,8,-3
31254.0,2019-12-23,"(596.5, 786.0]",2,2,0
31254.0,2019-12-23,"(786.0, 975.5]",1,4,-3
31254.0,2019-12-23,"(975.5, 1165.0]",2,16,-14
31255.0,2019-12-23,"(498.085, 727.75]",9,10,-1
31255.0,2019-12-23,"(727.75, 956.5]",2,9,-7
31255.0,2019-12-23,"(956.5, 1185.25]",2,3,-1
31256.0,2019-12-23,"(259.92, 531.0]",5,6,-1
31256.0,2019-12-23,"(531.0, 801.0]",5,9,-4
31256.0,2019-12-23,"(801.0, 1071.0]",4,7,-3
31256.0,2019-12-23,"(1071.0, 1341.0]",3,7,-4
31257.0,2019-12-23,"(468.166, 677.5]",4,8,-4
31257.0,2019-12-23,"(677.5, 886.0]",6,10,-4
31257.0,2019-12-23,"(886.0, 1094.5]",11,18,-7
31257.0,2019-12-23,"(1094.5, 1303.0]",5,8,-3
31258.0,2019-12-23,"(495.332, 663.0]",2,3,-1
31258.0,2019-12-23,"(663.0, 830.0]",19,37,-18
31258.0,2019-12-23,"(830.0, 997.0]",13,28,-15
31258.0,2019-12-23,"(997.0, 1164.0]",4,5,-1
31259.0,2019-12-23,"(390.0, 585.0]",1,1,0
31259.0,2019-12-23,"(585.0, 780.0]",3,1,2
31260.0,2019-12-23,"(409.322, 579.5]",3,6,-3
31260.0,2019-12-23,"(579.5, 749.0]",2,4,-2
31260.0,2019-12-23,"(918.5, 1088.0]",6,2,4
31261.0,2019-12-23,"(416.432, 559.0]",5,5,0
31261.0,2019-12-23,"(701.0, 843.0]",4,10,-6
31262.0,2019-12-23,"(566.292, 744.0]",2,4,-2
31262.0,2019-12-23,"(744.0, 921.0]",4,6,-2
31262.0,2019-12-23,"(921.0, 1098.0]",3,7,-4
31262.0,2019-12-23,"(1098.0, 1275.0]",2,7,-5
31263.0,2019-12-23,"(361.974, 619.5]",10,17,-7
31263.0,2019-12-23,"(619.5, 876.0]",10,18,-8
31263.0,2019-12-23,"(876.0, 1132.5]",11,22,-11
31263.0,2019-12-23,"(1132.5, 1389.0]",2,4,-2
31264.0,2019-12-23,"(475.086, 704.5]",9,11,-2
31264.0,2019-12-23,"(704.5, 933.0]",5,10,-5
31264.0,2019-12-23,"(933.0, 1161.5]",5,9,-4
31265.0,2019-12-23,"(289.963, 550.25]",7,16,-9
31265.0,2019-12-23,"(550.25, 809.5]",8,14,-6
31265.0,2019-12-23,"(809.5, 1068.75]",8,16,-8
31265.0,2019-12-23,"(1068.75, 1328.0]",10,16,-6
31266.0,2019-12-23,"(342.25, 668.5]",5,3,2
31266.0,2019-12-23,"(668.5, 994.75]",8,15,-7
31266.0,2019-12-23,"(994.75, 1321.0]",14,14,0
31267.0,2019-12-23,"(463.275, 645.25]",4,11,-7
31267.0,2019-12-23,"(645.25, 826.5]",3,8,-5
31267.0,2019-12-23,"(826.5, 1007.75]",5,9,-4
31267.0,2019-12-23,"(1007.75, 1189.0]",6,8,-2
31268.0,2019-12-23,"(418.157, 629.75]",3,17,-14
31268.0,2019-12-23,"(629.75, 840.5]",3,5,-2
31268.0,2019-12-23,"(840.5, 1051.25]",5,5,0
31268.0,2019-12-23,"(1051.25, 1262.0]",5,7,-2
31269.0,2019-12-23,"(328.985, 583.75]",4,9,-5
31269.0,2019-12-23,"(583.75, 837.5]",3,18,-15
31269.0,2019-12-23,"(837.5, 1091.25]",2,6,-4
31270.0,2019-12-23,"(368.146, 582.5]",7,9,-2
31270.0,2019-12-23,"(582.5, 796.0]",6,9,-3
31270.0,2019-12-23,"(796.0, 1009.5]",8,19,-11
31270.0,2019-12-23,"(1009.5, 1223.0]",2,7,-5
31271.0,2019-12-23,"(379.047, 618.25]",11,15,-4
31271.0,2019-12-23,"(618.25, 856.5]",7,9,-2
31271.0,2019-12-23,"(856.5, 1094.75]",7,24,-17
31271.0,2019-12-23,"(1094.75, 1333.0]",14,27,-13
31272.0,2019-12-23,"(431.263, 616.25]",10,11,-1
31272.0,2019-12-23,"(616.25, 800.5]",16,24,-8
31272.0,2019-12-23,"(800.5, 984.75]",18,26,-8
31272.0,2019-12-23,"(984.75, 1169.0]",1,8,-7
31273.0,2019-12-23,"(30.941, 296.75]",1,1,0
31273.0,2019-12-23,"(561.5, 826.25]",1,1,0
31273.0,2019-12-23,"(826.25, 1091.0]",3,1,2
31274.0,2019-12-23,"(444.379, 600.25]",2,3,-1
31274.0,2019-12-23,"(600.25, 755.5]",2,2,0
31274.0,2019-12-23,"(755.5, 910.75]",1,2,-1
31274.0,2019-12-23,"(910.75, 1066.0]",5,8,-3
31275.0,2019-12-23,"(398.981, 654.75]",6,15,-9
31275.0,2019-12-23,"(654.75, 909.5]",5,5,0
31275.0,2019-12-23,"(909.5, 1164.25]",4,9,-5
31275.0,2019-12-23,"(1164.25, 1419.0]",3,3,0
31276.0,2019-12-23,"(453.246, 642.5]",10,14,-4
31276.0,2019-12-23,"(642.5, 831.0]",3,6,-3
31276.0,2019-12-23,"(831.0, 1019.5]",3,7,-4
31276.0,2019-12-23,"(1019.5, 1208.0]",1,5,-4
31277.0,2019-12-23,"(446.29, 624.5]",14,14,0
31277.0,2019-12-23,"(624.5, 802.0]",4,7,-3
31277.0,2019-12-23,"(802.0, 979.5]",9,14,-5
31277.0,2019-12-23,"(979.5, 1157.0]",2,15,-13
31278.0,2019-12-23,"(24.696, 352.0]",1,1,0
31278.0,2019-12-23,"(352.0, 678.0]",2,5,-3
31278.0,2019-12-23,"(678.0, 1004.0]",8,18,-10
31278.0,2019-12-23,"(1004.0, 1330.0]",10,15,-5
31279.0,2019-12-23,"(469.173, 676.75]",11,14,-3
31279.0,2019-12-23,"(676.75, 883.5]",3,6,-3
31279.0,2019-12-23,"(883.5, 1090.25]",6,19,-13
31280.0,2019-12-23,"(355.05, 593.5]",4,11,-7
31280.0,2019-12-23,"(831.0, 1068.5]",2,4,-2
31280.0,2019-12-23,"(1068.5, 1306.0]",2,6,-4
31000.0,2019-12-24,"(693.75, 925.0]",2,1,1
31001.0,2019-12-24,"(687.643, 777.25]",1,3,-2
31001.0,2019-12-24,"(866.5, 955.75]",3,1,2
31001.0,2019-12-24,"(955.75, 1045.0]",1,4,-3
31002.0,2019-12-24,"(631.0, 718.0]",1,1,0
31002.0,2019-12-24,"(805.0, 892.0]",1,2,-1
31003.0,2019-12-24,"(470.505, 594.75]",1,1,0
31003.0,2019-12-24,"(718.5, 842.25]",1,2,-1
31004.0,2019-12-24,"(689.894, 716.5]",1,1,0
31004.0,2019-12-24,"(769.5, 796.0]",1,1,0
31005.0,2019-12-24,"(588.592, 691.0]",1,3,-2
31005.0,2019-12-24,"(691.0, 793.0]",1,1,0
31005.0,2019-12-24,"(895.0, 997.0]",1,2,-1
31006.0,2019-12-24,"(583.303, 758.25]",3,6,-3
31006.0,2019-12-24,"(758.25, 932.5]",4,4,0
31006.0,2019-12-24,"(932.5, 1106.75]",1,1,0
31007.0,2019-12-24,"(570.75, 714.5]",2,2,0
31007.0,2019-12-24,"(714.5, 858.25]",1,2,-1
31007.0,2019-12-24,"(858.25, 1002.0]",1,3,-2
31009.0,2019-12-24,"(430.446, 569.5]",2,2,0
31009.0,2019-12-24,"(846.5, 985.0]",1,2,-1
31010.0,2019-12-24,"(644.25, 777.5]",1,2,-1
31010.0,2019-12-24,"(910.75, 1044.0]",2,1,1
31011.0,2019-12-24,"(542.681, 622.75]",1,1,0
31011.0,2019-12-24,"(702.5, 782.25]",1,1,0
,,,,1.0,
,,,,2.0,
31013.0,2019-12-24,"(613.327, 782.25]",1,2,-1
31013.0,2019-12-24,"(782.25, 950.5]",3,6,-3
31013.0,2019-12-24,"(1118.75, 1287.0]",1,1,0
31014.0,2019-12-24,"(10.642, 351.5]",1,1,0
31014.0,2019-12-24,"(351.5, 691.0]",3,6,-3
31014.0,2019-12-24,"(691.0, 1030.5]",8,12,-4
31014.0,2019-12-24,"(1030.5, 1370.0]",1,1,0
31015.0,2019-12-24,"(133.073, 365.75]",2,2,0
31015.0,2019-12-24,"(365.75, 597.5]",2,2,0
31015.0,2019-12-24,"(829.25, 1061.0]",1,2,-1
31016.0,2019-12-24,"(539.513, 661.75]",1,1,0
31016.0,2019-12-24,"(783.5, 905.25]",2,2,0
31017.0,2019-12-24,"(725.355, 887.25]",1,1,0
,,,,2.0,
31019.0,2019-12-24,"(978.75, 1136.0]",2,1,1
31020.0,2019-12-24,"(947.941, 962.75]",1,1,0
31021.0,2019-12-24,"(526.736, 593.0]",1,1,0
31021.0,2019-12-24,"(725.0, 791.0]",2,1,1
31022.0,2019-12-24,"(509.215, 706.25]",2,4,-2
31022.0,2019-12-24,"(706.25, 902.5]",3,4,-1
31022.0,2019-12-24,"(902.5, 1098.75]",2,4,-2
31022.0,2019-12-24,"(1098.75, 1295.0]",1,4,-3
,,,,1.0,
,,,,2.0,
,,,,1.0,
,,,,1.0,
,,,,2.0,
31026.0,2019-12-24,"(616.0, 886.0]",1,1,0
,,,,1.0,
,,,,1.0,
,,,,2.0,
31028.0,2019-12-24,"(652.721, 722.75]",1,1,0
31029.0,2019-12-24,"(673.0, 786.0]",1,1,0
31029.0,2019-12-24,"(899.0, 1012.0]",4,2,2
31030.0,2019-12-24,"(924.626, 1018.5]",1,2,-1
31030.0,2019-12-24,"(1205.5, 1299.0]",2,2,0
,,,,1.0,
,,,,2.0,
31032.0,2019-12-24,"(1147.25, 1161.0]",1,1,0
31033.0,2019-12-24,"(956.999, 957.25]",2,2,0
,,,,2.0,
31035.0,2019-12-24,"(446.587, 550.25]",1,3,-2
31035.0,2019-12-24,"(756.75, 860.0]",1,1,0
31036.0,2019-12-24,"(562.384, 717.0]",1,1,0
31036.0,2019-12-24,"(1025.0, 1179.0]",1,2,-1
31037.0,2019-12-24,"(473.313, 645.75]",3,4,-1
31037.0,2019-12-24,"(645.75, 817.5]",1,2,-1
31037.0,2019-12-24,"(989.25, 1161.0]",1,4,-3
,,,,1.0,
,,,,1.0,
31039.0,2019-12-24,"(516.597, 617.75]",1,1,0
31040.0,2019-12-24,"(852.0, 938.0]",1,1,0
31041.0,2019-12-24,"(540.0, 767.0]",1,1,0
31041.0,2019-12-24,"(767.0, 994.0]",7,3,4
31042.0,2019-12-24,"(488.329, 656.75]",1,1,0
31042.0,2019-12-24,"(656.75, 824.5]",1,3,-2
31042.0,2019-12-24,"(824.5, 992.25]",1,2,-1
31043.0,2019-12-24,"(881.5, 1007.0]",2,1,1
31044.0,2019-12-24,"(258.0, 516.0]",1,1,0
31044.0,2019-12-24,"(516.0, 774.0]",2,1,1
31044.0,2019-12-24,"(774.0, 1032.0]",2,2,0
31045.0,2019-12-24,"(631.434, 773.5]",1,1,0
31045.0,2019-12-24,"(1056.5, 1198.0]",1,2,-1
31046.0,2019-12-24,"(777.946, 791.5]",1,1,0
31046.0,2019-12-24,"(818.5, 832.0]",1,1,0
31047.0,2019-12-24,"(762.75, 898.5]",1,2,-1
31047.0,2019-12-24,"(898.5, 1034.25]",2,5,-3
31047.0,2019-12-24,"(1034.25, 1170.0]",1,4,-3
31048.0,2019-12-24,"(998.75, 1101.0]",1,1,0
31049.0,2019-12-24,"(721.612, 819.0]",1,3,-2
31049.0,2019-12-24,"(1013.0, 1110.0]",1,1,0
31050.0,2019-12-24,"(724.97, 732.5]",1,1,0
31051.0,2019-12-24,"(550.25, 802.5]",1,3,-2
31051.0,2019-12-24,"(802.5, 1054.75]",1,2,-1
31051.0,2019-12-24,"(1054.75, 1307.0]",2,2,0
31052.0,2019-12-24,"(932.5, 1037.0]",1,1,0
31053.0,2019-12-24,"(576.796, 628.0]",1,5,-4
31053.0,2019-12-24,"(730.0, 781.0]",1,1,0
,,,,2.0,
31055.0,2019-12-24,"(610.5, 814.0]",1,1,0
31056.0,2019-12-24,"(-0.781, 195.25]",1,2,-1
31056.0,2019-12-24,"(585.75, 781.0]",1,1,0
31057.0,2019-12-24,"(396.75, 529.0]",1,1,0
,,,,1.0,
,,,,1.0,
,,,,1.0,
,,,,1.0,
31060.0,2019-12-24,"(512.5, 751.75]",1,1,0
31060.0,2019-12-24,"(751.75, 991.0]",4,3,1
,,,,2.0,
31062.0,2019-12-24,"(560.633, 652.75]",1,2,-1
31062.0,2019-12-24,"(652.75, 744.5]",4,5,-1
31062.0,2019-12-24,"(836.25, 928.0]",5,10,-5
31063.0,2019-12-24,"(551.928, 570.0]",1,1,0
31063.0,2019-12-24,"(606.0, 624.0]",1,2,-1
31064.0,2019-12-24,"(643.576, 750.0]",3,6,-3
31064.0,2019-12-24,"(750.0, 856.0]",1,2,-1
31064.0,2019-12-24,"(856.0, 962.0]",5,10,-5
31064.0,2019-12-24,"(962.0, 1068.0]",5,6,-1
31065.0,2019-12-24,"(603.729, 671.75]",1,2,-1
31065.0,2019-12-24,"(807.25, 875.0]",1,2,-1
31066.0,2019-12-24,"(788.25, 1051.0]",1,1,0
31067.0,2019-12-24,"(1087.25, 1243.0]",1,1,0
31068.0,2019-12-24,"(496.159, 707.25]",1,1,0
31068.0,2019-12-24,"(707.25, 917.5]",2,4,-2
31068.0,2019-12-24,"(917.5, 1127.75]",2,4,-2
31068.0,2019-12-24,"(1127.75, 1338.0]",1,1,0
31069.0,2019-12-24,"(84.609, 182.75]",1,1,0
31070.0,2019-12-24,"(817.892, 845.0]",1,1,0
31070.0,2019-12-24,"(899.0, 926.0]",1,1,0
31071.0,2019-12-24,"(604.656, 691.0]",1,1,0
31071.0,2019-12-24,"(777.0, 863.0]",3,2,1
31071.0,2019-12-24,"(863.0, 949.0]",4,4,0
,,,,2.0,
31073.0,2019-12-24,"(843.76, 904.0]",1,3,-2
31073.0,2019-12-24,"(1024.0, 1084.0]",1,1,0
31074.0,2019-12-24,"(867.921, 887.75]",1,1,0
31074.0,2019-12-24,"(927.25, 947.0]",1,1,0
,,,,2.0,
,,,,2.0,
31077.0,2019-12-24,"(631.193, 833.75]",2,4,-2
31077.0,2019-12-24,"(833.75, 1035.5]",2,4,-2
,,,,2.0,
31079.0,2019-12-24,"(1187.25, 1374.0]",1,2,-1
31080.0,2019-12-24,"(741.75, 989.0]",1,1,0
31081.0,2019-12-24,"(677.534, 794.5]",3,5,-2
31081.0,2019-12-24,"(1027.5, 1144.0]",1,2,-1
31082.0,2019-12-24,"(1139.5, 1147.0]",1,1,0
,,,,1.0,
,,,,1.0,
,,,,1.0,
,,,,1.0,
,,,,1.0,
,,,,1.0,
31085.0,2019-12-24,"(515.786, 569.5]",1,1,0
31086.0,2019-12-24,"(823.5, 1098.0]",2,1,1
31087.0,2019-12-24,"(624.5, 761.0]",1,1,0
31087.0,2019-12-24,"(897.5, 1034.0]",2,2,0
31088.0,2019-12-24,"(753.75, 1005.0]",1,1,0
31089.0,2019-12-24,"(654.75, 772.5]",3,2,1
31090.0,2019-12-24,"(666.788, 720.0]",1,2,-1
31090.0,2019-12-24,"(826.0, 879.0]",1,1,0
31091.0,2019-12-24,"(855.5, 971.0]",2,1,1
31092.0,2019-12-24,"(845.5, 972.0]",2,1,1
,,,,1.0,
,,,,1.0,
,,,,2.0,
31094.0,2019-12-24,"(795.0, 1060.0]",1,1,0
,,,,2.0,
31096.0,2019-12-24,"(793.75, 818.5]",1,1,0
31096.0,2019-12-24,"(843.25, 868.0]",1,1,0
31097.0,2019-12-24,"(671.915, 693.25]",1,1,0
31097.0,2019-12-24,"(714.5, 735.75]",1,1,0
31098.0,2019-12-24,"(617.25, 754.5]",2,3,-1
31098.0,2019-12-24,"(754.5, 891.75]",1,2,-1
31098.0,2019-12-24,"(891.75, 1029.0]",1,1,0
31099.0,2019-12-24,"(24.318, 195.5]",1,1,0
31099.0,2019-12-24,"(536.5, 707.0]",1,2,-1
31100.0,2019-12-24,"(566.209, 764.75]",3,6,-3
31100.0,2019-12-24,"(764.75, 962.5]",4,7,-3
31100.0,2019-12-24,"(962.5, 1160.25]",3,3,0
31101.0,2019-12-24,"(95.886, 375.5]",2,3,-1
31101.0,2019-12-24,"(375.5, 654.0]",8,11,-3
31101.0,2019-12-24,"(654.0, 932.5]",15,31,-16
31101.0,2019-12-24,"(932.5, 1211.0]",8,19,-11
31102.0,2019-12-24,"(504.077, 735.75]",1,7,-6
31102.0,2019-12-24,"(735.75, 966.5]",6,10,-4
31102.0,2019-12-24,"(966.5, 1197.25]",1,3,-2
31102.0,2019-12-24,"(1197.25, 1428.0]",2,2,0
31103.0,2019-12-24,"(645.5, 907.0]",3,4,-1
31103.0,2019-12-24,"(907.0, 1168.5]",4,11,-7
31103.0,2019-12-24,"(1168.5, 1430.0]",2,9,-7
31104.0,2019-12-24,"(14.717, 336.75]",1,2,-1
31104.0,2019-12-24,"(336.75, 657.5]",2,10,-8
31104.0,2019-12-24,"(657.5, 978.25]",7,16,-9
31104.0,2019-12-24,"(978.25, 1299.0]",6,10,-4
31105.0,2019-12-24,"(691.0, 867.0]",3,1,2
31105.0,2019-12-24,"(867.0, 1043.0]",1,7,-6
31106.0,2019-12-24,"(892.25, 1017.0]",1,1,0
31107.0,2019-12-24,"(336.9, 613.0]",3,10,-7
31107.0,2019-12-24,"(613.0, 888.0]",5,16,-11
31107.0,2019-12-24,"(888.0, 1163.0]",4,8,-4
31107.0,2019-12-24,"(1163.0, 1438.0]",2,4,-2
31108.0,2019-12-24,"(26.591, 380.25]",2,2,0
31108.0,2019-12-24,"(380.25, 732.5]",8,18,-10
31108.0,2019-12-24,"(732.5, 1084.75]",7,18,-11
31108.0,2019-12-24,"(1084.75, 1437.0]",1,3,-2
31109.0,2019-12-24,"(390.991, 644.25]",4,15,-11
31109.0,2019-12-24,"(644.25, 896.5]",5,11,-6
31109.0,2019-12-24,"(896.5, 1148.75]",7,10,-3
31110.0,2019-12-24,"(436.213, 633.75]",6,11,-5
31110.0,2019-12-24,"(633.75, 830.5]",5,15,-10
31110.0,2019-12-24,"(830.5, 1027.25]",4,9,-5
31110.0,2019-12-24,"(1027.25, 1224.0]",5,7,-2
31111.0,2019-12-24,"(407.097, 633.75]",4,9,-5
31111.0,2019-12-24,"(633.75, 859.5]",5,11,-6
31111.0,2019-12-24,"(859.5, 1085.25]",3,6,-3
31111.0,2019-12-24,"(1085.25, 1311.0]",4,5,-1
31112.0,2019-12-24,"(540.67, 623.5]",1,1,0
31112.0,2019-12-24,"(623.5, 706.0]",1,1,0
31113.0,2019-12-24,"(513.304, 688.0]",1,6,-5
31113.0,2019-12-24,"(688.0, 862.0]",2,4,-2
31113.0,2019-12-24,"(862.0, 1036.0]",2,3,-1
31113.0,2019-12-24,"(1036.0, 1210.0]",4,7,-3
31114.0,2019-12-24,"(381.974, 639.5]",3,7,-4
31114.0,2019-12-24,"(639.5, 896.0]",3,7,-4
31114.0,2019-12-24,"(896.0, 1152.5]",3,8,-5
31114.0,2019-12-24,"(1152.5, 1409.0]",1,5,-4
31115.0,2019-12-24,"(164.857, 451.75]",1,3,-2
31115.0,2019-12-24,"(451.75, 737.5]",2,7,-5
31115.0,2019-12-24,"(737.5, 1023.25]",3,5,-2
31115.0,2019-12-24,"(1023.25, 1309.0]",2,6,-4
31116.0,2019-12-24,"(394.375, 551.25]",1,4,-3
31116.0,2019-12-24,"(551.25, 707.5]",1,4,-3
31116.0,2019-12-24,"(707.5, 863.75]",5,8,-3
31116.0,2019-12-24,"(863.75, 1020.0]",3,5,-2
31117.0,2019-12-24,"(349.129, 567.75]",1,6,-5
31117.0,2019-12-24,"(567.75, 785.5]",7,13,-6
31117.0,2019-12-24,"(785.5, 1003.25]",1,3,-2
31117.0,2019-12-24,"(1003.25, 1221.0]",4,8,-4
31118.0,2019-12-24,"(24.621, 370.75]",1,1,0
31118.0,2019-12-24,"(370.75, 715.5]",2,7,-5
31118.0,2019-12-24,"(715.5, 1060.25]",5,9,-4
31118.0,2019-12-24,"(1060.25, 1405.0]",3,3,0
31119.0,2019-12-24,"(8.575, 366.25]",1,2,-1
31119.0,2019-12-24,"(366.25, 722.5]",8,19,-11
31119.0,2019-12-24,"(722.5, 1078.75]",9,20,-11
31119.0,2019-12-24,"(1078.75, 1435.0]",4,6,-2
31120.0,2019-12-24,"(435.306, 609.5]",2,4,-2
31120.0,2019-12-24,"(609.5, 783.0]",2,6,-4
31120.0,2019-12-24,"(783.0, 956.5]",1,2,-1
31121.0,2019-12-24,"(361.087, 590.25]",4,6,-2
31121.0,2019-12-24,"(590.25, 818.5]",1,6,-5
31121.0,2019-12-24,"(818.5, 1046.75]",6,8,-2
31121.0,2019-12-24,"(1046.75, 1275.0]",4,6,-2
31122.0,2019-12-24,"(437.077, 668.75]",1,5,-4
31122.0,2019-12-24,"(668.75, 899.5]",4,7,-3
31122.0,2019-12-24,"(899.5, 1130.25]",1,3,-2
31123.0,2019-12-24,"(636.5, 902.0]",6,3,3
31123.0,2019-12-24,"(902.0, 1167.5]",1,13,-12
31123.0,2019-12-24,"(1167.5, 1433.0]",1,5,-4
31124.0,2019-12-24,"(131.698, 458.5]",1,2,-1
31124.0,2019-12-24,"(458.5, 784.0]",8,18,-10
31124.0,2019-12-24,"(784.0, 1109.5]",11,27,-16
31124.0,2019-12-24,"(1109.5, 1435.0]",6,11,-5
31125.0,2019-12-24,"(453.068, 687.0]",3,9,-6
31125.0,2019-12-24,"(687.0, 920.0]",14,32,-18
31125.0,2019-12-24,"(920.0, 1153.0]",7,8,-1
31125.0,2019-12-24,"(1153.0, 1386.0]",3,7,-4
31126.0,2019-12-24,"(451.236, 643.0]",1,9,-8
31126.0,2019-12-24,"(834.0, 1025.0]",3,2,1
31126.0,2019-12-24,"(1025.0, 1216.0]",6,5,1
,,,,2.0,
31128.0,2019-12-24,"(448.202, 648.5]",6,7,-1
31128.0,2019-12-24,"(648.5, 848.0]",4,9,-5
31128.0,2019-12-24,"(848.0, 1047.5]",2,8,-6
31128.0,2019-12-24,"(1047.5, 1247.0]",5,8,-3
31129.0,2019-12-24,"(535.211, 733.25]",3,5,-2
31129.0,2019-12-24,"(733.25, 930.5]",18,30,-12
31129.0,2019-12-24,"(930.5, 1127.75]",5,13,-8
31129.0,2019-12-24,"(1127.75, 1325.0]",4,7,-3
31130.0,2019-12-24,"(606.187, 810.25]",5,12,-7
31130.0,2019-12-24,"(810.25, 1013.5]",2,4,-2
31130.0,2019-12-24,"(1013.5, 1216.75]",3,5,-2
31130.0,2019-12-24,"(1216.75, 1420.0]",1,2,-1
31131.0,2019-12-24,"(445.44, 586.0]",4,7,-3
31131.0,2019-12-24,"(866.0, 1006.0]",1,1,0
31200.0,2019-12-24,"(335.914, 608.5]",10,11,-1
31200.0,2019-12-24,"(608.5, 880.0]",12,20,-8
31200.0,2019-12-24,"(880.0, 1151.5]",7,12,-5
31200.0,2019-12-24,"(1151.5, 1423.0]",2,2,0
31201.0,2019-12-24,"(93.735, 411.25]",2,4,-2
31201.0,2019-12-24,"(411.25, 727.5]",13,25,-12
31201.0,2019-12-24,"(727.5, 1043.75]",24,42,-18
31201.0,2019-12-24,"(1043.75, 1360.0]",8,15,-7
31202.0,2019-12-24,"(346.5, 608.0]",5,1,4
31202.0,2019-12-24,"(608.0, 869.5]",8,12,-4
31202.0,2019-12-24,"(869.5, 1131.0]",6,17,-11
31203.0,2019-12-24,"(11.603, 362.25]",2,4,-2
31203.0,2019-12-24,"(362.25, 711.5]",9,18,-9
31203.0,2019-12-24,"(711.5, 1060.75]",11,21,-10
31203.0,2019-12-24,"(1060.75, 1410.0]",8,13,-5
31204.0,2019-12-24,"(296.921, 567.75]",2,3,-1
31204.0,2019-12-24,"(837.5, 1107.25]",1,2,-1
31204.0,2019-12-24,"(1107.25, 1377.0]",1,2,-1
31205.0,2019-12-24,"(485.362, 645.5]",2,4,-2
31205.0,2019-12-24,"(645.5, 805.0]",2,2,0
31205.0,2019-12-24,"(964.5, 1124.0]",4,2,2
,,,,1.0,
,,,,1.0,
,,,,2.0,
31208.0,2019-12-24,"(551.303, 726.25]",1,3,-2
31208.0,2019-12-24,"(900.5, 1074.75]",1,1,0
31208.0,2019-12-24,"(1074.75, 1249.0]",2,2,0
31209.0,2019-12-24,"(1183.0, 1335.0]",3,2,1
31211.0,2019-12-24,"(527.592, 630.0]",4,5,-1
31211.0,2019-12-24,"(630.0, 732.0]",5,5,0
31211.0,2019-12-24,"(834.0, 936.0]",4,8,-4
31212.0,2019-12-24,"(383.152, 596.0]",7,8,-1
31212.0,2019-12-24,"(596.0, 808.0]",4,8,-4
31212.0,2019-12-24,"(808.0, 1020.0]",4,6,-2
31212.0,2019-12-24,"(1020.0, 1232.0]",1,2,-1
31213.0,2019-12-24,"(482.204, 682.0]",10,14,-4
31213.0,2019-12-24,"(682.0, 881.0]",6,6,0
31213.0,2019-12-24,"(881.0, 1080.0]",4,7,-3
31213.0,2019-12-24,"(1080.0, 1279.0]",1,3,-2
31214.0,2019-12-24,"(3.593, 356.75]",3,8,-5
31214.0,2019-12-24,"(356.75, 708.5]",10,21,-11
31214.0,2019-12-24,"(708.5, 1060.25]",23,42,-19
31214.0,2019-12-24,"(1060.25, 1412.0]",8,13,-5
31215.0,2019-12-24,"(488.111, 711.25]",3,4,-1
31215.0,2019-12-24,"(711.25, 933.5]",6,9,-3
31215.0,2019-12-24,"(933.5, 1155.75]",4,9,-5
31215.0,2019-12-24,"(1155.75, 1378.0]",1,4,-3
31216.0,2019-12-24,"(486.36, 647.0]",4,6,-2
31216.0,2019-12-24,"(647.0, 807.0]",4,10,-6
31216.0,2019-12-24,"(807.0, 967.0]",1,5,-4
31216.0,2019-12-24,"(967.0, 1127.0]",5,7,-2
31217.0,2019-12-24,"(621.0, 828.0]",7,1,6
31218.0,2019-12-24,"(626.393, 778.75]",2,3,-1
31218.0,2019-12-24,"(778.75, 930.5]",10,15,-5
31218.0,2019-12-24,"(930.5, 1082.25]",5,7,-2
31218.0,2019-12-24,"(1082.25, 1234.0]",2,5,-3
31219.0,2019-12-24,"(593.567, 702.25]",3,3,0
31219.0,2019-12-24,"(702.25, 810.5]",3,3,0
31219.0,2019-12-24,"(810.5, 918.75]",3,6,-3
31220.0,2019-12-24,"(608.82, 654.0]",2,4,-2
31220.0,2019-12-24,"(744.0, 789.0]",1,2,-1
31221.0,2019-12-24,"(455.316, 627.0]",7,7,0
31221.0,2019-12-24,"(627.0, 798.0]",4,8,-4
31221.0,2019-12-24,"(798.0, 969.0]",7,18,-11
31221.0,2019-12-24,"(969.0, 1140.0]",2,6,-4
31222.0,2019-12-24,"(604.469, 737.75]",5,7,-2
31222.0,2019-12-24,"(737.75, 870.5]",2,4,-2
31222.0,2019-12-24,"(870.5, 1003.25]",1,6,-5
31223.0,2019-12-24,"(321.75, 614.5]",4,1,3
31223.0,2019-12-24,"(614.5, 907.25]",3,9,-6
31223.0,2019-12-24,"(907.25, 1200.0]",6,9,-3
31224.0,2019-12-24,"(562.512, 685.0]",1,2,-1
31224.0,2019-12-24,"(685.0, 807.0]",3,6,-3
31224.0,2019-12-24,"(807.0, 929.0]",1,1,0
31224.0,2019-12-24,"(929.0, 1051.0]",1,2,-1
31225.0,2019-12-24,"(539.5, 666.0]",1,1,0
31225.0,2019-12-24,"(666.0, 792.5]",1,2,-1
31225.0,2019-12-24,"(792.5, 919.0]",1,4,-3
31226.0,2019-12-24,"(635.0, 792.5]",1,1,0
31226.0,2019-12-24,"(792.5, 950.0]",1,2,-1
31227.0,2019-12-24,"(322.75, 545.5]",1,1,0
31227.0,2019-12-24,"(545.5, 768.25]",8,1,7
31227.0,2019-12-24,"(768.25, 991.0]",2,13,-11
31228.0,2019-12-24,"(60.917, 332.75]",2,4,-2
31228.0,2019-12-24,"(332.75, 603.5]",5,6,-1
31228.0,2019-12-24,"(603.5, 874.25]",12,17,-5
31228.0,2019-12-24,"(874.25, 1145.0]",9,14,-5
31229.0,2019-12-24,"(16.591, 370.25]",1,3,-2
31229.0,2019-12-24,"(370.25, 722.5]",8,26,-18
31229.0,2019-12-24,"(722.5, 1074.75]",20,28,-8
31229.0,2019-12-24,"(1074.75, 1427.0]",5,14,-9
31230.0,2019-12-24,"(393.105, 617.75]",7,8,-1
31230.0,2019-12-24,"(617.75, 841.5]",19,31,-12
31230.0,2019-12-24,"(841.5, 1065.25]",8,17,-9
31230.0,2019-12-24,"(1065.25, 1289.0]",4,5,-1
31231.0,2019-12-24,"(530.503, 655.25]",2,2,0
31231.0,2019-12-24,"(655.25, 779.5]",4,8,-4
31231.0,2019-12-24,"(779.5, 903.75]",8,9,-1
31232.0,2019-12-24,"(296.1, 522.0]",2,5,-3
31232.0,2019-12-24,"(522.0, 747.0]",3,3,0
31232.0,2019-12-24,"(747.0, 972.0]",4,7,-3
31233.0,2019-12-24,"(416.212, 614.0]",6,7,-1
31233.0,2019-12-24,"(614.0, 811.0]",3,11,-8
31233.0,2019-12-24,"(811.0, 1008.0]",5,8,-3
31233.0,2019-12-24,"(1008.0, 1205.0]",4,6,-2
31234.0,2019-12-24,"(356.0, 708.0]",4,1,3
31234.0,2019-12-24,"(708.0, 1060.0]",5,9,-4
31234.0,2019-12-24,"(1060.0, 1412.0]",3,9,-6
31235.0,2019-12-24,"(815.5, 889.25]",2,5,-3
31235.0,2019-12-24,"(889.25, 963.0]",4,3,1
31236.0,2019-12-24,"(495.1, 721.0]",4,4,0
31236.0,2019-12-24,"(721.0, 946.0]",2,6,-4
31236.0,2019-12-24,"(946.0, 1171.0]",1,3,-2
31236.0,2019-12-24,"(1171.0, 1396.0]",1,2,-1
31237.0,2019-12-24,"(532.17, 740.5]",4,9,-5
31237.0,2019-12-24,"(740.5, 948.0]",3,5,-2
31237.0,2019-12-24,"(948.0, 1155.5]",2,2,0
31237.0,2019-12-24,"(1155.5, 1363.0]",2,2,0
31238.0,2019-12-24,"(33.926, 303.5]",1,1,0
31238.0,2019-12-24,"(303.5, 572.0]",4,5,-1
31238.0,2019-12-24,"(572.0, 840.5]",6,10,-4
31238.0,2019-12-24,"(840.5, 1109.0]",4,15,-11
31239.0,2019-12-24,"(507.25, 723.5]",4,1,3
31239.0,2019-12-24,"(723.5, 939.75]",2,7,-5
31239.0,2019-12-24,"(939.75, 1156.0]",10,5,5
31240.0,2019-12-24,"(543.605, 642.75]",1,2,-1
31240.0,2019-12-24,"(642.75, 741.5]",2,2,0
31240.0,2019-12-24,"(741.5, 840.25]",5,11,-6
31240.0,2019-12-24,"(840.25, 939.0]",5,8,-3
31241.0,2019-12-24,"(101.8, 403.0]",1,1,0
31241.0,2019-12-24,"(403.0, 703.0]",7,12,-5
31241.0,2019-12-24,"(703.0, 1003.0]",9,19,-10
31241.0,2019-12-24,"(1003.0, 1303.0]",3,6,-3
31242.0,2019-12-24,"(491.353, 653.75]",9,12,-3
31242.0,2019-12-24,"(815.5, 977.25]",1,5,-4
31243.0,2019-12-24,"(445.444, 585.0]",1,1,0
31243.0,2019-12-24,"(585.0, 724.0]",2,4,-2
31243.0,2019-12-24,"(724.0, 863.0]",1,2,-1
31243.0,2019-12-24,"(863.0, 1002.0]",1,4,-3
31244.0,2019-12-24,"(754.0, 916.0]",1,3,-2
31244.0,2019-12-24,"(916.0, 1078.0]",3,6,-3
31244.0,2019-12-24,"(1078.0, 1240.0]",1,3,-2
31245.0,2019-12-24,"(634.5, 894.0]",6,3,3
31245.0,2019-12-24,"(894.0, 1153.5]",2,10,-8
31245.0,2019-12-24,"(1153.5, 1413.0]",2,6,-4
31246.0,2019-12-24,"(67.665, 402.75]",1,2,-1
31246.0,2019-12-24,"(402.75, 736.5]",6,13,-7
31246.0,2019-12-24,"(736.5, 1070.25]",10,17,-7
31246.0,2019-12-24,"(1070.25, 1404.0]",4,9,-5
31247.0,2019-12-24,"(549.171, 757.25]",5,8,-3
31247.0,2019-12-24,"(757.25, 964.5]",18,27,-9
31248.0,2019-12-24,"(528.347, 692.25]",10,20,-10
31248.0,2019-12-24,"(692.25, 855.5]",7,18,-11
31248.0,2019-12-24,"(855.5, 1018.75]",19,32,-13
31248.0,2019-12-24,"(1018.75, 1182.0]",2,8,-6
31249.0,2019-12-24,"(733.0, 822.0]",5,2,3
31249.0,2019-12-24,"(822.0, 911.0]",6,10,-4
31249.0,2019-12-24,"(911.0, 1000.0]",7,9,-2
31250.0,2019-12-24,"(306.75, 524.5]",1,1,0
31250.0,2019-12-24,"(524.5, 742.25]",7,1,6
31250.0,2019-12-24,"(742.25, 960.0]",4,8,-4
31251.0,2019-12-24,"(370.164, 580.0]",3,10,-7
31251.0,2019-12-24,"(580.0, 789.0]",3,9,-6
31251.0,2019-12-24,"(789.0, 998.0]",6,13,-7
31251.0,2019-12-24,"(998.0, 1207.0]",3,5,-2
31252.0,2019-12-24,"(603.367, 762.25]",2,5,-3
31252.0,2019-12-24,"(762.25, 920.5]",1,2,-1
31252.0,2019-12-24,"(1078.75, 1237.0]",1,3,-2
31253.0,2019-12-24,"(427.014, 674.5]",3,3,0
31253.0,2019-12-24,"(674.5, 921.0]",2,4,-2
31253.0,2019-12-24,"(1167.5, 1414.0]",1,1,0
31254.0,2019-12-24,"(497.419, 643.25]",1,1,0
31254.0,2019-12-24,"(643.25, 788.5]",1,2,-1
31254.0,2019-12-24,"(933.75, 1079.0]",4,3,1
31255.0,2019-12-24,"(515.181, 720.75]",3,6,-3
31255.0,2019-12-24,"(1130.25, 1335.0]",1,3,-2
31256.0,2019-12-24,"(542.406, 691.5]",9,10,-1
31256.0,2019-12-24,"(691.5, 840.0]",3,4,-1
31256.0,2019-12-24,"(840.0, 988.5]",2,7,-5
31256.0,2019-12-24,"(988.5, 1137.0]",7,7,0
31257.0,2019-12-24,"(411.25, 683.5]",2,1,1
31257.0,2019-12-24,"(683.5, 955.75]",8,6,2
31257.0,2019-12-24,"(955.75, 1228.0]",6,17,-11
31258.0,2019-12-24,"(615.438, 756.5]",7,14,-7
31258.0,2019-12-24,"(756.5, 897.0]",14,24,-10
31258.0,2019-12-24,"(897.0, 1037.5]",7,16,-9
31258.0,2019-12-24,"(1037.5, 1178.0]",8,13,-5
31259.0,2019-12-24,"(710.924, 730.0]",1,2,-1
31260.0,2019-12-24,"(591.434, 733.5]",1,2,-1
31260.0,2019-12-24,"(733.5, 875.0]",2,2,0
31260.0,2019-12-24,"(1016.5, 1158.0]",3,4,-1
31261.0,2019-12-24,"(490.522, 610.5]",3,3,0
31261.0,2019-12-24,"(730.0, 849.5]",1,2,-1
31261.0,2019-12-24,"(849.5, 969.0]",4,4,0
31262.0,2019-12-24,"(574.152, 787.0]",5,8,-3
31262.0,2019-12-24,"(787.0, 999.0]",4,5,-1
31262.0,2019-12-24,"(999.0, 1211.0]",3,6,-3
31263.0,2019-12-24,"(371.229, 564.75]",4,6,-2
31263.0,2019-12-24,"(564.75, 757.5]",1,7,-6
31263.0,2019-12-24,"(757.5, 950.25]",4,9,-5
31263.0,2019-12-24,"(950.25, 1143.0]",6,9,-3
31264.0,2019-12-24,"(567.492, 695.0]",5,7,-2
31264.0,2019-12-24,"(695.0, 822.0]",2,3,-1
31264.0,2019-12-24,"(822.0, 949.0]",2,6,-4
31264.0,2019-12-24,"(949.0, 1076.0]",2,5,-3
31265.0,2019-12-24,"(268.046, 507.5]",1,7,-6
31265.0,2019-12-24,"(507.5, 746.0]",7,8,-1
31265.0,2019-12-24,"(746.0, 984.5]",2,6,-4
31265.0,2019-12-24,"(984.5, 1223.0]",6,10,-4
31266.0,2019-12-24,"(75.719, 397.25]",1,4,-3
31266.0,2019-12-24,"(397.25, 717.5]",3,8,-5
31266.0,2019-12-24,"(717.5, 1037.75]",4,16,-12
31266.0,2019-12-24,"(1037.75, 1358.0]",4,6,-2
31267.0,2019-12-24,"(506.141, 721.75]",2,4,-2
31267.0,2019-12-24,"(721.75, 936.5]",4,7,-3
31267.0,2019-12-24,"(936.5, 1151.25]",3,5,-2
31267.0,2019-12-24,"(1151.25, 1366.0]",3,3,0
31268.0,2019-12-24,"(501.246, 690.5]",8,13,-5
31268.0,2019-12-24,"(690.5, 879.0]",1,4,-3
31268.0,2019-12-24,"(879.0, 1067.5]",2,3,-1
31268.0,2019-12-24,"(1067.5, 1256.0]",3,5,-2
31269.0,2019-12-24,"(565.162, 775.5]",5,8,-3
31269.0,2019-12-24,"(775.5, 985.0]",5,11,-6
31269.0,2019-12-24,"(985.0, 1194.5]",1,2,-1
31269.0,2019-12-24,"(1194.5, 1404.0]",2,4,-2
31270.0,2019-12-24,"(476.397, 627.75]",3,3,0
31270.0,2019-12-24,"(627.75, 778.5]",3,4,-1
31270.0,2019-12-24,"(778.5, 929.25]",2,3,-1
31270.0,2019-12-24,"(929.25, 1080.0]",1,3,-2
31271.0,2019-12-24,"(552.515, 674.25]",6,8,-2
31271.0,2019-12-24,"(674.25, 795.5]",4,10,-6
31271.0,2019-12-24,"(795.5, 916.75]",3,6,-3
31272.0,2019-12-24,"(341.5, 647.0]",4,1,3
31272.0,2019-12-24,"(647.0, 952.5]",10,4,6
31272.0,2019-12-24,"(952.5, 1258.0]",12,19,-7
31273.0,2019-12-24,"(757.0, 894.5]",1,1,0
31273.0,2019-12-24,"(894.5, 1032.0]",2,1,1
31274.0,2019-12-24,"(346.5, 690.0]",2,1,1
31274.0,2019-12-24,"(690.0, 1033.5]",4,6,-2
31274.0,2019-12-24,"(1033.5, 1377.0]",4,6,-2
31275.0,2019-12-24,"(460.039, 701.25]",2,6,-4
31275.0,2019-12-24,"(701.25, 941.5]",2,6,-4
31275.0,2019-12-24,"(941.5, 1181.75]",4,5,-1
31276.0,2019-12-24,"(507.683, 587.25]",2,4,-2
31276.0,2019-12-24,"(587.25, 666.5]",1,2,-1
31276.0,2019-12-24,"(666.5, 745.75]",3,4,-1
31276.0,2019-12-24,"(745.75, 825.0]",3,4,-1
31277.0,2019-12-24,"(469.231, 662.25]",5,6,-1
31277.0,2019-12-24,"(662.25, 854.5]",7,12,-5
31277.0,2019-12-24,"(854.5, 1046.75]",7,11,-4
31277.0,2019-12-24,"(1046.75, 1239.0]",1,6,-5
31278.0,2019-12-24,"(416.75, 734.5]",7,1,6
31278.0,2019-12-24,"(734.5, 1052.25]",2,14,-12
31278.0,2019-12-24,"(1052.25, 1370.0]",2,5,-3
31279.0,2019-12-24,"(504.438, 645.5]",6,8,-2
31279.0,2019-12-24,"(645.5, 786.0]",2,8,-6
31279.0,2019-12-24,"(786.0, 926.5]",1,2,-1
31280.0,2019-12-24,"(13.978, 270.5]",1,2,-1
31280.0,2019-12-24,"(526.0, 781.5]",4,6,-2
31280.0,2019-12-24,"(781.5, 1037.0]",4,7,-3
31000.0,2019-12-25,"(594.75, 793.0]",1,1,0
31001.0,2019-12-25,"(763.25, 777.0]",1,1,0
31002.0,2019-12-25,"(540.839, 581.25]",2,4,-2
31003.0,2019-12-25,"(370.507, 494.25]",1,1,0
31003.0,2019-12-25,"(740.75, 864.0]",2,2,0
31004.0,2019-12-25,"(971.0, 977.0]",1,1,0
,,,,1.0,
,,,,3.0,
31006.0,2019-12-25,"(755.694, 832.5]",3,3,0
31007.0,2019-12-25,"(626.659, 712.25]",1,1,0
31007.0,2019-12-25,"(712.25, 797.5]",1,2,-1
31007.0,2019-12-25,"(797.5, 882.75]",2,2,0
,,,,2.0,
31010.0,2019-12-25,"(555.5, 563.0]",1,1,0
31011.0,2019-12-25,"(1075.983, 1080.25]",2,2,0
,,,,1.0,
,,,,1.0,
31013.0,2019-12-25,"(908.75, 967.0]",1,4,-3
31014.0,2019-12-25,"(431.343, 596.25]",1,3,-2
31014.0,2019-12-25,"(596.25, 760.5]",2,4,-2
31014.0,2019-12-25,"(760.5, 924.75]",3,8,-5
31014.0,2019-12-25,"(924.75, 1089.0]",4,6,-2
31015.0,2019-12-25,"(1.809, 300.75]",1,1,0
31015.0,2019-12-25,"(598.5, 896.25]",2,4,-2
31015.0,2019-12-25,"(896.25, 1194.0]",3,6,-3
31016.0,2019-12-25,"(874.901, 899.75]",2,2,0
,,,,1.0,
,,,,2.0,
31018.0,2019-12-25,"(776.977, 782.75]",1,1,0
,,,,2.0,
31020.0,2019-12-25,"(586.616, 683.0]",1,2,-1
31020.0,2019-12-25,"(875.0, 971.0]",1,1,0
,,,,2.0,
31022.0,2019-12-25,"(749.635, 841.25]",1,1,0
,,,,2.0,
,,,,2.0,
,,,,1.0,
,,,,2.0,
,,,,2.0,
,,,,2.0,
,,,,1.0,
,,,,1.0,
31029.0,2019-12-25,"(775.75, 794.0]",1,1,0
31030.0,2019-12-25,"(981.75, 1091.0]",1,1,0
,,,,1.0,
,,,,1.0,
,,,,2.0,
,,,,1.0,
,,,,1.0,
,,,,2.0,
31035.0,2019-12-25,"(872.75, 903.0]",1,1,0
31036.0,2019-12-25,"(533.25, 711.0]",2,1,1
31037.0,2019-12-25,"(901.5, 987.75]",1,2,-1
31037.0,2019-12-25,"(987.75, 1074.0]",2,1,1
,,,,2.0,
,,,,2.0,
31040.0,2019-12-25,"(768.517, 889.75]",2,2,0
31041.0,2019-12-25,"(662.671, 745.25]",1,2,-1
31041.0,2019-12-25,"(745.25, 827.5]",1,3,-2
31041.0,2019-12-25,"(909.75, 992.0]",6,12,-6
31042.0,2019-12-25,"(682.914, 704.5]",1,1,0
31042.0,2019-12-25,"(747.5, 769.0]",1,2,-1
31043.0,2019-12-25,"(726.0, 968.0]",1,1,0
,,,,2.0,
31045.0,2019-12-25,"(657.239, 848.25]",1,5,-4
31045.0,2019-12-25,"(848.25, 1038.5]",1,1,0
31045.0,2019-12-25,"(1228.75, 1419.0]",1,1,0
,,,,2.0,
31047.0,2019-12-25,"(600.576, 707.0]",1,1,0
,,,,2.0,
31049.0,2019-12-25,"(932.75, 935.0]",1,1,0
,,,,2.0,
31051.0,2019-12-25,"(1076.5, 1119.0]",1,1,0
31052.0,2019-12-25,"(1026.25, 1036.0]",2,2,0
,,,,2.0,
,,,,2.0,
31055.0,2019-12-25,"(878.886, 907.5]",1,1,0
31055.0,2019-12-25,"(964.5, 993.0]",1,2,-1
,,,,2.0,
31057.0,2019-12-25,"(733.5, 978.0]",1,1,0
31058.0,2019-12-25,"(623.75, 696.0]",1,1,0
31059.0,2019-12-25,"(653.975, 660.25]",1,1,0
31060.0,2019-12-25,"(1002.5, 1021.25]",4,5,-1
31060.0,2019-12-25,"(1021.25, 1040.0]",1,4,-3
31061.0,2019-12-25,"(393.75, 525.0]",1,1,0
31062.0,2019-12-25,"(729.635, 821.25]",2,7,-5
31062.0,2019-12-25,"(821.25, 912.5]",2,3,-1
31062.0,2019-12-25,"(912.5, 1003.75]",3,6,-3
31062.0,2019-12-25,"(1003.75, 1095.0]",5,8,-3
,,,,2.0,
31064.0,2019-12-25,"(450.445, 589.75]",2,4,-2
31064.0,2019-12-25,"(589.75, 728.5]",2,5,-3
31064.0,2019-12-25,"(728.5, 867.25]",1,2,-1
31064.0,2019-12-25,"(867.25, 1006.0]",11,19,-8
31065.0,2019-12-25,"(420.79, 421.0]",1,2,-1
31066.0,2019-12-25,"(734.25, 770.0]",1,1,0
31067.0,2019-12-25,"(1092.75, 1251.0]",2,1,1
31068.0,2019-12-25,"(1030.0, 1037.0]",1,1,0
,,,,2.0,
31070.0,2019-12-25,"(953.75, 1004.0]",1,1,0
,,,,1.0,
,,,,1.0,
,,,,2.0,
,,,,2.0,
31073.0,2019-12-25,"(675.0, 900.0]",1,1,0
,,,,2.0,
31075.0,2019-12-25,"(819.932, 837.0]",1,1,0
,,,,2.0,
31077.0,2019-12-25,"(468.271, 651.25]",1,1,0
31077.0,2019-12-25,"(651.25, 833.5]",4,12,-8
31077.0,2019-12-25,"(833.5, 1015.75]",5,9,-4
31077.0,2019-12-25,"(1015.75, 1198.0]",3,5,-2
,,,,2.0,
,,,,1.0,
,,,,2.0,
31080.0,2019-12-25,"(688.25, 837.5]",1,1,0
,,,,1.0,
,,,,1.0,
,,,,2.0,
31083.0,2019-12-25,"(718.838, 759.5]",1,2,-1
31083.0,2019-12-25,"(840.5, 881.0]",1,1,0
31084.0,2019-12-25,"(793.38, 949.0]",1,1,0
31084.0,2019-12-25,"(1104.0, 1259.0]",1,1,0
,,,,2.0,
,,,,2.0,
,,,,2.0,
,,,,2.0,
,,,,1.0,
,,,,3.0,
31090.0,2019-12-25,"(683.579, 789.25]",1,2,-1
31090.0,2019-12-25,"(789.25, 894.5]",1,1,0
31090.0,2019-12-25,"(999.75, 1105.0]",2,1,1
31091.0,2019-12-25,"(579.75, 773.0]",1,1,0
31092.0,2019-12-25,"(580.5, 774.0]",2,1,1
,,,,2.0,
,,,,2.0,
31095.0,2019-12-25,"(780.779, 836.25]",1,1,0
31095.0,2019-12-25,"(946.75, 1002.0]",1,2,-1
,,,,2.0,
,,,,2.0,
,,,,1.0,
,,,,1.0,
,,,,2.0,
31100.0,2019-12-25,"(572.0, 839.5]",2,1,1
31100.0,2019-12-25,"(839.5, 1107.0]",3,1,2
31101.0,2019-12-25,"(25.668, 360.0]",1,2,-1
31101.0,2019-12-25,"(360.0, 693.0]",4,5,-1
31101.0,2019-12-25,"(693.0, 1026.0]",2,8,-6
31101.0,2019-12-25,"(1026.0, 1359.0]",3,4,-1
31102.0,2019-12-25,"(524.139, 740.25]",1,3,-2
31102.0,2019-12-25,"(955.5, 1170.75]",2,4,-2
31102.0,2019-12-25,"(1170.75, 1386.0]",1,1,0
31103.0,2019-12-25,"(148.834, 441.5]",1,1,0
31103.0,2019-12-25,"(733.0, 1024.5]",1,2,-1
31103.0,2019-12-25,"(1024.5, 1316.0]",1,5,-4
31104.0,2019-12-25,"(434.0, 721.0]",1,1,0
31104.0,2019-12-25,"(721.0, 1008.0]",4,3,1
31104.0,2019-12-25,"(1008.0, 1295.0]",12,7,5
31105.0,2019-12-25,"(1134.0, 1268.0]",1,1,0
31106.0,2019-12-25,"(748.0, 828.0]",1,1,0
31106.0,2019-12-25,"(828.0, 908.0]",1,1,0
31107.0,2019-12-25,"(588.0, 861.5]",4,2,2
31107.0,2019-12-25,"(861.5, 1135.0]",5,9,-4
31108.0,2019-12-25,"(399.41, 547.5]",4,7,-3
31108.0,2019-12-25,"(547.5, 695.0]",1,3,-2
31108.0,2019-12-25,"(695.0, 842.5]",1,3,-2
31108.0,2019-12-25,"(842.5, 990.0]",5,6,-1
31109.0,2019-12-25,"(418.186, 622.5]",1,1,0
31109.0,2019-12-25,"(622.5, 826.0]",1,2,-1
31109.0,2019-12-25,"(826.0, 1029.5]",4,9,-5
31109.0,2019-12-25,"(1029.5, 1233.0]",3,3,0
31110.0,2019-12-25,"(354.28, 535.0]",1,1,0
31110.0,2019-12-25,"(535.0, 715.0]",3,8,-5
31110.0,2019-12-25,"(715.0, 895.0]",2,4,-2
31110.0,2019-12-25,"(895.0, 1075.0]",4,6,-2
31111.0,2019-12-25,"(698.25, 835.5]",1,1,0
31111.0,2019-12-25,"(835.5, 972.75]",3,2,1
31112.0,2019-12-25,"(491.703, 566.25]",3,5,-2
31112.0,2019-12-25,"(640.5, 714.75]",1,1,0
31113.0,2019-12-25,"(892.5, 1069.75]",1,5,-4
31113.0,2019-12-25,"(1069.75, 1247.0]",1,3,-2
31114.0,2019-12-25,"(130.145, 344.75]",2,2,0
31114.0,2019-12-25,"(558.5, 772.25]",3,2,1
31114.0,2019-12-25,"(772.25, 986.0]",4,5,-1
31115.0,2019-12-25,"(285.878, 567.5]",1,2,-1
31115.0,2019-12-25,"(567.5, 848.0]",1,2,-1
31115.0,2019-12-25,"(848.0, 1128.5]",3,6,-3
31116.0,2019-12-25,"(911.75, 1030.5]",3,4,-1
31116.0,2019-12-25,"(1030.5, 1149.25]",1,5,-4
31116.0,2019-12-25,"(1149.25, 1268.0]",2,1,1
31117.0,2019-12-25,"(368.5, 684.0]",1,2,-1
31117.0,2019-12-25,"(684.0, 999.5]",3,3,0
31117.0,2019-12-25,"(999.5, 1315.0]",1,14,-13
31118.0,2019-12-25,"(532.221, 727.75]",2,7,-5
31118.0,2019-12-25,"(727.75, 922.5]",3,5,-2
31118.0,2019-12-25,"(1117.25, 1312.0]",4,3,1
31119.0,2019-12-25,"(513.142, 728.5]",3,6,-3
31119.0,2019-12-25,"(728.5, 943.0]",3,5,-2
31119.0,2019-12-25,"(943.0, 1157.5]",1,2,-1
31119.0,2019-12-25,"(1157.5, 1372.0]",1,2,-1
31120.0,2019-12-25,"(766.0, 903.0]",1,1,0
31120.0,2019-12-25,"(903.0, 1040.0]",3,1,2
31121.0,2019-12-25,"(550.23, 743.5]",1,2,-1
31121.0,2019-12-25,"(743.5, 936.0]",2,3,-1
31121.0,2019-12-25,"(936.0, 1128.5]",1,2,-1
31121.0,2019-12-25,"(1128.5, 1321.0]",1,3,-2
31122.0,2019-12-25,"(577.674, 659.5]",2,5,-3
31122.0,2019-12-25,"(822.5, 904.0]",1,1,0
31123.0,2019-12-25,"(167.131, 385.25]",1,1,0
31123.0,2019-12-25,"(819.75, 1037.0]",3,2,1
31124.0,2019-12-25,"(326.5, 643.0]",1,1,0
31124.0,2019-12-25,"(643.0, 959.5]",7,6,1
31124.0,2019-12-25,"(959.5, 1276.0]",2,12,-10
31125.0,2019-12-25,"(64.767, 374.25]",3,4,-1
31125.0,2019-12-25,"(374.25, 682.5]",1,4,-3
31125.0,2019-12-25,"(682.5, 990.75]",5,10,-5
31125.0,2019-12-25,"(990.75, 1299.0]",3,10,-7
31126.0,2019-12-25,"(964.5, 1147.25]",2,3,-1
31126.0,2019-12-25,"(1147.25, 1330.0]",2,1,1
,,,,2.0,
31128.0,2019-12-25,"(744.34, 910.0]",2,8,-6
31128.0,2019-12-25,"(910.0, 1075.0]",3,3,0
31128.0,2019-12-25,"(1075.0, 1240.0]",3,3,0
31128.0,2019-12-25,"(1240.0, 1405.0]",1,1,0
31129.0,2019-12-25,"(634.22, 830.0]",13,19,-6
31129.0,2019-12-25,"(830.0, 1025.0]",10,29,-19
31129.0,2019-12-25,"(1025.0, 1220.0]",4,6,-2
31129.0,2019-12-25,"(1220.0, 1415.0]",5,10,-5
31130.0,2019-12-25,"(22.661, 358.75]",1,1,0
31130.0,2019-12-25,"(693.5, 1028.25]",1,4,-3
31130.0,2019-12-25,"(1028.25, 1363.0]",1,3,-2
,,,,1.0,
,,,,3.0,
31200.0,2019-12-25,"(386.058, 622.5]",4,7,-3
31200.0,2019-12-25,"(622.5, 858.0]",5,10,-5
31200.0,2019-12-25,"(858.0, 1093.5]",2,3,-1
31200.0,2019-12-25,"(1093.5, 1329.0]",3,6,-3
31201.0,2019-12-25,"(516.194, 718.5]",3,4,-1
31201.0,2019-12-25,"(718.5, 920.0]",4,8,-4
31201.0,2019-12-25,"(920.0, 1121.5]",4,9,-5
31201.0,2019-12-25,"(1121.5, 1323.0]",2,5,-3
31202.0,2019-12-25,"(600.0, 767.0]",5,1,4
31202.0,2019-12-25,"(767.0, 934.0]",3,6,-3
31202.0,2019-12-25,"(934.0, 1101.0]",4,5,-1
31203.0,2019-12-25,"(44.682, 375.5]",1,2,-1
31203.0,2019-12-25,"(705.0, 1034.5]",7,4,3
31203.0,2019-12-25,"(1034.5, 1364.0]",6,9,-3
31204.0,2019-12-25,"(570.471, 703.25]",1,2,-1
31204.0,2019-12-25,"(835.5, 967.75]",1,2,-1
31204.0,2019-12-25,"(967.75, 1100.0]",6,6,0
31205.0,2019-12-25,"(855.972, 863.0]",2,3,-1
31205.0,2019-12-25,"(863.0, 870.0]",1,1,0
31205.0,2019-12-25,"(870.0, 877.0]",2,2,0
31206.0,2019-12-25,"(1046.993, 1048.75]",4,4,0
31206.0,2019-12-25,"(1048.75, 1050.5]",2,2,0
,,,,2.0,
,,,,1.0,
,,,,2.0,
31209.0,2019-12-25,"(1249.0, 1392.0]",1,2,-1
31211.0,2019-12-25,"(708.539, 824.25]",2,5,-3
31211.0,2019-12-25,"(939.5, 1054.75]",11,1,10
31212.0,2019-12-25,"(443.437, 584.75]",5,5,0
31212.0,2019-12-25,"(725.5, 866.25]",3,2,1
31213.0,2019-12-25,"(703.707, 777.25]",1,2,-1
31213.0,2019-12-25,"(777.25, 850.5]",4,5,-1
31213.0,2019-12-25,"(850.5, 923.75]",2,3,-1
31213.0,2019-12-25,"(923.75, 997.0]",4,4,0
31214.0,2019-12-25,"(467.031, 710.25]",5,7,-2
31214.0,2019-12-25,"(710.25, 952.5]",5,8,-3
31214.0,2019-12-25,"(952.5, 1194.75]",1,4,-3
31214.0,2019-12-25,"(1194.75, 1437.0]",1,2,-1
31215.0,2019-12-25,"(525.365, 684.75]",4,4,0
31215.0,2019-12-25,"(684.75, 843.5]",6,9,-3
31215.0,2019-12-25,"(843.5, 1002.25]",8,14,-6
31215.0,2019-12-25,"(1002.25, 1161.0]",9,17,-8
31216.0,2019-12-25,"(393.269, 576.75]",2,6,-4
31216.0,2019-12-25,"(759.5, 942.25]",1,2,-1
31216.0,2019-12-25,"(942.25, 1125.0]",6,10,-4
31217.0,2019-12-25,"(1144.75, 1190.0]",4,4,0
31218.0,2019-12-25,"(494.27, 677.5]",1,1,0
31218.0,2019-12-25,"(677.5, 860.0]",1,3,-2
31218.0,2019-12-25,"(860.0, 1042.5]",2,3,-1
31218.0,2019-12-25,"(1042.5, 1225.0]",3,7,-4
31219.0,2019-12-25,"(814.75, 859.5]",2,4,-2
31219.0,2019-12-25,"(904.25, 949.0]",2,6,-4
31220.0,2019-12-25,"(780.75, 789.0]",1,4,-3
31221.0,2019-12-25,"(430.016, 677.0]",3,4,-1
31221.0,2019-12-25,"(677.0, 923.0]",4,8,-4
31221.0,2019-12-25,"(923.0, 1169.0]",1,2,-1
31221.0,2019-12-25,"(1169.0, 1415.0]",1,1,0
31222.0,2019-12-25,"(578.433, 720.75]",3,5,-2
31222.0,2019-12-25,"(720.75, 862.5]",5,6,-1
31222.0,2019-12-25,"(862.5, 1004.25]",9,14,-5
31222.0,2019-12-25,"(1004.25, 1146.0]",6,8,-2
31223.0,2019-12-25,"(277.25, 499.5]",1,1,0
31223.0,2019-12-25,"(499.5, 721.75]",1,1,0
31223.0,2019-12-25,"(721.75, 944.0]",5,1,4
31224.0,2019-12-25,"(912.562, 1022.5]",1,3,-2
31224.0,2019-12-25,"(1022.5, 1132.0]",2,2,0
31224.0,2019-12-25,"(1241.5, 1351.0]",2,2,0
31225.0,2019-12-25,"(401.029, 644.75]",5,7,-2
31225.0,2019-12-25,"(644.75, 887.5]",6,10,-4
31225.0,2019-12-25,"(887.5, 1130.25]",8,13,-5
31225.0,2019-12-25,"(1130.25, 1373.0]",6,10,-4
31226.0,2019-12-25,"(801.5, 828.0]",2,1,1
31227.0,2019-12-25,"(770.75, 918.5]",3,1,2
31227.0,2019-12-25,"(918.5, 1066.25]",2,3,-1
31227.0,2019-12-25,"(1066.25, 1214.0]",1,2,-1
31228.0,2019-12-25,"(365.75, 711.5]",5,2,3
31228.0,2019-12-25,"(711.5, 1057.25]",10,8,2
31228.0,2019-12-25,"(1057.25, 1403.0]",4,23,-19
31229.0,2019-12-25,"(30.71, 354.5]",2,2,0
31229.0,2019-12-25,"(354.5, 677.0]",2,8,-6
31229.0,2019-12-25,"(677.0, 999.5]",2,9,-7
31229.0,2019-12-25,"(999.5, 1322.0]",4,5,-1
31230.0,2019-12-25,"(823.0, 1003.0]",1,4,-3
31230.0,2019-12-25,"(1183.0, 1363.0]",2,1,1
31231.0,2019-12-25,"(773.75, 848.5]",2,2,0
31231.0,2019-12-25,"(848.5, 923.25]",3,4,-1
31232.0,2019-12-25,"(740.815, 787.25]",3,4,-1
31232.0,2019-12-25,"(879.75, 926.0]",1,1,0
31233.0,2019-12-25,"(697.0, 932.0]",6,1,5
31233.0,2019-12-25,"(1167.0, 1402.0]",1,8,-7
31234.0,2019-12-25,"(368.083, 598.25]",1,2,-1
31234.0,2019-12-25,"(598.25, 827.5]",2,3,-1
31234.0,2019-12-25,"(827.5, 1056.75]",2,3,-1
31235.0,2019-12-25,"(938.0, 999.0]",11,10,1
31236.0,2019-12-25,"(691.99, 694.5]",1,1,0
31237.0,2019-12-25,"(609.599, 710.25]",3,3,0
31237.0,2019-12-25,"(910.75, 1011.0]",3,5,-2
31238.0,2019-12-25,"(61.117, 282.75]",1,1,0
31238.0,2019-12-25,"(724.25, 945.0]",2,1,1
31239.0,2019-12-25,"(538.64, 629.0]",2,2,0
31239.0,2019-12-25,"(629.0, 719.0]",1,1,0
31239.0,2019-12-25,"(809.0, 899.0]",3,7,-4
31240.0,2019-12-25,"(612.582, 717.5]",20,35,-15
31240.0,2019-12-25,"(717.5, 822.0]",7,18,-11
31240.0,2019-12-25,"(822.0, 926.5]",7,13,-6
31240.0,2019-12-25,"(926.5, 1031.0]",16,24,-8
31241.0,2019-12-25,"(113.765, 423.75]",1,4,-3
31241.0,2019-12-25,"(423.75, 732.5]",3,14,-11
31241.0,2019-12-25,"(732.5, 1041.25]",21,38,-17
31241.0,2019-12-25,"(1041.25, 1350.0]",6,8,-2
31242.0,2019-12-25,"(850.714, 922.5]",1,2,-1
31243.0,2019-12-25,"(657.75, 877.0]",7,1,6
31244.0,2019-12-25,"(630.0, 817.0]",3,1,2
31244.0,2019-12-25,"(1004.0, 1191.0]",1,6,-5
31245.0,2019-12-25,"(524.187, 728.25]",3,4,-1
31245.0,2019-12-25,"(728.25, 931.5]",1,9,-8
31245.0,2019-12-25,"(931.5, 1134.75]",3,6,-3
31246.0,2019-12-25,"(472.041, 712.75]",2,5,-3
31246.0,2019-12-25,"(712.75, 952.5]",7,11,-4
31246.0,2019-12-25,"(952.5, 1192.25]",4,11,-7
31246.0,2019-12-25,"(1192.25, 1432.0]",3,4,-1
31247.0,2019-12-25,"(495.243, 685.25]",3,9,-6
31247.0,2019-12-25,"(685.25, 874.5]",9,28,-19
31247.0,2019-12-25,"(874.5, 1063.75]",17,34,-17
31247.0,2019-12-25,"(1063.75, 1253.0]",3,10,-7
31248.0,2019-12-25,"(490.437, 631.75]",2,3,-1
31248.0,2019-12-25,"(631.75, 772.5]",1,7,-6
31248.0,2019-12-25,"(772.5, 913.25]",9,34,-25
31248.0,2019-12-25,"(913.25, 1054.0]",14,20,-6
31249.0,2019-12-25,"(413.357, 574.75]",7,13,-6
31249.0,2019-12-25,"(574.75, 735.5]",8,17,-9
31249.0,2019-12-25,"(735.5, 896.25]",15,26,-11
31249.0,2019-12-25,"(896.25, 1057.0]",20,31,-11
31250.0,2019-12-25,"(500.0, 750.0]",1,1,0
31250.0,2019-12-25,"(750.0, 1000.0]",5,1,4
31251.0,2019-12-25,"(15.705, 340.75]",1,1,0
31251.0,2019-12-25,"(340.75, 664.5]",2,3,-1
31251.0,2019-12-25,"(664.5, 988.25]",5,12,-7
31251.0,2019-12-25,"(988.25, 1312.0]",5,8,-3
31252.0,2019-12-25,"(653.571, 761.25]",1,1,0
31252.0,2019-12-25,"(761.25, 868.5]",2,2,0
31253.0,2019-12-25,"(849.75, 913.0]",3,3,0
31254.0,2019-12-25,"(704.414, 851.5]",1,3,-2
31255.0,2019-12-25,"(556.601, 656.75]",1,3,-2
31255.0,2019-12-25,"(656.75, 756.5]",1,1,0
31255.0,2019-12-25,"(856.25, 956.0]",1,3,-2
31256.0,2019-12-25,"(519.406, 668.5]",1,1,0
31256.0,2019-12-25,"(668.5, 817.0]",2,4,-2
31256.0,2019-12-25,"(817.0, 965.5]",6,12,-6
31257.0,2019-12-25,"(404.226, 598.5]",4,6,-2
31257.0,2019-12-25,"(598.5, 792.0]",1,2,-1
31257.0,2019-12-25,"(985.5, 1179.0]",1,5,-4
31258.0,2019-12-25,"(365.158, 576.5]",6,12,-6
31258.0,2019-12-25,"(576.5, 787.0]",26,46,-20
31258.0,2019-12-25,"(787.0, 997.5]",26,54,-28
31258.0,2019-12-25,"(997.5, 1208.0]",11,27,-16
,,,,2.0,
31260.0,2019-12-25,"(997.0, 1079.5]",1,2,-1
31260.0,2019-12-25,"(1079.5, 1162.0]",1,1,0
31261.0,2019-12-25,"(822.75, 915.5]",1,1,0
31261.0,2019-12-25,"(915.5, 1008.25]",2,2,0
31262.0,2019-12-25,"(723.607, 822.25]",1,1,0
31262.0,2019-12-25,"(1018.75, 1117.0]",1,1,0
31263.0,2019-12-25,"(386.104, 611.0]",1,1,0
31263.0,2019-12-25,"(611.0, 835.0]",2,3,-1
31263.0,2019-12-25,"(835.0, 1059.0]",5,11,-6
31263.0,2019-12-25,"(1059.0, 1283.0]",1,2,-1
31264.0,2019-12-25,"(654.688, 733.0]",2,2,0
31264.0,2019-12-25,"(811.0, 889.0]",2,1,1
31264.0,2019-12-25,"(889.0, 967.0]",3,3,0
31265.0,2019-12-25,"(15.681, 346.75]",2,3,-1
31265.0,2019-12-25,"(346.75, 676.5]",3,6,-3
31265.0,2019-12-25,"(676.5, 1006.25]",3,7,-4
31265.0,2019-12-25,"(1006.25, 1336.0]",1,5,-4
31266.0,2019-12-25,"(620.25, 843.5]",1,3,-2
31266.0,2019-12-25,"(843.5, 1066.75]",5,2,3
31266.0,2019-12-25,"(1066.75, 1290.0]",3,9,-6
31267.0,2019-12-25,"(632.697, 708.75]",1,2,-1
31267.0,2019-12-25,"(860.25, 936.0]",2,1,1
31268.0,2019-12-25,"(619.358, 780.5]",4,5,-1
31268.0,2019-12-25,"(780.5, 941.0]",4,5,-1
31269.0,2019-12-25,"(662.236, 854.0]",3,6,-3
31269.0,2019-12-25,"(854.0, 1045.0]",1,3,-2
31269.0,2019-12-25,"(1045.0, 1236.0]",2,4,-2
31269.0,2019-12-25,"(1236.0, 1427.0]",2,3,-1
31270.0,2019-12-25,"(601.75, 800.0]",1,1,0
31271.0,2019-12-25,"(698.469, 831.75]",8,21,-13
31271.0,2019-12-25,"(964.5, 1097.25]",9,3,6
31271.0,2019-12-25,"(1097.25, 1230.0]",2,9,-7
31272.0,2019-12-25,"(455.274, 637.5]",3,3,0
31272.0,2019-12-25,"(637.5, 819.0]",5,8,-3
31272.0,2019-12-25,"(819.0, 1000.5]",19,36,-17
31272.0,2019-12-25,"(1000.5, 1182.0]",4,11,-7
31273.0,2019-12-25,"(850.5, 870.25]",1,1,0
31273.0,2019-12-25,"(870.25, 890.0]",1,2,-1
31274.0,2019-12-25,"(565.598, 666.5]",1,1,0
31274.0,2019-12-25,"(666.5, 767.0]",2,2,0
31274.0,2019-12-25,"(767.0, 867.5]",2,4,-2
31274.0,2019-12-25,"(867.5, 968.0]",2,5,-3
31275.0,2019-12-25,"(678.5, 876.0]",2,1,1
31275.0,2019-12-25,"(876.0, 1073.5]",3,2,1
31275.0,2019-12-25,"(1073.5, 1271.0]",4,4,0
31276.0,2019-12-25,"(394.133, 611.75]",1,4,-3
31276.0,2019-12-25,"(611.75, 828.5]",4,7,-3
31276.0,2019-12-25,"(1045.25, 1262.0]",1,2,-1
31277.0,2019-12-25,"(584.492, 712.0]",5,9,-4
31277.0,2019-12-25,"(712.0, 839.0]",3,5,-2
31277.0,2019-12-25,"(839.0, 966.0]",9,13,-4
31277.0,2019-12-25,"(966.0, 1093.0]",5,7,-2
31278.0,2019-12-25,"(50.616, 398.0]",1,3,-2
31278.0,2019-12-25,"(398.0, 744.0]",3,7,-4
31278.0,2019-12-25,"(744.0, 1090.0]",4,9,-5
31278.0,2019-12-25,"(1090.0, 1436.0]",3,4,-1
,,,,1.0,
,,,,1.0,
31280.0,2019-12-25,"(562.335, 729.25]",2,3,-1
31280.0,2019-12-25,"(729.25, 895.5]",2,4,-2
31280.0,2019-12-25,"(895.5, 1061.75]",1,5,-4
31280.0,2019-12-25,"(1061.75, 1228.0]",3,3,0
31000.0,2019-12-26,"(969.939, 985.25]",1,1,0
,,,,1.0,
,,,,1.0,
31002.0,2019-12-26,"(782.5, 906.75]",2,2,0
31002.0,2019-12-26,"(906.75, 1031.0]",2,2,0
31003.0,2019-12-26,"(613.231, 806.25]",1,2,-1
31003.0,2019-12-26,"(1190.75, 1383.0]",2,4,-2
31004.0,2019-12-26,"(816.75, 874.0]",1,1,0
31005.0,2019-12-26,"(435.396, 587.0]",1,1,0
31005.0,2019-12-26,"(587.0, 738.0]",1,1,0
31006.0,2019-12-26,"(544.5, 816.75]",1,1,0
31006.0,2019-12-26,"(816.75, 1089.0]",4,1,3
31007.0,2019-12-26,"(609.5, 793.0]",2,3,-1
31007.0,2019-12-26,"(793.0, 976.5]",1,3,-2
31007.0,2019-12-26,"(976.5, 1160.0]",2,2,0
31009.0,2019-12-26,"(428.151, 641.25]",2,2,0
31009.0,2019-12-26,"(1065.75, 1278.0]",1,1,0
31010.0,2019-12-26,"(549.383, 704.25]",2,3,-1
31010.0,2019-12-26,"(704.25, 858.5]",1,1,0
31010.0,2019-12-26,"(1012.75, 1167.0]",1,2,-1
31011.0,2019-12-26,"(326.063, 561.25]",2,3,-1
31011.0,2019-12-26,"(795.5, 1029.75]",1,3,-2
31011.0,2019-12-26,"(1029.75, 1264.0]",4,6,-2
31012.0,2019-12-26,"(531.22, 727.0]",1,1,0
31013.0,2019-12-26,"(648.483, 778.25]",1,1,0
31013.0,2019-12-26,"(1036.75, 1166.0]",1,2,-1
31014.0,2019-12-26,"(318.047, 557.25]",4,4,0
31014.0,2019-12-26,"(557.25, 795.5]",4,6,-2
31014.0,2019-12-26,"(795.5, 1033.75]",8,10,-2
31014.0,2019-12-26,"(1033.75, 1272.0]",4,6,-2
31015.0,2019-12-26,"(387.007, 636.25]",3,4,-1
31015.0,2019-12-26,"(636.25, 884.5]",2,6,-4
31015.0,2019-12-26,"(884.5, 1132.75]",4,4,0
31015.0,2019-12-26,"(1132.75, 1381.0]",1,2,-1
31016.0,2019-12-26,"(514.356, 676.0]",2,3,-1
31016.0,2019-12-26,"(998.0, 1159.0]",1,3,-2
31017.0,2019-12-26,"(639.41, 787.5]",1,2,-1
31017.0,2019-12-26,"(787.5, 935.0]",1,1,0
31018.0,2019-12-26,"(765.498, 891.5]",2,2,0
31019.0,2019-12-26,"(729.689, 807.75]",2,5,-3
31019.0,2019-12-26,"(885.5, 963.25]",1,1,0
31019.0,2019-12-26,"(963.25, 1041.0]",1,1,0
31020.0,2019-12-26,"(887.0, 989.0]",1,1,0
31021.0,2019-12-26,"(729.75, 921.5]",2,1,1
31021.0,2019-12-26,"(1113.25, 1305.0]",1,4,-3
31022.0,2019-12-26,"(458.219, 654.25]",1,1,0
31022.0,2019-12-26,"(1044.75, 1240.0]",4,2,2
31023.0,2019-12-26,"(404.75, 684.5]",1,1,0
31023.0,2019-12-26,"(684.5, 964.25]",1,1,0
31023.0,2019-12-26,"(964.25, 1244.0]",3,1,2
31024.0,2019-12-26,"(568.296, 745.0]",2,3,-1
31024.0,2019-12-26,"(1097.0, 1273.0]",1,2,-1
31025.0,2019-12-26,"(716.447, 855.25]",2,4,-2
31025.0,2019-12-26,"(855.25, 993.5]",1,1,0
31025.0,2019-12-26,"(993.5, 1131.75]",1,1,0
,,,,1.0,
,,,,1.0,
,,,,2.0,
31027.0,2019-12-26,"(588.0, 784.0]",1,1,0
,,,,1.0,
,,,,2.0,
31029.0,2019-12-26,"(590.163, 800.25]",1,3,-2
31029.0,2019-12-26,"(1009.5, 1218.75]",2,1,1
31030.0,2019-12-26,"(929.75, 1091.0]",3,1,2
31031.0,2019-12-26,"(1023.0, 1141.0]",1,1,0
31031.0,2019-12-26,"(1141.0, 1259.0]",2,2,0
31032.0,2019-12-26,"(812.25, 1083.0]",2,1,1
31033.0,2019-12-26,"(942.764, 1002.0]",1,1,0
31033.0,2019-12-26,"(1061.0, 1120.0]",1,1,0
31034.0,2019-12-26,"(1193.0, 1402.0]",2,1,1
,,,,1.0,
,,,,1.0,
,,,,1.0,
31036.0,2019-12-26,"(447.75, 597.0]",1,1,0
31037.0,2019-12-26,"(474.213, 671.75]",3,5,-2
31037.0,2019-12-26,"(671.75, 868.5]",2,6,-4
31037.0,2019-12-26,"(868.5, 1065.25]",1,2,-1
31037.0,2019-12-26,"(1065.25, 1262.0]",1,2,-1
31038.0,2019-12-26,"(904.5, 1049.0]",1,1,0
31039.0,2019-12-26,"(455.346, 619.5]",3,4,-1
31039.0,2019-12-26,"(619.5, 783.0]",1,4,-3
31039.0,2019-12-26,"(946.5, 1110.0]",2,2,0
31040.0,2019-12-26,"(813.5, 941.0]",2,1,1
31040.0,2019-12-26,"(1068.5, 1196.0]",1,2,-1
31041.0,2019-12-26,"(947.25, 1263.0]",4,1,3
31042.0,2019-12-26,"(53.905, 328.75]",1,2,-1
31042.0,2019-12-26,"(328.75, 602.5]",2,2,0
31042.0,2019-12-26,"(876.25, 1150.0]",1,5,-4
31043.0,2019-12-26,"(411.412, 559.0]",1,2,-1
31043.0,2019-12-26,"(853.0, 1000.0]",2,3,-1
31044.0,2019-12-26,"(747.75, 997.0]",2,1,1
31045.0,2019-12-26,"(875.0, 975.0]",1,1,0
31045.0,2019-12-26,"(975.0, 1075.0]",1,1,0
31046.0,2019-12-26,"(636.0, 848.0]",1,1,0
31047.0,2019-12-26,"(417.26, 603.0]",2,5,-3
31047.0,2019-12-26,"(973.0, 1158.0]",2,2,0
31048.0,2019-12-26,"(900.75, 1201.0]",1,1,0
31049.0,2019-12-26,"(730.75, 867.5]",1,1,0
31049.0,2019-12-26,"(1004.25, 1141.0]",1,1,0
,,,,1.0,
,,,,1.0,
31051.0,2019-12-26,"(908.25, 1048.0]",1,1,0
31052.0,2019-12-26,"(448.338, 614.5]",1,2,-1
31052.0,2019-12-26,"(945.5, 1111.0]",2,3,-1
,,,,1.0,
,,,,1.0,
31054.0,2019-12-26,"(817.25, 823.0]",1,1,0
31055.0,2019-12-26,"(811.5, 865.0]",1,1,0
31055.0,2019-12-26,"(865.0, 918.5]",1,1,0
31056.0,2019-12-26,"(739.765, 798.75]",1,1,0
31056.0,2019-12-26,"(916.25, 975.0]",1,1,0
,,,,2.0,
,,,,2.0,
31059.0,2019-12-26,"(857.25, 1143.0]",1,1,0
31060.0,2019-12-26,"(724.541, 839.75]",2,4,-2
31060.0,2019-12-26,"(954.5, 1069.25]",2,1,1
31060.0,2019-12-26,"(1069.25, 1184.0]",1,2,-1
,,,,2.0,
31062.0,2019-12-26,"(527.488, 656.0]",1,2,-1
31062.0,2019-12-26,"(784.0, 912.0]",1,3,-2
31062.0,2019-12-26,"(912.0, 1040.0]",1,2,-1
31063.0,2019-12-26,"(807.999, 808.25]",1,1,0
31063.0,2019-12-26,"(808.75, 809.0]",1,3,-2
31064.0,2019-12-26,"(659.4, 810.0]",3,9,-6
31064.0,2019-12-26,"(810.0, 960.0]",5,7,-2
31064.0,2019-12-26,"(960.0, 1110.0]",2,4,-2
31064.0,2019-12-26,"(1110.0, 1260.0]",2,4,-2
31065.0,2019-12-26,"(662.5, 842.0]",1,1,0
31065.0,2019-12-26,"(842.0, 1021.5]",1,2,-1
,,,,1.0,
,,,,1.0,
31067.0,2019-12-26,"(802.828, 846.0]",1,2,-1
31067.0,2019-12-26,"(932.0, 975.0]",1,1,0
31068.0,2019-12-26,"(707.789, 760.75]",1,3,-2
31068.0,2019-12-26,"(866.25, 919.0]",1,1,0
31069.0,2019-12-26,"(711.0, 760.0]",1,1,0
,,,,1.0,
,,,,2.0,
31071.0,2019-12-26,"(320.049, 558.75]",1,3,-2
31071.0,2019-12-26,"(558.75, 796.5]",1,1,0
31071.0,2019-12-26,"(1034.25, 1272.0]",2,2,0
,,,,2.0,
,,,,1.0,
,,,,1.0,
31074.0,2019-12-26,"(624.485, 753.75]",1,1,0
31074.0,2019-12-26,"(1011.25, 1140.0]",2,3,-1
31075.0,2019-12-26,"(972.5, 1116.0]",1,1,0
,,,,1.0,
,,,,1.0,
31077.0,2019-12-26,"(624.75, 863.5]",1,1,0
31077.0,2019-12-26,"(863.5, 1102.25]",3,3,0
31077.0,2019-12-26,"(1102.25, 1341.0]",1,6,-5
31078.0,2019-12-26,"(1086.0, 1119.0]",1,1,0
31079.0,2019-12-26,"(718.0, 741.5]",1,1,0
31079.0,2019-12-26,"(741.5, 765.0]",1,1,0
31080.0,2019-12-26,"(917.5, 1115.75]",3,3,0
31080.0,2019-12-26,"(1115.75, 1314.0]",2,5,-3
31081.0,2019-12-26,"(796.806, 845.5]",1,2,-1
31081.0,2019-12-26,"(942.5, 991.0]",1,1,0
,,,,2.0,
31083.0,2019-12-26,"(609.75, 813.0]",1,1,0
31084.0,2019-12-26,"(496.298, 672.5]",1,2,-1
31084.0,2019-12-26,"(672.5, 848.0]",1,1,0
,,,,1.0,
,,,,2.0,
,,,,2.0,
31087.0,2019-12-26,"(1076.25, 1435.0]",1,1,0
31088.0,2019-12-26,"(722.5, 867.25]",1,1,0
31088.0,2019-12-26,"(867.25, 1012.0]",2,2,0
31089.0,2019-12-26,"(554.175, 761.25]",2,2,0
31089.0,2019-12-26,"(967.5, 1173.75]",1,3,-2
31090.0,2019-12-26,"(419.402, 569.5]",1,2,-1
31090.0,2019-12-26,"(868.5, 1018.0]",1,1,0
31091.0,2019-12-26,"(598.0, 762.0]",1,1,0
31091.0,2019-12-26,"(926.0, 1090.0]",2,1,1
31092.0,2019-12-26,"(713.25, 949.5]",2,1,1
31092.0,2019-12-26,"(949.5, 1185.75]",2,5,-3
31092.0,2019-12-26,"(1185.75, 1422.0]",1,2,-1
,,,,1.0,
,,,,1.0,
,,,,2.0,
31094.0,2019-12-26,"(577.0, 865.5]",1,1,0
31094.0,2019-12-26,"(865.5, 1154.0]",1,1,0
,,,,2.0,
31096.0,2019-12-26,"(137.041, 377.75]",1,1,0
31096.0,2019-12-26,"(617.5, 857.25]",1,1,0
31096.0,2019-12-26,"(857.25, 1097.0]",1,2,-1
,,,,2.0,
31098.0,2019-12-26,"(463.209, 661.75]",1,2,-1
31098.0,2019-12-26,"(661.75, 859.5]",1,2,-1
31098.0,2019-12-26,"(859.5, 1057.25]",1,5,-4
31098.0,2019-12-26,"(1057.25, 1255.0]",1,3,-2
31099.0,2019-12-26,"(698.25, 931.0]",2,1,1
31100.0,2019-12-26,"(582.5, 753.0]",1,1,0
31100.0,2019-12-26,"(753.0, 923.5]",1,4,-3
31100.0,2019-12-26,"(923.5, 1094.0]",1,1,0
31101.0,2019-12-26,"(204.785, 509.75]",1,5,-4
31101.0,2019-12-26,"(509.75, 813.5]",14,29,-15
31101.0,2019-12-26,"(813.5, 1117.25]",22,29,-7
31101.0,2019-12-26,"(1117.25, 1421.0]",8,10,-2
31102.0,2019-12-26,"(351.008, 600.0]",1,5,-4
31102.0,2019-12-26,"(1096.0, 1344.0]",2,1,1
31103.0,2019-12-26,"(626.25, 868.5]",4,6,-2
31103.0,2019-12-26,"(868.5, 1110.75]",1,16,-15
31103.0,2019-12-26,"(1110.75, 1353.0]",1,7,-6
31104.0,2019-12-26,"(524.194, 726.5]",1,6,-5
31104.0,2019-12-26,"(726.5, 928.0]",2,6,-4
31104.0,2019-12-26,"(928.0, 1129.5]",2,5,-3
31104.0,2019-12-26,"(1129.5, 1331.0]",5,14,-9
31105.0,2019-12-26,"(440.038, 681.5]",2,5,-3
31105.0,2019-12-26,"(922.0, 1162.5]",1,2,-1
31105.0,2019-12-26,"(1162.5, 1403.0]",2,2,0
31106.0,2019-12-26,"(549.573, 656.75]",1,4,-3
31107.0,2019-12-26,"(742.5, 1036.25]",1,2,-1
31107.0,2019-12-26,"(1036.25, 1330.0]",8,4,4
31108.0,2019-12-26,"(396.038, 637.5]",3,14,-11
31108.0,2019-12-26,"(637.5, 878.0]",6,15,-9
31108.0,2019-12-26,"(878.0, 1118.5]",8,13,-5
31108.0,2019-12-26,"(1118.5, 1359.0]",6,9,-3
31109.0,2019-12-26,"(392.965, 652.75]",2,9,-7
31109.0,2019-12-26,"(652.75, 911.5]",3,5,-2
31109.0,2019-12-26,"(911.5, 1170.25]",9,12,-3
31109.0,2019-12-26,"(1170.25, 1429.0]",2,4,-2
31110.0,2019-12-26,"(492.182, 697.5]",1,6,-5
31110.0,2019-12-26,"(697.5, 902.0]",4,9,-5
31110.0,2019-12-26,"(902.0, 1106.5]",8,15,-7
31110.0,2019-12-26,"(1106.5, 1311.0]",2,5,-3
31111.0,2019-12-26,"(403.025, 647.75]",3,4,-1
31111.0,2019-12-26,"(647.75, 891.5]",4,10,-6
31111.0,2019-12-26,"(891.5, 1135.25]",4,10,-6
31111.0,2019-12-26,"(1135.25, 1379.0]",3,7,-4
31112.0,2019-12-26,"(779.687, 858.25]",1,1,0
31112.0,2019-12-26,"(858.25, 936.5]",2,2,0
31112.0,2019-12-26,"(936.5, 1014.75]",1,4,-3
31112.0,2019-12-26,"(1014.75, 1093.0]",1,2,-1
31113.0,2019-12-26,"(312.088, 541.0]",1,5,-4
31113.0,2019-12-26,"(541.0, 769.0]",3,7,-4
31113.0,2019-12-26,"(997.0, 1225.0]",4,4,0
31114.0,2019-12-26,"(424.032, 667.0]",2,9,-7
31114.0,2019-12-26,"(667.0, 909.0]",1,5,-4
31114.0,2019-12-26,"(909.0, 1151.0]",7,12,-5
31114.0,2019-12-26,"(1151.0, 1393.0]",2,7,-5
31115.0,2019-12-26,"(374.013, 621.75]",2,5,-3
31115.0,2019-12-26,"(868.5, 1115.25]",2,3,-1
31115.0,2019-12-26,"(1115.25, 1362.0]",4,5,-1
31116.0,2019-12-26,"(383.069, 616.75]",2,7,-5
31116.0,2019-12-26,"(616.75, 849.5]",5,9,-4
31116.0,2019-12-26,"(849.5, 1082.25]",6,9,-3
31116.0,2019-12-26,"(1082.25, 1315.0]",4,4,0
31117.0,2019-12-26,"(275.887, 555.25]",2,10,-8
31117.0,2019-12-26,"(555.25, 833.5]",3,7,-4
31117.0,2019-12-26,"(833.5, 1111.75]",4,9,-5
31117.0,2019-12-26,"(1111.75, 1390.0]",1,4,-3
31118.0,2019-12-26,"(610.75, 746.5]",3,3,0
31118.0,2019-12-26,"(746.5, 882.25]",1,8,-7
31118.0,2019-12-26,"(882.25, 1018.0]",7,3,4
31119.0,2019-12-26,"(5.634, 348.5]",2,2,0
31119.0,2019-12-26,"(348.5, 690.0]",5,15,-10
31119.0,2019-12-26,"(690.0, 1031.5]",5,6,-1
31119.0,2019-12-26,"(1031.5, 1373.0]",9,16,-7
31120.0,2019-12-26,"(708.0, 858.0]",1,1,0
31120.0,2019-12-26,"(858.0, 1008.0]",1,1,0
31120.0,2019-12-26,"(1008.0, 1158.0]",3,1,2
31121.0,2019-12-26,"(384.058, 620.5]",4,7,-3
31121.0,2019-12-26,"(856.0, 1091.5]",4,1,3
31121.0,2019-12-26,"(1091.5, 1327.0]",2,5,-3
31122.0,2019-12-26,"(776.0, 920.5]",2,2,0
31122.0,2019-12-26,"(920.5, 1065.0]",1,1,0
31123.0,2019-12-26,"(853.5, 1100.75]",2,4,-2
31123.0,2019-12-26,"(1100.75, 1348.0]",2,1,1
31124.0,2019-12-26,"(392.967, 652.25]",7,11,-4
31124.0,2019-12-26,"(652.25, 910.5]",5,21,-16
31124.0,2019-12-26,"(910.5, 1168.75]",10,32,-22
31124.0,2019-12-26,"(1168.75, 1427.0]",9,19,-10
31125.0,2019-12-26,"(421.991, 675.25]",2,11,-9
31125.0,2019-12-26,"(675.25, 927.5]",6,10,-4
31125.0,2019-12-26,"(927.5, 1179.75]",8,13,-5
31125.0,2019-12-26,"(1179.75, 1432.0]",6,6,0
31126.0,2019-12-26,"(630.25, 865.5]",1,5,-4
31126.0,2019-12-26,"(865.5, 1100.75]",6,5,1
31126.0,2019-12-26,"(1100.75, 1336.0]",4,12,-8
,,,,2.0,
31128.0,2019-12-26,"(418.013, 665.75]",6,11,-5
31128.0,2019-12-26,"(665.75, 912.5]",5,8,-3
31128.0,2019-12-26,"(912.5, 1159.25]",7,13,-6
31128.0,2019-12-26,"(1159.25, 1406.0]",1,3,-2
31129.0,2019-12-26,"(549.212, 747.0]",2,5,-3
31129.0,2019-12-26,"(747.0, 944.0]",21,32,-11
31129.0,2019-12-26,"(944.0, 1141.0]",16,28,-12
31129.0,2019-12-26,"(1141.0, 1338.0]",3,8,-5
31130.0,2019-12-26,"(443.017, 689.75]",2,6,-4
31130.0,2019-12-26,"(935.5, 1181.25]",4,2,2
31130.0,2019-12-26,"(1181.25, 1427.0]",1,5,-4
31131.0,2019-12-26,"(658.5, 806.0]",1,5,-4
31131.0,2019-12-26,"(806.0, 953.5]",1,1,0
31131.0,2019-12-26,"(953.5, 1101.0]",1,2,-1
31200.0,2019-12-26,"(336.953, 599.75]",11,13,-2
31200.0,2019-12-26,"(599.75, 861.5]",2,10,-8
31200.0,2019-12-26,"(861.5, 1123.25]",12,21,-9
31200.0,2019-12-26,"(1123.25, 1385.0]",4,8,-4
31201.0,2019-12-26,"(91.708, 416.0]",1,2,-1
31201.0,2019-12-26,"(416.0, 739.0]",19,28,-9
31201.0,2019-12-26,"(739.0, 1062.0]",25,44,-19
31201.0,2019-12-26,"(1062.0, 1385.0]",12,23,-11
31202.0,2019-12-26,"(430.09, 658.5]",6,12,-6
31202.0,2019-12-26,"(658.5, 886.0]",3,7,-4
31202.0,2019-12-26,"(886.0, 1113.5]",16,24,-8
31202.0,2019-12-26,"(1113.5, 1341.0]",2,6,-4
31203.0,2019-12-26,"(424.014, 671.5]",5,9,-4
31203.0,2019-12-26,"(671.5, 918.0]",11,24,-13
31203.0,2019-12-26,"(918.0, 1164.5]",7,10,-3
31203.0,2019-12-26,"(1164.5, 1411.0]",3,6,-3
31204.0,2019-12-26,"(388.982, 644.5]",5,6,-1
31204.0,2019-12-26,"(644.5, 899.0]",2,5,-3
31204.0,2019-12-26,"(1153.5, 1408.0]",1,9,-8
31205.0,2019-12-26,"(499.134, 716.5]",1,2,-1
31205.0,2019-12-26,"(716.5, 933.0]",3,6,-3
31205.0,2019-12-26,"(933.0, 1149.5]",2,3,-1
31205.0,2019-12-26,"(1149.5, 1366.0]",2,4,-2
31206.0,2019-12-26,"(551.369, 709.75]",3,4,-1
31206.0,2019-12-26,"(709.75, 867.5]",1,3,-2
31206.0,2019-12-26,"(1025.25, 1183.0]",2,3,-1
31207.0,2019-12-26,"(846.5, 1070.25]",1,1,0
31207.0,2019-12-26,"(1070.25, 1294.0]",2,1,1
31208.0,2019-12-26,"(812.709, 885.75]",2,4,-2
31208.0,2019-12-26,"(958.5, 1031.25]",5,9,-4
31208.0,2019-12-26,"(1031.25, 1104.0]",1,1,0
31209.0,2019-12-26,"(502.504, 627.0]",1,2,-1
31209.0,2019-12-26,"(627.0, 751.0]",1,2,-1
31209.0,2019-12-26,"(875.0, 999.0]",4,2,2
31211.0,2019-12-26,"(732.365, 891.75]",2,4,-2
31211.0,2019-12-26,"(891.75, 1050.5]",2,2,0
31211.0,2019-12-26,"(1050.5, 1209.25]",1,5,-4
31212.0,2019-12-26,"(372.034, 614.5]",7,7,0
31212.0,2019-12-26,"(614.5, 856.0]",8,14,-6
31212.0,2019-12-26,"(856.0, 1097.5]",3,12,-9
31212.0,2019-12-26,"(1097.5, 1339.0]",7,10,-3
31213.0,2019-12-26,"(383.018, 629.5]",4,9,-5
31213.0,2019-12-26,"(629.5, 875.0]",5,7,-2
31213.0,2019-12-26,"(875.0, 1120.5]",17,23,-6
31213.0,2019-12-26,"(1120.5, 1366.0]",2,7,-5
31214.0,2019-12-26,"(0.601, 351.75]",2,4,-2
31214.0,2019-12-26,"(351.75, 701.5]",5,14,-9
31214.0,2019-12-26,"(701.5, 1051.25]",15,34,-19
31214.0,2019-12-26,"(1051.25, 1401.0]",13,20,-7
31215.0,2019-12-26,"(547.151, 760.25]",7,7,0
31215.0,2019-12-26,"(760.25, 972.5]",9,12,-3
31215.0,2019-12-26,"(972.5, 1184.75]",1,2,-1
31215.0,2019-12-26,"(1184.75, 1397.0]",2,3,-1
31216.0,2019-12-26,"(561.286, 740.5]",8,10,-2
31216.0,2019-12-26,"(740.5, 919.0]",12,16,-4
31216.0,2019-12-26,"(919.0, 1097.5]",2,11,-9
31216.0,2019-12-26,"(1097.5, 1276.0]",3,5,-2
31217.0,2019-12-26,"(440.067, 674.25]",6,6,0
31217.0,2019-12-26,"(907.5, 1140.75]",1,2,-1
31217.0,2019-12-26,"(1140.75, 1374.0]",2,5,-3
31218.0,2019-12-26,"(65.973, 323.75]",1,1,0
31218.0,2019-12-26,"(323.75, 580.5]",3,6,-3
31218.0,2019-12-26,"(580.5, 837.25]",7,9,-2
31218.0,2019-12-26,"(837.25, 1094.0]",6,14,-8
31219.0,2019-12-26,"(413.296, 590.0]",4,4,0
31219.0,2019-12-26,"(590.0, 766.0]",6,6,0
31219.0,2019-12-26,"(942.0, 1118.0]",2,4,-2
31220.0,2019-12-26,"(283.148, 497.0]",5,5,0
31220.0,2019-12-26,"(497.0, 710.0]",2,3,-1
31220.0,2019-12-26,"(710.0, 923.0]",7,11,-4
31220.0,2019-12-26,"(923.0, 1136.0]",2,9,-7
31221.0,2019-12-26,"(462.104, 687.0]",5,7,-2
31221.0,2019-12-26,"(687.0, 911.0]",6,8,-2
31221.0,2019-12-26,"(911.0, 1135.0]",7,17,-10
31221.0,2019-12-26,"(1135.0, 1359.0]",4,7,-3
31222.0,2019-12-26,"(503.299, 679.25]",8,9,-1
31222.0,2019-12-26,"(679.25, 854.5]",7,13,-6
31222.0,2019-12-26,"(854.5, 1029.75]",2,6,-4
31222.0,2019-12-26,"(1029.75, 1205.0]",1,7,-6
31223.0,2019-12-26,"(448.098, 674.5]",3,8,-5
31223.0,2019-12-26,"(674.5, 900.0]",1,4,-3
31223.0,2019-12-26,"(900.0, 1125.5]",1,6,-5
31224.0,2019-12-26,"(546.493, 673.75]",2,2,0
31224.0,2019-12-26,"(673.75, 800.5]",4,8,-4
31224.0,2019-12-26,"(800.5, 927.25]",3,7,-4
31224.0,2019-12-26,"(927.25, 1054.0]",3,9,-6
31225.0,2019-12-26,"(420.244, 610.0]",3,5,-2
31225.0,2019-12-26,"(610.0, 799.0]",3,6,-3
31225.0,2019-12-26,"(799.0, 988.0]",7,13,-6
31225.0,2019-12-26,"(988.0, 1177.0]",4,7,-3
31226.0,2019-12-26,"(477.371, 635.25]",1,3,-2
31226.0,2019-12-26,"(792.5, 949.75]",2,1,1
31226.0,2019-12-26,"(949.75, 1107.0]",3,3,0
31227.0,2019-12-26,"(508.328, 677.0]",11,17,-6
31227.0,2019-12-26,"(677.0, 845.0]",4,5,-1
31227.0,2019-12-26,"(845.0, 1013.0]",1,6,-5
31227.0,2019-12-26,"(1013.0, 1181.0]",10,16,-6
31228.0,2019-12-26,"(516.082, 746.5]",11,21,-10
31228.0,2019-12-26,"(746.5, 976.0]",8,16,-8
31228.0,2019-12-26,"(976.0, 1205.5]",14,23,-9
31228.0,2019-12-26,"(1205.5, 1435.0]",2,4,-2
31229.0,2019-12-26,"(373.25, 701.5]",3,1,2
31229.0,2019-12-26,"(701.5, 1029.75]",18,14,4
31229.0,2019-12-26,"(1029.75, 1358.0]",9,34,-25
31230.0,2019-12-26,"(361.09, 589.5]",5,6,-1
31230.0,2019-12-26,"(589.5, 817.0]",6,12,-6
31230.0,2019-12-26,"(817.0, 1044.5]",9,12,-3
31230.0,2019-12-26,"(1044.5, 1272.0]",6,18,-12
31231.0,2019-12-26,"(385.97, 644.5]",7,9,-2
31231.0,2019-12-26,"(644.5, 902.0]",5,9,-4
31231.0,2019-12-26,"(902.0, 1159.5]",3,12,-9
31231.0,2019-12-26,"(1159.5, 1417.0]",2,3,-1
31232.0,2019-12-26,"(415.984, 671.0]",5,6,-1
31232.0,2019-12-26,"(671.0, 925.0]",12,21,-9
31232.0,2019-12-26,"(925.0, 1179.0]",8,14,-6
31232.0,2019-12-26,"(1179.0, 1433.0]",3,9,-6
31233.0,2019-12-26,"(27.625, 372.75]",1,2,-1
31233.0,2019-12-26,"(372.75, 716.5]",7,13,-6
31233.0,2019-12-26,"(716.5, 1060.25]",3,7,-4
31233.0,2019-12-26,"(1060.25, 1404.0]",1,6,-5
31234.0,2019-12-26,"(68.827, 363.25]",1,1,0
31234.0,2019-12-26,"(363.25, 656.5]",2,5,-3
31234.0,2019-12-26,"(656.5, 949.75]",4,7,-3
31234.0,2019-12-26,"(949.75, 1243.0]",9,13,-4
31235.0,2019-12-26,"(628.505, 752.75]",2,6,-4
31235.0,2019-12-26,"(752.75, 876.5]",5,8,-3
31235.0,2019-12-26,"(876.5, 1000.25]",10,19,-9
31235.0,2019-12-26,"(1000.25, 1124.0]",4,8,-4
31236.0,2019-12-26,"(522.089, 750.75]",1,2,-1
31236.0,2019-12-26,"(750.75, 978.5]",4,8,-4
31236.0,2019-12-26,"(978.5, 1206.25]",2,4,-2
31237.0,2019-12-26,"(426.153, 638.75]",1,4,-3
31237.0,2019-12-26,"(638.75, 850.5]",4,6,-2
31237.0,2019-12-26,"(850.5, 1062.25]",6,12,-6
31237.0,2019-12-26,"(1062.25, 1274.0]",4,8,-4
31238.0,2019-12-26,"(501.172, 709.0]",8,8,0
31238.0,2019-12-26,"(709.0, 916.0]",3,8,-5
31238.0,2019-12-26,"(916.0, 1123.0]",5,17,-12
31239.0,2019-12-26,"(536.323, 706.25]",3,6,-3
31239.0,2019-12-26,"(706.25, 875.5]",5,8,-3
31239.0,2019-12-26,"(1044.75, 1214.0]",2,3,-1
31240.0,2019-12-26,"(736.73, 804.5]",3,10,-7
31240.0,2019-12-26,"(804.5, 872.0]",4,10,-6
31240.0,2019-12-26,"(872.0, 939.5]",8,16,-8
31240.0,2019-12-26,"(939.5, 1007.0]",6,15,-9
31241.0,2019-12-26,"(272.854, 560.5]",2,5,-3
31241.0,2019-12-26,"(560.5, 847.0]",8,27,-19
31241.0,2019-12-26,"(847.0, 1133.5]",8,17,-9
31241.0,2019-12-26,"(1133.5, 1420.0]",5,11,-6
31242.0,2019-12-26,"(323.973, 581.75]",8,10,-2
31242.0,2019-12-26,"(581.75, 838.5]",1,3,-2
31242.0,2019-12-26,"(838.5, 1095.25]",4,8,-4
31243.0,2019-12-26,"(401.342, 566.5]",10,11,-1
31243.0,2019-12-26,"(566.5, 731.0]",5,10,-5
31243.0,2019-12-26,"(731.0, 895.5]",4,14,-10
31243.0,2019-12-26,"(895.5, 1060.0]",7,17,-10
31244.0,2019-12-26,"(373.123, 593.25]",4,8,-4
31244.0,2019-12-26,"(593.25, 812.5]",1,1,0
31244.0,2019-12-26,"(812.5, 1031.75]",2,11,-9
31244.0,2019-12-26,"(1031.75, 1251.0]",4,4,0
31245.0,2019-12-26,"(539.103, 764.25]",2,5,-3
31245.0,2019-12-26,"(764.25, 988.5]",1,5,-4
31245.0,2019-12-26,"(988.5, 1212.75]",6,12,-6
31245.0,2019-12-26,"(1212.75, 1437.0]",7,10,-3
31246.0,2019-12-26,"(424.261, 609.75]",2,3,-1
31246.0,2019-12-26,"(609.75, 794.5]",7,12,-5
31246.0,2019-12-26,"(794.5, 979.25]",8,21,-13
31246.0,2019-12-26,"(979.25, 1164.0]",11,15,-4
31247.0,2019-12-26,"(563.263, 748.25]",16,29,-13
31247.0,2019-12-26,"(748.25, 932.5]",34,58,-24
31247.0,2019-12-26,"(932.5, 1116.75]",11,35,-24
31247.0,2019-12-26,"(1116.75, 1301.0]",4,7,-3
31248.0,2019-12-26,"(677.435, 819.25]",9,15,-6
31248.0,2019-12-26,"(819.25, 960.5]",5,21,-16
31248.0,2019-12-26,"(960.5, 1101.75]",15,20,-5
31248.0,2019-12-26,"(1101.75, 1243.0]",1,2,-1
31249.0,2019-12-26,"(432.03, 675.5]",6,9,-3
31249.0,2019-12-26,"(675.5, 918.0]",8,24,-16
31249.0,2019-12-26,"(918.0, 1160.5]",14,26,-12
31249.0,2019-12-26,"(1160.5, 1403.0]",2,6,-4
31250.0,2019-12-26,"(526.427, 670.25]",3,3,0
31250.0,2019-12-26,"(813.5, 956.75]",3,4,-1
31250.0,2019-12-26,"(956.75, 1100.0]",1,6,-5
31251.0,2019-12-26,"(370.0, 621.0]",2,5,-3
31251.0,2019-12-26,"(621.0, 871.0]",5,9,-4
31251.0,2019-12-26,"(871.0, 1121.0]",3,12,-9
31251.0,2019-12-26,"(1121.0, 1371.0]",2,3,-1
31252.0,2019-12-26,"(532.459, 668.25]",2,2,0
31252.0,2019-12-26,"(668.25, 803.5]",1,1,0
31252.0,2019-12-26,"(803.5, 938.75]",1,3,-2
31252.0,2019-12-26,"(938.75, 1074.0]",2,4,-2
31253.0,2019-12-26,"(529.129, 747.75]",2,3,-1
31253.0,2019-12-26,"(747.75, 965.5]",4,8,-4
31253.0,2019-12-26,"(965.5, 1183.25]",1,5,-4
31254.0,2019-12-26,"(465.166, 674.5]",4,5,-1
31254.0,2019-12-26,"(674.5, 883.0]",5,9,-4
31254.0,2019-12-26,"(883.0, 1091.5]",2,7,-5
31254.0,2019-12-26,"(1091.5, 1300.0]",2,2,0
31255.0,2019-12-26,"(556.225, 750.75]",5,6,-1
31255.0,2019-12-26,"(750.75, 944.5]",1,1,0
31255.0,2019-12-26,"(944.5, 1138.25]",2,5,-3
31255.0,2019-12-26,"(1138.25, 1332.0]",1,2,-1
31256.0,2019-12-26,"(412.224, 607.0]",5,5,0
31256.0,2019-12-26,"(607.0, 801.0]",1,4,-3
31256.0,2019-12-26,"(801.0, 995.0]",4,5,-1
31256.0,2019-12-26,"(995.0, 1189.0]",7,12,-5
31257.0,2019-12-26,"(396.076, 628.0]",3,6,-3
31257.0,2019-12-26,"(628.0, 859.0]",3,6,-3
31257.0,2019-12-26,"(859.0, 1090.0]",5,7,-2
31257.0,2019-12-26,"(1090.0, 1321.0]",3,6,-3
31258.0,2019-12-26,"(462.203, 662.25]",6,14,-8
31258.0,2019-12-26,"(662.25, 861.5]",15,27,-12
31258.0,2019-12-26,"(861.5, 1060.75]",36,76,-40
31258.0,2019-12-26,"(1060.75, 1260.0]",15,28,-13
31259.0,2019-12-26,"(952.5, 954.0]",1,1,0
31260.0,2019-12-26,"(400.3, 576.0]",4,7,-3
31260.0,2019-12-26,"(926.0, 1101.0]",3,2,1
31261.0,2019-12-26,"(477.075, 709.25]",5,8,-3
31261.0,2019-12-26,"(709.25, 940.5]",3,6,-3
31261.0,2019-12-26,"(940.5, 1171.75]",5,10,-5
31261.0,2019-12-26,"(1171.75, 1403.0]",1,3,-2
31262.0,2019-12-26,"(556.305, 730.75]",1,4,-3
31262.0,2019-12-26,"(730.75, 904.5]",5,6,-1
31262.0,2019-12-26,"(904.5, 1078.25]",3,6,-3
31263.0,2019-12-26,"(24.79, 328.5]",1,1,0
31263.0,2019-12-26,"(328.5, 631.0]",5,9,-4
31263.0,2019-12-26,"(631.0, 933.5]",7,15,-8
31263.0,2019-12-26,"(933.5, 1236.0]",15,24,-9
31264.0,2019-12-26,"(471.222, 666.5]",1,2,-1
31264.0,2019-12-26,"(666.5, 861.0]",7,7,0
31264.0,2019-12-26,"(861.0, 1055.5]",5,12,-7
31264.0,2019-12-26,"(1055.5, 1250.0]",2,2,0
31265.0,2019-12-26,"(398.25, 741.5]",5,1,4
31265.0,2019-12-26,"(741.5, 1084.75]",8,12,-4
31265.0,2019-12-26,"(1084.75, 1428.0]",7,12,-5
31266.0,2019-12-26,"(315.943, 581.25]",2,8,-6
31266.0,2019-12-26,"(581.25, 845.5]",6,15,-9
31266.0,2019-12-26,"(845.5, 1109.75]",3,5,-2
31266.0,2019-12-26,"(1109.75, 1374.0]",6,10,-4
31267.0,2019-12-26,"(541.219, 737.25]",3,6,-3
31267.0,2019-12-26,"(737.25, 932.5]",1,2,-1
31267.0,2019-12-26,"(932.5, 1127.75]",4,7,-3
31267.0,2019-12-26,"(1127.75, 1323.0]",7,7,0
31268.0,2019-12-26,"(357.949, 621.75]",4,10,-6
31268.0,2019-12-26,"(621.75, 884.5]",3,3,0
31268.0,2019-12-26,"(884.5, 1147.25]",3,5,-2
31268.0,2019-12-26,"(1147.25, 1410.0]",2,5,-3
31269.0,2019-12-26,"(382.137, 598.75]",4,4,0
31269.0,2019-12-26,"(598.75, 814.5]",5,9,-4
31269.0,2019-12-26,"(814.5, 1030.25]",5,17,-12
31269.0,2019-12-26,"(1030.25, 1246.0]",1,2,-1
31270.0,2019-12-26,"(459.302, 634.5]",3,3,0
31270.0,2019-12-26,"(634.5, 809.0]",5,8,-3
31270.0,2019-12-26,"(809.0, 983.5]",6,11,-5
31270.0,2019-12-26,"(983.5, 1158.0]",3,8,-5
31271.0,2019-12-26,"(532.322, 702.5]",10,15,-5
31271.0,2019-12-26,"(702.5, 872.0]",5,25,-20
31271.0,2019-12-26,"(872.0, 1041.5]",8,21,-13
31271.0,2019-12-26,"(1041.5, 1211.0]",13,24,-11
31272.0,2019-12-26,"(292.25, 550.5]",6,1,5
31272.0,2019-12-26,"(550.5, 808.75]",14,7,7
31272.0,2019-12-26,"(808.75, 1067.0]",32,20,12
31273.0,2019-12-26,"(701.0, 910.0]",6,2,4
31273.0,2019-12-26,"(910.0, 1119.0]",4,10,-6
31274.0,2019-12-26,"(372.25, 708.5]",4,1,3
31274.0,2019-12-26,"(708.5, 1044.75]",6,8,-2
31274.0,2019-12-26,"(1044.75, 1381.0]",1,11,-10
31275.0,2019-12-26,"(397.985, 652.75]",4,8,-4
31275.0,2019-12-26,"(652.75, 906.5]",1,3,-2
31275.0,2019-12-26,"(906.5, 1160.25]",2,5,-3
31275.0,2019-12-26,"(1160.25, 1414.0]",3,3,0
31276.0,2019-12-26,"(50.845, 340.75]",1,1,0
31276.0,2019-12-26,"(340.75, 629.5]",6,7,-1
31276.0,2019-12-26,"(629.5, 918.25]",2,3,-1
31276.0,2019-12-26,"(918.25, 1207.0]",2,4,-2
31277.0,2019-12-26,"(442.134, 659.5]",14,18,-4
31277.0,2019-12-26,"(659.5, 876.0]",4,12,-8
31277.0,2019-12-26,"(876.0, 1092.5]",15,29,-14
31277.0,2019-12-26,"(1092.5, 1309.0]",2,5,-3
31278.0,2019-12-26,"(209.98, 466.0]",1,3,-2
31278.0,2019-12-26,"(466.0, 721.0]",5,14,-9
31278.0,2019-12-26,"(721.0, 976.0]",6,13,-7
31278.0,2019-12-26,"(976.0, 1231.0]",4,7,-3
31279.0,2019-12-26,"(473.241, 663.75]",7,8,-1
31279.0,2019-12-26,"(663.75, 853.5]",2,8,-6
31279.0,2019-12-26,"(853.5, 1043.25]",3,8,-5
31279.0,2019-12-26,"(1043.25, 1233.0]",3,9,-6
31280.0,2019-12-26,"(297.057, 533.75]",1,3,-2
31280.0,2019-12-26,"(533.75, 769.5]",1,3,-2
31280.0,2019-12-26,"(769.5, 1005.25]",4,7,-3
31280.0,2019-12-26,"(1005.25, 1241.0]",2,3,-1
31000.0,2019-12-27,"(992.5, 1284.0]",2,1,1
31001.0,2019-12-27,"(1056.25, 1186.0]",1,1,0
31002.0,2019-12-27,"(623.5, 733.0]",1,3,-2
31002.0,2019-12-27,"(842.5, 952.0]",2,1,1
31003.0,2019-12-27,"(208.874, 491.5]",1,3,-2
31003.0,2019-12-27,"(491.5, 773.0]",3,3,0
31003.0,2019-12-27,"(773.0, 1054.5]",1,4,-3
31003.0,2019-12-27,"(1054.5, 1336.0]",2,3,-1
,,,,2.0,
31005.0,2019-12-27,"(801.68, 882.0]",3,4,-1
31005.0,2019-12-27,"(1042.0, 1122.0]",2,1,1
31006.0,2019-12-27,"(121.835, 414.25]",1,1,0
31006.0,2019-12-27,"(414.25, 705.5]",1,1,0
31006.0,2019-12-27,"(705.5, 996.75]",2,4,-2
31006.0,2019-12-27,"(996.75, 1288.0]",2,4,-2
31007.0,2019-12-27,"(369.008, 618.0]",1,4,-3
31007.0,2019-12-27,"(618.0, 866.0]",1,2,-1
31007.0,2019-12-27,"(866.0, 1114.0]",2,8,-6
31009.0,2019-12-27,"(373.399, 524.25]",3,3,0
31009.0,2019-12-27,"(524.25, 674.5]",1,1,0
31009.0,2019-12-27,"(674.5, 824.75]",1,2,-1
31009.0,2019-12-27,"(824.75, 975.0]",1,1,0
31010.0,2019-12-27,"(436.393, 588.75]",1,3,-2
31010.0,2019-12-27,"(588.75, 740.5]",1,2,-1
31010.0,2019-12-27,"(740.5, 892.25]",2,3,-1
31010.0,2019-12-27,"(892.25, 1044.0]",4,5,-1
31011.0,2019-12-27,"(580.556, 692.0]",1,1,0
31011.0,2019-12-27,"(803.0, 914.0]",1,1,0
31011.0,2019-12-27,"(914.0, 1025.0]",3,2,1
31012.0,2019-12-27,"(1149.5, 1279.0]",1,1,0
31013.0,2019-12-27,"(856.428, 1000.0]",2,3,-1
31013.0,2019-12-27,"(1286.0, 1429.0]",1,1,0
31014.0,2019-12-27,"(340.057, 576.75]",7,10,-3
31014.0,2019-12-27,"(576.75, 812.5]",1,6,-5
31014.0,2019-12-27,"(812.5, 1048.25]",12,19,-7
31014.0,2019-12-27,"(1048.25, 1284.0]",7,8,-1
31015.0,2019-12-27,"(303.084, 533.0]",4,5,-1
31015.0,2019-12-27,"(533.0, 762.0]",1,8,-7
31015.0,2019-12-27,"(762.0, 991.0]",1,2,-1
31015.0,2019-12-27,"(991.0, 1220.0]",3,3,0
31016.0,2019-12-27,"(388.5, 518.0]",1,1,0
31017.0,2019-12-27,"(672.501, 797.75]",1,2,-1
31018.0,2019-12-27,"(1033.0, 1076.0]",2,2,0
31018.0,2019-12-27,"(1076.0, 1119.0]",1,1,0
31019.0,2019-12-27,"(455.225, 649.75]",1,1,0
31019.0,2019-12-27,"(1037.25, 1231.0]",1,1,0
31020.0,2019-12-27,"(646.605, 745.75]",2,3,-1
31021.0,2019-12-27,"(387.954, 650.5]",3,4,-1
31021.0,2019-12-27,"(912.0, 1173.5]",1,3,-2
31022.0,2019-12-27,"(691.399, 842.25]",1,2,-1
31022.0,2019-12-27,"(992.5, 1142.75]",2,6,-4
31023.0,2019-12-27,"(703.5, 948.0]",2,1,1
31023.0,2019-12-27,"(948.0, 1192.5]",2,3,-1
31024.0,2019-12-27,"(407.169, 615.75]",3,3,0
31024.0,2019-12-27,"(615.75, 823.5]",1,2,-1
31024.0,2019-12-27,"(823.5, 1031.25]",4,9,-5
31024.0,2019-12-27,"(1031.25, 1239.0]",2,5,-3
31025.0,2019-12-27,"(877.0, 1031.0]",1,1,0
31025.0,2019-12-27,"(1031.0, 1185.0]",1,1,0
31026.0,2019-12-27,"(995.75, 1193.0]",1,1,0
,,,,1.0,
,,,,2.0,
,,,,1.0,
,,,,1.0,
31029.0,2019-12-27,"(12.767, 322.25]",1,1,0
31029.0,2019-12-27,"(630.5, 938.75]",2,6,-4
31029.0,2019-12-27,"(938.75, 1247.0]",2,3,-1
31030.0,2019-12-27,"(905.5, 1078.25]",2,3,-1
31030.0,2019-12-27,"(1078.25, 1251.0]",1,4,-3
,,,,1.0,
,,,,1.0,
,,,,3.0,
31032.0,2019-12-27,"(534.0, 712.0]",1,1,0
31033.0,2019-12-27,"(491.642, 581.5]",1,2,-1
31034.0,2019-12-27,"(575.181, 780.75]",1,1,0
31034.0,2019-12-27,"(780.75, 985.5]",3,4,-1
31034.0,2019-12-27,"(985.5, 1190.25]",1,1,0
31035.0,2019-12-27,"(677.25, 789.5]",1,2,-1
31036.0,2019-12-27,"(737.0, 770.0]",1,1,0
31037.0,2019-12-27,"(466.215, 663.25]",3,5,-2
31037.0,2019-12-27,"(859.5, 1055.75]",1,4,-3
31037.0,2019-12-27,"(1055.75, 1252.0]",4,7,-3
31038.0,2019-12-27,"(1058.5, 1257.0]",1,1,0
31039.0,2019-12-27,"(628.194, 830.5]",1,4,-3
31039.0,2019-12-27,"(1032.0, 1233.5]",1,2,-1
31040.0,2019-12-27,"(460.469, 593.75]",2,2,0
31040.0,2019-12-27,"(593.75, 726.5]",1,2,-1
31040.0,2019-12-27,"(859.25, 992.0]",1,1,0
31041.0,2019-12-27,"(547.311, 720.25]",2,2,0
31041.0,2019-12-27,"(720.25, 892.5]",1,1,0
31041.0,2019-12-27,"(892.5, 1064.75]",1,3,-2
31042.0,2019-12-27,"(471.274, 653.5]",3,4,-1
31042.0,2019-12-27,"(653.5, 835.0]",1,2,-1
31042.0,2019-12-27,"(835.0, 1016.5]",1,3,-2
31042.0,2019-12-27,"(1016.5, 1198.0]",1,3,-2
31043.0,2019-12-27,"(595.454, 732.5]",1,2,-1
31043.0,2019-12-27,"(732.5, 869.0]",2,2,0
31043.0,2019-12-27,"(1005.5, 1142.0]",1,5,-4
31044.0,2019-12-27,"(801.0, 1068.0]",5,1,4
31045.0,2019-12-27,"(13.72, 335.0]",1,1,0
31045.0,2019-12-27,"(655.0, 975.0]",2,1,1
31045.0,2019-12-27,"(975.0, 1295.0]",1,3,-2
31046.0,2019-12-27,"(653.5, 806.0]",1,2,-1
31046.0,2019-12-27,"(806.0, 958.5]",1,1,0
31046.0,2019-12-27,"(958.5, 1111.0]",2,1,1
31047.0,2019-12-27,"(477.14, 693.0]",1,4,-3
31047.0,2019-12-27,"(908.0, 1123.0]",4,1,3
31047.0,2019-12-27,"(1123.0, 1338.0]",2,6,-4
31048.0,2019-12-27,"(504.336, 671.0]",1,1,0
31048.0,2019-12-27,"(1003.0, 1169.0]",1,2,-1
31049.0,2019-12-27,"(949.25, 1036.0]",1,1,0
,,,,1.0,
,,,,2.0,
31051.0,2019-12-27,"(562.75, 824.5]",1,1,0
31051.0,2019-12-27,"(824.5, 1086.25]",1,1,0
31051.0,2019-12-27,"(1086.25, 1348.0]",2,2,0
31052.0,2019-12-27,"(478.348, 642.0]",3,6,-3
31052.0,2019-12-27,"(642.0, 805.0]",1,2,-1
31052.0,2019-12-27,"(968.0, 1131.0]",2,1,1
,,,,1.0,
,,,,1.0,
,,,,1.0,
31054.0,2019-12-27,"(749.25, 999.0]",1,1,0
,,,,2.0,
31056.0,2019-12-27,"(53.131, 271.25]",1,1,0
31056.0,2019-12-27,"(705.75, 923.0]",1,1,0
,,,,2.0,
,,,,1.0,
,,,,1.0,
31059.0,2019-12-27,"(982.0, 1009.0]",1,2,-1
31059.0,2019-12-27,"(1009.0, 1036.0]",1,2,-1
31060.0,2019-12-27,"(546.0, 799.0]",1,1,0
31060.0,2019-12-27,"(799.0, 1052.0]",4,1,3
31061.0,2019-12-27,"(411.0, 548.0]",1,1,0
31062.0,2019-12-27,"(687.75, 884.5]",2,1,1
31062.0,2019-12-27,"(1081.25, 1278.0]",2,4,-2
,,,,1.0,
,,,,1.0,
31064.0,2019-12-27,"(639.28, 820.0]",3,6,-3
31064.0,2019-12-27,"(820.0, 1000.0]",3,5,-2
31064.0,2019-12-27,"(1000.0, 1180.0]",3,7,-4
31064.0,2019-12-27,"(1180.0, 1360.0]",3,4,-1
31065.0,2019-12-27,"(567.75, 751.5]",1,1,0
31065.0,2019-12-27,"(935.25, 1119.0]",1,2,-1
,,,,1.0,
,,,,2.0,
,,,,1.0,
,,,,1.0,
,,,,1.0,
31068.0,2019-12-27,"(653.737, 719.75]",1,1,0
31068.0,2019-12-27,"(719.75, 785.5]",1,2,-1
31068.0,2019-12-27,"(851.25, 917.0]",1,1,0
31069.0,2019-12-27,"(824.75, 945.0]",2,2,0
31070.0,2019-12-27,"(703.394, 855.5]",1,2,-1
31070.0,2019-12-27,"(1158.5, 1310.0]",2,1,1
31071.0,2019-12-27,"(400.75, 661.5]",1,1,0
31071.0,2019-12-27,"(661.5, 922.25]",3,2,1
31071.0,2019-12-27,"(922.25, 1183.0]",3,5,-2
31072.0,2019-12-27,"(491.398, 642.5]",1,2,-1
31072.0,2019-12-27,"(943.5, 1094.0]",1,1,0
31073.0,2019-12-27,"(1216.0, 1318.0]",2,1,1
,,,,2.0,
31075.0,2019-12-27,"(972.0, 1114.0]",1,1,0
31076.0,2019-12-27,"(792.75, 861.0]",1,1,0
31077.0,2019-12-27,"(562.382, 717.5]",4,9,-5
31077.0,2019-12-27,"(717.5, 872.0]",10,10,0
31077.0,2019-12-27,"(872.0, 1026.5]",2,7,-5
31077.0,2019-12-27,"(1026.5, 1181.0]",1,1,0
,,,,2.0,
,,,,1.0,
,,,,1.0,
31080.0,2019-12-27,"(808.0, 956.0]",1,3,-2
31080.0,2019-12-27,"(956.0, 1104.0]",2,1,1
31081.0,2019-12-27,"(763.25, 880.5]",1,1,0
31081.0,2019-12-27,"(880.5, 997.75]",2,1,1
31081.0,2019-12-27,"(997.75, 1115.0]",2,3,-1
31082.0,2019-12-27,"(917.75, 963.5]",1,1,0
31082.0,2019-12-27,"(1009.25, 1055.0]",1,1,0
31083.0,2019-12-27,"(672.0, 1008.0]",1,1,0
31083.0,2019-12-27,"(1008.0, 1344.0]",1,1,0
31084.0,2019-12-27,"(8.719, 330.25]",1,2,-1
31084.0,2019-12-27,"(650.5, 970.75]",4,8,-4
31084.0,2019-12-27,"(970.75, 1291.0]",3,8,-5
31085.0,2019-12-27,"(1177.5, 1251.0]",1,3,-2
31086.0,2019-12-27,"(1035.795, 1087.25]",1,1,0
31086.0,2019-12-27,"(1087.25, 1138.5]",1,1,0
31087.0,2019-12-27,"(744.897, 770.75]",1,2,-1
31088.0,2019-12-27,"(688.5, 1032.75]",1,1,0
31088.0,2019-12-27,"(1032.75, 1377.0]",1,1,0
31089.0,2019-12-27,"(464.027, 708.25]",4,5,-1
31089.0,2019-12-27,"(708.25, 951.5]",2,4,-2
31089.0,2019-12-27,"(951.5, 1194.75]",2,5,-3
31089.0,2019-12-27,"(1194.75, 1438.0]",1,1,0
31090.0,2019-12-27,"(577.5, 727.0]",1,1,0
31090.0,2019-12-27,"(876.5, 1026.0]",1,2,-1
31091.0,2019-12-27,"(607.187, 811.25]",1,1,0
31091.0,2019-12-27,"(811.25, 1014.5]",1,1,0
31091.0,2019-12-27,"(1014.5, 1217.75]",1,1,0
31092.0,2019-12-27,"(704.75, 937.5]",1,2,-1
31092.0,2019-12-27,"(937.5, 1170.25]",1,1,0
31092.0,2019-12-27,"(1170.25, 1403.0]",1,2,-1
,,,,1.0,
,,,,1.0,
,,,,2.0,
31094.0,2019-12-27,"(753.75, 1005.0]",1,1,0
,,,,2.0,
31096.0,2019-12-27,"(896.25, 959.5]",1,1,0
31096.0,2019-12-27,"(1022.75, 1086.0]",1,1,0
31097.0,2019-12-27,"(899.25, 914.0]",2,1,1
31098.0,2019-12-27,"(47.927, 317.25]",1,1,0
31098.0,2019-12-27,"(585.5, 853.75]",2,2,0
31098.0,2019-12-27,"(853.75, 1122.0]",1,5,-4
31099.0,2019-12-27,"(633.567, 742.25]",2,3,-1
31100.0,2019-12-27,"(591.219, 787.25]",4,5,-1
31100.0,2019-12-27,"(787.25, 982.5]",3,4,-1
31100.0,2019-12-27,"(982.5, 1177.75]",4,8,-4
31101.0,2019-12-27,"(358.25, 686.5]",7,3,4
31101.0,2019-12-27,"(686.5, 1014.75]",21,16,5
31101.0,2019-12-27,"(1014.75, 1343.0]",16,33,-17
31102.0,2019-12-27,"(418.007, 667.25]",1,5,-4
31102.0,2019-12-27,"(915.5, 1163.75]",1,5,-4
31102.0,2019-12-27,"(1163.75, 1412.0]",6,3,3
31103.0,2019-12-27,"(21.72, 343.0]",1,2,-1
31103.0,2019-12-27,"(343.0, 663.0]",3,15,-12
31103.0,2019-12-27,"(663.0, 983.0]",2,11,-9
31103.0,2019-12-27,"(983.0, 1303.0]",4,12,-8
31104.0,2019-12-27,"(299.877, 581.75]",4,12,-8
31104.0,2019-12-27,"(581.75, 862.5]",4,13,-9
31104.0,2019-12-27,"(862.5, 1143.25]",12,23,-11
31104.0,2019-12-27,"(1143.25, 1424.0]",4,11,-7
31105.0,2019-12-27,"(683.0, 925.0]",1,4,-3
31105.0,2019-12-27,"(925.0, 1167.0]",3,2,1
31106.0,2019-12-27,"(546.132, 764.0]",1,4,-3
31106.0,2019-12-27,"(764.0, 981.0]",2,5,-3
31106.0,2019-12-27,"(1198.0, 1415.0]",2,3,-1
31107.0,2019-12-27,"(4.59, 358.5]",1,1,0
31107.0,2019-12-27,"(358.5, 711.0]",1,8,-7
31107.0,2019-12-27,"(711.0, 1063.5]",6,15,-9
31107.0,2019-12-27,"(1063.5, 1416.0]",9,16,-7
31108.0,2019-12-27,"(0.633, 343.75]",1,1,0
31108.0,2019-12-27,"(343.75, 685.5]",5,15,-10
31108.0,2019-12-27,"(685.5, 1027.25]",13,25,-12
31108.0,2019-12-27,"(1027.25, 1369.0]",21,31,-10
31109.0,2019-12-27,"(380.0, 727.0]",4,1,3
31109.0,2019-12-27,"(727.0, 1074.0]",6,11,-5
31109.0,2019-12-27,"(1074.0, 1421.0]",5,12,-7
31110.0,2019-12-27,"(488.062, 723.5]",1,4,-3
31110.0,2019-12-27,"(723.5, 958.0]",6,11,-5
31110.0,2019-12-27,"(958.0, 1192.5]",8,16,-8
31110.0,2019-12-27,"(1192.5, 1427.0]",3,6,-3
31111.0,2019-12-27,"(115.744, 431.0]",1,1,0
31111.0,2019-12-27,"(431.0, 745.0]",4,6,-2
31111.0,2019-12-27,"(745.0, 1059.0]",7,17,-10
31111.0,2019-12-27,"(1059.0, 1373.0]",9,14,-5
31112.0,2019-12-27,"(740.616, 837.0]",2,4,-2
31112.0,2019-12-27,"(837.0, 933.0]",3,3,0
31112.0,2019-12-27,"(933.0, 1029.0]",5,7,-2
31112.0,2019-12-27,"(1029.0, 1125.0]",1,2,-1
31113.0,2019-12-27,"(317.022, 562.5]",1,5,-4
31113.0,2019-12-27,"(807.0, 1051.5]",3,8,-5
31113.0,2019-12-27,"(1051.5, 1296.0]",3,7,-4
31114.0,2019-12-27,"(303.926, 573.5]",5,14,-9
31114.0,2019-12-27,"(573.5, 842.0]",3,9,-6
31114.0,2019-12-27,"(842.0, 1110.5]",10,13,-3
31114.0,2019-12-27,"(1110.5, 1379.0]",10,14,-4
31115.0,2019-12-27,"(99.754, 412.5]",1,4,-3
31115.0,2019-12-27,"(724.0, 1035.5]",1,5,-4
31115.0,2019-12-27,"(1035.5, 1347.0]",6,4,2
31116.0,2019-12-27,"(431.103, 656.25]",1,2,-1
31116.0,2019-12-27,"(880.5, 1104.75]",4,1,3
31116.0,2019-12-27,"(1104.75, 1329.0]",4,5,-1
31117.0,2019-12-27,"(-1.231, 307.75]",1,2,-1
31117.0,2019-12-27,"(307.75, 615.5]",1,10,-9
31117.0,2019-12-27,"(615.5, 923.25]",2,10,-8
31117.0,2019-12-27,"(923.25, 1231.0]",5,9,-4
31118.0,2019-12-27,"(484.107, 708.25]",1,9,-8
31118.0,2019-12-27,"(708.25, 931.5]",1,4,-3
31118.0,2019-12-27,"(931.5, 1154.75]",5,13,-8
31118.0,2019-12-27,"(1154.75, 1378.0]",5,8,-3
31119.0,2019-12-27,"(2.828, 297.0]",2,2,0
31119.0,2019-12-27,"(590.0, 883.0]",7,8,-1
31119.0,2019-12-27,"(883.0, 1176.0]",11,14,-3
31120.0,2019-12-27,"(532.197, 733.75]",3,6,-3
31120.0,2019-12-27,"(934.5, 1135.25]",1,6,-5
31120.0,2019-12-27,"(1135.25, 1336.0]",3,5,-2
31121.0,2019-12-27,"(160.866, 445.5]",2,3,-1
31121.0,2019-12-27,"(445.5, 729.0]",8,9,-1
31121.0,2019-12-27,"(729.0, 1012.5]",4,8,-4
31121.0,2019-12-27,"(1012.5, 1296.0]",5,10,-5
31122.0,2019-12-27,"(519.336, 686.0]",2,4,-2
31122.0,2019-12-27,"(686.0, 852.0]",1,4,-3
31122.0,2019-12-27,"(852.0, 1018.0]",5,6,-1
31122.0,2019-12-27,"(1018.0, 1184.0]",4,9,-5
31123.0,2019-12-27,"(967.25, 1170.0]",2,3,-1
31124.0,2019-12-27,"(379.955, 642.25]",2,9,-7
31124.0,2019-12-27,"(642.25, 903.5]",4,18,-14
31124.0,2019-12-27,"(903.5, 1164.75]",11,29,-18
31124.0,2019-12-27,"(1164.75, 1426.0]",4,14,-10
31125.0,2019-12-27,"(357.006, 606.5]",1,15,-14
31125.0,2019-12-27,"(606.5, 855.0]",9,18,-9
31125.0,2019-12-27,"(855.0, 1103.5]",10,17,-7
31125.0,2019-12-27,"(1103.5, 1352.0]",11,19,-8
31126.0,2019-12-27,"(64.706, 389.5]",1,1,0
31126.0,2019-12-27,"(389.5, 713.0]",1,7,-6
31126.0,2019-12-27,"(713.0, 1036.5]",5,9,-4
31126.0,2019-12-27,"(1036.5, 1360.0]",13,19,-6
,,,,2.0,
31128.0,2019-12-27,"(297.889, 576.75]",10,12,-2
31128.0,2019-12-27,"(576.75, 854.5]",14,30,-16
31128.0,2019-12-27,"(854.5, 1132.25]",6,9,-3
31128.0,2019-12-27,"(1132.25, 1410.0]",5,9,-4
31129.0,2019-12-27,"(552.212, 750.0]",8,18,-10
31129.0,2019-12-27,"(750.0, 947.0]",13,25,-12
31129.0,2019-12-27,"(947.0, 1144.0]",15,23,-8
31129.0,2019-12-27,"(1144.0, 1341.0]",6,9,-3
31130.0,2019-12-27,"(364.045, 603.75]",1,4,-3
31130.0,2019-12-27,"(603.75, 842.5]",5,6,-1
31130.0,2019-12-27,"(842.5, 1081.25]",3,3,0
31130.0,2019-12-27,"(1081.25, 1320.0]",4,7,-3
31131.0,2019-12-27,"(275.948, 540.0]",2,8,-6
31131.0,2019-12-27,"(803.0, 1066.0]",5,1,4
31131.0,2019-12-27,"(1066.0, 1329.0]",4,12,-8
31200.0,2019-12-27,"(336.915, 609.25]",11,16,-5
31200.0,2019-12-27,"(609.25, 880.5]",10,22,-12
31200.0,2019-12-27,"(880.5, 1151.75]",15,22,-7
31200.0,2019-12-27,"(1151.75, 1423.0]",6,14,-8
31201.0,2019-12-27,"(45.669, 379.75]",3,6,-3
31201.0,2019-12-27,"(379.75, 712.5]",12,23,-11
31201.0,2019-12-27,"(712.5, 1045.25]",29,55,-26
31201.0,2019-12-27,"(1045.25, 1378.0]",32,49,-17
31202.0,2019-12-27,"(110.712, 434.0]",1,4,-3
31202.0,2019-12-27,"(434.0, 756.0]",5,11,-6
31202.0,2019-12-27,"(756.0, 1078.0]",14,26,-12
31202.0,2019-12-27,"(1078.0, 1400.0]",5,11,-6
31203.0,2019-12-27,"(483.5, 802.0]",10,3,7
31203.0,2019-12-27,"(802.0, 1120.5]",18,16,2
31203.0,2019-12-27,"(1120.5, 1439.0]",9,36,-27
31204.0,2019-12-27,"(381.255, 568.25]",7,9,-2
31204.0,2019-12-27,"(568.25, 754.5]",1,9,-8
31204.0,2019-12-27,"(754.5, 940.75]",3,11,-8
31205.0,2019-12-27,"(388.36, 549.0]",1,1,0
31205.0,2019-12-27,"(549.0, 709.0]",3,6,-3
31205.0,2019-12-27,"(709.0, 869.0]",1,2,-1
31205.0,2019-12-27,"(869.0, 1029.0]",2,6,-4
31206.0,2019-12-27,"(529.193, 731.75]",2,2,0
31206.0,2019-12-27,"(731.75, 933.5]",2,5,-3
31206.0,2019-12-27,"(1135.25, 1337.0]",1,2,-1
31207.0,2019-12-27,"(588.5, 778.0]",3,1,2
31207.0,2019-12-27,"(778.0, 967.5]",2,4,-2
31208.0,2019-12-27,"(391.238, 582.5]",1,2,-1
31208.0,2019-12-27,"(582.5, 773.0]",1,4,-3
31208.0,2019-12-27,"(773.0, 963.5]",1,2,-1
31208.0,2019-12-27,"(963.5, 1154.0]",4,5,-1
31209.0,2019-12-27,"(383.074, 615.5]",3,5,-2
31209.0,2019-12-27,"(847.0, 1078.5]",3,3,0
31209.0,2019-12-27,"(1078.5, 1310.0]",6,10,-4
31211.0,2019-12-27,"(388.202, 588.5]",2,3,-1
31211.0,2019-12-27,"(588.5, 788.0]",3,4,-1
31211.0,2019-12-27,"(788.0, 987.5]",4,7,-3
31211.0,2019-12-27,"(987.5, 1187.0]",5,11,-6
31212.0,2019-12-27,"(376.005, 625.75]",10,12,-2
31212.0,2019-12-27,"(625.75, 874.5]",7,11,-4
31212.0,2019-12-27,"(874.5, 1123.25]",9,17,-8
31212.0,2019-12-27,"(1123.25, 1372.0]",7,12,-5
31213.0,2019-12-27,"(380.976, 638.0]",6,9,-3
31213.0,2019-12-27,"(638.0, 894.0]",9,14,-5
31213.0,2019-12-27,"(894.0, 1150.0]",15,22,-7
31213.0,2019-12-27,"(1150.0, 1406.0]",1,5,-4
31214.0,2019-12-27,"(9.605, 359.75]",2,2,0
31214.0,2019-12-27,"(359.75, 708.5]",7,20,-13
31214.0,2019-12-27,"(708.5, 1057.25]",13,29,-16
31214.0,2019-12-27,"(1057.25, 1406.0]",9,16,-7
31215.0,2019-12-27,"(459.311, 632.25]",11,21,-10
31215.0,2019-12-27,"(632.25, 804.5]",3,5,-2
31215.0,2019-12-27,"(804.5, 976.75]",6,8,-2
31215.0,2019-12-27,"(976.75, 1149.0]",10,17,-7
31216.0,2019-12-27,"(462.12, 683.0]",8,11,-3
31216.0,2019-12-27,"(683.0, 903.0]",5,8,-3
31216.0,2019-12-27,"(903.0, 1123.0]",7,13,-6
31216.0,2019-12-27,"(1123.0, 1343.0]",4,11,-7
31217.0,2019-12-27,"(438.395, 590.25]",6,7,-1
31217.0,2019-12-27,"(892.75, 1044.0]",4,2,2
31218.0,2019-12-27,"(410.068, 644.0]",4,11,-7
31218.0,2019-12-27,"(644.0, 877.0]",6,9,-3
31218.0,2019-12-27,"(877.0, 1110.0]",11,26,-15
31218.0,2019-12-27,"(1110.0, 1343.0]",3,5,-2
31219.0,2019-12-27,"(412.045, 651.75]",4,6,-2
31219.0,2019-12-27,"(651.75, 890.5]",13,25,-12
31219.0,2019-12-27,"(890.5, 1129.25]",1,7,-6
31219.0,2019-12-27,"(1129.25, 1368.0]",1,4,-3
31220.0,2019-12-27,"(282.863, 568.25]",11,12,-1
31220.0,2019-12-27,"(568.25, 852.5]",5,11,-6
31220.0,2019-12-27,"(852.5, 1136.75]",2,9,-7
31221.0,2019-12-27,"(387.083, 617.25]",9,11,-2
31221.0,2019-12-27,"(617.25, 846.5]",2,4,-2
31221.0,2019-12-27,"(846.5, 1075.75]",5,10,-5
31221.0,2019-12-27,"(1075.75, 1305.0]",2,5,-3
31222.0,2019-12-27,"(415.147, 629.25]",4,5,-1
31222.0,2019-12-27,"(629.25, 842.5]",5,8,-3
31222.0,2019-12-27,"(842.5, 1055.75]",10,17,-7
31222.0,2019-12-27,"(1055.75, 1269.0]",4,7,-3
31223.0,2019-12-27,"(407.0, 744.0]",6,1,5
31223.0,2019-12-27,"(744.0, 1081.0]",7,14,-7
31223.0,2019-12-27,"(1081.0, 1418.0]",4,12,-8
31224.0,2019-12-27,"(492.353, 654.75]",5,6,-1
31224.0,2019-12-27,"(654.75, 816.5]",2,4,-2
31224.0,2019-12-27,"(816.5, 978.25]",4,7,-3
31224.0,2019-12-27,"(978.25, 1140.0]",5,14,-9
31225.0,2019-12-27,"(127.808, 427.0]",2,2,0
31225.0,2019-12-27,"(427.0, 725.0]",4,5,-1
31225.0,2019-12-27,"(725.0, 1023.0]",6,8,-2
31225.0,2019-12-27,"(1023.0, 1321.0]",16,23,-7
31226.0,2019-12-27,"(841.0, 989.0]",1,2,-1
31226.0,2019-12-27,"(989.0, 1137.0]",3,1,2
31227.0,2019-12-27,"(425.108, 649.0]",7,10,-3
31227.0,2019-12-27,"(649.0, 872.0]",4,6,-2
31227.0,2019-12-27,"(872.0, 1095.0]",5,13,-8
31228.0,2019-12-27,"(459.037, 700.75]",7,20,-13
31228.0,2019-12-27,"(700.75, 941.5]",15,25,-10
31228.0,2019-12-27,"(941.5, 1182.25]",27,38,-11
31228.0,2019-12-27,"(1182.25, 1423.0]",3,14,-11
31229.0,2019-12-27,"(369.942, 635.5]",2,14,-12
31229.0,2019-12-27,"(635.5, 900.0]",16,31,-15
31229.0,2019-12-27,"(900.0, 1164.5]",26,44,-18
31229.0,2019-12-27,"(1164.5, 1429.0]",11,21,-10
31230.0,2019-12-27,"(408.104, 633.0]",7,11,-4
31230.0,2019-12-27,"(633.0, 857.0]",19,29,-10
31230.0,2019-12-27,"(857.0, 1081.0]",5,19,-14
31230.0,2019-12-27,"(1081.0, 1305.0]",2,10,-8
31231.0,2019-12-27,"(448.033, 690.75]",4,6,-2
31231.0,2019-12-27,"(690.75, 932.5]",8,13,-5
31231.0,2019-12-27,"(932.5, 1174.25]",16,23,-7
31231.0,2019-12-27,"(1174.25, 1416.0]",3,7,-4
31232.0,2019-12-27,"(58.642, 399.5]",2,5,-3
31232.0,2019-12-27,"(399.5, 739.0]",6,10,-4
31232.0,2019-12-27,"(739.0, 1078.5]",16,23,-7
31232.0,2019-12-27,"(1078.5, 1418.0]",8,19,-11
31233.0,2019-12-27,"(376.212, 574.0]",7,8,-1
31233.0,2019-12-27,"(574.0, 771.0]",5,9,-4
31233.0,2019-12-27,"(771.0, 968.0]",9,12,-3
31233.0,2019-12-27,"(968.0, 1165.0]",6,17,-11
31234.0,2019-12-27,"(380.005, 629.75]",4,8,-4
31234.0,2019-12-27,"(629.75, 878.5]",4,4,0
31234.0,2019-12-27,"(878.5, 1127.25]",4,9,-5
31234.0,2019-12-27,"(1127.25, 1376.0]",4,10,-6
31235.0,2019-12-27,"(546.233, 738.75]",9,11,-2
31235.0,2019-12-27,"(738.75, 930.5]",4,17,-13
31235.0,2019-12-27,"(930.5, 1122.25]",6,18,-12
31235.0,2019-12-27,"(1122.25, 1314.0]",1,2,-1
31236.0,2019-12-27,"(631.247, 820.25]",7,9,-2
31236.0,2019-12-27,"(820.25, 1008.5]",5,11,-6
31236.0,2019-12-27,"(1196.75, 1385.0]",1,4,-3
31237.0,2019-12-27,"(354.25, 668.5]",1,1,0
31237.0,2019-12-27,"(668.5, 982.75]",4,4,0
31237.0,2019-12-27,"(982.75, 1297.0]",7,7,0
31238.0,2019-12-27,"(74.687, 404.25]",1,1,0
31238.0,2019-12-27,"(404.25, 732.5]",9,13,-4
31238.0,2019-12-27,"(732.5, 1060.75]",9,21,-12
31238.0,2019-12-27,"(1060.75, 1389.0]",13,20,-7
31239.0,2019-12-27,"(40.79, 344.5]",1,2,-1
31239.0,2019-12-27,"(344.5, 647.0]",5,5,0
31239.0,2019-12-27,"(647.0, 949.5]",9,20,-11
31239.0,2019-12-27,"(949.5, 1252.0]",2,7,-5
31240.0,2019-12-27,"(674.517, 795.75]",9,20,-11
31240.0,2019-12-27,"(795.75, 916.5]",8,17,-9
31240.0,2019-12-27,"(916.5, 1037.25]",10,26,-16
31240.0,2019-12-27,"(1037.25, 1158.0]",4,4,0
31241.0,2019-12-27,"(274.889, 553.75]",3,11,-8
31241.0,2019-12-27,"(553.75, 831.5]",4,15,-11
31241.0,2019-12-27,"(831.5, 1109.25]",14,22,-8
31241.0,2019-12-27,"(1109.25, 1387.0]",10,16,-6
31242.0,2019-12-27,"(392.143, 607.25]",9,16,-7
31242.0,2019-12-27,"(607.25, 821.5]",7,16,-9
31243.0,2019-12-27,"(400.109, 623.75]",10,15,-5
31243.0,2019-12-27,"(623.75, 846.5]",14,20,-6
31243.0,2019-12-27,"(846.5, 1069.25]",13,35,-22
31243.0,2019-12-27,"(1069.25, 1292.0]",5,12,-7
31244.0,2019-12-27,"(492.163, 702.25]",3,4,-1
31244.0,2019-12-27,"(702.25, 911.5]",2,3,-1
31244.0,2019-12-27,"(911.5, 1120.75]",2,8,-6
31244.0,2019-12-27,"(1120.75, 1330.0]",2,3,-1
31245.0,2019-12-27,"(174.753, 487.75]",2,3,-1
31245.0,2019-12-27,"(487.75, 799.5]",8,18,-10
31245.0,2019-12-27,"(799.5, 1111.25]",7,9,-2
31245.0,2019-12-27,"(1111.25, 1423.0]",2,7,-5
31246.0,2019-12-27,"(448.043, 688.25]",2,6,-4
31246.0,2019-12-27,"(688.25, 927.5]",17,21,-4
31246.0,2019-12-27,"(927.5, 1166.75]",9,23,-14
31246.0,2019-12-27,"(1166.75, 1406.0]",4,11,-7
31247.0,2019-12-27,"(478.235, 670.25]",19,28,-9
31247.0,2019-12-27,"(670.25, 861.5]",27,45,-18
31247.0,2019-12-27,"(861.5, 1052.75]",48,92,-44
31247.0,2019-12-27,"(1052.75, 1244.0]",17,32,-15
31248.0,2019-12-27,"(469.129, 687.75]",16,22,-6
31248.0,2019-12-27,"(687.75, 905.5]",21,58,-37
31248.0,2019-12-27,"(905.5, 1123.25]",20,38,-18
31248.0,2019-12-27,"(1123.25, 1341.0]",12,23,-11
31249.0,2019-12-27,"(416.224, 611.0]",2,4,-2
31249.0,2019-12-27,"(611.0, 805.0]",12,24,-12
31249.0,2019-12-27,"(805.0, 999.0]",10,23,-13
31249.0,2019-12-27,"(999.0, 1193.0]",6,15,-9
31250.0,2019-12-27,"(470.37, 628.5]",7,9,-2
31250.0,2019-12-27,"(628.5, 786.0]",1,4,-3
31250.0,2019-12-27,"(786.0, 943.5]",2,6,-4
31251.0,2019-12-27,"(-0.408, 353.0]",2,2,0
31251.0,2019-12-27,"(353.0, 705.0]",2,6,-4
31251.0,2019-12-27,"(705.0, 1057.0]",12,22,-10
31251.0,2019-12-27,"(1057.0, 1409.0]",6,11,-5
31252.0,2019-12-27,"(390.294, 567.5]",2,4,-2
31252.0,2019-12-27,"(567.5, 744.0]",4,6,-2
31252.0,2019-12-27,"(744.0, 920.5]",1,2,-1
31253.0,2019-12-27,"(422.287, 601.25]",4,4,0
31253.0,2019-12-27,"(601.25, 779.5]",1,2,-1
31253.0,2019-12-27,"(779.5, 957.75]",4,6,-2
31253.0,2019-12-27,"(957.75, 1136.0]",3,7,-4
31254.0,2019-12-27,"(120.97, 379.5]",3,3,0
31254.0,2019-12-27,"(379.5, 637.0]",5,6,-1
31254.0,2019-12-27,"(637.0, 894.5]",6,9,-3
31254.0,2019-12-27,"(894.5, 1152.0]",4,10,-6
31255.0,2019-12-27,"(509.403, 659.25]",4,7,-3
31255.0,2019-12-27,"(808.5, 957.75]",1,2,-1
31255.0,2019-12-27,"(957.75, 1107.0]",3,1,2
31256.0,2019-12-27,"(274.123, 494.25]",4,5,-1
31256.0,2019-12-27,"(494.25, 713.5]",2,2,0
31256.0,2019-12-27,"(713.5, 932.75]",9,11,-2
31256.0,2019-12-27,"(932.75, 1152.0]",3,5,-2
31257.0,2019-12-27,"(394.205, 593.75]",4,13,-9
31257.0,2019-12-27,"(792.5, 991.25]",3,6,-3
31257.0,2019-12-27,"(991.25, 1190.0]",3,6,-3
31258.0,2019-12-27,"(432.112, 655.0]",11,24,-13
31258.0,2019-12-27,"(655.0, 877.0]",38,83,-45
31258.0,2019-12-27,"(877.0, 1099.0]",51,91,-40
31258.0,2019-12-27,"(1099.0, 1321.0]",7,24,-17
31259.0,2019-12-27,"(366.5, 549.75]",2,1,1
31259.0,2019-12-27,"(549.75, 733.0]",4,2,2
31260.0,2019-12-27,"(491.071, 724.25]",6,11,-5
31260.0,2019-12-27,"(724.25, 956.5]",1,3,-2
31260.0,2019-12-27,"(956.5, 1188.75]",1,7,-6
31260.0,2019-12-27,"(1188.75, 1421.0]",1,2,-1
31261.0,2019-12-27,"(475.354, 637.5]",5,6,-1
31261.0,2019-12-27,"(637.5, 799.0]",2,6,-4
31261.0,2019-12-27,"(799.0, 960.5]",1,8,-7
31261.0,2019-12-27,"(960.5, 1122.0]",2,11,-9
31262.0,2019-12-27,"(390.13, 608.5]",2,3,-1
31262.0,2019-12-27,"(608.5, 826.0]",1,2,-1
31262.0,2019-12-27,"(826.0, 1043.5]",5,9,-4
31262.0,2019-12-27,"(1043.5, 1261.0]",5,8,-3
31263.0,2019-12-27,"(447.137, 663.75]",8,13,-5
31263.0,2019-12-27,"(663.75, 879.5]",6,11,-5
31263.0,2019-12-27,"(879.5, 1095.25]",5,14,-9
31263.0,2019-12-27,"(1095.25, 1311.0]",2,6,-4
31264.0,2019-12-27,"(462.073, 694.75]",6,6,0
31264.0,2019-12-27,"(694.75, 926.5]",3,11,-8
31264.0,2019-12-27,"(926.5, 1158.25]",7,12,-5
31264.0,2019-12-27,"(1158.25, 1390.0]",1,4,-3
31265.0,2019-12-27,"(391.967, 651.25]",7,15,-8
31265.0,2019-12-27,"(651.25, 909.5]",10,19,-9
31265.0,2019-12-27,"(909.5, 1167.75]",16,26,-10
31265.0,2019-12-27,"(1167.75, 1426.0]",6,16,-10
31266.0,2019-12-27,"(50.684, 381.0]",1,3,-2
31266.0,2019-12-27,"(381.0, 710.0]",8,19,-11
31266.0,2019-12-27,"(710.0, 1039.0]",18,35,-17
31266.0,2019-12-27,"(1039.0, 1368.0]",8,18,-10
31267.0,2019-12-27,"(481.18, 687.0]",5,11,-6
31267.0,2019-12-27,"(687.0, 892.0]",4,8,-4
31267.0,2019-12-27,"(892.0, 1097.0]",3,9,-6
31267.0,2019-12-27,"(1097.0, 1302.0]",4,9,-5
31268.0,2019-12-27,"(413.045, 652.75]",6,10,-4
31268.0,2019-12-27,"(652.75, 891.5]",4,10,-6
31268.0,2019-12-27,"(891.5, 1130.25]",6,9,-3
31268.0,2019-12-27,"(1130.25, 1369.0]",1,6,-5
31269.0,2019-12-27,"(384.202, 584.5]",8,11,-3
31269.0,2019-12-27,"(584.5, 784.0]",7,12,-5
31269.0,2019-12-27,"(784.0, 983.5]",4,17,-13
31269.0,2019-12-27,"(983.5, 1183.0]",8,13,-5
31270.0,2019-12-27,"(461.078, 692.5]",7,9,-2
31270.0,2019-12-27,"(692.5, 923.0]",4,10,-6
31270.0,2019-12-27,"(923.0, 1153.5]",3,7,-4
31271.0,2019-12-27,"(417.045, 656.75]",12,12,0
31271.0,2019-12-27,"(656.75, 895.5]",14,25,-11
31271.0,2019-12-27,"(895.5, 1134.25]",8,30,-22
31271.0,2019-12-27,"(1134.25, 1373.0]",6,16,-10
31272.0,2019-12-27,"(309.913, 582.75]",10,12,-2
31272.0,2019-12-27,"(582.75, 854.5]",14,18,-4
31272.0,2019-12-27,"(854.5, 1126.25]",11,29,-18
31272.0,2019-12-27,"(1126.25, 1398.0]",5,8,-3
31273.0,2019-12-27,"(529.501, 654.75]",1,2,-1
31273.0,2019-12-27,"(779.5, 904.25]",3,3,0
31273.0,2019-12-27,"(904.25, 1029.0]",6,12,-6
31274.0,2019-12-27,"(481.278, 662.5]",5,9,-4
31274.0,2019-12-27,"(662.5, 843.0]",2,3,-1
31274.0,2019-12-27,"(843.0, 1023.5]",3,12,-9
31274.0,2019-12-27,"(1023.5, 1204.0]",1,5,-4
31275.0,2019-12-27,"(287.879, 569.25]",5,10,-5
31275.0,2019-12-27,"(569.25, 849.5]",9,15,-6
31275.0,2019-12-27,"(849.5, 1129.75]",11,26,-15
31275.0,2019-12-27,"(1129.75, 1410.0]",4,5,-1
31276.0,2019-12-27,"(473.16, 684.0]",5,8,-3
31276.0,2019-12-27,"(684.0, 894.0]",11,20,-9
31276.0,2019-12-27,"(894.0, 1104.0]",3,8,-5
31276.0,2019-12-27,"(1104.0, 1314.0]",5,9,-4
31277.0,2019-12-27,"(438.119, 659.25]",9,9,0
31277.0,2019-12-27,"(659.25, 879.5]",14,29,-15
31277.0,2019-12-27,"(879.5, 1099.75]",13,31,-18
31277.0,2019-12-27,"(1099.75, 1320.0]",2,6,-4
31278.0,2019-12-27,"(8.786, 313.5]",2,2,0
31278.0,2019-12-27,"(313.5, 617.0]",2,3,-1
31278.0,2019-12-27,"(617.0, 920.5]",3,6,-3
31278.0,2019-12-27,"(920.5, 1224.0]",9,14,-5
31279.0,2019-12-27,"(419.237, 610.75]",11,12,-1
31279.0,2019-12-27,"(801.5, 992.25]",1,2,-1
31279.0,2019-12-27,"(992.25, 1183.0]",2,6,-4
31280.0,2019-12-27,"(369.952, 633.0]",1,7,-6
31280.0,2019-12-27,"(633.0, 895.0]",6,7,-1
31280.0,2019-12-27,"(895.0, 1157.0]",2,5,-3
31280.0,2019-12-27,"(1157.0, 1419.0]",1,1,0
,,,,1.0,
,,,,1.0,
31001.0,2019-12-28,"(1046.5, 1093.0]",1,2,-1
31002.0,2019-12-28,"(580.56, 691.0]",2,4,-2
31002.0,2019-12-28,"(691.0, 801.0]",2,6,-4
31002.0,2019-12-28,"(801.0, 911.0]",6,12,-6
31002.0,2019-12-28,"(911.0, 1021.0]",2,3,-1
31003.0,2019-12-28,"(646.343, 811.25]",1,5,-4
31003.0,2019-12-28,"(811.25, 975.5]",3,5,-2
31003.0,2019-12-28,"(1139.75, 1304.0]",1,1,0
31004.0,2019-12-28,"(719.75, 834.5]",1,3,-2
31004.0,2019-12-28,"(949.25, 1064.0]",2,1,1
31005.0,2019-12-28,"(62.792, 366.0]",1,1,0
31005.0,2019-12-28,"(668.0, 970.0]",5,1,4
31005.0,2019-12-28,"(970.0, 1272.0]",2,8,-6
31006.0,2019-12-28,"(699.339, 865.25]",1,3,-2
31006.0,2019-12-28,"(865.25, 1030.5]",5,8,-3
31006.0,2019-12-28,"(1030.5, 1195.75]",2,4,-2
31007.0,2019-12-28,"(646.381, 801.75]",2,6,-4
31007.0,2019-12-28,"(956.5, 1111.25]",5,1,4
31009.0,2019-12-28,"(1075.25, 1175.0]",3,3,0
31010.0,2019-12-28,"(506.215, 703.25]",8,16,-8
31010.0,2019-12-28,"(703.25, 899.5]",5,8,-3
31010.0,2019-12-28,"(899.5, 1095.75]",2,6,-4
31010.0,2019-12-28,"(1095.75, 1292.0]",3,6,-3
31011.0,2019-12-28,"(353.0, 591.0]",1,1,0
31011.0,2019-12-28,"(591.0, 829.0]",4,1,3
31011.0,2019-12-28,"(829.0, 1067.0]",1,6,-5
31012.0,2019-12-28,"(803.0, 872.0]",2,2,0
31013.0,2019-12-28,"(383.0, 645.0]",1,1,0
31013.0,2019-12-28,"(907.0, 1169.0]",4,1,3
31014.0,2019-12-28,"(561.0, 747.0]",3,3,0
31014.0,2019-12-28,"(933.0, 1119.0]",6,6,0
31015.0,2019-12-28,"(545.173, 752.75]",3,4,-1
31015.0,2019-12-28,"(752.75, 959.5]",2,8,-6
31015.0,2019-12-28,"(959.5, 1166.25]",1,1,0
31016.0,2019-12-28,"(681.386, 835.5]",3,5,-2
31016.0,2019-12-28,"(835.5, 989.0]",1,3,-2
31016.0,2019-12-28,"(1142.5, 1296.0]",1,2,-1
31017.0,2019-12-28,"(1101.0, 1161.0]",1,1,0
31018.0,2019-12-28,"(686.298, 862.5]",1,2,-1
31018.0,2019-12-28,"(1213.5, 1389.0]",2,2,0
31019.0,2019-12-28,"(709.5, 1016.25]",4,1,3
31020.0,2019-12-28,"(819.5, 897.25]",1,1,0
31020.0,2019-12-28,"(897.25, 975.0]",1,2,-1
31021.0,2019-12-28,"(487.285, 666.75]",1,1,0
31021.0,2019-12-28,"(666.75, 845.5]",3,8,-5
31021.0,2019-12-28,"(845.5, 1024.25]",1,3,-2
31021.0,2019-12-28,"(1024.25, 1203.0]",1,1,0
31022.0,2019-12-28,"(698.5, 996.75]",5,1,4
31022.0,2019-12-28,"(996.75, 1295.0]",6,11,-5
31023.0,2019-12-28,"(356.5, 696.0]",3,1,2
31023.0,2019-12-28,"(696.0, 1035.5]",2,4,-2
31023.0,2019-12-28,"(1035.5, 1375.0]",1,3,-2
31024.0,2019-12-28,"(427.5, 744.0]",3,1,2
31024.0,2019-12-28,"(744.0, 1060.5]",2,4,-2
31024.0,2019-12-28,"(1060.5, 1377.0]",2,4,-2
31025.0,2019-12-28,"(742.56, 853.0]",1,2,-1
31025.0,2019-12-28,"(853.0, 963.0]",1,1,0
31025.0,2019-12-28,"(1073.0, 1183.0]",1,1,0
31026.0,2019-12-28,"(846.0, 951.0]",6,3,3
31026.0,2019-12-28,"(951.0, 1056.0]",1,8,-7
31027.0,2019-12-28,"(610.187, 814.25]",1,2,-1
31027.0,2019-12-28,"(1017.5, 1220.75]",1,3,-2
31027.0,2019-12-28,"(1220.75, 1424.0]",1,1,0
31028.0,2019-12-28,"(797.497, 923.75]",5,9,-4
31028.0,2019-12-28,"(1175.25, 1301.0]",1,1,0
31029.0,2019-12-28,"(780.75, 963.5]",3,2,1
31029.0,2019-12-28,"(1146.25, 1329.0]",1,5,-4
31030.0,2019-12-28,"(98.749, 412.75]",2,2,0
31030.0,2019-12-28,"(725.5, 1038.25]",1,1,0
31030.0,2019-12-28,"(1038.25, 1351.0]",3,4,-1
31031.0,2019-12-28,"(448.126, 667.5]",1,4,-3
31031.0,2019-12-28,"(886.0, 1104.5]",1,5,-4
31031.0,2019-12-28,"(1104.5, 1323.0]",1,2,-1
31032.0,2019-12-28,"(874.0, 1128.0]",1,2,-1
,,,,1.0,
,,,,1.0,
31034.0,2019-12-28,"(829.482, 959.5]",5,7,-2
31035.0,2019-12-28,"(121.986, 376.5]",2,2,0
31036.0,2019-12-28,"(21.75, 29.0]",1,1,0
31037.0,2019-12-28,"(533.133, 750.75]",1,3,-2
31037.0,2019-12-28,"(750.75, 967.5]",1,7,-6
31037.0,2019-12-28,"(967.5, 1184.25]",1,2,-1
31037.0,2019-12-28,"(1184.25, 1401.0]",1,2,-1
31038.0,2019-12-28,"(532.526, 651.5]",1,1,0
31038.0,2019-12-28,"(651.5, 770.0]",1,2,-1
,,,,2.0,
31040.0,2019-12-28,"(546.309, 719.75]",3,4,-1
31040.0,2019-12-28,"(1065.25, 1238.0]",1,1,0
31041.0,2019-12-28,"(604.403, 754.25]",3,7,-4
31041.0,2019-12-28,"(754.25, 903.5]",7,9,-2
31041.0,2019-12-28,"(903.5, 1052.75]",4,8,-4
31041.0,2019-12-28,"(1052.75, 1202.0]",1,1,0
31042.0,2019-12-28,"(477.403, 627.25]",2,3,-1
31042.0,2019-12-28,"(627.25, 776.5]",4,4,0
31042.0,2019-12-28,"(776.5, 925.75]",3,7,-4
31042.0,2019-12-28,"(925.75, 1075.0]",5,10,-5
31043.0,2019-12-28,"(606.569, 714.75]",1,1,0
31043.0,2019-12-28,"(714.75, 822.5]",1,2,-1
31043.0,2019-12-28,"(930.25, 1038.0]",4,6,-2
31044.0,2019-12-28,"(867.75, 1157.0]",5,1,4
31045.0,2019-12-28,"(744.776, 801.0]",1,1,0
31045.0,2019-12-28,"(913.0, 969.0]",1,1,0
31046.0,2019-12-28,"(780.75, 832.5]",1,2,-1
31047.0,2019-12-28,"(743.75, 896.5]",5,5,0
31047.0,2019-12-28,"(1049.25, 1202.0]",2,5,-3
,,,,1.0,
,,,,2.0,
,,,,1.0,
31049.0,2019-12-28,"(601.5, 722.0]",1,2,-1
31049.0,2019-12-28,"(842.5, 963.0]",1,1,0
31050.0,2019-12-28,"(671.5, 767.0]",1,1,0
31050.0,2019-12-28,"(862.5, 958.0]",1,2,-1
31051.0,2019-12-28,"(149.717, 471.75]",1,1,0
31051.0,2019-12-28,"(792.5, 1113.25]",2,1,1
31051.0,2019-12-28,"(1113.25, 1434.0]",2,7,-5
31052.0,2019-12-28,"(798.25, 957.5]",1,1,0
31052.0,2019-12-28,"(1116.75, 1276.0]",2,2,0
31053.0,2019-12-28,"(910.75, 1060.0]",1,1,0
,,,,2.0,
31055.0,2019-12-28,"(582.574, 689.5]",1,2,-1
31055.0,2019-12-28,"(689.5, 796.0]",2,4,-2
31055.0,2019-12-28,"(902.5, 1009.0]",2,1,1
31056.0,2019-12-28,"(525.118, 746.5]",1,3,-2
31056.0,2019-12-28,"(967.0, 1187.5]",1,1,0
31057.0,2019-12-28,"(633.907, 657.25]",2,3,-1
31057.0,2019-12-28,"(703.75, 727.0]",1,2,-1
31058.0,2019-12-28,"(769.75, 853.0]",2,1,1
31059.0,2019-12-28,"(706.5, 733.0]",2,2,0
31060.0,2019-12-28,"(537.321, 707.75]",3,7,-4
31060.0,2019-12-28,"(707.75, 877.5]",2,4,-2
31060.0,2019-12-28,"(877.5, 1047.25]",4,9,-5
31060.0,2019-12-28,"(1047.25, 1217.0]",2,5,-3
31061.0,2019-12-28,"(924.5, 932.0]",1,1,0
31062.0,2019-12-28,"(556.555, 668.25]",4,11,-7
31062.0,2019-12-28,"(668.25, 779.5]",11,17,-6
31062.0,2019-12-28,"(779.5, 890.75]",8,18,-10
31062.0,2019-12-28,"(890.75, 1002.0]",7,14,-7
31063.0,2019-12-28,"(638.457, 774.75]",4,8,-4
31063.0,2019-12-28,"(1046.25, 1182.0]",2,2,0
31064.0,2019-12-28,"(472.231, 665.25]",5,7,-2
31064.0,2019-12-28,"(665.25, 857.5]",16,41,-25
31064.0,2019-12-28,"(857.5, 1049.75]",18,35,-17
31064.0,2019-12-28,"(1049.75, 1242.0]",7,12,-5
31065.0,2019-12-28,"(906.75, 1209.0]",1,1,0
,,,,2.0,
,,,,4.0,
31067.0,2019-12-28,"(600.578, 706.5]",1,5,-4
31068.0,2019-12-28,"(978.907, 1002.25]",1,2,-1
31068.0,2019-12-28,"(1048.75, 1072.0]",1,2,-1
31069.0,2019-12-28,"(119.766, 429.5]",1,1,0
31069.0,2019-12-28,"(1046.5, 1355.0]",1,1,0
31070.0,2019-12-28,"(865.0, 1022.0]",1,2,-1
31070.0,2019-12-28,"(1022.0, 1179.0]",1,2,-1
31071.0,2019-12-28,"(505.213, 702.75]",7,11,-4
31071.0,2019-12-28,"(702.75, 899.5]",4,9,-5
31071.0,2019-12-28,"(899.5, 1096.25]",5,5,0
31071.0,2019-12-28,"(1096.25, 1293.0]",2,3,-1
,,,,1.0,
,,,,3.0,
31073.0,2019-12-28,"(114.218, 310.5]",1,1,0
31073.0,2019-12-28,"(701.5, 897.0]",1,2,-1
31074.0,2019-12-28,"(1045.75, 1198.0]",2,1,1
31075.0,2019-12-28,"(463.569, 571.75]",1,1,0
31076.0,2019-12-28,"(641.751, 704.25]",3,3,0
31076.0,2019-12-28,"(766.5, 828.75]",1,1,0
31076.0,2019-12-28,"(828.75, 891.0]",2,1,1
31077.0,2019-12-28,"(597.223, 792.25]",10,17,-7
31077.0,2019-12-28,"(792.25, 986.5]",8,15,-7
31077.0,2019-12-28,"(986.5, 1180.75]",4,10,-6
31077.0,2019-12-28,"(1180.75, 1375.0]",4,4,0
,,,,2.0,
31079.0,2019-12-28,"(610.93, 628.5]",1,1,0
31080.0,2019-12-28,"(750.5, 960.0]",2,2,0
31080.0,2019-12-28,"(960.0, 1169.5]",2,4,-2
31080.0,2019-12-28,"(1169.5, 1379.0]",2,5,-3
31081.0,2019-12-28,"(464.226, 658.5]",1,2,-1
31081.0,2019-12-28,"(658.5, 852.0]",2,2,0
31081.0,2019-12-28,"(852.0, 1045.5]",1,2,-1
31081.0,2019-12-28,"(1045.5, 1239.0]",1,2,-1
31082.0,2019-12-28,"(906.75, 967.0]",2,1,1
31083.0,2019-12-28,"(439.233, 631.75]",1,2,-1
31083.0,2019-12-28,"(631.75, 823.5]",2,5,-3
31083.0,2019-12-28,"(823.5, 1015.25]",4,7,-3
31083.0,2019-12-28,"(1015.25, 1207.0]",4,4,0
31084.0,2019-12-28,"(736.495, 863.25]",2,3,-1
31084.0,2019-12-28,"(863.25, 989.5]",1,1,0
31084.0,2019-12-28,"(1115.75, 1242.0]",2,1,1
,,,,1.0,
,,,,4.0,
31086.0,2019-12-28,"(649.671, 732.25]",1,1,0
31086.0,2019-12-28,"(896.75, 979.0]",1,1,0
31087.0,2019-12-28,"(444.264, 629.0]",1,3,-2
31087.0,2019-12-28,"(629.0, 813.0]",1,1,0
31087.0,2019-12-28,"(997.0, 1181.0]",1,1,0
31088.0,2019-12-28,"(744.72, 815.0]",2,6,-4
31088.0,2019-12-28,"(885.0, 955.0]",1,1,0
31089.0,2019-12-28,"(686.25, 934.5]",2,1,1
31089.0,2019-12-28,"(934.5, 1182.75]",4,7,-3
31089.0,2019-12-28,"(1182.75, 1431.0]",3,5,-2
31090.0,2019-12-28,"(625.25, 682.5]",1,1,0
31090.0,2019-12-28,"(682.5, 739.75]",1,1,0
31090.0,2019-12-28,"(739.75, 797.0]",3,1,2
31091.0,2019-12-28,"(128.008, 377.0]",1,1,0
31091.0,2019-12-28,"(625.0, 873.0]",1,1,0
31091.0,2019-12-28,"(873.0, 1121.0]",4,2,2
31092.0,2019-12-28,"(7.211, 205.25]",1,1,0
31092.0,2019-12-28,"(599.75, 797.0]",1,2,-1
31093.0,2019-12-28,"(1093.25, 1269.0]",2,1,1
31094.0,2019-12-28,"(748.867, 782.25]",2,2,0
31094.0,2019-12-28,"(848.75, 882.0]",3,2,1
31095.0,2019-12-28,"(643.277, 824.75]",2,5,-3
31095.0,2019-12-28,"(1186.25, 1367.0]",1,1,0
31096.0,2019-12-28,"(961.25, 1047.0]",2,1,1
31097.0,2019-12-28,"(680.579, 786.25]",1,2,-1
31097.0,2019-12-28,"(786.25, 891.5]",1,1,0
31097.0,2019-12-28,"(891.5, 996.75]",2,3,-1
31098.0,2019-12-28,"(842.75, 896.5]",1,1,0
31098.0,2019-12-28,"(896.5, 950.25]",1,1,0
31098.0,2019-12-28,"(950.25, 1004.0]",5,1,4
31099.0,2019-12-28,"(669.689, 747.75]",1,2,-1
31099.0,2019-12-28,"(903.25, 981.0]",1,2,-1
31100.0,2019-12-28,"(637.212, 835.0]",4,8,-4
31100.0,2019-12-28,"(835.0, 1032.0]",1,1,0
31100.0,2019-12-28,"(1229.0, 1426.0]",4,2,2
31101.0,2019-12-28,"(21.671, 355.25]",1,5,-4
31101.0,2019-12-28,"(355.25, 687.5]",17,26,-9
31101.0,2019-12-28,"(687.5, 1019.75]",34,57,-23
31101.0,2019-12-28,"(1019.75, 1352.0]",14,23,-9
31102.0,2019-12-28,"(59.786, 364.5]",2,3,-1
31102.0,2019-12-28,"(364.5, 668.0]",1,6,-5
31102.0,2019-12-28,"(668.0, 971.5]",1,8,-7
31102.0,2019-12-28,"(971.5, 1275.0]",4,8,-4
31103.0,2019-12-28,"(486.23, 679.5]",1,6,-5
31103.0,2019-12-28,"(679.5, 872.0]",2,8,-6
31103.0,2019-12-28,"(872.0, 1064.5]",2,4,-2
31103.0,2019-12-28,"(1064.5, 1257.0]",4,10,-6
31104.0,2019-12-28,"(20.649, 359.75]",1,6,-5
31104.0,2019-12-28,"(359.75, 697.5]",7,16,-9
31104.0,2019-12-28,"(697.5, 1035.25]",10,26,-16
31104.0,2019-12-28,"(1035.25, 1373.0]",11,21,-10
31105.0,2019-12-28,"(639.5, 907.25]",2,1,1
31105.0,2019-12-28,"(907.25, 1175.0]",3,9,-6
31106.0,2019-12-28,"(721.0, 996.5]",1,2,-1
31106.0,2019-12-28,"(996.5, 1272.0]",2,2,0
31107.0,2019-12-28,"(155.734, 473.5]",2,6,-4
31107.0,2019-12-28,"(473.5, 790.0]",10,24,-14
31107.0,2019-12-28,"(790.0, 1106.5]",9,25,-16
31107.0,2019-12-28,"(1106.5, 1423.0]",3,12,-9
31108.0,2019-12-28,"(90.653, 428.75]",3,3,0
31108.0,2019-12-28,"(428.75, 765.5]",4,9,-5
31108.0,2019-12-28,"(765.5, 1102.25]",14,29,-15
31108.0,2019-12-28,"(1102.25, 1439.0]",6,7,-1
31109.0,2019-12-28,"(32.768, 342.0]",4,7,-3
31109.0,2019-12-28,"(342.0, 650.0]",5,10,-5
31109.0,2019-12-28,"(650.0, 958.0]",11,20,-9
31109.0,2019-12-28,"(958.0, 1266.0]",23,37,-14
31110.0,2019-12-28,"(409.314, 581.5]",2,4,-2
31110.0,2019-12-28,"(581.5, 753.0]",8,14,-6
31110.0,2019-12-28,"(753.0, 924.5]",3,7,-4
31110.0,2019-12-28,"(924.5, 1096.0]",4,8,-4
31111.0,2019-12-28,"(57.635, 400.25]",1,3,-2
31111.0,2019-12-28,"(400.25, 741.5]",5,11,-6
31111.0,2019-12-28,"(741.5, 1082.75]",17,25,-8
31111.0,2019-12-28,"(1082.75, 1424.0]",11,16,-5
31112.0,2019-12-28,"(669.237, 860.75]",7,13,-6
31112.0,2019-12-28,"(860.75, 1051.5]",8,14,-6
31112.0,2019-12-28,"(1051.5, 1242.25]",8,14,-6
31112.0,2019-12-28,"(1242.25, 1433.0]",1,1,0
31113.0,2019-12-28,"(95.739, 412.25]",2,2,0
31113.0,2019-12-28,"(412.25, 727.5]",7,28,-21
31113.0,2019-12-28,"(727.5, 1042.75]",3,14,-11
31113.0,2019-12-28,"(1042.75, 1358.0]",3,9,-6
31114.0,2019-12-28,"(63.75, 377.5]",1,2,-1
31114.0,2019-12-28,"(377.5, 690.0]",2,8,-6
31114.0,2019-12-28,"(690.0, 1002.5]",11,27,-16
31114.0,2019-12-28,"(1002.5, 1315.0]",10,20,-10
31115.0,2019-12-28,"(38.603, 389.25]",1,4,-3
31115.0,2019-12-28,"(389.25, 738.5]",2,9,-7
31115.0,2019-12-28,"(738.5, 1087.75]",5,11,-6
31115.0,2019-12-28,"(1087.75, 1437.0]",4,8,-4
31116.0,2019-12-28,"(151.817, 448.75]",1,1,0
31116.0,2019-12-28,"(448.75, 744.5]",3,4,-1
31116.0,2019-12-28,"(744.5, 1040.25]",11,21,-10
31116.0,2019-12-28,"(1040.25, 1336.0]",11,19,-8
31117.0,2019-12-28,"(542.75, 838.5]",2,6,-4
31117.0,2019-12-28,"(838.5, 1134.25]",3,15,-12
31117.0,2019-12-28,"(1134.25, 1430.0]",3,12,-9
31118.0,2019-12-28,"(28.621, 374.75]",1,1,0
31118.0,2019-12-28,"(374.75, 719.5]",1,14,-13
31118.0,2019-12-28,"(719.5, 1064.25]",3,12,-9
31118.0,2019-12-28,"(1064.25, 1409.0]",2,5,-3
31119.0,2019-12-28,"(8.686, 338.5]",3,4,-1
31119.0,2019-12-28,"(338.5, 667.0]",8,13,-5
31119.0,2019-12-28,"(667.0, 995.5]",12,23,-11
31119.0,2019-12-28,"(995.5, 1324.0]",2,10,-8
31120.0,2019-12-28,"(45.709, 369.75]",2,2,0
31120.0,2019-12-28,"(369.75, 692.5]",3,6,-3
31120.0,2019-12-28,"(692.5, 1015.25]",7,8,-1
31120.0,2019-12-28,"(1015.25, 1338.0]",8,13,-5
31121.0,2019-12-28,"(62.709, 386.75]",2,2,0
31121.0,2019-12-28,"(386.75, 709.5]",2,4,-2
31121.0,2019-12-28,"(709.5, 1032.25]",10,21,-11
31121.0,2019-12-28,"(1032.25, 1355.0]",6,12,-6
31122.0,2019-12-28,"(451.031, 694.25]",7,8,-1
31122.0,2019-12-28,"(694.25, 936.5]",3,14,-11
31122.0,2019-12-28,"(936.5, 1178.75]",5,9,-4
31123.0,2019-12-28,"(576.152, 789.0]",2,7,-5
31123.0,2019-12-28,"(789.0, 1001.0]",2,5,-3
31123.0,2019-12-28,"(1213.0, 1425.0]",1,2,-1
31124.0,2019-12-28,"(0.616, 348.0]",2,2,0
31124.0,2019-12-28,"(348.0, 694.0]",8,17,-9
31124.0,2019-12-28,"(694.0, 1040.0]",13,37,-24
31124.0,2019-12-28,"(1040.0, 1386.0]",14,24,-10
31125.0,2019-12-28,"(20.717, 342.75]",3,3,0
31125.0,2019-12-28,"(342.75, 663.5]",6,10,-4
31125.0,2019-12-28,"(663.5, 984.25]",20,36,-16
31125.0,2019-12-28,"(984.25, 1305.0]",12,20,-8
31126.0,2019-12-28,"(68.691, 397.25]",1,2,-1
31126.0,2019-12-28,"(397.25, 724.5]",3,10,-7
31126.0,2019-12-28,"(724.5, 1051.75]",3,13,-10
31126.0,2019-12-28,"(1051.75, 1379.0]",5,8,-3
,,,,2.0,
31128.0,2019-12-28,"(125.7, 452.0]",1,2,-1
31128.0,2019-12-28,"(452.0, 777.0]",7,21,-14
31128.0,2019-12-28,"(777.0, 1102.0]",13,25,-12
31128.0,2019-12-28,"(1102.0, 1427.0]",6,12,-6
31129.0,2019-12-28,"(562.342, 727.5]",13,25,-12
31129.0,2019-12-28,"(727.5, 892.0]",30,56,-26
31129.0,2019-12-28,"(892.0, 1056.5]",35,61,-26
31129.0,2019-12-28,"(1056.5, 1221.0]",16,28,-12
31130.0,2019-12-28,"(694.5, 1034.25]",3,1,2
31130.0,2019-12-28,"(1034.25, 1374.0]",6,3,3
31131.0,2019-12-28,"(447.027, 691.25]",2,7,-5
31131.0,2019-12-28,"(691.25, 934.5]",5,11,-6
31131.0,2019-12-28,"(934.5, 1177.75]",1,3,-2
31200.0,2019-12-28,"(3.589, 357.75]",4,5,-1
31200.0,2019-12-28,"(357.75, 710.5]",8,15,-7
31200.0,2019-12-28,"(710.5, 1063.25]",23,34,-11
31200.0,2019-12-28,"(1063.25, 1416.0]",7,14,-7
31201.0,2019-12-28,"(370.5, 726.0]",14,7,7
31201.0,2019-12-28,"(726.0, 1081.5]",47,28,19
31201.0,2019-12-28,"(1081.5, 1437.0]",5,83,-78
31202.0,2019-12-28,"(17.62, 364.0]",2,6,-4
31202.0,2019-12-28,"(364.0, 709.0]",6,11,-5
31202.0,2019-12-28,"(709.0, 1054.0]",20,35,-15
31202.0,2019-12-28,"(1054.0, 1399.0]",8,17,-9
31203.0,2019-12-28,"(38.656, 376.0]",1,2,-1
31203.0,2019-12-28,"(376.0, 712.0]",8,13,-5
31203.0,2019-12-28,"(712.0, 1048.0]",24,44,-20
31203.0,2019-12-28,"(1048.0, 1384.0]",26,39,-13
31204.0,2019-12-28,"(672.621, 767.75]",2,5,-3
31204.0,2019-12-28,"(767.75, 862.5]",9,14,-5
31205.0,2019-12-28,"(443.109, 666.75]",4,4,0
31205.0,2019-12-28,"(889.5, 1112.25]",4,2,2
31205.0,2019-12-28,"(1112.25, 1335.0]",3,8,-5
31206.0,2019-12-28,"(756.5, 806.75]",2,3,-1
31206.0,2019-12-28,"(806.75, 857.0]",7,2,5
31207.0,2019-12-28,"(547.163, 757.25]",2,4,-2
31207.0,2019-12-28,"(757.25, 966.5]",1,5,-4
31207.0,2019-12-28,"(1175.75, 1385.0]",1,1,0
31208.0,2019-12-28,"(643.338, 809.5]",4,5,-1
31208.0,2019-12-28,"(809.5, 975.0]",5,7,-2
31208.0,2019-12-28,"(1140.5, 1306.0]",2,3,-1
31209.0,2019-12-28,"(423.0, 761.0]",3,1,2
31209.0,2019-12-28,"(761.0, 1099.0]",8,5,3
31209.0,2019-12-28,"(1099.0, 1437.0]",3,12,-9
31211.0,2019-12-28,"(697.5, 1027.25]",12,1,11
31211.0,2019-12-28,"(1027.25, 1357.0]",7,3,4
31212.0,2019-12-28,"(56.654, 394.5]",1,1,0
31212.0,2019-12-28,"(394.5, 731.0]",7,13,-6
31212.0,2019-12-28,"(731.0, 1067.5]",6,10,-4
31212.0,2019-12-28,"(1067.5, 1404.0]",6,9,-3
31213.0,2019-12-28,"(454.116, 676.0]",4,7,-3
31213.0,2019-12-28,"(676.0, 897.0]",3,11,-8
31213.0,2019-12-28,"(897.0, 1118.0]",12,15,-3
31213.0,2019-12-28,"(1118.0, 1339.0]",2,3,-1
31214.0,2019-12-28,"(12.614, 360.5]",3,6,-3
31214.0,2019-12-28,"(360.5, 707.0]",13,27,-14
31214.0,2019-12-28,"(707.0, 1053.5]",18,36,-18
31214.0,2019-12-28,"(1053.5, 1400.0]",22,39,-17
31215.0,2019-12-28,"(526.176, 733.0]",10,12,-2
31215.0,2019-12-28,"(733.0, 939.0]",28,42,-14
31215.0,2019-12-28,"(939.0, 1145.0]",25,49,-24
31215.0,2019-12-28,"(1145.0, 1351.0]",5,9,-4
31216.0,2019-12-28,"(333.293, 510.75]",1,1,0
31216.0,2019-12-28,"(510.75, 687.5]",2,5,-3
31216.0,2019-12-28,"(687.5, 864.25]",5,7,-2
31216.0,2019-12-28,"(864.25, 1041.0]",6,6,0
31217.0,2019-12-28,"(771.63, 864.5]",4,6,-2
31217.0,2019-12-28,"(864.5, 957.0]",2,12,-10
31217.0,2019-12-28,"(957.0, 1049.5]",5,13,-8
31217.0,2019-12-28,"(1049.5, 1142.0]",10,19,-9
31218.0,2019-12-28,"(5.876, 288.0]",1,1,0
31218.0,2019-12-28,"(569.0, 850.0]",8,11,-3
31218.0,2019-12-28,"(850.0, 1131.0]",12,32,-20
31219.0,2019-12-28,"(543.368, 702.0]",15,15,0
31219.0,2019-12-28,"(702.0, 860.0]",14,21,-7
31219.0,2019-12-28,"(860.0, 1018.0]",25,59,-34
31219.0,2019-12-28,"(1018.0, 1176.0]",7,13,-6
31220.0,2019-12-28,"(610.5, 814.0]",3,1,2
31221.0,2019-12-28,"(50.62, 397.0]",1,3,-2
31221.0,2019-12-28,"(397.0, 742.0]",7,8,-1
31221.0,2019-12-28,"(742.0, 1087.0]",6,21,-15
31221.0,2019-12-28,"(1087.0, 1432.0]",5,7,-2
31222.0,2019-12-28,"(546.216, 743.0]",3,13,-10
31222.0,2019-12-28,"(743.0, 939.0]",5,6,-1
31222.0,2019-12-28,"(939.0, 1135.0]",18,25,-7
31222.0,2019-12-28,"(1135.0, 1331.0]",4,10,-6
31223.0,2019-12-28,"(357.5, 666.0]",4,1,3
31223.0,2019-12-28,"(666.0, 974.5]",6,7,-1
31223.0,2019-12-28,"(974.5, 1283.0]",6,11,-5
31224.0,2019-12-28,"(637.216, 834.0]",8,11,-3
31224.0,2019-12-28,"(834.0, 1030.0]",1,6,-5
31224.0,2019-12-28,"(1030.0, 1226.0]",1,1,0
31224.0,2019-12-28,"(1226.0, 1422.0]",4,4,0
31225.0,2019-12-28,"(296.024, 541.0]",1,1,0
31225.0,2019-12-28,"(541.0, 785.0]",4,10,-6
31225.0,2019-12-28,"(785.0, 1029.0]",12,23,-11
31225.0,2019-12-28,"(1029.0, 1273.0]",4,6,-2
31226.0,2019-12-28,"(694.303, 869.25]",2,6,-4
31226.0,2019-12-28,"(869.25, 1043.5]",5,10,-5
31227.0,2019-12-28,"(484.119, 705.25]",6,17,-11
31227.0,2019-12-28,"(705.25, 925.5]",4,5,-1
31227.0,2019-12-28,"(925.5, 1145.75]",5,7,-2
31227.0,2019-12-28,"(1145.75, 1366.0]",4,7,-3
31228.0,2019-12-28,"(95.731, 414.25]",1,2,-1
31228.0,2019-12-28,"(414.25, 731.5]",11,15,-4
31228.0,2019-12-28,"(731.5, 1048.75]",30,53,-23
31228.0,2019-12-28,"(1048.75, 1366.0]",16,32,-16
31229.0,2019-12-28,"(356.0, 706.0]",17,3,14
31229.0,2019-12-28,"(706.0, 1056.0]",18,35,-17
31229.0,2019-12-28,"(1056.0, 1406.0]",14,35,-21
31230.0,2019-12-28,"(588.232, 781.0]",13,18,-5
31230.0,2019-12-28,"(781.0, 973.0]",7,13,-6
31230.0,2019-12-28,"(973.0, 1165.0]",13,20,-7
31230.0,2019-12-28,"(1165.0, 1357.0]",9,15,-6
31231.0,2019-12-28,"(712.361, 872.75]",10,16,-6
31231.0,2019-12-28,"(872.75, 1032.5]",10,17,-7
31231.0,2019-12-28,"(1032.5, 1192.25]",2,6,-4
31231.0,2019-12-28,"(1192.25, 1352.0]",1,7,-6
31232.0,2019-12-28,"(85.67, 419.5]",1,3,-2
31232.0,2019-12-28,"(419.5, 752.0]",6,10,-4
31232.0,2019-12-28,"(752.0, 1084.5]",31,52,-21
31232.0,2019-12-28,"(1084.5, 1417.0]",7,10,-3
31233.0,2019-12-28,"(675.5, 1008.25]",13,2,11
31233.0,2019-12-28,"(1008.25, 1341.0]",11,1,10
31234.0,2019-12-28,"(21.801, 322.75]",2,3,-1
31234.0,2019-12-28,"(622.5, 922.25]",8,12,-4
31234.0,2019-12-28,"(922.25, 1222.0]",16,13,3
31235.0,2019-12-28,"(639.478, 770.5]",4,15,-11
31235.0,2019-12-28,"(770.5, 901.0]",5,15,-10
31235.0,2019-12-28,"(901.0, 1031.5]",18,31,-13
31235.0,2019-12-28,"(1031.5, 1162.0]",10,16,-6
31236.0,2019-12-28,"(386.353, 548.75]",3,3,0
31236.0,2019-12-28,"(548.75, 710.5]",2,3,-1
31236.0,2019-12-28,"(710.5, 872.25]",1,8,-7
31236.0,2019-12-28,"(872.25, 1034.0]",4,6,-2
31237.0,2019-12-28,"(573.36, 734.0]",2,8,-6
31237.0,2019-12-28,"(734.0, 894.0]",2,8,-6
31237.0,2019-12-28,"(894.0, 1054.0]",11,14,-3
31237.0,2019-12-28,"(1054.0, 1214.0]",4,7,-3
31238.0,2019-12-28,"(55.642, 396.5]",1,1,0
31238.0,2019-12-28,"(396.5, 736.0]",4,9,-5
31238.0,2019-12-28,"(736.0, 1075.5]",14,23,-9
31238.0,2019-12-28,"(1075.5, 1415.0]",4,7,-3
31239.0,2019-12-28,"(46.672, 380.0]",2,3,-1
31239.0,2019-12-28,"(380.0, 712.0]",2,4,-2
31239.0,2019-12-28,"(712.0, 1044.0]",10,17,-7
31239.0,2019-12-28,"(1044.0, 1376.0]",11,16,-5
31240.0,2019-12-28,"(537.245, 726.75]",8,15,-7
31240.0,2019-12-28,"(726.75, 915.5]",32,65,-33
31240.0,2019-12-28,"(915.5, 1104.25]",22,34,-12
31240.0,2019-12-28,"(1104.25, 1293.0]",2,4,-2
31241.0,2019-12-28,"(128.768, 438.0]",1,2,-1
31241.0,2019-12-28,"(438.0, 746.0]",5,30,-25
31241.0,2019-12-28,"(746.0, 1054.0]",9,19,-10
31241.0,2019-12-28,"(1054.0, 1362.0]",2,7,-5
31242.0,2019-12-28,"(349.166, 558.5]",1,1,0
31242.0,2019-12-28,"(558.5, 767.0]",1,7,-6
31242.0,2019-12-28,"(767.0, 975.5]",2,7,-5
31242.0,2019-12-28,"(975.5, 1184.0]",5,10,-5
31243.0,2019-12-28,"(252.835, 545.25]",1,1,0
31243.0,2019-12-28,"(545.25, 836.5]",12,37,-25
31243.0,2019-12-28,"(836.5, 1127.75]",23,35,-12
31243.0,2019-12-28,"(1127.75, 1419.0]",4,8,-4
31244.0,2019-12-28,"(434.137, 650.75]",5,8,-3
31244.0,2019-12-28,"(650.75, 866.5]",1,10,-9
31244.0,2019-12-28,"(866.5, 1082.25]",5,5,0
31244.0,2019-12-28,"(1082.25, 1298.0]",3,4,-1
31245.0,2019-12-28,"(357.0, 713.0]",4,1,3
31245.0,2019-12-28,"(713.0, 1069.0]",12,11,1
31245.0,2019-12-28,"(1069.0, 1425.0]",18,20,-2
31246.0,2019-12-28,"(14.612, 363.0]",1,1,0
31246.0,2019-12-28,"(363.0, 710.0]",9,13,-4
31246.0,2019-12-28,"(710.0, 1057.0]",49,75,-26
31246.0,2019-12-28,"(1057.0, 1404.0]",5,12,-7
31247.0,2019-12-28,"(392.215, 589.25]",8,11,-3
31247.0,2019-12-28,"(589.25, 785.5]",36,67,-31
31247.0,2019-12-28,"(785.5, 981.75]",61,127,-66
31247.0,2019-12-28,"(981.75, 1178.0]",48,99,-51
31248.0,2019-12-28,"(441.056, 678.0]",14,24,-10
31248.0,2019-12-28,"(678.0, 914.0]",37,82,-45
31248.0,2019-12-28,"(914.0, 1150.0]",53,98,-45
31248.0,2019-12-28,"(1150.0, 1386.0]",11,19,-8
31249.0,2019-12-28,"(560.31, 733.5]",20,41,-21
31249.0,2019-12-28,"(733.5, 906.0]",35,66,-31
31249.0,2019-12-28,"(906.0, 1078.5]",36,69,-33
31249.0,2019-12-28,"(1078.5, 1251.0]",5,9,-4
31250.0,2019-12-28,"(478.483, 608.25]",1,2,-1
31250.0,2019-12-28,"(608.25, 737.5]",3,3,0
31250.0,2019-12-28,"(866.75, 996.0]",5,3,2
31251.0,2019-12-28,"(12.605, 362.75]",7,7,0
31251.0,2019-12-28,"(711.5, 1060.25]",8,7,1
31251.0,2019-12-28,"(1060.25, 1409.0]",3,18,-15
31252.0,2019-12-28,"(672.35, 835.5]",1,3,-2
31252.0,2019-12-28,"(835.5, 998.0]",3,4,-1
31252.0,2019-12-28,"(998.0, 1160.5]",1,1,0
31252.0,2019-12-28,"(1160.5, 1323.0]",3,6,-3
31253.0,2019-12-28,"(465.039, 706.25]",1,1,0
31253.0,2019-12-28,"(706.25, 946.5]",2,5,-3
31253.0,2019-12-28,"(946.5, 1186.75]",4,8,-4
31254.0,2019-12-28,"(449.75, 754.5]",2,1,1
31254.0,2019-12-28,"(754.5, 1059.25]",9,6,3
31254.0,2019-12-28,"(1059.25, 1364.0]",7,15,-8
31255.0,2019-12-28,"(103.685, 433.75]",1,1,0
31255.0,2019-12-28,"(762.5, 1091.25]",9,7,2
31255.0,2019-12-28,"(1091.25, 1420.0]",1,10,-9
31256.0,2019-12-28,"(26.738, 343.5]",1,2,-1
31256.0,2019-12-28,"(659.0, 974.5]",20,40,-20
31256.0,2019-12-28,"(974.5, 1290.0]",9,19,-10
31257.0,2019-12-28,"(189.873, 472.75]",1,3,-2
31257.0,2019-12-28,"(472.75, 754.5]",2,2,0
31257.0,2019-12-28,"(754.5, 1036.25]",6,9,-3
31257.0,2019-12-28,"(1036.25, 1318.0]",10,14,-4
31258.0,2019-12-28,"(408.139, 624.25]",13,25,-12
31258.0,2019-12-28,"(624.25, 839.5]",74,171,-97
31258.0,2019-12-28,"(839.5, 1054.75]",76,166,-90
31258.0,2019-12-28,"(1054.75, 1270.0]",27,44,-17
31259.0,2019-12-28,"(758.392, 911.0]",2,5,-3
31260.0,2019-12-28,"(664.418, 810.5]",5,11,-6
31260.0,2019-12-28,"(810.5, 956.0]",6,15,-9
31260.0,2019-12-28,"(956.0, 1101.5]",10,14,-4
31260.0,2019-12-28,"(1101.5, 1247.0]",2,3,-1
31261.0,2019-12-28,"(763.25, 911.5]",8,1,7
31261.0,2019-12-28,"(911.5, 1059.75]",2,13,-11
31261.0,2019-12-28,"(1059.75, 1208.0]",5,9,-4
31262.0,2019-12-28,"(816.555, 928.25]",2,2,0
31262.0,2019-12-28,"(1039.5, 1150.75]",2,4,-2
31262.0,2019-12-28,"(1150.75, 1262.0]",4,4,0
31263.0,2019-12-28,"(3.632, 347.0]",1,2,-1
31263.0,2019-12-28,"(347.0, 689.0]",3,10,-7
31263.0,2019-12-28,"(689.0, 1031.0]",22,32,-10
31263.0,2019-12-28,"(1031.0, 1373.0]",7,17,-10
31264.0,2019-12-28,"(644.243, 834.25]",16,19,-3
31264.0,2019-12-28,"(834.25, 1023.5]",8,17,-9
31264.0,2019-12-28,"(1023.5, 1212.75]",11,12,-1
31265.0,2019-12-28,"(478.043, 718.25]",5,8,-3
31265.0,2019-12-28,"(718.25, 957.5]",2,11,-9
31265.0,2019-12-28,"(957.5, 1196.75]",5,9,-4
31265.0,2019-12-28,"(1196.75, 1436.0]",2,3,-1
31266.0,2019-12-28,"(-0.349, 338.25]",3,8,-5
31266.0,2019-12-28,"(338.25, 675.5]",4,9,-5
31266.0,2019-12-28,"(675.5, 1012.75]",14,28,-14
31266.0,2019-12-28,"(1012.75, 1350.0]",7,19,-12
31267.0,2019-12-28,"(52.641, 393.75]",1,1,0
31267.0,2019-12-28,"(393.75, 733.5]",1,7,-6
31267.0,2019-12-28,"(733.5, 1073.25]",7,18,-11
31267.0,2019-12-28,"(1073.25, 1413.0]",5,9,-4
31268.0,2019-12-28,"(41.663, 377.25]",2,3,-1
31268.0,2019-12-28,"(377.25, 711.5]",6,13,-7
31268.0,2019-12-28,"(711.5, 1045.75]",17,31,-14
31268.0,2019-12-28,"(1045.75, 1380.0]",10,14,-4
31269.0,2019-12-28,"(371.343, 536.25]",1,2,-1
31269.0,2019-12-28,"(536.25, 700.5]",3,11,-8
31269.0,2019-12-28,"(700.5, 864.75]",4,12,-8
31269.0,2019-12-28,"(864.75, 1029.0]",3,15,-12
31270.0,2019-12-28,"(570.155, 782.25]",5,7,-2
31270.0,2019-12-28,"(782.25, 993.5]",13,25,-12
31270.0,2019-12-28,"(993.5, 1204.75]",10,21,-11
31271.0,2019-12-28,"(361.0, 695.0]",10,1,9
31271.0,2019-12-28,"(695.0, 1029.0]",37,15,22
31271.0,2019-12-28,"(1029.0, 1363.0]",26,84,-58
31272.0,2019-12-28,"(565.374, 722.5]",16,16,0
31272.0,2019-12-28,"(722.5, 879.0]",28,37,-9
31272.0,2019-12-28,"(879.0, 1035.5]",16,35,-19
31272.0,2019-12-28,"(1035.5, 1192.0]",3,6,-3
31273.0,2019-12-28,"(683.677, 764.75]",1,2,-1
31273.0,2019-12-28,"(764.75, 845.5]",7,12,-5
31273.0,2019-12-28,"(845.5, 926.25]",4,9,-5
31273.0,2019-12-28,"(926.25, 1007.0]",7,13,-6
31274.0,2019-12-28,"(582.295, 759.25]",4,12,-8
31274.0,2019-12-28,"(759.25, 935.5]",8,11,-3
31274.0,2019-12-28,"(935.5, 1111.75]",8,12,-4
31274.0,2019-12-28,"(1111.75, 1288.0]",3,3,0
31275.0,2019-12-28,"(35.674, 368.5]",2,2,0
31275.0,2019-12-28,"(368.5, 700.0]",2,5,-3
31275.0,2019-12-28,"(700.0, 1031.5]",11,18,-7
31275.0,2019-12-28,"(1031.5, 1363.0]",5,13,-8
31276.0,2019-12-28,"(963.25, 1255.0]",1,1,0
31277.0,2019-12-28,"(554.142, 769.5]",10,18,-8
31277.0,2019-12-28,"(769.5, 984.0]",53,85,-32
31277.0,2019-12-28,"(984.0, 1198.5]",4,7,-3
31277.0,2019-12-28,"(1198.5, 1413.0]",1,2,-1
31278.0,2019-12-28,"(14.784, 320.0]",1,4,-3
31278.0,2019-12-28,"(320.0, 624.0]",3,8,-5
31278.0,2019-12-28,"(624.0, 928.0]",5,10,-5
31278.0,2019-12-28,"(928.0, 1232.0]",7,17,-10
31279.0,2019-12-28,"(592.211, 790.25]",1,8,-7
31279.0,2019-12-28,"(1184.75, 1382.0]",2,2,0
31280.0,2019-12-28,"(451.271, 634.25]",4,9,-5
31280.0,2019-12-28,"(634.25, 816.5]",2,9,-7
31280.0,2019-12-28,"(816.5, 998.75]",4,10,-6
31280.0,2019-12-28,"(998.75, 1181.0]",3,7,-4
31000.0,2019-12-29,"(411.75, 549.0]",1,1,0
31001.0,2019-12-29,"(316.25, 632.5]",1,1,0
31001.0,2019-12-29,"(948.75, 1265.0]",2,1,1
,,,,2.0,
31003.0,2019-12-29,"(286.75, 573.5]",2,1,1
31003.0,2019-12-29,"(860.25, 1147.0]",2,2,0
,,,,2.0,
31005.0,2019-12-29,"(543.0, 724.0]",1,1,0
31006.0,2019-12-29,"(541.929, 559.75]",1,1,0
31007.0,2019-12-29,"(613.77, 671.5]",2,2,0
,,,,2.0,
31010.0,2019-12-29,"(477.539, 593.25]",1,5,-4
31010.0,2019-12-29,"(593.25, 708.5]",1,2,-1
31011.0,2019-12-29,"(506.088, 735.0]",1,2,-1
31012.0,2019-12-29,"(1040.992, 1043.0]",1,1,0
31013.0,2019-12-29,"(485.767, 544.25]",2,2,0
31013.0,2019-12-29,"(544.25, 602.5]",1,3,-2
31013.0,2019-12-29,"(660.75, 719.0]",1,2,-1
31014.0,2019-12-29,"(18.88, 300.0]",1,1,0
31014.0,2019-12-29,"(300.0, 580.0]",2,2,0
31014.0,2019-12-29,"(860.0, 1140.0]",1,2,-1
31015.0,2019-12-29,"(297.5, 595.0]",1,1,0
31015.0,2019-12-29,"(595.0, 892.5]",2,1,1
31015.0,2019-12-29,"(892.5, 1190.0]",1,2,-1
31016.0,2019-12-29,"(834.647, 923.25]",1,1,0
,,,,2.0,
31018.0,2019-12-29,"(879.0, 1172.0]",1,1,0
,,,,1.0,
,,,,1.0,
,,,,2.0,
,,,,1.0,
,,,,1.0,
31022.0,2019-12-29,"(268.5, 483.0]",1,2,-1
31022.0,2019-12-29,"(483.0, 697.5]",1,1,0
31023.0,2019-12-29,"(838.75, 1086.0]",2,2,0
31024.0,2019-12-29,"(9.005, 258.75]",1,2,-1
31024.0,2019-12-29,"(756.25, 1005.0]",1,1,0
31025.0,2019-12-29,"(1052.25, 1403.0]",1,1,0
31026.0,2019-12-29,"(771.0, 1028.0]",1,1,0
,,,,2.0,
,,,,1.0,
,,,,1.0,
,,,,1.0,
,,,,1.0,
,,,,2.0,
31031.0,2019-12-29,"(1029.0, 1372.0]",1,1,0
,,,,2.0,
,,,,2.0,
31034.0,2019-12-29,"(587.0, 609.0]",1,1,0
,,,,2.0,
,,,,1.0,
,,,,1.0,
31037.0,2019-12-29,"(375.5, 717.0]",1,1,0
,,,,1.0,
,,,,1.0,
31039.0,2019-12-29,"(129.163, 339.25]",1,1,0
31039.0,2019-12-29,"(757.75, 967.0]",2,3,-1
,,,,1.0,
,,,,1.0,
,,,,3.0,
,,,,2.0,
31042.0,2019-12-29,"(369.75, 493.0]",1,1,0
,,,,2.0,
,,,,2.0,
,,,,2.0,
,,,,2.0,
31047.0,2019-12-29,"(481.184, 686.0]",1,2,-1
31048.0,2019-12-29,"(449.25, 599.0]",2,1,1
31049.0,2019-12-29,"(35.797, 337.75]",1,1,0
31050.0,2019-12-29,"(42.75, 57.0]",1,1,0
31051.0,2019-12-29,"(852.967, 861.25]",1,1,0
31052.0,2019-12-29,"(1047.75, 1051.0]",1,1,0
,,,,1.0,
,,,,1.0,
,,,,2.0,
,,,,1.0,
,,,,1.0,
31056.0,2019-12-29,"(-1.212, 303.0]",3,4,-1
31056.0,2019-12-29,"(909.0, 1212.0]",1,1,0
,,,,2.0,
,,,,2.0,
31059.0,2019-12-29,"(699.0, 932.0]",1,1,0
31060.0,2019-12-29,"(482.25, 643.0]",1,1,0
31061.0,2019-12-29,"(418.5, 558.0]",1,1,0
31062.0,2019-12-29,"(471.0, 628.0]",1,1,0
31063.0,2019-12-29,"(1426.75, 1429.0]",1,1,0
31064.0,2019-12-29,"(436.306, 610.5]",2,5,-3
31064.0,2019-12-29,"(610.5, 784.0]",1,2,-1
,,,,2.0,
,,,,2.0,
31067.0,2019-12-29,"(7.399, 158.25]",1,1,0
31067.0,2019-12-29,"(458.75, 609.0]",1,2,-1
,,,,2.0,
,,,,1.0,
,,,,1.0,
31070.0,2019-12-29,"(589.327, 758.25]",1,2,-1
31070.0,2019-12-29,"(926.5, 1094.75]",1,1,0
31070.0,2019-12-29,"(1094.75, 1263.0]",1,1,0
31071.0,2019-12-29,"(500.498, 626.5]",3,5,-2
31072.0,2019-12-29,"(587.75, 594.0]",1,1,0
,,,,2.0,
31074.0,2019-12-29,"(470.833, 512.75]",1,2,-1
31074.0,2019-12-29,"(596.25, 638.0]",1,2,-1
,,,,2.0,
31076.0,2019-12-29,"(570.983, 575.25]",1,1,0
31077.0,2019-12-29,"(539.191, 742.25]",4,6,-2
31077.0,2019-12-29,"(742.25, 944.5]",2,3,-1
31077.0,2019-12-29,"(1146.75, 1349.0]",1,1,0
,,,,2.0,
31079.0,2019-12-29,"(821.25, 888.0]",1,1,0
31080.0,2019-12-29,"(591.278, 772.5]",1,3,-2
31080.0,2019-12-29,"(1133.5, 1314.0]",1,1,0
,,,,1.0,
,,,,1.0,
,,,,2.0,
,,,,2.0,
31084.0,2019-12-29,"(195.6, 296.0]",2,4,-2
,,,,1.0,
,,,,2.0,
,,,,1.0,
,,,,1.0,
,,,,2.0,
31088.0,2019-12-29,"(793.75, 858.0]",2,2,0
31089.0,2019-12-29,"(67.647, 407.25]",1,1,0
31089.0,2019-12-29,"(745.5, 1083.75]",1,1,0
,,,,1.0,
,,,,1.0,
,,,,2.0,
31092.0,2019-12-29,"(937.662, 1022.5]",1,1,0
,,,,2.0,
31094.0,2019-12-29,"(614.25, 819.0]",1,1,0
,,,,2.0,
31096.0,2019-12-29,"(1208.951, 1221.25]",1,1,0
31097.0,2019-12-29,"(636.0, 848.0]",1,1,0
,,,,1.0,
,,,,1.0,
,,,,2.0,
31100.0,2019-12-29,"(1108.674, 1190.5]",1,1,0
31101.0,2019-12-29,"(145.77, 454.5]",2,4,-2
31101.0,2019-12-29,"(454.5, 762.0]",7,10,-3
31101.0,2019-12-29,"(762.0, 1069.5]",6,6,0
31101.0,2019-12-29,"(1069.5, 1377.0]",3,5,-2
31102.0,2019-12-29,"(100.669, 434.75]",1,2,-1
31102.0,2019-12-29,"(1100.25, 1433.0]",2,6,-4
31103.0,2019-12-29,"(94.726, 414.5]",1,1,0
31103.0,2019-12-29,"(414.5, 733.0]",4,8,-4
31103.0,2019-12-29,"(733.0, 1051.5]",1,4,-3
31103.0,2019-12-29,"(1051.5, 1370.0]",2,9,-7
31104.0,2019-12-29,"(43.671, 377.25]",1,3,-2
31104.0,2019-12-29,"(377.25, 709.5]",2,10,-8
31104.0,2019-12-29,"(709.5, 1041.75]",2,4,-2
31104.0,2019-12-29,"(1041.75, 1374.0]",2,3,-1
31105.0,2019-12-29,"(47.731, 366.25]",1,1,0
31105.0,2019-12-29,"(1000.75, 1318.0]",1,1,0
31106.0,2019-12-29,"(798.5, 993.25]",1,1,0
31106.0,2019-12-29,"(993.25, 1188.0]",2,1,1
31107.0,2019-12-29,"(55.954, 318.5]",3,3,0
31107.0,2019-12-29,"(318.5, 580.0]",1,5,-4
31107.0,2019-12-29,"(580.0, 841.5]",2,6,-4
31107.0,2019-12-29,"(841.5, 1103.0]",4,9,-5
31108.0,2019-12-29,"(425.259, 611.25]",1,6,-5
31108.0,2019-12-29,"(796.5, 981.75]",1,2,-1
31108.0,2019-12-29,"(981.75, 1167.0]",3,4,-1
31109.0,2019-12-29,"(10.635, 353.25]",1,5,-4
31109.0,2019-12-29,"(353.25, 694.5]",3,6,-3
31109.0,2019-12-29,"(694.5, 1035.75]",2,5,-3
31109.0,2019-12-29,"(1035.75, 1377.0]",3,6,-3
31110.0,2019-12-29,"(14.791, 318.25]",1,3,-2
31110.0,2019-12-29,"(318.25, 620.5]",5,8,-3
31110.0,2019-12-29,"(922.75, 1225.0]",3,9,-6
31111.0,2019-12-29,"(4.659, 341.25]",1,5,-4
31111.0,2019-12-29,"(341.25, 676.5]",2,4,-2
31111.0,2019-12-29,"(676.5, 1011.75]",2,4,-2
31111.0,2019-12-29,"(1011.75, 1347.0]",6,8,-2
31112.0,2019-12-29,"(608.263, 793.25]",2,2,0
31112.0,2019-12-29,"(1161.75, 1346.0]",2,1,1
31113.0,2019-12-29,"(31.665, 366.75]",3,3,0
31113.0,2019-12-29,"(366.75, 700.5]",1,4,-3
31113.0,2019-12-29,"(700.5, 1034.25]",1,2,-1
31113.0,2019-12-29,"(1034.25, 1368.0]",1,4,-3
31114.0,2019-12-29,"(64.724, 385.0]",1,3,-2
31114.0,2019-12-29,"(385.0, 704.0]",1,6,-5
31114.0,2019-12-29,"(704.0, 1023.0]",1,5,-4
31114.0,2019-12-29,"(1023.0, 1342.0]",2,4,-2
31115.0,2019-12-29,"(62.634, 405.5]",1,2,-1
31115.0,2019-12-29,"(405.5, 747.0]",2,9,-7
31115.0,2019-12-29,"(747.0, 1088.5]",1,2,-1
31115.0,2019-12-29,"(1088.5, 1430.0]",1,2,-1
31116.0,2019-12-29,"(2.748, 317.0]",1,2,-1
31116.0,2019-12-29,"(317.0, 630.0]",1,2,-1
31116.0,2019-12-29,"(630.0, 943.0]",2,7,-5
31116.0,2019-12-29,"(943.0, 1256.0]",2,3,-1
31117.0,2019-12-29,"(468.213, 665.75]",2,9,-7
31117.0,2019-12-29,"(862.5, 1059.25]",2,5,-3
31117.0,2019-12-29,"(1059.25, 1256.0]",2,3,-1
31118.0,2019-12-29,"(44.681, 375.75]",2,3,-1
31118.0,2019-12-29,"(375.75, 705.5]",2,5,-3
31118.0,2019-12-29,"(705.5, 1035.25]",1,2,-1
31118.0,2019-12-29,"(1035.25, 1365.0]",2,3,-1
31119.0,2019-12-29,"(50.631, 394.25]",3,3,0
31119.0,2019-12-29,"(394.25, 736.5]",4,11,-7
31119.0,2019-12-29,"(736.5, 1078.75]",2,3,-1
31119.0,2019-12-29,"(1078.75, 1421.0]",4,5,-1
31120.0,2019-12-29,"(700.5, 1034.75]",1,3,-2
31120.0,2019-12-29,"(1034.75, 1369.0]",2,1,1
31121.0,2019-12-29,"(590.609, 688.75]",1,2,-1
31121.0,2019-12-29,"(884.25, 982.0]",1,2,-1
31122.0,2019-12-29,"(403.0, 727.0]",1,1,0
31122.0,2019-12-29,"(1051.0, 1375.0]",2,2,0
31123.0,2019-12-29,"(139.783, 445.25]",1,3,-2
31123.0,2019-12-29,"(445.25, 749.5]",1,4,-3
31124.0,2019-12-29,"(3.802, 304.5]",2,5,-3
31124.0,2019-12-29,"(304.5, 604.0]",4,9,-5
31124.0,2019-12-29,"(604.0, 903.5]",4,12,-8
31124.0,2019-12-29,"(903.5, 1203.0]",4,8,-4
31125.0,2019-12-29,"(9.835, 302.25]",2,4,-2
31125.0,2019-12-29,"(302.25, 593.5]",2,4,-2
31125.0,2019-12-29,"(593.5, 884.75]",5,5,0
31125.0,2019-12-29,"(884.75, 1176.0]",1,4,-3
31126.0,2019-12-29,"(555.5, 832.25]",1,1,0
31126.0,2019-12-29,"(832.25, 1109.0]",3,2,1
,,,,2.0,
31128.0,2019-12-29,"(348.962, 609.5]",3,9,-6
31128.0,2019-12-29,"(609.5, 869.0]",1,4,-3
31128.0,2019-12-29,"(869.0, 1128.5]",4,6,-2
31128.0,2019-12-29,"(1128.5, 1388.0]",1,3,-2
31129.0,2019-12-29,"(85.913, 358.75]",2,3,-1
31129.0,2019-12-29,"(358.75, 630.5]",7,11,-4
31129.0,2019-12-29,"(902.25, 1174.0]",1,2,-1
31130.0,2019-12-29,"(201.969, 460.75]",1,2,-1
31130.0,2019-12-29,"(460.75, 718.5]",2,4,-2
31130.0,2019-12-29,"(718.5, 976.25]",3,5,-2
31130.0,2019-12-29,"(976.25, 1234.0]",1,1,0
31131.0,2019-12-29,"(461.0, 602.0]",2,1,1
31200.0,2019-12-29,"(110.681, 441.75]",3,3,0
31200.0,2019-12-29,"(441.75, 771.5]",18,23,-5
31200.0,2019-12-29,"(771.5, 1101.25]",3,6,-3
31200.0,2019-12-29,"(1101.25, 1431.0]",5,8,-3
31201.0,2019-12-29,"(111.815, 409.25]",1,2,-1
31201.0,2019-12-29,"(409.25, 705.5]",16,22,-6
31201.0,2019-12-29,"(705.5, 1001.75]",5,11,-6
31201.0,2019-12-29,"(1001.75, 1298.0]",8,14,-6
31202.0,2019-12-29,"(511.097, 737.75]",6,13,-7
31202.0,2019-12-29,"(737.75, 963.5]",1,3,-2
31202.0,2019-12-29,"(963.5, 1189.25]",4,6,-2
31203.0,2019-12-29,"(9.61, 358.5]",2,5,-3
31203.0,2019-12-29,"(358.5, 706.0]",5,10,-5
31203.0,2019-12-29,"(706.0, 1053.5]",4,7,-3
31203.0,2019-12-29,"(1053.5, 1401.0]",6,11,-5
,,,,1.0,
,,,,1.0,
31205.0,2019-12-29,"(356.25, 475.0]",1,1,0
,,,,2.0,
,,,,1.0,
,,,,1.0,
31208.0,2019-12-29,"(24.877, 306.75]",1,1,0
31208.0,2019-12-29,"(587.5, 868.25]",2,2,0
31208.0,2019-12-29,"(868.25, 1149.0]",1,3,-2
31209.0,2019-12-29,"(575.5, 863.25]",1,1,0
31209.0,2019-12-29,"(863.25, 1151.0]",2,1,1
31211.0,2019-12-29,"(591.75, 789.0]",1,1,0
31212.0,2019-12-29,"(46.637, 388.75]",3,3,0
31212.0,2019-12-29,"(388.75, 729.5]",9,17,-8
31212.0,2019-12-29,"(729.5, 1070.25]",7,9,-2
31213.0,2019-12-29,"(553.136, 770.0]",3,4,-1
31213.0,2019-12-29,"(1202.0, 1418.0]",1,1,0
31214.0,2019-12-29,"(22.61, 371.5]",2,4,-2
31214.0,2019-12-29,"(371.5, 719.0]",6,13,-7
31214.0,2019-12-29,"(719.0, 1066.5]",5,9,-4
31214.0,2019-12-29,"(1066.5, 1414.0]",8,11,-3
31215.0,2019-12-29,"(268.0, 518.0]",1,1,0
31215.0,2019-12-29,"(768.0, 1018.0]",2,1,1
31216.0,2019-12-29,"(529.18, 735.0]",4,7,-3
31217.0,2019-12-29,"(464.25, 619.0]",2,1,1
31218.0,2019-12-29,"(610.0, 636.0]",4,1,3
,,,,1.0,
,,,,2.0,
,,,,1.0,
,,,,1.0,
31221.0,2019-12-29,"(1.866, 286.5]",1,2,-1
31221.0,2019-12-29,"(286.5, 570.0]",3,3,0
31221.0,2019-12-29,"(570.0, 853.5]",2,3,-1
31221.0,2019-12-29,"(853.5, 1137.0]",1,2,-1
31222.0,2019-12-29,"(169.635, 261.25]",2,4,-2
31222.0,2019-12-29,"(352.5, 443.75]",2,3,-1
31222.0,2019-12-29,"(443.75, 535.0]",1,1,0
31223.0,2019-12-29,"(261.75, 461.5]",1,2,-1
31223.0,2019-12-29,"(661.25, 861.0]",1,1,0
31224.0,2019-12-29,"(682.589, 785.75]",2,7,-5
31225.0,2019-12-29,"(18.598, 370.5]",1,2,-1
31225.0,2019-12-29,"(370.5, 721.0]",3,3,0
31225.0,2019-12-29,"(721.0, 1071.5]",1,1,0
31225.0,2019-12-29,"(1071.5, 1422.0]",1,2,-1
,,,,1.0,
,,,,1.0,
31227.0,2019-12-29,"(331.75, 645.5]",2,1,1
31227.0,2019-12-29,"(959.25, 1273.0]",1,4,-3
31228.0,2019-12-29,"(42.824, 338.0]",1,2,-1
31228.0,2019-12-29,"(338.0, 632.0]",4,8,-4
31228.0,2019-12-29,"(632.0, 926.0]",7,13,-6
31228.0,2019-12-29,"(926.0, 1220.0]",2,8,-6
31229.0,2019-12-29,"(15.624, 361.0]",3,4,-1
31229.0,2019-12-29,"(361.0, 705.0]",8,20,-12
31229.0,2019-12-29,"(705.0, 1049.0]",8,18,-10
31229.0,2019-12-29,"(1049.0, 1393.0]",2,11,-9
31230.0,2019-12-29,"(351.016, 598.0]",2,4,-2
31230.0,2019-12-29,"(598.0, 844.0]",4,5,-1
31230.0,2019-12-29,"(844.0, 1090.0]",2,2,0
31230.0,2019-12-29,"(1090.0, 1336.0]",2,4,-2
31231.0,2019-12-29,"(787.0, 887.5]",1,1,0
31231.0,2019-12-29,"(887.5, 988.0]",1,1,0
31232.0,2019-12-29,"(111.731, 430.25]",1,3,-2
31232.0,2019-12-29,"(430.25, 747.5]",5,5,0
31232.0,2019-12-29,"(747.5, 1064.75]",1,1,0
31232.0,2019-12-29,"(1064.75, 1382.0]",1,1,0
31233.0,2019-12-29,"(536.505, 660.75]",2,2,0
31233.0,2019-12-29,"(908.25, 1032.0]",2,4,-2
31234.0,2019-12-29,"(466.501, 591.75]",1,2,-1
31234.0,2019-12-29,"(716.5, 841.25]",1,3,-2
31234.0,2019-12-29,"(841.25, 966.0]",1,2,-1
31235.0,2019-12-29,"(533.5, 549.25]",1,2,-1
31236.0,2019-12-29,"(570.542, 685.5]",1,2,-1
31236.0,2019-12-29,"(914.5, 1029.0]",2,4,-2
31237.0,2019-12-29,"(619.75, 890.5]",3,1,2
31237.0,2019-12-29,"(1161.25, 1432.0]",1,4,-3
31238.0,2019-12-29,"(66.766, 376.5]",2,2,0
31238.0,2019-12-29,"(376.5, 685.0]",1,7,-6
31238.0,2019-12-29,"(685.0, 993.5]",1,1,0
31238.0,2019-12-29,"(993.5, 1302.0]",1,2,-1
31239.0,2019-12-29,"(32.984, 288.0]",2,5,-3
31239.0,2019-12-29,"(288.0, 542.0]",1,2,-1
31239.0,2019-12-29,"(542.0, 796.0]",3,6,-3
31239.0,2019-12-29,"(796.0, 1050.0]",2,3,-1
31240.0,2019-12-29,"(432.549, 545.75]",1,2,-1
31240.0,2019-12-29,"(545.75, 658.5]",1,1,0
31241.0,2019-12-29,"(372.5, 627.0]",2,1,1
31241.0,2019-12-29,"(881.5, 1136.0]",5,7,-2
31242.0,2019-12-29,"(451.528, 570.0]",2,5,-3
31242.0,2019-12-29,"(570.0, 688.0]",2,2,0
31242.0,2019-12-29,"(688.0, 806.0]",1,1,0
31243.0,2019-12-29,"(339.0, 605.0]",2,2,0
31243.0,2019-12-29,"(605.0, 871.0]",6,4,2
31243.0,2019-12-29,"(871.0, 1137.0]",2,7,-5
31244.0,2019-12-29,"(30.764, 341.0]",1,1,0
31244.0,2019-12-29,"(341.0, 650.0]",3,8,-5
31244.0,2019-12-29,"(650.0, 959.0]",1,1,0
31244.0,2019-12-29,"(959.0, 1268.0]",1,2,-1
31245.0,2019-12-29,"(14.82, 311.0]",2,4,-2
31245.0,2019-12-29,"(311.0, 606.0]",1,1,0
31245.0,2019-12-29,"(606.0, 901.0]",1,2,-1
31245.0,2019-12-29,"(901.0, 1196.0]",1,5,-4
31246.0,2019-12-29,"(133.107, 357.25]",1,2,-1
31246.0,2019-12-29,"(357.25, 580.5]",1,3,-2
31246.0,2019-12-29,"(580.5, 803.75]",4,5,-1
31246.0,2019-12-29,"(803.75, 1027.0]",3,5,-2
31247.0,2019-12-29,"(492.464, 627.0]",11,17,-6
31247.0,2019-12-29,"(761.0, 895.0]",2,2,0
31247.0,2019-12-29,"(895.0, 1029.0]",5,5,0
31248.0,2019-12-29,"(523.5, 777.25]",8,2,6
31248.0,2019-12-29,"(777.25, 1031.0]",5,11,-6
31249.0,2019-12-29,"(460.496, 587.0]",1,5,-4
31249.0,2019-12-29,"(587.0, 713.0]",1,2,-1
31249.0,2019-12-29,"(839.0, 965.0]",1,2,-1
31250.0,2019-12-29,"(427.422, 572.5]",1,3,-2
31250.0,2019-12-29,"(861.5, 1006.0]",3,3,0
31251.0,2019-12-29,"(18.77, 327.5]",2,2,0
31251.0,2019-12-29,"(942.5, 1250.0]",2,3,-1
31252.0,2019-12-29,"(562.617, 658.75]",1,1,0
31253.0,2019-12-29,"(376.5, 564.75]",1,1,0
31253.0,2019-12-29,"(564.75, 753.0]",4,1,3
31254.0,2019-12-29,"(395.75, 599.5]",2,1,1
31255.0,2019-12-29,"(502.073, 734.75]",2,8,-6
31255.0,2019-12-29,"(1198.25, 1430.0]",1,2,-1
31256.0,2019-12-29,"(472.0, 701.5]",1,1,0
31256.0,2019-12-29,"(701.5, 931.0]",1,1,0
31257.0,2019-12-29,"(456.437, 597.75]",3,5,-2
31257.0,2019-12-29,"(597.75, 738.5]",2,2,0
31257.0,2019-12-29,"(879.25, 1020.0]",1,3,-2
31258.0,2019-12-29,"(466.06, 702.0]",19,35,-16
31258.0,2019-12-29,"(702.0, 937.0]",3,8,-5
31258.0,2019-12-29,"(937.0, 1172.0]",4,4,0
31258.0,2019-12-29,"(1172.0, 1407.0]",1,3,-2
,,,,1.0,
,,,,1.0,
31260.0,2019-12-29,"(4.982, 260.5]",1,1,0
31260.0,2019-12-29,"(260.5, 515.0]",2,4,-2
31260.0,2019-12-29,"(769.5, 1024.0]",1,1,0
31261.0,2019-12-29,"(720.75, 771.0]",2,2,0
31262.0,2019-12-29,"(40.902, 316.5]",1,1,0
31262.0,2019-12-29,"(316.5, 591.0]",1,3,-2
31262.0,2019-12-29,"(865.5, 1140.0]",3,3,0
31263.0,2019-12-29,"(388.162, 598.5]",5,9,-4
31263.0,2019-12-29,"(598.5, 808.0]",5,11,-6
31263.0,2019-12-29,"(808.0, 1017.5]",1,1,0
31263.0,2019-12-29,"(1017.5, 1227.0]",2,5,-3
31264.0,2019-12-29,"(44.642, 385.5]",6,10,-4
31265.0,2019-12-29,"(2.598, 354.5]",2,4,-2
31265.0,2019-12-29,"(354.5, 705.0]",5,8,-3
31265.0,2019-12-29,"(705.0, 1055.5]",3,4,-1
31265.0,2019-12-29,"(1055.5, 1406.0]",1,5,-4
31266.0,2019-12-29,"(46.821, 342.75]",1,5,-4
31266.0,2019-12-29,"(342.75, 637.5]",6,12,-6
31266.0,2019-12-29,"(932.25, 1227.0]",5,2,3
31267.0,2019-12-29,"(108.688, 438.0]",1,2,-1
31267.0,2019-12-29,"(766.0, 1094.0]",2,4,-2
31267.0,2019-12-29,"(1094.0, 1422.0]",1,4,-3
31268.0,2019-12-29,"(26.614, 374.5]",1,3,-2
31268.0,2019-12-29,"(374.5, 721.0]",2,2,0
31268.0,2019-12-29,"(721.0, 1067.5]",3,6,-3
31268.0,2019-12-29,"(1067.5, 1414.0]",1,3,-2
31269.0,2019-12-29,"(540.559, 651.25]",1,2,-1
31269.0,2019-12-29,"(761.5, 871.75]",1,1,0
31269.0,2019-12-29,"(871.75, 982.0]",1,2,-1
31270.0,2019-12-29,"(582.5, 870.75]",2,1,1
31270.0,2019-12-29,"(870.75, 1159.0]",1,3,-2
31271.0,2019-12-29,"(484.385, 638.75]",4,7,-3
31271.0,2019-12-29,"(638.75, 792.5]",5,5,0
31271.0,2019-12-29,"(946.25, 1100.0]",1,2,-1
31272.0,2019-12-29,"(465.923, 485.25]",1,2,-1
31272.0,2019-12-29,"(523.75, 543.0]",2,2,0
31273.0,2019-12-29,"(92.614, 189.5]",1,1,0
31273.0,2019-12-29,"(382.5, 479.0]",1,3,-2
31274.0,2019-12-29,"(1254.0, 1426.0]",1,1,0
31275.0,2019-12-29,"(20.988, 275.0]",1,1,0
31275.0,2019-12-29,"(781.0, 1034.0]",2,2,0
31276.0,2019-12-29,"(603.934, 620.5]",1,1,0
31277.0,2019-12-29,"(528.475, 660.25]",9,14,-5
31277.0,2019-12-29,"(791.5, 922.75]",2,2,0
31277.0,2019-12-29,"(922.75, 1054.0]",1,2,-1
31278.0,2019-12-29,"(493.072, 726.0]",3,5,-2
31278.0,2019-12-29,"(1190.0, 1422.0]",1,1,0
31279.0,2019-12-29,"(721.25, 760.0]",1,1,0
31280.0,2019-12-29,"(493.611, 591.25]",2,3,-1
,,,,1.0,
,,,,1.0,
31001.0,2019-12-30,"(894.5, 1008.0]",1,1,0
31002.0,2019-12-30,"(503.488, 632.0]",1,3,-2
31002.0,2019-12-30,"(760.0, 888.0]",1,1,0
31002.0,2019-12-30,"(888.0, 1016.0]",1,3,-2
31003.0,2019-12-30,"(540.2, 741.0]",1,1,0
31003.0,2019-12-30,"(741.0, 941.0]",1,1,0
31003.0,2019-12-30,"(1141.0, 1341.0]",1,4,-3
31004.0,2019-12-30,"(866.0, 1054.5]",3,2,1
31004.0,2019-12-30,"(1054.5, 1243.0]",2,5,-3
31005.0,2019-12-30,"(432.347, 596.25]",9,9,0
31005.0,2019-12-30,"(922.75, 1086.0]",4,1,3
31006.0,2019-12-30,"(633.447, 772.25]",1,1,0
31006.0,2019-12-30,"(910.5, 1048.75]",1,1,0
31006.0,2019-12-30,"(1048.75, 1187.0]",1,2,-1
31007.0,2019-12-30,"(409.07, 642.5]",4,12,-8
31007.0,2019-12-30,"(642.5, 875.0]",2,2,0
31007.0,2019-12-30,"(875.0, 1107.5]",11,17,-6
31007.0,2019-12-30,"(1107.5, 1340.0]",2,7,-5
31009.0,2019-12-30,"(463.478, 594.5]",6,6,0
31009.0,2019-12-30,"(855.5, 986.0]",1,3,-2
31010.0,2019-12-30,"(429.084, 659.0]",2,3,-1
31010.0,2019-12-30,"(659.0, 888.0]",1,3,-2
31010.0,2019-12-30,"(888.0, 1117.0]",2,3,-1
31010.0,2019-12-30,"(1117.0, 1346.0]",2,2,0
31011.0,2019-12-30,"(377.31, 550.5]",2,4,-2
31011.0,2019-12-30,"(723.0, 895.5]",1,2,-1
31011.0,2019-12-30,"(895.5, 1068.0]",1,5,-4
31012.0,2019-12-30,"(509.42, 655.0]",4,4,0
31012.0,2019-12-30,"(655.0, 800.0]",1,2,-1
31013.0,2019-12-30,"(528.281, 708.75]",1,2,-1
31013.0,2019-12-30,"(888.5, 1068.25]",1,2,-1
31013.0,2019-12-30,"(1068.25, 1248.0]",2,1,1
31014.0,2019-12-30,"(396.977, 653.75]",7,7,0
31014.0,2019-12-30,"(653.75, 909.5]",2,3,-1
31014.0,2019-12-30,"(909.5, 1165.25]",4,12,-8
31014.0,2019-12-30,"(1165.25, 1421.0]",2,2,0
31015.0,2019-12-30,"(308.095, 535.25]",5,5,0
31015.0,2019-12-30,"(535.25, 761.5]",2,2,0
31015.0,2019-12-30,"(987.75, 1214.0]",8,3,5
31016.0,2019-12-30,"(817.5, 1013.25]",3,3,0
31016.0,2019-12-30,"(1013.25, 1209.0]",3,4,-1
31017.0,2019-12-30,"(516.085, 745.75]",2,6,-4
31017.0,2019-12-30,"(745.75, 974.5]",2,3,-1
31017.0,2019-12-30,"(974.5, 1203.25]",3,6,-3
31018.0,2019-12-30,"(653.25, 777.5]",1,1,0
31018.0,2019-12-30,"(777.5, 901.75]",1,1,0
31018.0,2019-12-30,"(901.75, 1026.0]",2,1,1
31019.0,2019-12-30,"(562.339, 728.25]",1,1,0
31019.0,2019-12-30,"(728.25, 893.5]",1,2,-1
31019.0,2019-12-30,"(893.5, 1058.75]",1,2,-1
31019.0,2019-12-30,"(1058.75, 1224.0]",1,3,-2
31020.0,2019-12-30,"(1042.617, 1138.75]",2,3,-1
31020.0,2019-12-30,"(1330.25, 1426.0]",1,1,0
31021.0,2019-12-30,"(1013.0, 1224.5]",4,1,3
31021.0,2019-12-30,"(1224.5, 1436.0]",1,4,-3
31022.0,2019-12-30,"(540.112, 763.0]",1,3,-2
31022.0,2019-12-30,"(763.0, 985.0]",3,6,-3
31022.0,2019-12-30,"(1207.0, 1429.0]",1,6,-5
31023.0,2019-12-30,"(894.75, 1016.0]",1,1,0
31024.0,2019-12-30,"(516.157, 727.75]",1,1,0
31024.0,2019-12-30,"(938.5, 1149.25]",4,8,-4
31024.0,2019-12-30,"(1149.25, 1360.0]",2,6,-4
31025.0,2019-12-30,"(924.514, 1046.5]",3,5,-2
31025.0,2019-12-30,"(1289.5, 1411.0]",1,1,0
31026.0,2019-12-30,"(1096.5, 1212.75]",2,1,1
31027.0,2019-12-30,"(1148.0, 1199.0]",1,1,0
31028.0,2019-12-30,"(822.75, 1097.0]",2,1,1
31029.0,2019-12-30,"(868.5, 1070.75]",1,4,-3
31029.0,2019-12-30,"(1070.75, 1273.0]",3,2,1
31030.0,2019-12-30,"(950.25, 1096.0]",3,1,2
31031.0,2019-12-30,"(458.03, 701.5]",1,4,-3
31031.0,2019-12-30,"(701.5, 944.0]",1,4,-3
31031.0,2019-12-30,"(944.0, 1186.5]",1,3,-2
31031.0,2019-12-30,"(1186.5, 1429.0]",1,1,0
31032.0,2019-12-30,"(902.25, 1203.0]",1,1,0
31033.0,2019-12-30,"(625.5, 834.0]",1,1,0
31034.0,2019-12-30,"(1139.5, 1198.0]",1,2,-1
31035.0,2019-12-30,"(972.0, 1192.5]",3,1,2
31035.0,2019-12-30,"(1192.5, 1413.0]",1,1,0
31036.0,2019-12-30,"(506.445, 645.75]",1,2,-1
31036.0,2019-12-30,"(923.25, 1062.0]",2,1,1
31037.0,2019-12-30,"(417.011, 665.25]",8,11,-3
31037.0,2019-12-30,"(665.25, 912.5]",2,5,-3
31037.0,2019-12-30,"(912.5, 1159.75]",1,10,-9
31038.0,2019-12-30,"(702.692, 780.0]",1,1,0
31039.0,2019-12-30,"(518.275, 700.25]",5,8,-3
31039.0,2019-12-30,"(1062.75, 1244.0]",2,3,-1
31040.0,2019-12-30,"(357.75, 715.5]",1,1,0
31040.0,2019-12-30,"(1073.25, 1431.0]",1,1,0
31041.0,2019-12-30,"(466.393, 618.75]",1,1,0
31041.0,2019-12-30,"(618.75, 770.5]",1,1,0
31041.0,2019-12-30,"(770.5, 922.25]",2,2,0
31041.0,2019-12-30,"(922.25, 1074.0]",2,4,-2
31042.0,2019-12-30,"(449.268, 633.0]",6,8,-2
31042.0,2019-12-30,"(999.0, 1182.0]",4,1,3
31043.0,2019-12-30,"(418.401, 568.75]",1,3,-2
31043.0,2019-12-30,"(868.25, 1018.0]",2,1,1
31044.0,2019-12-30,"(591.403, 741.25]",1,1,0
31044.0,2019-12-30,"(890.5, 1039.75]",2,3,-1
31045.0,2019-12-30,"(955.0, 1130.5]",2,1,1
31045.0,2019-12-30,"(1130.5, 1306.0]",1,1,0
,,,,1.0,
,,,,1.0,
31047.0,2019-12-30,"(424.041, 664.75]",5,8,-3
31047.0,2019-12-30,"(664.75, 904.5]",1,1,0
31047.0,2019-12-30,"(904.5, 1144.25]",1,8,-7
31047.0,2019-12-30,"(1144.25, 1384.0]",3,7,-4
31048.0,2019-12-30,"(878.5, 1096.75]",1,2,-1
31048.0,2019-12-30,"(1096.75, 1315.0]",1,3,-2
31049.0,2019-12-30,"(1120.5, 1310.0]",1,2,-1
,,,,1.0,
,,,,1.0,
31051.0,2019-12-30,"(821.5, 1079.25]",3,3,0
31051.0,2019-12-30,"(1079.25, 1337.0]",2,6,-4
31052.0,2019-12-30,"(268.727, 337.25]",1,2,-1
31052.0,2019-12-30,"(473.75, 542.0]",1,1,0
31053.0,2019-12-30,"(897.75, 1197.0]",3,1,2
31054.0,2019-12-30,"(774.75, 1033.0]",2,1,1
31055.0,2019-12-30,"(641.5, 776.0]",1,1,0
31055.0,2019-12-30,"(910.5, 1045.0]",1,2,-1
31056.0,2019-12-30,"(135.995, 388.25]",1,1,0
31056.0,2019-12-30,"(639.5, 890.75]",1,1,0
31056.0,2019-12-30,"(890.75, 1142.0]",2,2,0
31057.0,2019-12-30,"(1049.475, 1050.0]",1,2,-1
,,,,2.0,
31059.0,2019-12-30,"(864.75, 1153.0]",2,1,1
31060.0,2019-12-30,"(862.75, 1108.0]",1,1,0
31061.0,2019-12-30,"(511.0, 766.5]",1,1,0
31061.0,2019-12-30,"(766.5, 1022.0]",1,1,0
31062.0,2019-12-30,"(609.583, 714.25]",1,2,-1
31062.0,2019-12-30,"(922.75, 1027.0]",6,2,4
31063.0,2019-12-30,"(726.75, 969.0]",5,1,4
31064.0,2019-12-30,"(525.194, 727.5]",4,8,-4
31064.0,2019-12-30,"(727.5, 929.0]",2,5,-3
31064.0,2019-12-30,"(929.0, 1130.5]",11,21,-10
31064.0,2019-12-30,"(1130.5, 1332.0]",2,4,-2
31065.0,2019-12-30,"(920.5, 1142.75]",1,2,-1
31066.0,2019-12-30,"(865.25, 995.0]",2,1,1
31067.0,2019-12-30,"(886.25, 1043.0]",2,1,1
31068.0,2019-12-30,"(1017.0, 1356.0]",3,1,2
31069.0,2019-12-30,"(898.75, 1061.0]",1,3,-2
31070.0,2019-12-30,"(1111.5, 1263.0]",3,1,2
31071.0,2019-12-30,"(478.477, 609.75]",2,5,-3
31071.0,2019-12-30,"(871.25, 1002.0]",6,12,-6
31072.0,2019-12-30,"(916.75, 1060.0]",1,1,0
,,,,2.0,
31074.0,2019-12-30,"(813.75, 1085.0]",1,1,0
31075.0,2019-12-30,"(971.0, 1117.0]",2,1,1
31076.0,2019-12-30,"(1014.5, 1043.0]",2,1,1
31077.0,2019-12-30,"(621.406, 770.5]",1,5,-4
31077.0,2019-12-30,"(770.5, 919.0]",2,2,0
31077.0,2019-12-30,"(919.0, 1067.5]",6,12,-6
31077.0,2019-12-30,"(1067.5, 1216.0]",4,7,-3
,,,,1.0,
,,,,1.0,
31079.0,2019-12-30,"(590.75, 779.5]",1,1,0
31079.0,2019-12-30,"(968.25, 1157.0]",3,2,1
31080.0,2019-12-30,"(56.846, 346.5]",1,1,0
31080.0,2019-12-30,"(923.5, 1212.0]",5,3,2
31081.0,2019-12-30,"(1110.25, 1302.0]",1,1,0
31082.0,2019-12-30,"(1043.0, 1123.0]",1,1,0
31082.0,2019-12-30,"(1203.0, 1283.0]",1,1,0
31083.0,2019-12-30,"(525.468, 659.0]",1,3,-2
31083.0,2019-12-30,"(925.0, 1058.0]",1,1,0
31084.0,2019-12-30,"(608.29, 786.5]",1,2,-1
31084.0,2019-12-30,"(786.5, 964.0]",4,5,-1
31084.0,2019-12-30,"(1141.5, 1319.0]",1,4,-3
31085.0,2019-12-30,"(1233.961, 1243.75]",2,2,0
31086.0,2019-12-30,"(949.715, 1021.25]",3,5,-2
31087.0,2019-12-30,"(901.0, 1125.0]",1,1,0
31087.0,2019-12-30,"(1125.0, 1349.0]",2,1,1
31088.0,2019-12-30,"(1013.25, 1163.0]",1,1,0
31089.0,2019-12-30,"(404.074, 636.5]",4,8,-4
31089.0,2019-12-30,"(636.5, 868.0]",1,1,0
31089.0,2019-12-30,"(868.0, 1099.5]",7,17,-10
31089.0,2019-12-30,"(1099.5, 1331.0]",3,5,-2
31090.0,2019-12-30,"(637.999, 638.25]",1,1,0
31091.0,2019-12-30,"(764.0, 961.5]",3,3,0
31091.0,2019-12-30,"(961.5, 1159.0]",4,2,2
31092.0,2019-12-30,"(4.819, 301.25]",1,1,0
31092.0,2019-12-30,"(891.75, 1187.0]",3,1,2
31093.0,2019-12-30,"(991.25, 1003.0]",1,1,0
31094.0,2019-12-30,"(836.25, 1115.0]",1,1,0
,,,,2.0,
31096.0,2019-12-30,"(509.252, 697.0]",1,2,-1
31096.0,2019-12-30,"(1071.0, 1258.0]",1,1,0
31097.0,2019-12-30,"(1259.25, 1388.0]",1,1,0
31098.0,2019-12-30,"(450.169, 658.75]",1,4,-3
31098.0,2019-12-30,"(866.5, 1074.25]",3,4,-1
31098.0,2019-12-30,"(1074.25, 1282.0]",2,2,0
31099.0,2019-12-30,"(958.5, 971.0]",1,1,0
31100.0,2019-12-30,"(509.074, 741.5]",7,8,-1
31100.0,2019-12-30,"(741.5, 973.0]",3,5,-2
31100.0,2019-12-30,"(973.0, 1204.5]",2,4,-2
31101.0,2019-12-30,"(320.964, 581.0]",9,23,-14
31101.0,2019-12-30,"(581.0, 840.0]",10,16,-6
31101.0,2019-12-30,"(840.0, 1099.0]",21,29,-8
31101.0,2019-12-30,"(1099.0, 1358.0]",12,19,-7
31102.0,2019-12-30,"(445.128, 664.0]",2,10,-8
31102.0,2019-12-30,"(882.0, 1100.0]",2,4,-2
31102.0,2019-12-30,"(1100.0, 1318.0]",4,6,-2
31103.0,2019-12-30,"(656.0, 955.0]",2,1,1
31103.0,2019-12-30,"(955.0, 1254.0]",5,10,-5
31104.0,2019-12-30,"(316.02, 562.0]",2,8,-6
31104.0,2019-12-30,"(562.0, 807.0]",4,7,-3
31104.0,2019-12-30,"(807.0, 1052.0]",9,21,-12
31104.0,2019-12-30,"(1052.0, 1297.0]",9,13,-4
31105.0,2019-12-30,"(832.5, 1066.25]",4,3,1
31105.0,2019-12-30,"(1066.25, 1300.0]",3,4,-1
31106.0,2019-12-30,"(516.371, 674.25]",2,4,-2
31106.0,2019-12-30,"(674.25, 831.5]",1,1,0
31106.0,2019-12-30,"(988.75, 1146.0]",2,3,-1
31107.0,2019-12-30,"(402.981, 658.75]",4,14,-10
31107.0,2019-12-30,"(658.75, 913.5]",3,9,-6
31107.0,2019-12-30,"(913.5, 1168.25]",13,27,-14
31107.0,2019-12-30,"(1168.25, 1423.0]",5,8,-3
31108.0,2019-12-30,"(312.75, 615.5]",3,1,2
31108.0,2019-12-30,"(615.5, 918.25]",7,13,-6
31108.0,2019-12-30,"(918.25, 1221.0]",27,21,6
31109.0,2019-12-30,"(389.956, 652.0]",4,11,-7
31109.0,2019-12-30,"(652.0, 913.0]",7,8,-1
31109.0,2019-12-30,"(913.0, 1174.0]",7,14,-7
31109.0,2019-12-30,"(1174.0, 1435.0]",3,11,-8
31110.0,2019-12-30,"(309.923, 580.25]",6,12,-6
31110.0,2019-12-30,"(580.25, 849.5]",5,8,-3
31110.0,2019-12-30,"(849.5, 1118.75]",16,32,-16
31110.0,2019-12-30,"(1118.75, 1388.0]",5,12,-7
31111.0,2019-12-30,"(395.05, 633.5]",2,5,-3
31111.0,2019-12-30,"(633.5, 871.0]",2,4,-2
31111.0,2019-12-30,"(871.0, 1108.5]",7,14,-7
31111.0,2019-12-30,"(1108.5, 1346.0]",7,11,-4
31112.0,2019-12-30,"(695.75, 886.5]",1,1,0
31112.0,2019-12-30,"(886.5, 1077.25]",1,2,-1
31112.0,2019-12-30,"(1077.25, 1268.0]",5,2,3
31113.0,2019-12-30,"(343.977, 600.75]",3,16,-13
31113.0,2019-12-30,"(600.75, 856.5]",2,7,-5
31113.0,2019-12-30,"(856.5, 1112.25]",5,9,-4
31113.0,2019-12-30,"(1112.25, 1368.0]",6,8,-2
31114.0,2019-12-30,"(595.75, 867.5]",3,12,-9
31114.0,2019-12-30,"(867.5, 1139.25]",11,8,3
31114.0,2019-12-30,"(1139.25, 1411.0]",9,20,-11
31115.0,2019-12-30,"(600.25, 858.5]",3,12,-9
31115.0,2019-12-30,"(858.5, 1116.75]",5,6,-1
31115.0,2019-12-30,"(1116.75, 1375.0]",8,9,-1
31116.0,2019-12-30,"(424.032, 667.0]",1,6,-5
31116.0,2019-12-30,"(667.0, 909.0]",2,4,-2
31116.0,2019-12-30,"(909.0, 1151.0]",12,16,-4
31116.0,2019-12-30,"(1151.0, 1393.0]",2,8,-6
31117.0,2019-12-30,"(544.75, 799.5]",2,9,-7
31117.0,2019-12-30,"(799.5, 1054.25]",4,10,-6
31117.0,2019-12-30,"(1054.25, 1309.0]",6,12,-6
31118.0,2019-12-30,"(396.129, 614.75]",2,9,-7
31118.0,2019-12-30,"(614.75, 832.5]",1,5,-4
31118.0,2019-12-30,"(832.5, 1050.25]",6,7,-1
31118.0,2019-12-30,"(1050.25, 1268.0]",7,8,-1
31119.0,2019-12-30,"(342.933, 610.75]",5,19,-14
31119.0,2019-12-30,"(610.75, 877.5]",3,7,-4
31119.0,2019-12-30,"(877.5, 1144.25]",11,23,-12
31119.0,2019-12-30,"(1144.25, 1411.0]",10,20,-10
31120.0,2019-12-30,"(645.0, 897.0]",1,6,-5
31120.0,2019-12-30,"(897.0, 1149.0]",8,3,5
31120.0,2019-12-30,"(1149.0, 1401.0]",6,13,-7
31121.0,2019-12-30,"(371.062, 606.5]",9,10,-1
31121.0,2019-12-30,"(606.5, 841.0]",2,3,-1
31121.0,2019-12-30,"(841.0, 1075.5]",1,7,-6
31121.0,2019-12-30,"(1075.5, 1310.0]",6,13,-7
31122.0,2019-12-30,"(358.962, 619.5]",1,5,-4
31122.0,2019-12-30,"(879.0, 1138.5]",5,4,1
31122.0,2019-12-30,"(1138.5, 1398.0]",3,15,-12
31123.0,2019-12-30,"(353.137, 569.75]",1,6,-5
31123.0,2019-12-30,"(569.75, 785.5]",1,5,-4
31123.0,2019-12-30,"(1001.25, 1217.0]",6,9,-3
31124.0,2019-12-30,"(8.59, 362.5]",1,3,-2
31124.0,2019-12-30,"(362.5, 715.0]",11,26,-15
31124.0,2019-12-30,"(715.0, 1067.5]",14,48,-34
31124.0,2019-12-30,"(1067.5, 1420.0]",16,34,-18
31125.0,2019-12-30,"(31.627, 376.25]",2,2,0
31125.0,2019-12-30,"(376.25, 719.5]",3,21,-18
31125.0,2019-12-30,"(719.5, 1062.75]",14,19,-5
31125.0,2019-12-30,"(1062.75, 1406.0]",18,26,-8
31126.0,2019-12-30,"(295.983, 551.25]",2,12,-10
31126.0,2019-12-30,"(551.25, 805.5]",1,8,-7
31126.0,2019-12-30,"(805.5, 1059.75]",10,12,-2
31126.0,2019-12-30,"(1059.75, 1314.0]",8,17,-9
,,,,2.0,
31128.0,2019-12-30,"(381.127, 600.25]",13,20,-7
31128.0,2019-12-30,"(600.25, 818.5]",4,10,-6
31128.0,2019-12-30,"(818.5, 1036.75]",10,17,-7
31128.0,2019-12-30,"(1036.75, 1255.0]",5,14,-9
31129.0,2019-12-30,"(419.127, 638.25]",10,14,-4
31129.0,2019-12-30,"(638.25, 856.5]",7,11,-4
31129.0,2019-12-30,"(856.5, 1074.75]",19,32,-13
31129.0,2019-12-30,"(1074.75, 1293.0]",14,27,-13
31130.0,2019-12-30,"(415.259, 601.25]",2,5,-3
31130.0,2019-12-30,"(601.25, 786.5]",1,2,-1
31130.0,2019-12-30,"(786.5, 971.75]",6,12,-6
31130.0,2019-12-30,"(971.75, 1157.0]",8,10,-2
31131.0,2019-12-30,"(726.75, 933.5]",2,4,-2
31131.0,2019-12-30,"(1140.25, 1347.0]",2,3,-1
31200.0,2019-12-30,"(334.95, 598.5]",13,18,-5
31200.0,2019-12-30,"(598.5, 861.0]",10,18,-8
31200.0,2019-12-30,"(861.0, 1123.5]",14,31,-17
31200.0,2019-12-30,"(1123.5, 1386.0]",6,11,-5
31201.0,2019-12-30,"(295.895, 573.25]",11,27,-16
31201.0,2019-12-30,"(573.25, 849.5]",17,29,-12
31201.0,2019-12-30,"(849.5, 1125.75]",37,64,-27
31201.0,2019-12-30,"(1125.75, 1402.0]",14,23,-9
31202.0,2019-12-30,"(26.656, 364.0]",1,1,0
31202.0,2019-12-30,"(364.0, 700.0]",4,14,-10
31202.0,2019-12-30,"(700.0, 1036.0]",14,21,-7
31202.0,2019-12-30,"(1036.0, 1372.0]",17,27,-10
31203.0,2019-12-30,"(75.659, 412.25]",2,4,-2
31203.0,2019-12-30,"(412.25, 747.5]",11,18,-7
31203.0,2019-12-30,"(747.5, 1082.75]",28,44,-16
31203.0,2019-12-30,"(1082.75, 1418.0]",18,30,-12
31204.0,2019-12-30,"(431.02, 677.0]",8,8,0
31204.0,2019-12-30,"(677.0, 922.0]",3,7,-4
31204.0,2019-12-30,"(922.0, 1167.0]",3,11,-8
31204.0,2019-12-30,"(1167.0, 1412.0]",2,4,-2
31205.0,2019-12-30,"(440.16, 651.0]",4,6,-2
31205.0,2019-12-30,"(651.0, 861.0]",3,5,-2
31205.0,2019-12-30,"(861.0, 1071.0]",1,5,-4
31206.0,2019-12-30,"(464.314, 636.5]",5,5,0
31206.0,2019-12-30,"(979.5, 1151.0]",7,6,1
31207.0,2019-12-30,"(842.5, 1092.25]",3,3,0
31207.0,2019-12-30,"(1092.25, 1342.0]",2,1,1
31208.0,2019-12-30,"(426.226, 620.5]",2,3,-1
31208.0,2019-12-30,"(814.0, 1007.5]",2,7,-5
31208.0,2019-12-30,"(1007.5, 1201.0]",2,3,-1
31209.0,2019-12-30,"(682.5, 833.0]",1,2,-1
31209.0,2019-12-30,"(833.0, 983.5]",2,1,1
31209.0,2019-12-30,"(983.5, 1134.0]",1,2,-1
31211.0,2019-12-30,"(477.348, 641.0]",6,7,-1
31211.0,2019-12-30,"(804.0, 967.0]",3,1,2
31211.0,2019-12-30,"(967.0, 1130.0]",2,4,-2
31212.0,2019-12-30,"(39.697, 366.75]",1,1,0
31212.0,2019-12-30,"(366.75, 692.5]",17,28,-11
31212.0,2019-12-30,"(692.5, 1018.25]",11,23,-12
31212.0,2019-12-30,"(1018.25, 1344.0]",16,25,-9
31213.0,2019-12-30,"(370.996, 623.0]",13,19,-6
31213.0,2019-12-30,"(623.0, 874.0]",8,18,-10
31213.0,2019-12-30,"(874.0, 1125.0]",9,18,-9
31213.0,2019-12-30,"(1125.0, 1376.0]",2,6,-4
31214.0,2019-12-30,"(358.5, 710.0]",12,1,11
31214.0,2019-12-30,"(710.0, 1061.5]",18,30,-12
31214.0,2019-12-30,"(1061.5, 1413.0]",24,34,-10
31215.0,2019-12-30,"(36.86, 323.0]",1,2,-1
31215.0,2019-12-30,"(323.0, 608.0]",7,9,-2
31215.0,2019-12-30,"(608.0, 893.0]",11,14,-3
31215.0,2019-12-30,"(893.0, 1178.0]",15,25,-10
31216.0,2019-12-30,"(334.086, 563.5]",4,6,-2
31216.0,2019-12-30,"(563.5, 792.0]",4,4,0
31217.0,2019-12-30,"(383.163, 593.25]",5,7,-2
31217.0,2019-12-30,"(802.5, 1011.75]",1,6,-5
31217.0,2019-12-30,"(1011.75, 1221.0]",4,10,-6
31218.0,2019-12-30,"(406.264, 591.0]",7,19,-12
31218.0,2019-12-30,"(591.0, 775.0]",1,1,0
31218.0,2019-12-30,"(775.0, 959.0]",14,24,-10
31218.0,2019-12-30,"(959.0, 1143.0]",9,15,-6
31219.0,2019-12-30,"(355.261, 540.75]",2,2,0
31219.0,2019-12-30,"(540.75, 725.5]",9,9,0
31219.0,2019-12-30,"(725.5, 910.25]",9,17,-8
31219.0,2019-12-30,"(910.25, 1095.0]",2,12,-10
31220.0,2019-12-30,"(287.208, 486.0]",4,5,-1
31220.0,2019-12-30,"(486.0, 684.0]",8,8,0
31220.0,2019-12-30,"(684.0, 882.0]",4,7,-3
31220.0,2019-12-30,"(882.0, 1080.0]",1,16,-15
31221.0,2019-12-30,"(455.174, 662.5]",17,20,-3
31221.0,2019-12-30,"(662.5, 869.0]",5,9,-4
31221.0,2019-12-30,"(869.0, 1075.5]",10,18,-8
31221.0,2019-12-30,"(1075.5, 1282.0]",3,10,-7
31222.0,2019-12-30,"(502.347, 666.25]",8,8,0
31222.0,2019-12-30,"(666.25, 829.5]",2,5,-3
31222.0,2019-12-30,"(829.5, 992.75]",8,10,-2
31222.0,2019-12-30,"(992.75, 1156.0]",3,12,-9
31223.0,2019-12-30,"(40.631, 384.25]",1,3,-2
31223.0,2019-12-30,"(384.25, 726.5]",6,17,-11
31223.0,2019-12-30,"(726.5, 1068.75]",5,14,-9
31223.0,2019-12-30,"(1068.75, 1411.0]",13,26,-13
31224.0,2019-12-30,"(433.158, 644.5]",10,10,0
31224.0,2019-12-30,"(644.5, 855.0]",3,6,-3
31224.0,2019-12-30,"(855.0, 1065.5]",3,13,-10
31225.0,2019-12-30,"(399.975, 657.25]",3,4,-1
31225.0,2019-12-30,"(657.25, 913.5]",7,10,-3
31225.0,2019-12-30,"(913.5, 1169.75]",9,25,-16
31226.0,2019-12-30,"(351.01, 599.5]",2,6,-4
31226.0,2019-12-30,"(599.5, 847.0]",1,1,0
31226.0,2019-12-30,"(847.0, 1094.5]",3,6,-3
31226.0,2019-12-30,"(1094.5, 1342.0]",3,4,-1
31227.0,2019-12-30,"(443.246, 632.5]",18,20,-2
31227.0,2019-12-30,"(821.0, 1009.5]",4,2,2
31227.0,2019-12-30,"(1009.5, 1198.0]",3,7,-4
31228.0,2019-12-30,"(12.72, 334.0]",1,1,0
31228.0,2019-12-30,"(334.0, 654.0]",11,16,-5
31228.0,2019-12-30,"(654.0, 974.0]",9,15,-6
31228.0,2019-12-30,"(974.0, 1294.0]",34,52,-18
31229.0,2019-12-30,"(7.725, 327.75]",1,1,0
31229.0,2019-12-30,"(327.75, 646.5]",10,40,-30
31229.0,2019-12-30,"(646.5, 965.25]",10,29,-19
31229.0,2019-12-30,"(965.25, 1284.0]",32,47,-15
31230.0,2019-12-30,"(395.082, 625.5]",16,18,-2
31230.0,2019-12-30,"(625.5, 855.0]",7,10,-3
31230.0,2019-12-30,"(855.0, 1084.5]",12,27,-15
31230.0,2019-12-30,"(1084.5, 1314.0]",4,15,-11
31231.0,2019-12-30,"(338.925, 608.75]",6,7,-1
31231.0,2019-12-30,"(608.75, 877.5]",3,5,-2
31231.0,2019-12-30,"(877.5, 1146.25]",2,9,-7
31232.0,2019-12-30,"(33.638, 375.5]",1,4,-3
31232.0,2019-12-30,"(375.5, 716.0]",6,10,-4
31232.0,2019-12-30,"(716.0, 1056.5]",9,17,-8
31232.0,2019-12-30,"(1056.5, 1397.0]",7,19,-12
31233.0,2019-12-30,"(293.951, 557.25]",9,13,-4
31233.0,2019-12-30,"(557.25, 819.5]",7,10,-3
31233.0,2019-12-30,"(819.5, 1081.75]",8,22,-14
31233.0,2019-12-30,"(1081.75, 1344.0]",3,10,-7
31234.0,2019-12-30,"(360.5, 677.0]",6,1,5
31234.0,2019-12-30,"(677.0, 993.5]",5,12,-7
31234.0,2019-12-30,"(993.5, 1310.0]",13,8,5
31235.0,2019-12-30,"(530.255, 717.25]",2,3,-1
31235.0,2019-12-30,"(903.5, 1089.75]",5,17,-12
31235.0,2019-12-30,"(1089.75, 1276.0]",6,10,-4
31236.0,2019-12-30,"(487.276, 669.0]",2,4,-2
31236.0,2019-12-30,"(850.0, 1031.0]",3,4,-1
31237.0,2019-12-30,"(32.723, 353.25]",1,1,0
31237.0,2019-12-30,"(353.25, 672.5]",2,5,-3
31237.0,2019-12-30,"(672.5, 991.75]",5,10,-5
31237.0,2019-12-30,"(991.75, 1311.0]",12,18,-6
31238.0,2019-12-30,"(25.627, 370.25]",3,3,0
31238.0,2019-12-30,"(370.25, 713.5]",11,15,-4
31238.0,2019-12-30,"(713.5, 1056.75]",6,14,-8
31238.0,2019-12-30,"(1056.75, 1400.0]",5,12,-7
31239.0,2019-12-30,"(409.137, 625.75]",12,13,-1
31239.0,2019-12-30,"(625.75, 841.5]",3,6,-3
31239.0,2019-12-30,"(841.5, 1057.25]",12,26,-14
31239.0,2019-12-30,"(1057.25, 1273.0]",4,9,-5
31240.0,2019-12-30,"(649.264, 834.0]",2,5,-3
31240.0,2019-12-30,"(834.0, 1018.0]",7,15,-8
31240.0,2019-12-30,"(1018.0, 1202.0]",7,8,-1
31240.0,2019-12-30,"(1202.0, 1386.0]",5,10,-5
31241.0,2019-12-30,"(276.913, 549.75]",3,12,-9
31241.0,2019-12-30,"(549.75, 821.5]",6,10,-4
31241.0,2019-12-30,"(821.5, 1093.25]",13,23,-10
31241.0,2019-12-30,"(1093.25, 1365.0]",9,16,-7
31242.0,2019-12-30,"(293.043, 533.25]",5,5,0
31242.0,2019-12-30,"(533.25, 772.5]",7,8,-1
31242.0,2019-12-30,"(772.5, 1011.75]",8,12,-4
31242.0,2019-12-30,"(1011.75, 1251.0]",1,12,-11
31243.0,2019-12-30,"(378.196, 580.0]",15,19,-4
31243.0,2019-12-30,"(580.0, 781.0]",6,8,-2
31243.0,2019-12-30,"(781.0, 982.0]",6,10,-4
31243.0,2019-12-30,"(982.0, 1183.0]",14,31,-17
31244.0,2019-12-30,"(418.104, 643.0]",13,19,-6
31244.0,2019-12-30,"(643.0, 867.0]",2,6,-4
31244.0,2019-12-30,"(867.0, 1091.0]",8,17,-9
31244.0,2019-12-30,"(1091.0, 1315.0]",4,7,-3
31245.0,2019-12-30,"(330.923, 601.25]",7,12,-5
31245.0,2019-12-30,"(601.25, 870.5]",1,3,-2
31245.0,2019-12-30,"(870.5, 1139.75]",6,12,-6
31245.0,2019-12-30,"(1139.75, 1409.0]",15,22,-7
31246.0,2019-12-30,"(379.143, 594.25]",5,6,-1
31246.0,2019-12-30,"(594.25, 808.5]",5,5,0
31246.0,2019-12-30,"(808.5, 1022.75]",8,13,-5
31246.0,2019-12-30,"(1022.75, 1237.0]",11,20,-9
31247.0,2019-12-30,"(466.152, 679.0]",20,31,-11
31247.0,2019-12-30,"(679.0, 891.0]",5,15,-10
31247.0,2019-12-30,"(891.0, 1103.0]",23,47,-24
31247.0,2019-12-30,"(1103.0, 1315.0]",3,9,-6
31248.0,2019-12-30,"(481.223, 676.25]",9,15,-6
31248.0,2019-12-30,"(676.25, 870.5]",8,24,-16
31248.0,2019-12-30,"(870.5, 1064.75]",18,49,-31
31248.0,2019-12-30,"(1064.75, 1259.0]",10,22,-12
31249.0,2019-12-30,"(408.087, 637.25]",8,17,-9
31249.0,2019-12-30,"(637.25, 865.5]",4,6,-2
31249.0,2019-12-30,"(865.5, 1093.75]",31,54,-23
31249.0,2019-12-30,"(1093.75, 1322.0]",5,10,-5
31250.0,2019-12-30,"(471.196, 673.0]",15,19,-4
31250.0,2019-12-30,"(673.0, 874.0]",1,3,-2
31250.0,2019-12-30,"(874.0, 1075.0]",3,11,-8
31250.0,2019-12-30,"(1075.0, 1276.0]",1,8,-7
31251.0,2019-12-30,"(314.935, 582.25]",4,11,-7
31251.0,2019-12-30,"(582.25, 848.5]",5,16,-11
31251.0,2019-12-30,"(848.5, 1114.75]",9,21,-12
31251.0,2019-12-30,"(1114.75, 1381.0]",9,17,-8
31252.0,2019-12-30,"(561.33, 729.5]",3,3,0
31252.0,2019-12-30,"(729.5, 897.0]",2,8,-6
31252.0,2019-12-30,"(897.0, 1064.5]",2,10,-8
31252.0,2019-12-30,"(1064.5, 1232.0]",1,6,-5
31253.0,2019-12-30,"(391.052, 629.0]",14,16,-2
31253.0,2019-12-30,"(629.0, 866.0]",1,4,-3
31253.0,2019-12-30,"(866.0, 1103.0]",3,5,-2
31254.0,2019-12-30,"(419.178, 625.5]",8,9,-1
31254.0,2019-12-30,"(625.5, 831.0]",2,5,-3
31254.0,2019-12-30,"(831.0, 1036.5]",3,11,-8
31254.0,2019-12-30,"(1036.5, 1242.0]",1,9,-8
31255.0,2019-12-30,"(361.5, 691.0]",6,2,4
31255.0,2019-12-30,"(691.0, 1020.5]",7,9,-2
31255.0,2019-12-30,"(1020.5, 1350.0]",2,15,-13
31256.0,2019-12-30,"(263.977, 520.75]",6,6,0
31256.0,2019-12-30,"(520.75, 776.5]",4,5,-1
31256.0,2019-12-30,"(776.5, 1032.25]",9,23,-14
31256.0,2019-12-30,"(1032.25, 1288.0]",5,14,-9
31257.0,2019-12-30,"(317.008, 566.0]",4,10,-6
31257.0,2019-12-30,"(566.0, 814.0]",5,11,-6
31257.0,2019-12-30,"(814.0, 1062.0]",13,22,-9
31258.0,2019-12-30,"(557.162, 767.5]",14,23,-9
31258.0,2019-12-30,"(767.5, 977.0]",18,42,-24
31258.0,2019-12-30,"(977.0, 1186.5]",31,71,-40
31258.0,2019-12-30,"(1186.5, 1396.0]",11,17,-6
31259.0,2019-12-30,"(497.402, 647.5]",6,6,0
31259.0,2019-12-30,"(797.0, 946.5]",2,3,-1
31259.0,2019-12-30,"(946.5, 1096.0]",4,12,-8
31260.0,2019-12-30,"(364.037, 605.75]",8,10,-2
31260.0,2019-12-30,"(846.5, 1087.25]",2,10,-8
31260.0,2019-12-30,"(1087.25, 1328.0]",2,9,-7
31261.0,2019-12-30,"(432.054, 669.5]",4,4,0
31261.0,2019-12-30,"(669.5, 906.0]",2,6,-4
31261.0,2019-12-30,"(906.0, 1142.5]",4,15,-11
31261.0,2019-12-30,"(1142.5, 1379.0]",7,9,-2
31262.0,2019-12-30,"(432.135, 649.25]",3,4,-1
31262.0,2019-12-30,"(649.25, 865.5]",1,3,-2
31262.0,2019-12-30,"(865.5, 1081.75]",2,6,-4
31262.0,2019-12-30,"(1081.75, 1298.0]",3,7,-4
31263.0,2019-12-30,"(380.022, 625.5]",12,20,-8
31263.0,2019-12-30,"(625.5, 870.0]",3,7,-4
31263.0,2019-12-30,"(870.0, 1114.5]",13,24,-11
31263.0,2019-12-30,"(1114.5, 1359.0]",11,20,-9
31264.0,2019-12-30,"(404.016, 651.0]",8,14,-6
31264.0,2019-12-30,"(651.0, 897.0]",3,7,-4
31264.0,2019-12-30,"(897.0, 1143.0]",3,12,-9
31264.0,2019-12-30,"(1143.0, 1389.0]",2,5,-3
31265.0,2019-12-30,"(347.924, 618.0]",7,15,-8
31265.0,2019-12-30,"(618.0, 887.0]",7,14,-7
31265.0,2019-12-30,"(887.0, 1156.0]",13,25,-12
31265.0,2019-12-30,"(1156.0, 1425.0]",4,7,-3
31266.0,2019-12-30,"(21.614, 369.5]",1,6,-5
31266.0,2019-12-30,"(369.5, 716.0]",2,12,-10
31266.0,2019-12-30,"(716.0, 1062.5]",14,28,-14
31266.0,2019-12-30,"(1062.5, 1409.0]",13,18,-5
31267.0,2019-12-30,"(437.05, 675.5]",7,12,-5
31267.0,2019-12-30,"(675.5, 913.0]",4,8,-4
31267.0,2019-12-30,"(913.0, 1150.5]",8,15,-7
31268.0,2019-12-30,"(2.658, 339.5]",1,2,-1
31268.0,2019-12-30,"(339.5, 675.0]",3,14,-11
31268.0,2019-12-30,"(675.0, 1010.5]",9,17,-8
31268.0,2019-12-30,"(1010.5, 1346.0]",21,31,-10
31269.0,2019-12-30,"(348.14, 564.0]",4,7,-3
31269.0,2019-12-30,"(564.0, 779.0]",4,6,-2
31269.0,2019-12-30,"(779.0, 994.0]",7,21,-14
31269.0,2019-12-30,"(994.0, 1209.0]",6,13,-7
31270.0,2019-12-30,"(266.834, 559.5]",4,8,-4
31270.0,2019-12-30,"(559.5, 851.0]",4,6,-2
31270.0,2019-12-30,"(851.0, 1142.5]",13,22,-9
31270.0,2019-12-30,"(1142.5, 1434.0]",1,7,-6
31271.0,2019-12-30,"(382.08, 613.0]",20,28,-8
31271.0,2019-12-30,"(613.0, 843.0]",5,12,-7
31271.0,2019-12-30,"(843.0, 1073.0]",14,35,-21
31271.0,2019-12-30,"(1073.0, 1303.0]",2,6,-4
31272.0,2019-12-30,"(306.166, 515.5]",7,8,-1
31272.0,2019-12-30,"(515.5, 724.0]",15,19,-4
31272.0,2019-12-30,"(724.0, 932.5]",3,8,-5
31272.0,2019-12-30,"(932.5, 1141.0]",2,4,-2
31273.0,2019-12-30,"(708.25, 946.5]",6,2,4
31273.0,2019-12-30,"(946.5, 1184.75]",3,10,-7
31273.0,2019-12-30,"(1184.75, 1423.0]",1,6,-5
31274.0,2019-12-30,"(413.133, 630.75]",2,2,0
31274.0,2019-12-30,"(630.75, 847.5]",4,5,-1
31274.0,2019-12-30,"(847.5, 1064.25]",3,8,-5
31274.0,2019-12-30,"(1064.25, 1281.0]",1,4,-3
31275.0,2019-12-30,"(325.031, 568.25]",5,10,-5
31275.0,2019-12-30,"(568.25, 810.5]",3,6,-3
31275.0,2019-12-30,"(810.5, 1052.75]",8,19,-11
31275.0,2019-12-30,"(1052.75, 1295.0]",2,4,-2
31276.0,2019-12-30,"(49.71, 373.5]",1,1,0
31276.0,2019-12-30,"(373.5, 696.0]",8,10,-2
31276.0,2019-12-30,"(696.0, 1018.5]",15,26,-11
31276.0,2019-12-30,"(1018.5, 1341.0]",1,5,-4
31277.0,2019-12-30,"(277.995, 530.25]",10,10,0
31277.0,2019-12-30,"(530.25, 781.5]",12,18,-6
31277.0,2019-12-30,"(781.5, 1032.75]",13,33,-20
31277.0,2019-12-30,"(1032.75, 1284.0]",14,22,-8
31278.0,2019-12-30,"(361.0, 698.0]",2,1,1
31278.0,2019-12-30,"(698.0, 1035.0]",11,13,-2
31278.0,2019-12-30,"(1035.0, 1372.0]",7,14,-7
31279.0,2019-12-30,"(298.083, 528.25]",3,4,-1
31279.0,2019-12-30,"(528.25, 757.5]",4,7,-3
31279.0,2019-12-30,"(757.5, 986.75]",7,10,-3
31279.0,2019-12-30,"(986.75, 1216.0]",5,18,-13
31280.0,2019-12-30,"(361.007, 610.25]",4,11,-7
31280.0,2019-12-30,"(858.5, 1106.75]",4,2,2
31280.0,2019-12-30,"(1106.75, 1355.0]",8,8,0
,,,,1.0,
,,,,1.0,
31001.0,2019-12-31,"(837.5, 850.0]",1,1,0
31002.0,2019-12-31,"(524.51, 647.5]",1,5,-4
31002.0,2019-12-31,"(647.5, 770.0]",5,6,-1
31002.0,2019-12-31,"(770.0, 892.5]",1,4,-3
31002.0,2019-12-31,"(892.5, 1015.0]",1,2,-1
31003.0,2019-12-31,"(425.27, 608.5]",4,6,-2
31003.0,2019-12-31,"(973.5, 1156.0]",1,2,-1
31004.0,2019-12-31,"(915.75, 955.5]",1,1,0
31004.0,2019-12-31,"(995.25, 1035.0]",2,2,0
31005.0,2019-12-31,"(825.511, 948.25]",1,3,-2
31005.0,2019-12-31,"(948.25, 1070.5]",3,5,-2
31006.0,2019-12-31,"(676.304, 851.0]",2,2,0
31006.0,2019-12-31,"(851.0, 1025.0]",2,3,-1
31007.0,2019-12-31,"(395.011, 643.25]",5,11,-6
31007.0,2019-12-31,"(643.25, 890.5]",3,7,-4
31007.0,2019-12-31,"(890.5, 1137.75]",5,13,-8
31007.0,2019-12-31,"(1137.75, 1385.0]",3,5,-2
31009.0,2019-12-31,"(446.008, 695.0]",2,2,0
31009.0,2019-12-31,"(1191.0, 1439.0]",1,2,-1
31010.0,2019-12-31,"(852.25, 1017.5]",1,2,-1
31011.0,2019-12-31,"(333.898, 610.5]",5,8,-3
31011.0,2019-12-31,"(610.5, 886.0]",1,4,-3
31011.0,2019-12-31,"(886.0, 1161.5]",5,6,-1
31012.0,2019-12-31,"(503.234, 695.5]",2,2,0
31012.0,2019-12-31,"(695.5, 887.0]",1,1,0
31013.0,2019-12-31,"(525.219, 721.25]",1,3,-2
31013.0,2019-12-31,"(721.25, 916.5]",1,1,0
31013.0,2019-12-31,"(916.5, 1111.75]",3,7,-4
31014.0,2019-12-31,"(317.249, 505.75]",7,8,-1
31014.0,2019-12-31,"(505.75, 693.5]",7,13,-6
31014.0,2019-12-31,"(693.5, 881.25]",4,8,-4
31014.0,2019-12-31,"(881.25, 1069.0]",10,14,-4
31015.0,2019-12-31,"(27.749, 341.75]",2,3,-1
31015.0,2019-12-31,"(341.75, 654.5]",6,6,0
31015.0,2019-12-31,"(654.5, 967.25]",1,2,-1
31015.0,2019-12-31,"(967.25, 1280.0]",2,5,-3
31016.0,2019-12-31,"(424.175, 631.25]",3,8,-5
31016.0,2019-12-31,"(631.25, 837.5]",2,3,-1
31016.0,2019-12-31,"(837.5, 1043.75]",1,2,-1
31016.0,2019-12-31,"(1043.75, 1250.0]",1,2,-1
31017.0,2019-12-31,"(299.0, 587.0]",2,1,1
31017.0,2019-12-31,"(587.0, 875.0]",5,3,2
31018.0,2019-12-31,"(677.0, 812.0]",1,3,-2
31018.0,2019-12-31,"(812.0, 947.0]",2,1,1
31019.0,2019-12-31,"(603.347, 767.25]",2,4,-2
31019.0,2019-12-31,"(767.25, 930.5]",1,2,-1
31019.0,2019-12-31,"(1093.75, 1257.0]",1,3,-2
31020.0,2019-12-31,"(347.75, 641.5]",4,1,3
31020.0,2019-12-31,"(935.25, 1229.0]",3,4,-1
31021.0,2019-12-31,"(529.486, 658.5]",2,5,-3
31021.0,2019-12-31,"(787.0, 915.5]",5,4,1
31021.0,2019-12-31,"(915.5, 1044.0]",1,7,-6
31022.0,2019-12-31,"(447.011, 695.25]",2,3,-1
31022.0,2019-12-31,"(695.25, 942.5]",5,9,-4
31022.0,2019-12-31,"(942.5, 1189.75]",3,7,-4
31022.0,2019-12-31,"(1189.75, 1437.0]",3,5,-2
31023.0,2019-12-31,"(544.5, 792.25]",3,2,1
31023.0,2019-12-31,"(792.25, 1040.0]",2,4,-2
31024.0,2019-12-31,"(352.982, 608.5]",5,8,-3
31024.0,2019-12-31,"(608.5, 863.0]",3,7,-4
31024.0,2019-12-31,"(863.0, 1117.5]",7,14,-7
31024.0,2019-12-31,"(1117.5, 1372.0]",2,3,-1
31025.0,2019-12-31,"(358.331, 526.25]",2,3,-1
31026.0,2019-12-31,"(405.082, 635.5]",2,4,-2
31026.0,2019-12-31,"(865.0, 1094.5]",1,1,0
31026.0,2019-12-31,"(1094.5, 1324.0]",2,4,-2
31027.0,2019-12-31,"(574.632, 667.0]",1,1,0
31027.0,2019-12-31,"(759.0, 851.0]",1,3,-2
31027.0,2019-12-31,"(851.0, 943.0]",1,2,-1
31028.0,2019-12-31,"(1109.25, 1261.0]",1,1,0
31029.0,2019-12-31,"(649.5, 826.0]",3,3,0
31029.0,2019-12-31,"(826.0, 1002.5]",1,3,-2
31029.0,2019-12-31,"(1002.5, 1179.0]",2,1,1
31030.0,2019-12-31,"(744.75, 973.5]",1,3,-2
31030.0,2019-12-31,"(973.5, 1202.25]",2,6,-4
31030.0,2019-12-31,"(1202.25, 1431.0]",2,4,-2
31031.0,2019-12-31,"(978.75, 1098.0]",5,1,4
31032.0,2019-12-31,"(39.97, 298.5]",1,1,0
31032.0,2019-12-31,"(556.0, 813.5]",1,1,0
31032.0,2019-12-31,"(813.5, 1071.0]",2,2,0
31033.0,2019-12-31,"(528.62, 624.0]",1,1,0
31034.0,2019-12-31,"(476.506, 600.5]",3,5,-2
31034.0,2019-12-31,"(847.5, 971.0]",3,5,-2
31035.0,2019-12-31,"(0.712, 324.0]",2,2,0
31035.0,2019-12-31,"(324.0, 646.0]",1,5,-4
31035.0,2019-12-31,"(646.0, 968.0]",2,4,-2
31035.0,2019-12-31,"(968.0, 1290.0]",3,4,-1
31036.0,2019-12-31,"(517.511, 640.25]",1,3,-2
31036.0,2019-12-31,"(640.25, 762.5]",1,2,-1
31036.0,2019-12-31,"(762.5, 884.75]",1,3,-2
31036.0,2019-12-31,"(884.75, 1007.0]",2,2,0
31037.0,2019-12-31,"(441.158, 652.5]",5,6,-1
31037.0,2019-12-31,"(652.5, 863.0]",5,9,-4
31037.0,2019-12-31,"(863.0, 1073.5]",4,12,-8
31037.0,2019-12-31,"(1073.5, 1284.0]",1,3,-2
31038.0,2019-12-31,"(480.447, 619.25]",1,2,-1
31038.0,2019-12-31,"(619.25, 757.5]",2,2,0
31038.0,2019-12-31,"(895.75, 1034.0]",1,2,-1
31039.0,2019-12-31,"(351.033, 593.75]",2,5,-3
31039.0,2019-12-31,"(593.75, 835.5]",2,3,-1
31039.0,2019-12-31,"(835.5, 1077.25]",1,6,-5
31040.0,2019-12-31,"(470.188, 674.0]",1,3,-2
31040.0,2019-12-31,"(877.0, 1080.0]",3,5,-2
31041.0,2019-12-31,"(508.562, 618.5]",5,5,0
31041.0,2019-12-31,"(728.0, 837.5]",1,3,-2
31041.0,2019-12-31,"(837.5, 947.0]",2,3,-1
31042.0,2019-12-31,"(440.018, 686.5]",9,11,-2
31042.0,2019-12-31,"(686.5, 932.0]",7,14,-7
31042.0,2019-12-31,"(1177.5, 1423.0]",6,9,-3
31043.0,2019-12-31,"(606.175, 813.25]",1,4,-3
31043.0,2019-12-31,"(813.25, 1019.5]",3,4,-1
31043.0,2019-12-31,"(1225.75, 1432.0]",1,1,0
31044.0,2019-12-31,"(498.392, 651.0]",3,9,-6
31044.0,2019-12-31,"(803.0, 955.0]",3,4,-1
31045.0,2019-12-31,"(541.114, 763.5]",1,3,-2
31045.0,2019-12-31,"(763.5, 985.0]",3,6,-3
31045.0,2019-12-31,"(1206.5, 1428.0]",4,1,3
31046.0,2019-12-31,"(12.0, 16.0]",1,1,0
31047.0,2019-12-31,"(400.963, 661.25]",3,8,-5
31047.0,2019-12-31,"(661.25, 920.5]",3,7,-4
31047.0,2019-12-31,"(920.5, 1179.75]",1,3,-2
31047.0,2019-12-31,"(1179.75, 1439.0]",1,2,-1
31048.0,2019-12-31,"(756.5, 974.0]",1,3,-2
31048.0,2019-12-31,"(974.0, 1191.5]",5,2,3
31049.0,2019-12-31,"(431.336, 598.0]",1,2,-1
31049.0,2019-12-31,"(930.0, 1096.0]",2,4,-2
31050.0,2019-12-31,"(836.25, 941.0]",1,1,0
31051.0,2019-12-31,"(12.831, 306.25]",1,2,-1
31051.0,2019-12-31,"(598.5, 890.75]",1,3,-2
31051.0,2019-12-31,"(890.75, 1183.0]",4,4,0
31052.0,2019-12-31,"(583.25, 775.5]",1,1,0
31052.0,2019-12-31,"(775.5, 967.75]",1,2,-1
31052.0,2019-12-31,"(967.75, 1160.0]",2,1,1
31053.0,2019-12-31,"(1036.25, 1067.0]",1,2,-1
31054.0,2019-12-31,"(772.25, 798.0]",1,1,0
31055.0,2019-12-31,"(764.5, 897.75]",1,1,0
31055.0,2019-12-31,"(897.75, 1031.0]",2,1,1
31056.0,2019-12-31,"(21.989, 275.75]",1,1,0
31056.0,2019-12-31,"(781.25, 1034.0]",2,5,-3
31057.0,2019-12-31,"(640.582, 745.5]",2,4,-2
31057.0,2019-12-31,"(850.0, 954.5]",1,2,-1
31057.0,2019-12-31,"(954.5, 1059.0]",1,2,-1
,,,,2.0,
31059.0,2019-12-31,"(769.75, 962.5]",3,1,2
31059.0,2019-12-31,"(962.5, 1155.25]",1,4,-3
31059.0,2019-12-31,"(1155.25, 1348.0]",1,1,0
31060.0,2019-12-31,"(702.749, 765.75]",2,2,0
31060.0,2019-12-31,"(891.25, 954.0]",3,1,2
31061.0,2019-12-31,"(600.931, 618.25]",1,1,0
31061.0,2019-12-31,"(652.75, 670.0]",1,1,0
31062.0,2019-12-31,"(560.543, 675.25]",2,3,-1
31062.0,2019-12-31,"(789.5, 903.75]",5,8,-3
31062.0,2019-12-31,"(903.75, 1018.0]",2,5,-3
,,,,1.0,
,,,,2.0,
31064.0,2019-12-31,"(513.377, 669.75]",1,2,-1
31064.0,2019-12-31,"(669.75, 825.5]",5,11,-6
31064.0,2019-12-31,"(825.5, 981.25]",4,8,-4
31064.0,2019-12-31,"(981.25, 1137.0]",5,10,-5
31065.0,2019-12-31,"(579.0, 694.0]",1,1,0
31065.0,2019-12-31,"(809.0, 924.0]",1,3,-2
31066.0,2019-12-31,"(756.5, 788.25]",1,1,0
31067.0,2019-12-31,"(893.0, 1137.5]",2,1,1
31067.0,2019-12-31,"(1137.5, 1382.0]",1,2,-1
31068.0,2019-12-31,"(743.787, 797.25]",1,1,0
31068.0,2019-12-31,"(903.75, 957.0]",1,1,0
31069.0,2019-12-31,"(452.458, 588.5]",1,2,-1
31069.0,2019-12-31,"(724.0, 859.5]",1,1,0
31069.0,2019-12-31,"(859.5, 995.0]",3,2,1
31070.0,2019-12-31,"(906.847, 945.25]",1,2,-1
31070.0,2019-12-31,"(1021.75, 1060.0]",1,1,0
31071.0,2019-12-31,"(328.899, 605.25]",4,7,-3
31071.0,2019-12-31,"(605.25, 880.5]",3,7,-4
31071.0,2019-12-31,"(880.5, 1155.75]",9,15,-6
31072.0,2019-12-31,"(636.0, 638.0]",1,1,0
31073.0,2019-12-31,"(488.732, 556.0]",1,2,-1
31073.0,2019-12-31,"(690.0, 757.0]",1,3,-2
31074.0,2019-12-31,"(536.37, 694.5]",1,1,0
31074.0,2019-12-31,"(694.5, 852.0]",1,4,-3
31074.0,2019-12-31,"(852.0, 1009.5]",1,2,-1
31074.0,2019-12-31,"(1009.5, 1167.0]",3,5,-2
31075.0,2019-12-31,"(927.5, 1127.25]",1,1,0
31075.0,2019-12-31,"(1127.25, 1327.0]",1,1,0
31076.0,2019-12-31,"(591.25, 785.0]",1,1,0
31077.0,2019-12-31,"(637.5, 794.0]",7,1,6
31077.0,2019-12-31,"(794.0, 950.5]",4,8,-4
31077.0,2019-12-31,"(950.5, 1107.0]",6,13,-7
31078.0,2019-12-31,"(593.933, 610.75]",1,1,0
31078.0,2019-12-31,"(627.5, 644.25]",1,1,0
31079.0,2019-12-31,"(601.173, 808.75]",1,3,-2
31079.0,2019-12-31,"(808.75, 1015.5]",2,5,-3
31080.0,2019-12-31,"(620.75, 885.5]",2,4,-2
31080.0,2019-12-31,"(885.5, 1150.25]",6,4,2
31080.0,2019-12-31,"(1150.25, 1415.0]",2,9,-7
31081.0,2019-12-31,"(812.0, 956.0]",1,1,0
31081.0,2019-12-31,"(956.0, 1100.0]",1,4,-3
31082.0,2019-12-31,"(786.25, 1047.0]",1,1,0
31083.0,2019-12-31,"(787.5, 917.0]",3,3,0
31084.0,2019-12-31,"(556.134, 773.5]",2,2,0
31084.0,2019-12-31,"(773.5, 990.0]",1,3,-2
31085.0,2019-12-31,"(841.25, 941.0]",2,1,1
,,,,1.0,
,,,,1.0,
31087.0,2019-12-31,"(446.434, 588.5]",2,3,-1
31087.0,2019-12-31,"(871.5, 1013.0]",2,1,1
31088.0,2019-12-31,"(571.5, 737.0]",1,1,0
31088.0,2019-12-31,"(737.0, 902.5]",1,1,0
31088.0,2019-12-31,"(902.5, 1068.0]",2,3,-1
31089.0,2019-12-31,"(3.578, 360.5]",1,2,-1
31089.0,2019-12-31,"(360.5, 716.0]",6,7,-1
31089.0,2019-12-31,"(716.0, 1071.5]",1,15,-14
31089.0,2019-12-31,"(1071.5, 1427.0]",3,5,-2
31090.0,2019-12-31,"(457.664, 542.0]",1,2,-1
31091.0,2019-12-31,"(852.0, 1019.0]",4,1,3
31091.0,2019-12-31,"(1019.0, 1186.0]",1,1,0
31092.0,2019-12-31,"(71.047, 310.25]",1,1,0
31092.0,2019-12-31,"(786.75, 1025.0]",2,1,1
,,,,1.0,
,,,,1.0,
,,,,1.0,
31094.0,2019-12-31,"(604.624, 699.0]",1,2,-1
31094.0,2019-12-31,"(793.0, 887.0]",1,1,0
31094.0,2019-12-31,"(887.0, 981.0]",2,2,0
31095.0,2019-12-31,"(906.849, 944.75]",1,2,-1
31095.0,2019-12-31,"(1020.25, 1058.0]",2,2,0
31096.0,2019-12-31,"(781.5, 909.25]",2,1,1
31096.0,2019-12-31,"(909.25, 1037.0]",1,2,-1
31097.0,2019-12-31,"(473.264, 658.0]",2,3,-1
31097.0,2019-12-31,"(658.0, 842.0]",1,3,-2
31097.0,2019-12-31,"(842.0, 1026.0]",2,3,-1
31098.0,2019-12-31,"(430.069, 663.75]",2,7,-5
31098.0,2019-12-31,"(663.75, 896.5]",1,2,-1
31098.0,2019-12-31,"(896.5, 1129.25]",5,5,0
31098.0,2019-12-31,"(1129.25, 1362.0]",1,5,-4
31099.0,2019-12-31,"(884.25, 890.0]",1,1,0
31100.0,2019-12-31,"(316.25, 561.5]",1,1,0
31100.0,2019-12-31,"(561.5, 806.75]",3,2,1
31100.0,2019-12-31,"(806.75, 1052.0]",1,4,-3
31101.0,2019-12-31,"(354.75, 705.5]",15,3,12
31101.0,2019-12-31,"(705.5, 1056.25]",28,26,2
31101.0,2019-12-31,"(1056.25, 1407.0]",16,47,-31
31102.0,2019-12-31,"(166.796, 469.0]",2,3,-1
31102.0,2019-12-31,"(469.0, 770.0]",2,19,-17
31102.0,2019-12-31,"(770.0, 1071.0]",6,11,-5
31102.0,2019-12-31,"(1071.0, 1372.0]",4,6,-2
31103.0,2019-12-31,"(383.07, 616.5]",3,11,-8
31103.0,2019-12-31,"(616.5, 849.0]",1,9,-8
31103.0,2019-12-31,"(849.0, 1081.5]",6,13,-7
31103.0,2019-12-31,"(1081.5, 1314.0]",5,10,-5
31104.0,2019-12-31,"(325.956, 588.0]",3,14,-11
31104.0,2019-12-31,"(588.0, 849.0]",6,14,-8
31104.0,2019-12-31,"(849.0, 1110.0]",11,22,-11
31104.0,2019-12-31,"(1110.0, 1371.0]",12,16,-4
31105.0,2019-12-31,"(887.5, 1082.25]",1,2,-1
31105.0,2019-12-31,"(1082.25, 1277.0]",1,3,-2
31106.0,2019-12-31,"(450.358, 611.5]",1,5,-4
31106.0,2019-12-31,"(772.0, 932.5]",1,2,-1
31106.0,2019-12-31,"(932.5, 1093.0]",3,2,1
31107.0,2019-12-31,"(140.714, 463.5]",1,4,-3
31107.0,2019-12-31,"(463.5, 785.0]",8,18,-10
31107.0,2019-12-31,"(785.0, 1106.5]",8,23,-15
31107.0,2019-12-31,"(1106.5, 1428.0]",6,11,-5
31108.0,2019-12-31,"(398.97, 657.5]",6,20,-14
31108.0,2019-12-31,"(657.5, 915.0]",16,41,-25
31108.0,2019-12-31,"(915.0, 1172.5]",24,31,-7
31108.0,2019-12-31,"(1172.5, 1430.0]",8,13,-5
31109.0,2019-12-31,"(392.963, 653.25]",8,18,-10
31109.0,2019-12-31,"(653.25, 912.5]",5,10,-5
31109.0,2019-12-31,"(912.5, 1171.75]",9,15,-6
31109.0,2019-12-31,"(1171.75, 1431.0]",6,8,-2
31110.0,2019-12-31,"(323.898, 600.5]",9,18,-9
31110.0,2019-12-31,"(600.5, 876.0]",7,13,-6
31110.0,2019-12-31,"(876.0, 1151.5]",9,17,-8
31110.0,2019-12-31,"(1151.5, 1427.0]",3,7,-4
31111.0,2019-12-31,"(58.002, 308.5]",1,2,-1
31111.0,2019-12-31,"(558.0, 807.5]",8,1,7
31111.0,2019-12-31,"(807.5, 1057.0]",8,16,-8
31112.0,2019-12-31,"(501.474, 633.5]",1,3,-2
31112.0,2019-12-31,"(633.5, 765.0]",2,3,-1
31112.0,2019-12-31,"(896.5, 1028.0]",2,1,1
31113.0,2019-12-31,"(317.907, 592.25]",2,11,-9
31113.0,2019-12-31,"(592.25, 865.5]",2,8,-6
31113.0,2019-12-31,"(865.5, 1138.75]",5,11,-6
31113.0,2019-12-31,"(1138.75, 1412.0]",5,8,-3
31114.0,2019-12-31,"(9.579, 366.25]",2,2,0
31114.0,2019-12-31,"(366.25, 721.5]",1,8,-7
31114.0,2019-12-31,"(721.5, 1076.75]",19,33,-14
31114.0,2019-12-31,"(1076.75, 1432.0]",12,19,-7
31115.0,2019-12-31,"(459.25, 752.5]",2,4,-2
31115.0,2019-12-31,"(752.5, 1045.75]",5,11,-6
31115.0,2019-12-31,"(1045.75, 1339.0]",1,13,-12
31116.0,2019-12-31,"(403.092, 631.0]",4,14,-10
31116.0,2019-12-31,"(631.0, 858.0]",7,9,-2
31116.0,2019-12-31,"(858.0, 1085.0]",11,16,-5
31116.0,2019-12-31,"(1085.0, 1312.0]",4,8,-4
31117.0,2019-12-31,"(579.0, 846.0]",2,13,-11
31117.0,2019-12-31,"(846.0, 1113.0]",6,17,-11
31117.0,2019-12-31,"(1113.0, 1380.0]",6,10,-4
31118.0,2019-12-31,"(342.925, 612.75]",2,9,-7
31118.0,2019-12-31,"(612.75, 881.5]",3,12,-9
31118.0,2019-12-31,"(881.5, 1150.25]",12,18,-6
31118.0,2019-12-31,"(1150.25, 1419.0]",3,6,-3
31119.0,2019-12-31,"(368.982, 624.5]",5,14,-9
31119.0,2019-12-31,"(624.5, 879.0]",4,7,-3
31119.0,2019-12-31,"(879.0, 1133.5]",8,11,-3
31119.0,2019-12-31,"(1133.5, 1388.0]",7,10,-3
31120.0,2019-12-31,"(678.25, 925.5]",1,4,-3
31120.0,2019-12-31,"(925.5, 1172.75]",6,3,3
31120.0,2019-12-31,"(1172.75, 1420.0]",3,10,-7
31121.0,2019-12-31,"(465.182, 670.5]",9,11,-2
31121.0,2019-12-31,"(670.5, 875.0]",2,8,-6
31121.0,2019-12-31,"(875.0, 1079.5]",3,10,-7
31121.0,2019-12-31,"(1079.5, 1284.0]",4,8,-4
31122.0,2019-12-31,"(678.25, 925.5]",3,3,0
31122.0,2019-12-31,"(925.5, 1172.75]",3,6,-3
31122.0,2019-12-31,"(1172.75, 1420.0]",4,4,0
31123.0,2019-12-31,"(63.7, 390.0]",1,2,-1
31123.0,2019-12-31,"(390.0, 715.0]",2,11,-9
31123.0,2019-12-31,"(715.0, 1040.0]",2,11,-9
31123.0,2019-12-31,"(1040.0, 1365.0]",5,13,-8
31124.0,2019-12-31,"(309.894, 587.5]",5,9,-4
31124.0,2019-12-31,"(587.5, 864.0]",12,34,-22
31124.0,2019-12-31,"(864.0, 1140.5]",12,33,-21
31124.0,2019-12-31,"(1140.5, 1417.0]",3,10,-7
31125.0,2019-12-31,"(407.972, 666.0]",5,26,-21
31125.0,2019-12-31,"(666.0, 923.0]",13,26,-13
31125.0,2019-12-31,"(923.0, 1180.0]",14,21,-7
31125.0,2019-12-31,"(1180.0, 1437.0]",5,10,-5
31126.0,2019-12-31,"(640.25, 888.5]",3,11,-8
31126.0,2019-12-31,"(888.5, 1136.75]",6,8,-2
31126.0,2019-12-31,"(1136.75, 1385.0]",5,11,-6
,,,,2.0,
31128.0,2019-12-31,"(10.623, 356.25]",2,2,0
31128.0,2019-12-31,"(356.25, 700.5]",14,27,-13
31128.0,2019-12-31,"(700.5, 1044.75]",11,23,-12
31128.0,2019-12-31,"(1044.75, 1389.0]",3,7,-4
31129.0,2019-12-31,"(553.122, 773.5]",12,18,-6
31129.0,2019-12-31,"(773.5, 993.0]",3,17,-14
31129.0,2019-12-31,"(993.0, 1212.5]",7,13,-6
31129.0,2019-12-31,"(1212.5, 1432.0]",1,1,0
31130.0,2019-12-31,"(628.0, 850.0]",5,3,2
31130.0,2019-12-31,"(850.0, 1072.0]",6,10,-4
31130.0,2019-12-31,"(1072.0, 1294.0]",3,10,-7
31131.0,2019-12-31,"(689.25, 894.5]",1,4,-3
31131.0,2019-12-31,"(894.5, 1099.75]",2,1,1
31131.0,2019-12-31,"(1099.75, 1305.0]",1,5,-4
31200.0,2019-12-31,"(137.848, 427.0]",2,3,-1
31200.0,2019-12-31,"(427.0, 715.0]",15,16,-1
31200.0,2019-12-31,"(715.0, 1003.0]",30,49,-19
31200.0,2019-12-31,"(1003.0, 1291.0]",6,8,-2
31201.0,2019-12-31,"(6.594, 359.5]",2,2,0
31201.0,2019-12-31,"(359.5, 711.0]",20,43,-23
31201.0,2019-12-31,"(711.0, 1062.5]",33,60,-27
31201.0,2019-12-31,"(1062.5, 1414.0]",18,30,-12
31202.0,2019-12-31,"(336.94, 603.0]",5,17,-12
31202.0,2019-12-31,"(603.0, 868.0]",15,22,-7
31202.0,2019-12-31,"(868.0, 1133.0]",25,43,-18
31202.0,2019-12-31,"(1133.0, 1398.0]",8,11,-3
31203.0,2019-12-31,"(406.0, 744.0]",11,4,7
31203.0,2019-12-31,"(744.0, 1082.0]",29,30,-1
31203.0,2019-12-31,"(1082.0, 1420.0]",14,45,-31
31204.0,2019-12-31,"(407.148, 621.0]",6,9,-3
31204.0,2019-12-31,"(621.0, 834.0]",1,2,-1
31204.0,2019-12-31,"(834.0, 1047.0]",4,12,-8
31204.0,2019-12-31,"(1047.0, 1260.0]",3,5,-2
31205.0,2019-12-31,"(418.349, 581.75]",3,4,-1
31205.0,2019-12-31,"(581.75, 744.5]",3,5,-2
31205.0,2019-12-31,"(744.5, 907.25]",1,5,-4
31205.0,2019-12-31,"(907.25, 1070.0]",1,3,-2
31206.0,2019-12-31,"(466.103, 691.25]",3,4,-1
31206.0,2019-12-31,"(691.25, 915.5]",1,2,-1
31207.0,2019-12-31,"(568.75, 675.5]",2,2,0
31207.0,2019-12-31,"(675.5, 782.25]",1,2,-1
31207.0,2019-12-31,"(782.25, 889.0]",1,2,-1
31208.0,2019-12-31,"(409.024, 654.0]",6,8,-2
31208.0,2019-12-31,"(654.0, 898.0]",4,9,-5
31208.0,2019-12-31,"(898.0, 1142.0]",3,6,-3
31209.0,2019-12-31,"(517.188, 721.0]",1,2,-1
31209.0,2019-12-31,"(721.0, 924.0]",2,4,-2
31209.0,2019-12-31,"(924.0, 1127.0]",1,1,0
31211.0,2019-12-31,"(388.321, 558.75]",3,4,-1
31211.0,2019-12-31,"(558.75, 728.5]",3,7,-4
31211.0,2019-12-31,"(728.5, 898.25]",2,4,-2
31211.0,2019-12-31,"(898.25, 1068.0]",3,5,-2
31212.0,2019-12-31,"(463.068, 697.0]",18,26,-8
31212.0,2019-12-31,"(697.0, 930.0]",8,18,-10
31212.0,2019-12-31,"(930.0, 1163.0]",8,14,-6
31212.0,2019-12-31,"(1163.0, 1396.0]",8,8,0
31213.0,2019-12-31,"(403.087, 632.25]",16,19,-3
31213.0,2019-12-31,"(632.25, 860.5]",5,11,-6
31213.0,2019-12-31,"(860.5, 1088.75]",6,16,-10
31213.0,2019-12-31,"(1088.75, 1317.0]",3,5,-2
31214.0,2019-12-31,"(449.5, 764.0]",18,2,16
31214.0,2019-12-31,"(764.0, 1078.5]",15,42,-27
31214.0,2019-12-31,"(1078.5, 1393.0]",11,31,-20
31215.0,2019-12-31,"(522.112, 745.0]",11,14,-3
31215.0,2019-12-31,"(745.0, 967.0]",5,9,-4
31215.0,2019-12-31,"(967.0, 1189.0]",9,14,-5
31215.0,2019-12-31,"(1189.0, 1411.0]",4,6,-2
31216.0,2019-12-31,"(554.456, 691.0]",6,6,0
31216.0,2019-12-31,"(691.0, 827.0]",5,6,-1
31216.0,2019-12-31,"(827.0, 963.0]",3,8,-5
31217.0,2019-12-31,"(376.436, 518.0]",5,6,-1
31217.0,2019-12-31,"(518.0, 659.0]",2,3,-1
31217.0,2019-12-31,"(659.0, 800.0]",2,4,-2
31217.0,2019-12-31,"(800.0, 941.0]",1,3,-2
31218.0,2019-12-31,"(332.079, 563.25]",5,11,-6
31218.0,2019-12-31,"(563.25, 793.5]",4,6,-2
31218.0,2019-12-31,"(793.5, 1023.75]",8,16,-8
31218.0,2019-12-31,"(1023.75, 1254.0]",3,7,-4
31219.0,2019-12-31,"(435.115, 657.25]",6,6,0
31219.0,2019-12-31,"(657.25, 878.5]",18,24,-6
31219.0,2019-12-31,"(878.5, 1099.75]",9,25,-16
31219.0,2019-12-31,"(1099.75, 1321.0]",2,5,-3
31220.0,2019-12-31,"(393.299, 569.25]",12,13,-1
31220.0,2019-12-31,"(569.25, 744.5]",1,4,-3
31220.0,2019-12-31,"(744.5, 919.75]",4,15,-11
31220.0,2019-12-31,"(919.75, 1095.0]",3,11,-8
31221.0,2019-12-31,"(411.139, 627.25]",16,20,-4
31221.0,2019-12-31,"(627.25, 842.5]",5,12,-7
31221.0,2019-12-31,"(842.5, 1057.75]",4,15,-11
31221.0,2019-12-31,"(1057.75, 1273.0]",2,4,-2
31222.0,2019-12-31,"(445.019, 691.25]",12,18,-6
31222.0,2019-12-31,"(691.25, 936.5]",7,9,-2
31222.0,2019-12-31,"(936.5, 1181.75]",2,7,-5
31222.0,2019-12-31,"(1181.75, 1427.0]",2,2,0
31223.0,2019-12-31,"(3.573, 361.75]",1,2,-1
31223.0,2019-12-31,"(361.75, 718.5]",8,21,-13
31223.0,2019-12-31,"(718.5, 1075.25]",15,24,-9
31223.0,2019-12-31,"(1075.25, 1432.0]",4,6,-2
31224.0,2019-12-31,"(417.289, 595.75]",12,13,-1
31224.0,2019-12-31,"(595.75, 773.5]",4,6,-2
31224.0,2019-12-31,"(773.5, 951.25]",5,15,-10
31224.0,2019-12-31,"(951.25, 1129.0]",4,10,-6
31225.0,2019-12-31,"(364.099, 590.25]",5,9,-4
31225.0,2019-12-31,"(590.25, 815.5]",8,12,-4
31225.0,2019-12-31,"(815.5, 1040.75]",4,7,-3
31225.0,2019-12-31,"(1040.75, 1266.0]",3,3,0
31226.0,2019-12-31,"(1089.75, 1153.0]",3,2,1
31227.0,2019-12-31,"(470.032, 713.0]",11,16,-5
31227.0,2019-12-31,"(713.0, 955.0]",4,9,-5
31227.0,2019-12-31,"(955.0, 1197.0]",8,13,-5
31227.0,2019-12-31,"(1197.0, 1439.0]",5,9,-4
31228.0,2019-12-31,"(399.134, 616.5]",7,11,-4
31228.0,2019-12-31,"(616.5, 833.0]",9,14,-5
31228.0,2019-12-31,"(833.0, 1049.5]",10,22,-12
31228.0,2019-12-31,"(1049.5, 1266.0]",8,16,-8
31229.0,2019-12-31,"(13.616, 361.0]",2,5,-3
31229.0,2019-12-31,"(361.0, 707.0]",10,41,-31
31229.0,2019-12-31,"(707.0, 1053.0]",31,54,-23
31229.0,2019-12-31,"(1053.0, 1399.0]",12,20,-8
31230.0,2019-12-31,"(295.25, 590.5]",20,1,19
31230.0,2019-12-31,"(590.5, 885.75]",21,28,-7
31230.0,2019-12-31,"(885.75, 1181.0]",19,36,-17
31231.0,2019-12-31,"(404.215, 601.25]",8,8,0
31231.0,2019-12-31,"(601.25, 797.5]",11,15,-4
31231.0,2019-12-31,"(797.5, 993.75]",6,16,-10
31231.0,2019-12-31,"(993.75, 1190.0]",4,9,-5
31232.0,2019-12-31,"(50.716, 373.0]",1,3,-2
31232.0,2019-12-31,"(373.0, 694.0]",3,3,0
31232.0,2019-12-31,"(694.0, 1015.0]",42,62,-20
31232.0,2019-12-31,"(1015.0, 1336.0]",5,10,-5
31233.0,2019-12-31,"(380.25, 732.5]",16,1,15
31233.0,2019-12-31,"(732.5, 1084.75]",24,23,1
31233.0,2019-12-31,"(1084.75, 1437.0]",6,40,-34
31234.0,2019-12-31,"(197.925, 467.75]",1,3,-2
31234.0,2019-12-31,"(467.75, 736.5]",6,12,-6
31234.0,2019-12-31,"(736.5, 1005.25]",10,15,-5
31234.0,2019-12-31,"(1005.25, 1274.0]",9,19,-10
31235.0,2019-12-31,"(486.056, 723.0]",6,9,-3
31235.0,2019-12-31,"(723.0, 959.0]",7,18,-11
31235.0,2019-12-31,"(959.0, 1195.0]",4,8,-4
31235.0,2019-12-31,"(1195.0, 1431.0]",1,1,0
31236.0,2019-12-31,"(478.04, 719.0]",2,2,0
31236.0,2019-12-31,"(719.0, 959.0]",2,5,-3
31237.0,2019-12-31,"(11.644, 352.0]",1,1,0
31237.0,2019-12-31,"(352.0, 691.0]",5,11,-6
31237.0,2019-12-31,"(691.0, 1030.0]",13,22,-9
31237.0,2019-12-31,"(1030.0, 1369.0]",6,11,-5
31238.0,2019-12-31,"(33.75, 347.5]",1,1,0
31238.0,2019-12-31,"(347.5, 660.0]",6,9,-3
31238.0,2019-12-31,"(660.0, 972.5]",7,23,-16
31238.0,2019-12-31,"(972.5, 1285.0]",4,14,-10
31239.0,2019-12-31,"(432.368, 591.0]",7,11,-4
31239.0,2019-12-31,"(591.0, 749.0]",5,6,-1
31239.0,2019-12-31,"(749.0, 907.0]",2,5,-3
31239.0,2019-12-31,"(907.0, 1065.0]",7,15,-8
31240.0,2019-12-31,"(504.224, 699.0]",2,3,-1
31240.0,2019-12-31,"(699.0, 893.0]",7,18,-11
31240.0,2019-12-31,"(893.0, 1087.0]",3,7,-4
31240.0,2019-12-31,"(1087.0, 1281.0]",2,4,-2
31241.0,2019-12-31,"(331.046, 570.5]",4,10,-6
31241.0,2019-12-31,"(570.5, 809.0]",8,18,-10
31241.0,2019-12-31,"(809.0, 1047.5]",12,21,-9
31241.0,2019-12-31,"(1047.5, 1286.0]",13,16,-3
31242.0,2019-12-31,"(465.175, 672.25]",8,10,-2
31242.0,2019-12-31,"(672.25, 878.5]",2,5,-3
31242.0,2019-12-31,"(878.5, 1084.75]",2,7,-5
31242.0,2019-12-31,"(1084.75, 1291.0]",3,5,-2
31243.0,2019-12-31,"(389.006, 638.5]",14,18,-4
31243.0,2019-12-31,"(638.5, 887.0]",7,18,-11
31243.0,2019-12-31,"(887.0, 1135.5]",10,23,-13
31243.0,2019-12-31,"(1135.5, 1384.0]",6,9,-3
31244.0,2019-12-31,"(404.174, 611.5]",10,15,-5
31244.0,2019-12-31,"(611.5, 818.0]",2,7,-5
31244.0,2019-12-31,"(818.0, 1024.5]",7,21,-14
31244.0,2019-12-31,"(1024.5, 1231.0]",4,8,-4
31245.0,2019-12-31,"(510.091, 738.25]",5,12,-7
31245.0,2019-12-31,"(738.25, 965.5]",3,9,-6
31245.0,2019-12-31,"(965.5, 1192.75]",3,10,-7
31245.0,2019-12-31,"(1192.75, 1420.0]",3,6,-3
31246.0,2019-12-31,"(383.012, 631.0]",3,5,-2
31246.0,2019-12-31,"(631.0, 878.0]",13,20,-7
31246.0,2019-12-31,"(878.0, 1125.0]",12,23,-11
31246.0,2019-12-31,"(1125.0, 1372.0]",2,3,-1
31247.0,2019-12-31,"(414.982, 670.5]",13,21,-8
31247.0,2019-12-31,"(670.5, 925.0]",23,40,-17
31247.0,2019-12-31,"(925.0, 1179.5]",21,46,-25
31247.0,2019-12-31,"(1179.5, 1434.0]",3,3,0
31248.0,2019-12-31,"(477.29, 655.5]",8,15,-7
31248.0,2019-12-31,"(655.5, 833.0]",9,23,-14
31248.0,2019-12-31,"(833.0, 1010.5]",32,56,-24
31248.0,2019-12-31,"(1010.5, 1188.0]",12,21,-9
31249.0,2019-12-31,"(7.725, 327.75]",2,4,-2
31249.0,2019-12-31,"(327.75, 646.5]",5,8,-3
31249.0,2019-12-31,"(646.5, 965.25]",21,53,-32
31249.0,2019-12-31,"(965.25, 1284.0]",16,28,-12
31250.0,2019-12-31,"(520.366, 679.5]",8,8,0
31250.0,2019-12-31,"(679.5, 838.0]",2,6,-4
31250.0,2019-12-31,"(838.0, 996.5]",2,6,-4
31251.0,2019-12-31,"(307.987, 562.25]",5,7,-2
31251.0,2019-12-31,"(562.25, 815.5]",3,9,-6
31251.0,2019-12-31,"(815.5, 1068.75]",7,16,-9
31251.0,2019-12-31,"(1068.75, 1322.0]",9,14,-5
31252.0,2019-12-31,"(454.083, 684.25]",4,4,0
31252.0,2019-12-31,"(684.25, 913.5]",6,11,-5
31252.0,2019-12-31,"(913.5, 1142.75]",3,5,-2
31252.0,2019-12-31,"(1142.75, 1372.0]",1,2,-1
31253.0,2019-12-31,"(422.196, 624.0]",6,6,0
31253.0,2019-12-31,"(825.0, 1026.0]",3,4,-1
31253.0,2019-12-31,"(1026.0, 1227.0]",1,7,-6
31254.0,2019-12-31,"(440.006, 689.5]",13,16,-3
31254.0,2019-12-31,"(689.5, 938.0]",3,7,-4
31254.0,2019-12-31,"(938.0, 1186.5]",2,13,-11
31254.0,2019-12-31,"(1186.5, 1435.0]",2,3,-1
31255.0,2019-12-31,"(279.0, 547.0]",4,1,3
31255.0,2019-12-31,"(547.0, 815.0]",4,5,-1
31255.0,2019-12-31,"(815.0, 1083.0]",4,11,-7
31256.0,2019-12-31,"(263.975, 521.25]",3,3,0
31256.0,2019-12-31,"(521.25, 777.5]",10,14,-4
31256.0,2019-12-31,"(777.5, 1033.75]",8,16,-8
31256.0,2019-12-31,"(1033.75, 1290.0]",5,12,-7
31257.0,2019-12-31,"(330.918, 602.5]",3,8,-5
31257.0,2019-12-31,"(602.5, 873.0]",5,10,-5
31257.0,2019-12-31,"(873.0, 1143.5]",13,20,-7
31257.0,2019-12-31,"(1143.5, 1414.0]",3,7,-4
31258.0,2019-12-31,"(68.704, 394.0]",1,2,-1
31258.0,2019-12-31,"(394.0, 718.0]",9,21,-12
31258.0,2019-12-31,"(718.0, 1042.0]",45,82,-37
31258.0,2019-12-31,"(1042.0, 1366.0]",10,14,-4
31259.0,2019-12-31,"(389.986, 644.5]",5,6,-1
31259.0,2019-12-31,"(898.0, 1151.5]",2,4,-2
31259.0,2019-12-31,"(1151.5, 1405.0]",2,6,-4
31260.0,2019-12-31,"(457.187, 661.25]",8,8,0
31260.0,2019-12-31,"(661.25, 864.5]",4,7,-3
31260.0,2019-12-31,"(864.5, 1067.75]",2,16,-14
31260.0,2019-12-31,"(1067.75, 1271.0]",2,3,-1
31261.0,2019-12-31,"(356.946, 621.5]",10,12,-2
31261.0,2019-12-31,"(621.5, 885.0]",1,3,-2
31261.0,2019-12-31,"(885.0, 1148.5]",1,9,-8
31261.0,2019-12-31,"(1148.5, 1412.0]",2,3,-1
31262.0,2019-12-31,"(432.005, 681.75]",5,9,-4
31262.0,2019-12-31,"(681.75, 930.5]",3,6,-3
31262.0,2019-12-31,"(930.5, 1179.25]",9,15,-6
31262.0,2019-12-31,"(1179.25, 1428.0]",1,5,-4
31263.0,2019-12-31,"(467.049, 705.75]",10,19,-9
31263.0,2019-12-31,"(705.75, 943.5]",10,21,-11
31263.0,2019-12-31,"(943.5, 1181.25]",2,10,-8
31263.0,2019-12-31,"(1181.25, 1419.0]",1,3,-2
31264.0,2019-12-31,"(400.292, 578.0]",5,5,0
31264.0,2019-12-31,"(578.0, 755.0]",7,9,-2
31264.0,2019-12-31,"(755.0, 932.0]",8,11,-3
31264.0,2019-12-31,"(932.0, 1109.0]",5,13,-8
31265.0,2019-12-31,"(86.651, 425.25]",1,1,0
31265.0,2019-12-31,"(425.25, 762.5]",13,28,-15
31265.0,2019-12-31,"(762.5, 1099.75]",19,36,-17
31265.0,2019-12-31,"(1099.75, 1437.0]",2,4,-2
31266.0,2019-12-31,"(392.0, 739.0]",9,1,8
31266.0,2019-12-31,"(739.0, 1086.0]",20,34,-14
31266.0,2019-12-31,"(1086.0, 1433.0]",4,34,-30
31267.0,2019-12-31,"(457.096, 684.0]",7,14,-7
31267.0,2019-12-31,"(684.0, 910.0]",10,18,-8
31267.0,2019-12-31,"(910.0, 1136.0]",9,17,-8
31268.0,2019-12-31,"(75.645, 415.75]",2,3,-1
31268.0,2019-12-31,"(415.75, 754.5]",8,26,-18
31268.0,2019-12-31,"(754.5, 1093.25]",12,15,-3
31268.0,2019-12-31,"(1093.25, 1432.0]",6,10,-4
31269.0,2019-12-31,"(343.043, 583.25]",4,7,-3
31269.0,2019-12-31,"(583.25, 822.5]",10,21,-11
31269.0,2019-12-31,"(822.5, 1061.75]",3,11,-8
31269.0,2019-12-31,"(1061.75, 1301.0]",4,7,-3
31270.0,2019-12-31,"(269.919, 541.25]",2,5,-3
31270.0,2019-12-31,"(541.25, 811.5]",8,9,-1
31270.0,2019-12-31,"(811.5, 1081.75]",6,14,-8
31270.0,2019-12-31,"(1081.75, 1352.0]",8,10,-2
31271.0,2019-12-31,"(476.062, 711.5]",12,17,-5
31271.0,2019-12-31,"(711.5, 946.0]",6,18,-12
31271.0,2019-12-31,"(946.0, 1180.5]",20,35,-15
31271.0,2019-12-31,"(1180.5, 1415.0]",1,2,-1
31272.0,2019-12-31,"(308.912, 582.0]",13,16,-3
31272.0,2019-12-31,"(582.0, 854.0]",20,28,-8
31272.0,2019-12-31,"(854.0, 1126.0]",9,25,-16
31272.0,2019-12-31,"(1126.0, 1398.0]",1,1,0
31273.0,2019-12-31,"(482.804, 532.0]",1,2,-1
31273.0,2019-12-31,"(581.0, 630.0]",1,1,0
31274.0,2019-12-31,"(383.964, 644.0]",5,6,-1
31274.0,2019-12-31,"(644.0, 903.0]",5,17,-12
31274.0,2019-12-31,"(903.0, 1162.0]",8,15,-7
31274.0,2019-12-31,"(1162.0, 1421.0]",6,10,-4
31275.0,2019-12-31,"(299.005, 548.75]",9,14,-5
31275.0,2019-12-31,"(548.75, 797.5]",3,11,-8
31275.0,2019-12-31,"(797.5, 1046.25]",8,12,-4
31275.0,2019-12-31,"(1046.25, 1295.0]",2,5,-3
31276.0,2019-12-31,"(533.221, 728.75]",8,12,-4
31276.0,2019-12-31,"(728.75, 923.5]",7,12,-5
31276.0,2019-12-31,"(923.5, 1118.25]",8,14,-6
31277.0,2019-12-31,"(280.856, 568.0]",17,20,-3
31277.0,2019-12-31,"(568.0, 854.0]",14,32,-18
31277.0,2019-12-31,"(854.0, 1140.0]",4,10,-6
31278.0,2019-12-31,"(293.75, 587.5]",3,1,2
31278.0,2019-12-31,"(587.5, 881.25]",8,7,1
31278.0,2019-12-31,"(881.25, 1175.0]",10,20,-10
31279.0,2019-12-31,"(385.286, 564.5]",4,5,-1
31279.0,2019-12-31,"(564.5, 743.0]",1,3,-2
31279.0,2019-12-31,"(921.5, 1100.0]",3,4,-1
31280.0,2019-12-31,"(76.803, 377.25]",1,1,0
31280.0,2019-12-31,"(377.25, 676.5]",3,9,-6
31280.0,2019-12-31,"(676.5, 975.75]",7,13,-6
31280.0,2019-12-31,"(975.75, 1275.0]",3,12,-9
31000.0,2020-01-01,"(876.0, 915.0]",1,2,-1
31001.0,2020-01-01,"(891.0, 976.0]",1,1,0
31002.0,2020-01-01,"(574.592, 677.0]",4,8,-4
31002.0,2020-01-01,"(677.0, 779.0]",2,4,-2
31002.0,2020-01-01,"(779.0, 881.0]",3,3,0
31002.0,2020-01-01,"(881.0, 983.0]",2,5,-3
31003.0,2020-01-01,"(672.0, 811.0]",1,1,0
31003.0,2020-01-01,"(811.0, 950.0]",1,3,-2
31003.0,2020-01-01,"(950.0, 1089.0]",1,2,-1
31004.0,2020-01-01,"(1105.5, 1303.0]",1,1,0
31005.0,2020-01-01,"(681.5, 990.75]",3,1,2
31005.0,2020-01-01,"(990.75, 1300.0]",2,5,-3
31006.0,2020-01-01,"(63.805, 363.75]",1,1,0
31006.0,2020-01-01,"(363.75, 662.5]",1,2,-1
31006.0,2020-01-01,"(961.25, 1260.0]",2,5,-3
31007.0,2020-01-01,"(62.935, 330.25]",2,3,-1
31007.0,2020-01-01,"(596.5, 862.75]",2,5,-3
31007.0,2020-01-01,"(862.75, 1129.0]",4,7,-3
,,,,1.0,
,,,,1.0,
31010.0,2020-01-01,"(-1.101, 275.25]",2,3,-1
31010.0,2020-01-01,"(550.5, 825.75]",1,1,0
31010.0,2020-01-01,"(825.75, 1101.0]",1,1,0
31011.0,2020-01-01,"(105.089, 333.75]",1,1,0
31011.0,2020-01-01,"(333.75, 561.5]",1,1,0
31011.0,2020-01-01,"(789.25, 1017.0]",3,7,-4
31012.0,2020-01-01,"(438.0, 584.0]",1,1,0
31013.0,2020-01-01,"(65.002, 315.5]",1,1,0
31013.0,2020-01-01,"(814.5, 1064.0]",3,1,2
31014.0,2020-01-01,"(176.045, 415.75]",1,1,0
31014.0,2020-01-01,"(415.75, 654.5]",2,3,-1
31014.0,2020-01-01,"(654.5, 893.25]",5,16,-11
31014.0,2020-01-01,"(893.25, 1132.0]",4,5,-1
31015.0,2020-01-01,"(718.586, 822.5]",2,4,-2
31015.0,2020-01-01,"(822.5, 926.0]",3,4,-1
31015.0,2020-01-01,"(926.0, 1029.5]",2,5,-3
31015.0,2020-01-01,"(1029.5, 1133.0]",1,1,0
31016.0,2020-01-01,"(920.75, 1046.5]",1,2,-1
31016.0,2020-01-01,"(1046.5, 1172.25]",2,1,1
31016.0,2020-01-01,"(1172.25, 1298.0]",1,2,-1
31017.0,2020-01-01,"(743.0, 835.0]",1,1,0
,,,,1.0,
,,,,4.0,
31019.0,2020-01-01,"(670.5, 943.75]",3,1,2
31020.0,2020-01-01,"(227.921, 498.75]",1,1,0
31020.0,2020-01-01,"(768.5, 1038.25]",2,4,-2
31020.0,2020-01-01,"(1038.25, 1308.0]",1,4,-3
31021.0,2020-01-01,"(540.618, 636.5]",6,6,0
31021.0,2020-01-01,"(827.5, 923.0]",1,4,-3
31022.0,2020-01-01,"(148.225, 342.75]",1,3,-2
31022.0,2020-01-01,"(730.25, 924.0]",2,3,-1
31023.0,2020-01-01,"(418.25, 737.5]",3,2,1
31023.0,2020-01-01,"(737.5, 1056.75]",2,4,-2
31023.0,2020-01-01,"(1056.75, 1376.0]",1,5,-4
31024.0,2020-01-01,"(26.751, 340.25]",1,4,-3
31024.0,2020-01-01,"(340.25, 652.5]",1,3,-2
31024.0,2020-01-01,"(964.75, 1277.0]",2,2,0
31025.0,2020-01-01,"(663.534, 780.5]",1,2,-1
31025.0,2020-01-01,"(780.5, 897.0]",1,2,-1
31025.0,2020-01-01,"(897.0, 1013.5]",1,1,0
31025.0,2020-01-01,"(1013.5, 1130.0]",1,1,0
31026.0,2020-01-01,"(958.0, 1249.0]",2,1,1
,,,,2.0,
31028.0,2020-01-01,"(695.25, 927.0]",1,1,0
31029.0,2020-01-01,"(722.711, 795.25]",1,3,-2
31029.0,2020-01-01,"(867.5, 939.75]",1,4,-3
31029.0,2020-01-01,"(939.75, 1012.0]",1,3,-2
31030.0,2020-01-01,"(128.838, 420.5]",1,1,0
31030.0,2020-01-01,"(711.0, 1001.5]",1,1,0
31031.0,2020-01-01,"(489.266, 673.5]",1,2,-1
31031.0,2020-01-01,"(1040.5, 1224.0]",2,2,0
31032.0,2020-01-01,"(1049.5, 1111.75]",3,3,0
31032.0,2020-01-01,"(1111.75, 1174.0]",2,3,-1
31033.0,2020-01-01,"(901.25, 987.0]",2,1,1
31034.0,2020-01-01,"(150.194, 352.5]",1,1,0
31034.0,2020-01-01,"(755.5, 957.0]",2,7,-5
31035.0,2020-01-01,"(507.137, 723.75]",1,2,-1
31035.0,2020-01-01,"(723.75, 939.5]",2,3,-1
31035.0,2020-01-01,"(1155.25, 1371.0]",1,4,-3
,,,,2.0,
31037.0,2020-01-01,"(662.0, 928.5]",4,1,3
31037.0,2020-01-01,"(928.5, 1195.0]",4,2,2
,,,,2.0,
31039.0,2020-01-01,"(126.991, 380.25]",1,1,0
31039.0,2020-01-01,"(380.25, 632.5]",2,2,0
31039.0,2020-01-01,"(632.5, 884.75]",1,3,-2
31039.0,2020-01-01,"(884.75, 1137.0]",1,2,-1
,,,,1.0,
,,,,1.0,
31041.0,2020-01-01,"(15.944, 281.0]",4,9,-5
31041.0,2020-01-01,"(545.0, 809.0]",2,4,-2
31041.0,2020-01-01,"(809.0, 1073.0]",3,6,-3
31042.0,2020-01-01,"(595.5, 883.75]",3,6,-3
31042.0,2020-01-01,"(883.75, 1172.0]",4,6,-2
,,,,1.0,
,,,,2.0,
31044.0,2020-01-01,"(-0.993, 248.25]",1,2,-1
31044.0,2020-01-01,"(744.75, 993.0]",3,3,0
31045.0,2020-01-01,"(845.695, 922.25]",2,5,-3
31045.0,2020-01-01,"(922.25, 998.5]",2,4,-2
31045.0,2020-01-01,"(998.5, 1074.75]",2,2,0
31046.0,2020-01-01,"(1008.0, 1031.0]",1,1,0
31047.0,2020-01-01,"(843.534, 960.5]",4,5,-1
31047.0,2020-01-01,"(1077.0, 1193.5]",1,2,-1
31048.0,2020-01-01,"(29.719, 351.25]",2,2,0
31048.0,2020-01-01,"(671.5, 991.75]",1,1,0
31049.0,2020-01-01,"(666.677, 747.75]",1,1,0
31049.0,2020-01-01,"(747.75, 828.5]",1,1,0
31049.0,2020-01-01,"(828.5, 909.25]",2,4,-2
31050.0,2020-01-01,"(714.75, 953.0]",1,1,0
31051.0,2020-01-01,"(131.186, 335.5]",2,2,0
31051.0,2020-01-01,"(742.5, 946.0]",1,1,0
31052.0,2020-01-01,"(975.75, 1021.0]",1,1,0
31053.0,2020-01-01,"(796.989, 799.75]",1,1,0
31054.0,2020-01-01,"(635.25, 847.0]",1,1,0
31055.0,2020-01-01,"(917.5, 977.0]",1,1,0
31056.0,2020-01-01,"(1026.25, 1276.0]",2,1,1
31057.0,2020-01-01,"(843.25, 874.5]",1,2,-1
31057.0,2020-01-01,"(905.75, 937.0]",1,2,-1
,,,,2.0,
31059.0,2020-01-01,"(637.0, 868.5]",2,1,1
31059.0,2020-01-01,"(868.5, 1100.0]",5,5,0
31060.0,2020-01-01,"(685.593, 787.75]",2,3,-1
31060.0,2020-01-01,"(787.75, 889.5]",4,8,-4
31060.0,2020-01-01,"(889.5, 991.25]",2,2,0
31060.0,2020-01-01,"(991.25, 1093.0]",1,4,-3
31061.0,2020-01-01,"(975.75, 1301.0]",1,1,0
31062.0,2020-01-01,"(620.602, 720.5]",2,6,-4
31062.0,2020-01-01,"(720.5, 820.0]",1,2,-1
31062.0,2020-01-01,"(820.0, 919.5]",2,3,-1
31062.0,2020-01-01,"(919.5, 1019.0]",3,6,-3
31063.0,2020-01-01,"(699.693, 776.75]",1,2,-1
31063.0,2020-01-01,"(853.5, 930.25]",1,1,0
31063.0,2020-01-01,"(930.25, 1007.0]",1,1,0
31064.0,2020-01-01,"(561.554, 673.5]",1,2,-1
31064.0,2020-01-01,"(785.0, 896.5]",2,5,-3
31064.0,2020-01-01,"(896.5, 1008.0]",11,17,-6
31065.0,2020-01-01,"(898.75, 999.0]",1,2,-1
,,,,1.0,
,,,,1.0,
31067.0,2020-01-01,"(783.0, 1039.0]",2,3,-1
31067.0,2020-01-01,"(1039.0, 1295.0]",2,1,1
31068.0,2020-01-01,"(649.717, 720.75]",1,1,0
31068.0,2020-01-01,"(862.25, 933.0]",1,1,0
31069.0,2020-01-01,"(34.765, 344.75]",1,1,0
31069.0,2020-01-01,"(962.25, 1271.0]",1,2,-1
31070.0,2020-01-01,"(1140.5, 1214.0]",1,2,-1
31071.0,2020-01-01,"(11.76, 323.0]",1,1,0
31071.0,2020-01-01,"(633.0, 943.0]",4,7,-3
31071.0,2020-01-01,"(943.0, 1253.0]",4,9,-5
,,,,2.0,
31073.0,2020-01-01,"(940.25, 1028.5]",1,1,0
31073.0,2020-01-01,"(1116.75, 1205.0]",1,1,0
31074.0,2020-01-01,"(587.908, 611.0]",1,2,-1
31074.0,2020-01-01,"(657.0, 680.0]",1,1,0
31075.0,2020-01-01,"(861.917, 882.75]",1,1,0
,,,,1.0,
,,,,1.0,
31077.0,2020-01-01,"(574.358, 735.5]",3,8,-5
31077.0,2020-01-01,"(735.5, 896.0]",5,6,-1
31077.0,2020-01-01,"(896.0, 1056.5]",7,13,-6
31077.0,2020-01-01,"(1056.5, 1217.0]",2,6,-4
31078.0,2020-01-01,"(141.0, 188.0]",1,1,0
31079.0,2020-01-01,"(108.718, 430.5]",1,1,0
31079.0,2020-01-01,"(751.0, 1071.5]",1,1,0
31079.0,2020-01-01,"(1071.5, 1392.0]",1,4,-3
31080.0,2020-01-01,"(577.264, 762.0]",1,4,-3
31080.0,2020-01-01,"(762.0, 946.0]",3,6,-3
31080.0,2020-01-01,"(946.0, 1130.0]",1,2,-1
31080.0,2020-01-01,"(1130.0, 1314.0]",1,1,0
31081.0,2020-01-01,"(398.339, 564.25]",2,2,0
31081.0,2020-01-01,"(894.75, 1060.0]",1,2,-1
,,,,1.0,
,,,,1.0,
31083.0,2020-01-01,"(658.626, 752.5]",2,4,-2
31083.0,2020-01-01,"(939.5, 1033.0]",4,1,3
31084.0,2020-01-01,"(851.536, 968.0]",1,2,-1
31084.0,2020-01-01,"(1084.0, 1200.0]",2,2,0
31084.0,2020-01-01,"(1200.0, 1316.0]",1,1,0
31085.0,2020-01-01,"(-0.123, 30.75]",1,2,-1
31085.0,2020-01-01,"(92.25, 123.0]",1,1,0
31086.0,2020-01-01,"(842.974, 849.5]",1,1,0
31087.0,2020-01-01,"(821.691, 899.25]",1,4,-3
31087.0,2020-01-01,"(899.25, 976.5]",1,1,0
31087.0,2020-01-01,"(1053.75, 1131.0]",2,2,0
31088.0,2020-01-01,"(182.067, 416.25]",2,2,0
31088.0,2020-01-01,"(882.75, 1116.0]",1,1,0
31089.0,2020-01-01,"(104.778, 411.5]",1,4,-3
31089.0,2020-01-01,"(717.0, 1022.5]",1,3,-2
31089.0,2020-01-01,"(1022.5, 1328.0]",1,2,-1
31090.0,2020-01-01,"(519.688, 598.0]",1,1,0
31090.0,2020-01-01,"(676.0, 754.0]",2,1,1
31090.0,2020-01-01,"(754.0, 832.0]",2,2,0
31091.0,2020-01-01,"(812.5, 883.75]",4,1,3
31091.0,2020-01-01,"(883.75, 955.0]",1,2,-1
31092.0,2020-01-01,"(758.25, 1011.0]",1,1,0
,,,,1.0,
,,,,1.0,
,,,,1.0,
31094.0,2020-01-01,"(276.323, 446.25]",1,1,0
31094.0,2020-01-01,"(784.75, 954.0]",1,2,-1
31095.0,2020-01-01,"(214.5, 286.0]",1,1,0
31096.0,2020-01-01,"(95.912, 369.0]",1,1,0
31096.0,2020-01-01,"(913.0, 1185.0]",1,1,0
31097.0,2020-01-01,"(997.871, 1030.25]",1,1,0
31097.0,2020-01-01,"(1062.5, 1094.75]",2,2,0
31098.0,2020-01-01,"(-0.396, 99.0]",2,3,-1
31098.0,2020-01-01,"(297.0, 396.0]",1,1,0
31099.0,2020-01-01,"(908.75, 997.0]",1,1,0
31100.0,2020-01-01,"(921.789, 974.75]",1,1,0
31100.0,2020-01-01,"(1080.25, 1133.0]",3,1,2
31101.0,2020-01-01,"(34.623, 380.25]",8,14,-6
31101.0,2020-01-01,"(380.25, 724.5]",10,13,-3
31101.0,2020-01-01,"(724.5, 1068.75]",21,35,-14
31101.0,2020-01-01,"(1068.75, 1413.0]",9,14,-5
31102.0,2020-01-01,"(117.758, 429.5]",4,7,-3
31102.0,2020-01-01,"(429.5, 740.0]",3,7,-4
31102.0,2020-01-01,"(740.0, 1050.5]",4,14,-10
31102.0,2020-01-01,"(1050.5, 1361.0]",3,5,-2
31103.0,2020-01-01,"(50.654, 388.5]",2,4,-2
31103.0,2020-01-01,"(725.0, 1061.5]",5,3,2
31103.0,2020-01-01,"(1061.5, 1398.0]",3,24,-21
31104.0,2020-01-01,"(14.676, 347.0]",4,9,-5
31104.0,2020-01-01,"(347.0, 678.0]",2,10,-8
31104.0,2020-01-01,"(678.0, 1009.0]",10,26,-16
31104.0,2020-01-01,"(1009.0, 1340.0]",13,27,-14
31105.0,2020-01-01,"(47.759, 359.25]",1,1,0
31105.0,2020-01-01,"(669.5, 979.75]",1,4,-3
31105.0,2020-01-01,"(979.75, 1290.0]",1,3,-2
31106.0,2020-01-01,"(57.85, 346.5]",1,3,-2
31106.0,2020-01-01,"(921.5, 1209.0]",1,1,0
31107.0,2020-01-01,"(56.703, 382.25]",4,6,-2
31107.0,2020-01-01,"(382.25, 706.5]",1,1,0
31107.0,2020-01-01,"(706.5, 1030.75]",7,19,-12
31107.0,2020-01-01,"(1030.75, 1355.0]",5,8,-3
31108.0,2020-01-01,"(40.787, 345.25]",5,10,-5
31108.0,2020-01-01,"(345.25, 648.5]",1,3,-2
31108.0,2020-01-01,"(648.5, 951.75]",9,23,-14
31108.0,2020-01-01,"(951.75, 1255.0]",21,28,-7
31109.0,2020-01-01,"(60.695, 388.25]",6,12,-6
31109.0,2020-01-01,"(388.25, 714.5]",1,3,-2
31109.0,2020-01-01,"(714.5, 1040.75]",10,18,-8
31109.0,2020-01-01,"(1040.75, 1367.0]",6,13,-7
31110.0,2020-01-01,"(81.838, 373.5]",2,4,-2
31110.0,2020-01-01,"(373.5, 664.0]",3,13,-10
31110.0,2020-01-01,"(664.0, 954.5]",6,15,-9
31110.0,2020-01-01,"(954.5, 1245.0]",11,17,-6
31111.0,2020-01-01,"(580.241, 770.75]",1,3,-2
31111.0,2020-01-01,"(770.75, 960.5]",2,7,-5
31111.0,2020-01-01,"(960.5, 1150.25]",4,5,-1
31111.0,2020-01-01,"(1150.25, 1340.0]",2,2,0
31112.0,2020-01-01,"(599.293, 776.75]",1,2,-1
31112.0,2020-01-01,"(776.75, 953.5]",2,4,-2
31112.0,2020-01-01,"(953.5, 1130.25]",5,6,-1
31112.0,2020-01-01,"(1130.25, 1307.0]",1,1,0
31113.0,2020-01-01,"(20.746, 335.5]",3,12,-9
31113.0,2020-01-01,"(335.5, 649.0]",1,8,-7
31113.0,2020-01-01,"(649.0, 962.5]",3,14,-11
31113.0,2020-01-01,"(962.5, 1276.0]",3,8,-5
31114.0,2020-01-01,"(29.596, 382.0]",5,14,-9
31114.0,2020-01-01,"(382.0, 733.0]",1,6,-5
31114.0,2020-01-01,"(733.0, 1084.0]",9,19,-10
31114.0,2020-01-01,"(1084.0, 1435.0]",4,7,-3
31115.0,2020-01-01,"(19.639, 361.25]",6,9,-3
31115.0,2020-01-01,"(701.5, 1041.75]",2,2,0
31115.0,2020-01-01,"(1041.75, 1382.0]",3,15,-12
31116.0,2020-01-01,"(395.25, 657.5]",1,1,0
31116.0,2020-01-01,"(657.5, 919.75]",5,2,3
31116.0,2020-01-01,"(919.75, 1182.0]",11,17,-6
31117.0,2020-01-01,"(18.695, 346.25]",5,9,-4
31117.0,2020-01-01,"(672.5, 998.75]",7,5,2
31117.0,2020-01-01,"(998.75, 1325.0]",4,17,-13
31118.0,2020-01-01,"(26.667, 361.25]",4,6,-2
31118.0,2020-01-01,"(361.25, 694.5]",1,3,-2
31118.0,2020-01-01,"(694.5, 1027.75]",8,16,-8
31118.0,2020-01-01,"(1027.75, 1361.0]",2,5,-3
31119.0,2020-01-01,"(32.63, 376.5]",2,3,-1
31119.0,2020-01-01,"(376.5, 719.0]",4,12,-8
31119.0,2020-01-01,"(719.0, 1061.5]",8,21,-13
31119.0,2020-01-01,"(1061.5, 1404.0]",8,12,-4
31120.0,2020-01-01,"(110.814, 408.5]",3,3,0
31120.0,2020-01-01,"(705.0, 1001.5]",6,2,4
31120.0,2020-01-01,"(1001.5, 1298.0]",4,11,-7
31121.0,2020-01-01,"(74.928, 344.0]",2,3,-1
31121.0,2020-01-01,"(344.0, 612.0]",2,3,-1
31121.0,2020-01-01,"(612.0, 880.0]",5,6,-1
31121.0,2020-01-01,"(880.0, 1148.0]",4,6,-2
31122.0,2020-01-01,"(13.793, 316.75]",2,6,-4
31122.0,2020-01-01,"(316.75, 618.5]",3,4,-1
31122.0,2020-01-01,"(618.5, 920.25]",8,14,-6
31122.0,2020-01-01,"(920.25, 1222.0]",7,12,-5
31123.0,2020-01-01,"(62.833, 355.75]",2,6,-4
31123.0,2020-01-01,"(647.5, 939.25]",3,2,1
31123.0,2020-01-01,"(939.25, 1231.0]",3,12,-9
31124.0,2020-01-01,"(67.653, 405.75]",2,5,-3
31124.0,2020-01-01,"(405.75, 742.5]",4,12,-8
31124.0,2020-01-01,"(742.5, 1079.25]",10,34,-24
31124.0,2020-01-01,"(1079.25, 1416.0]",8,19,-11
31125.0,2020-01-01,"(78.816, 376.0]",5,9,-4
31125.0,2020-01-01,"(376.0, 672.0]",7,12,-5
31125.0,2020-01-01,"(672.0, 968.0]",16,40,-24
31125.0,2020-01-01,"(968.0, 1264.0]",15,22,-7
31126.0,2020-01-01,"(41.753, 354.75]",1,6,-5
31126.0,2020-01-01,"(354.75, 666.5]",1,2,-1
31126.0,2020-01-01,"(666.5, 978.25]",1,10,-9
31126.0,2020-01-01,"(978.25, 1290.0]",8,12,-4
,,,,2.0,
31128.0,2020-01-01,"(20.591, 374.25]",5,6,-1
31128.0,2020-01-01,"(374.25, 726.5]",5,12,-7
31128.0,2020-01-01,"(726.5, 1078.75]",15,28,-13
31128.0,2020-01-01,"(1078.75, 1431.0]",7,13,-6
31129.0,2020-01-01,"(221.82, 518.0]",2,3,-1
31129.0,2020-01-01,"(518.0, 813.0]",15,23,-8
31129.0,2020-01-01,"(813.0, 1108.0]",33,52,-19
31129.0,2020-01-01,"(1108.0, 1403.0]",5,7,-2
31130.0,2020-01-01,"(146.797, 448.75]",2,3,-1
31130.0,2020-01-01,"(749.5, 1050.25]",10,17,-7
31130.0,2020-01-01,"(1050.25, 1351.0]",8,12,-4
31131.0,2020-01-01,"(23.771, 332.25]",3,4,-1
31131.0,2020-01-01,"(639.5, 946.75]",2,9,-7
31131.0,2020-01-01,"(946.75, 1254.0]",5,8,-3
31200.0,2020-01-01,"(13.682, 344.5]",2,5,-3
31200.0,2020-01-01,"(344.5, 674.0]",7,11,-4
31200.0,2020-01-01,"(674.0, 1003.5]",23,30,-7
31200.0,2020-01-01,"(1003.5, 1333.0]",4,7,-3
31201.0,2020-01-01,"(76.76, 388.0]",2,7,-5
31201.0,2020-01-01,"(388.0, 698.0]",8,10,-2
31201.0,2020-01-01,"(698.0, 1008.0]",34,63,-29
31201.0,2020-01-01,"(1008.0, 1318.0]",17,37,-20
31202.0,2020-01-01,"(15.666, 350.5]",3,9,-6
31202.0,2020-01-01,"(350.5, 684.0]",3,6,-3
31202.0,2020-01-01,"(684.0, 1017.5]",12,21,-9
31202.0,2020-01-01,"(1017.5, 1351.0]",4,10,-6
31203.0,2020-01-01,"(27.624, 373.0]",2,5,-3
31203.0,2020-01-01,"(373.0, 717.0]",6,10,-4
31203.0,2020-01-01,"(717.0, 1061.0]",13,22,-9
31203.0,2020-01-01,"(1061.0, 1405.0]",5,9,-4
31204.0,2020-01-01,"(664.352, 827.0]",1,5,-4
31204.0,2020-01-01,"(827.0, 989.0]",3,5,-2
31204.0,2020-01-01,"(989.0, 1151.0]",4,5,-1
31204.0,2020-01-01,"(1151.0, 1313.0]",2,2,0
31205.0,2020-01-01,"(644.648, 733.0]",1,1,0
31205.0,2020-01-01,"(733.0, 821.0]",2,2,0
31205.0,2020-01-01,"(909.0, 997.0]",1,3,-2
31206.0,2020-01-01,"(728.0, 750.0]",2,3,-1
31207.0,2020-01-01,"(872.5, 983.25]",1,1,0
31207.0,2020-01-01,"(983.25, 1094.0]",1,2,-1
31208.0,2020-01-01,"(34.703, 360.25]",3,3,0
31208.0,2020-01-01,"(360.25, 684.5]",2,6,-4
31208.0,2020-01-01,"(684.5, 1008.75]",5,8,-3
31208.0,2020-01-01,"(1008.75, 1333.0]",3,5,-2
31209.0,2020-01-01,"(68.174, 275.5]",1,1,0
31209.0,2020-01-01,"(688.5, 895.0]",6,13,-7
31211.0,2020-01-01,"(806.742, 871.5]",2,4,-2
31211.0,2020-01-01,"(871.5, 936.0]",1,2,-1
31211.0,2020-01-01,"(1000.5, 1065.0]",2,2,0
31212.0,2020-01-01,"(18.676, 351.0]",2,2,0
31212.0,2020-01-01,"(351.0, 682.0]",8,12,-4
31212.0,2020-01-01,"(682.0, 1013.0]",4,6,-2
31212.0,2020-01-01,"(1013.0, 1344.0]",4,8,-4
31213.0,2020-01-01,"(156.844, 447.0]",2,3,-1
31213.0,2020-01-01,"(447.0, 736.0]",5,6,-1
31213.0,2020-01-01,"(736.0, 1025.0]",5,9,-4
31213.0,2020-01-01,"(1025.0, 1314.0]",2,4,-2
31214.0,2020-01-01,"(13.688, 343.0]",5,7,-2
31214.0,2020-01-01,"(343.0, 671.0]",3,7,-4
31214.0,2020-01-01,"(671.0, 999.0]",9,28,-19
31214.0,2020-01-01,"(999.0, 1327.0]",17,25,-8
31215.0,2020-01-01,"(331.75, 636.5]",3,2,1
31215.0,2020-01-01,"(636.5, 941.25]",14,3,11
31215.0,2020-01-01,"(941.25, 1246.0]",9,22,-13
31216.0,2020-01-01,"(574.223, 769.25]",1,3,-2
31216.0,2020-01-01,"(769.25, 963.5]",4,4,0
31217.0,2020-01-01,"(520.407, 669.25]",1,1,0
31217.0,2020-01-01,"(669.25, 817.5]",4,9,-5
31217.0,2020-01-01,"(817.5, 965.75]",1,4,-3
31217.0,2020-01-01,"(965.75, 1114.0]",2,3,-1
31218.0,2020-01-01,"(339.0, 675.0]",2,3,-1
31218.0,2020-01-01,"(675.0, 1011.0]",4,2,2
31218.0,2020-01-01,"(1011.0, 1347.0]",1,5,-4
31219.0,2020-01-01,"(25.966, 285.5]",1,1,0
31219.0,2020-01-01,"(544.0, 802.5]",5,5,0
31219.0,2020-01-01,"(802.5, 1061.0]",13,19,-6
31220.0,2020-01-01,"(692.25, 923.0]",3,1,2
31221.0,2020-01-01,"(730.651, 818.25]",3,3,0
31221.0,2020-01-01,"(818.25, 905.5]",1,1,0
31221.0,2020-01-01,"(992.75, 1080.0]",5,7,-2
31222.0,2020-01-01,"(551.146, 765.5]",2,2,0
31222.0,2020-01-01,"(765.5, 979.0]",7,15,-8
31222.0,2020-01-01,"(1192.5, 1406.0]",2,1,1
31223.0,2020-01-01,"(369.25, 700.5]",4,3,1
31223.0,2020-01-01,"(700.5, 1031.75]",4,5,-1
31223.0,2020-01-01,"(1031.75, 1363.0]",4,16,-12
31224.0,2020-01-01,"(103.038, 344.5]",1,2,-1
31224.0,2020-01-01,"(585.0, 825.5]",1,1,0
31224.0,2020-01-01,"(825.5, 1066.0]",2,5,-3
31225.0,2020-01-01,"(327.0, 638.0]",1,1,0
31225.0,2020-01-01,"(638.0, 949.0]",6,1,5
31225.0,2020-01-01,"(949.0, 1260.0]",7,14,-7
31226.0,2020-01-01,"(732.436, 874.0]",1,1,0
31226.0,2020-01-01,"(874.0, 1015.0]",2,4,-2
31226.0,2020-01-01,"(1015.0, 1156.0]",1,2,-1
31226.0,2020-01-01,"(1156.0, 1297.0]",1,3,-2
31227.0,2020-01-01,"(966.75, 1082.5]",3,2,1
31227.0,2020-01-01,"(1198.25, 1314.0]",1,3,-2
31228.0,2020-01-01,"(352.0, 675.0]",1,3,-2
31228.0,2020-01-01,"(675.0, 998.0]",24,3,21
31228.0,2020-01-01,"(998.0, 1321.0]",9,33,-24
31229.0,2020-01-01,"(29.68, 361.0]",4,12,-8
31229.0,2020-01-01,"(361.0, 691.0]",6,15,-9
31229.0,2020-01-01,"(691.0, 1021.0]",22,49,-27
31229.0,2020-01-01,"(1021.0, 1351.0]",13,26,-13
31230.0,2020-01-01,"(222.994, 475.5]",1,2,-1
31230.0,2020-01-01,"(727.0, 978.5]",6,12,-6
31230.0,2020-01-01,"(978.5, 1230.0]",10,10,0
31231.0,2020-01-01,"(80.007, 329.25]",1,1,0
31231.0,2020-01-01,"(825.75, 1074.0]",7,9,-2
31232.0,2020-01-01,"(41.713, 364.75]",3,3,0
31232.0,2020-01-01,"(364.75, 686.5]",3,4,-1
31232.0,2020-01-01,"(686.5, 1008.25]",12,25,-13
31232.0,2020-01-01,"(1008.25, 1330.0]",8,16,-8
31233.0,2020-01-01,"(404.0, 749.0]",2,1,1
31233.0,2020-01-01,"(749.0, 1094.0]",6,2,4
31233.0,2020-01-01,"(1094.0, 1439.0]",4,12,-8
31234.0,2020-01-01,"(106.842, 397.5]",1,3,-2
31234.0,2020-01-01,"(397.5, 687.0]",2,4,-2
31234.0,2020-01-01,"(687.0, 976.5]",3,7,-4
31234.0,2020-01-01,"(976.5, 1266.0]",6,7,-1
31235.0,2020-01-01,"(511.414, 658.5]",1,1,0
31235.0,2020-01-01,"(658.5, 805.0]",1,1,0
31235.0,2020-01-01,"(805.0, 951.5]",6,14,-8
31235.0,2020-01-01,"(951.5, 1098.0]",12,21,-9
31236.0,2020-01-01,"(525.464, 660.0]",1,1,0
31236.0,2020-01-01,"(928.0, 1062.0]",1,1,0
31237.0,2020-01-01,"(45.636, 388.0]",1,1,0
31237.0,2020-01-01,"(729.0, 1070.0]",1,3,-2
31237.0,2020-01-01,"(1070.0, 1411.0]",3,4,-1
31238.0,2020-01-01,"(42.636, 385.0]",2,4,-2
31238.0,2020-01-01,"(385.0, 726.0]",2,6,-4
31238.0,2020-01-01,"(726.0, 1067.0]",16,18,-2
31238.0,2020-01-01,"(1067.0, 1408.0]",3,6,-3
31239.0,2020-01-01,"(96.834, 389.5]",1,2,-1
31239.0,2020-01-01,"(389.5, 681.0]",1,1,0
31239.0,2020-01-01,"(681.0, 972.5]",10,11,-1
31239.0,2020-01-01,"(972.5, 1264.0]",3,4,-1
31240.0,2020-01-01,"(464.408, 613.0]",1,2,-1
31240.0,2020-01-01,"(761.0, 909.0]",9,1,8
31240.0,2020-01-01,"(909.0, 1057.0]",23,28,-5
31241.0,2020-01-01,"(77.881, 358.75]",2,7,-5
31241.0,2020-01-01,"(638.5, 918.25]",8,21,-13
31241.0,2020-01-01,"(918.25, 1198.0]",9,14,-5
31242.0,2020-01-01,"(532.397, 683.75]",1,1,0
31242.0,2020-01-01,"(683.75, 834.5]",1,1,0
31242.0,2020-01-01,"(834.5, 985.25]",2,5,-3
31242.0,2020-01-01,"(985.25, 1136.0]",5,11,-6
31243.0,2020-01-01,"(65.823, 361.25]",1,3,-2
31243.0,2020-01-01,"(361.25, 655.5]",4,6,-2
31243.0,2020-01-01,"(655.5, 949.75]",7,9,-2
31243.0,2020-01-01,"(949.75, 1244.0]",7,20,-13
31244.0,2020-01-01,"(340.0, 632.0]",1,1,0
31244.0,2020-01-01,"(632.0, 924.0]",4,6,-2
31244.0,2020-01-01,"(924.0, 1216.0]",3,9,-6
31245.0,2020-01-01,"(13.623, 359.25]",3,5,-2
31245.0,2020-01-01,"(359.25, 703.5]",4,6,-2
31245.0,2020-01-01,"(703.5, 1047.75]",2,14,-12
31245.0,2020-01-01,"(1047.75, 1392.0]",5,8,-3
31246.0,2020-01-01,"(42.743, 358.25]",2,5,-3
31246.0,2020-01-01,"(358.25, 672.5]",5,8,-3
31246.0,2020-01-01,"(672.5, 986.75]",8,12,-4
31246.0,2020-01-01,"(986.75, 1301.0]",9,27,-18
31247.0,2020-01-01,"(4.8, 306.0]",4,8,-4
31247.0,2020-01-01,"(306.0, 606.0]",5,13,-8
31247.0,2020-01-01,"(606.0, 906.0]",31,52,-21
31247.0,2020-01-01,"(906.0, 1206.0]",30,65,-35
31248.0,2020-01-01,"(510.113, 732.75]",4,11,-7
31248.0,2020-01-01,"(732.75, 954.5]",26,57,-31
31248.0,2020-01-01,"(954.5, 1176.25]",26,39,-13
31248.0,2020-01-01,"(1176.25, 1398.0]",7,9,-2
31249.0,2020-01-01,"(547.28, 728.0]",5,7,-2
31249.0,2020-01-01,"(728.0, 908.0]",19,37,-18
31249.0,2020-01-01,"(908.0, 1088.0]",18,37,-19
31249.0,2020-01-01,"(1088.0, 1268.0]",6,11,-5
31250.0,2020-01-01,"(679.366, 838.5]",2,4,-2
31251.0,2020-01-01,"(56.653, 394.75]",7,9,-2
31251.0,2020-01-01,"(731.5, 1068.25]",9,5,4
31251.0,2020-01-01,"(1068.25, 1405.0]",3,13,-10
31252.0,2020-01-01,"(1014.0, 1042.0]",1,1,0
31253.0,2020-01-01,"(569.227, 763.25]",2,2,0
31253.0,2020-01-01,"(763.25, 956.5]",1,2,-1
31253.0,2020-01-01,"(956.5, 1149.75]",1,1,0
31253.0,2020-01-01,"(1149.75, 1343.0]",2,5,-3
31254.0,2020-01-01,"(0.662, 336.5]",2,3,-1
31254.0,2020-01-01,"(336.5, 671.0]",1,1,0
31254.0,2020-01-01,"(671.0, 1005.5]",4,7,-3
31254.0,2020-01-01,"(1005.5, 1340.0]",2,2,0
31255.0,2020-01-01,"(92.828, 387.0]",3,4,-1
31255.0,2020-01-01,"(387.0, 680.0]",1,3,-2
31255.0,2020-01-01,"(680.0, 973.0]",1,2,-1
31255.0,2020-01-01,"(973.0, 1266.0]",1,2,-1
31256.0,2020-01-01,"(46.76, 358.0]",1,1,0
31256.0,2020-01-01,"(668.0, 978.0]",5,8,-3
31256.0,2020-01-01,"(978.0, 1288.0]",3,7,-4
31257.0,2020-01-01,"(702.5, 1017.75]",6,2,4
31257.0,2020-01-01,"(1017.75, 1333.0]",2,2,0
31258.0,2020-01-01,"(-0.35, 338.5]",4,7,-3
31258.0,2020-01-01,"(338.5, 676.0]",15,22,-7
31258.0,2020-01-01,"(676.0, 1013.5]",48,104,-56
31258.0,2020-01-01,"(1013.5, 1351.0]",13,23,-10
31259.0,2020-01-01,"(179.192, 382.0]",2,4,-2
31259.0,2020-01-01,"(382.0, 584.0]",2,4,-2
31259.0,2020-01-01,"(786.0, 988.0]",2,5,-3
31260.0,2020-01-01,"(45.778, 352.5]",2,2,0
31260.0,2020-01-01,"(658.0, 963.5]",2,2,0
31260.0,2020-01-01,"(963.5, 1269.0]",5,7,-2
31261.0,2020-01-01,"(831.75, 1104.0]",9,1,8
31262.0,2020-01-01,"(51.921, 322.75]",2,3,-1
31262.0,2020-01-01,"(592.5, 862.25]",2,6,-4
31262.0,2020-01-01,"(862.25, 1132.0]",4,7,-3
31263.0,2020-01-01,"(0.888, 280.0]",3,6,-3
31263.0,2020-01-01,"(280.0, 558.0]",1,4,-3
31263.0,2020-01-01,"(558.0, 836.0]",3,5,-2
31263.0,2020-01-01,"(836.0, 1114.0]",13,19,-6
31264.0,2020-01-01,"(18.702, 344.5]",2,3,-1
31264.0,2020-01-01,"(669.0, 993.5]",9,3,6
31264.0,2020-01-01,"(993.5, 1318.0]",2,15,-13
31265.0,2020-01-01,"(75.722, 396.5]",5,7,-2
31265.0,2020-01-01,"(396.5, 716.0]",6,16,-10
31265.0,2020-01-01,"(716.0, 1035.5]",13,20,-7
31265.0,2020-01-01,"(1035.5, 1355.0]",12,22,-10
31266.0,2020-01-01,"(42.644, 383.0]",3,9,-6
31266.0,2020-01-01,"(383.0, 722.0]",2,11,-9
31266.0,2020-01-01,"(722.0, 1061.0]",9,23,-14
31266.0,2020-01-01,"(1061.0, 1400.0]",13,16,-3
31267.0,2020-01-01,"(37.664, 373.0]",5,5,0
31267.0,2020-01-01,"(707.0, 1041.0]",4,2,2
31267.0,2020-01-01,"(1041.0, 1375.0]",4,7,-3
31268.0,2020-01-01,"(30.759, 342.25]",4,14,-10
31268.0,2020-01-01,"(652.5, 962.75]",5,1,4
31268.0,2020-01-01,"(962.75, 1273.0]",8,6,2
31269.0,2020-01-01,"(18.696, 346.0]",2,2,0
31269.0,2020-01-01,"(672.0, 998.0]",9,4,5
31269.0,2020-01-01,"(998.0, 1324.0]",6,17,-11
31270.0,2020-01-01,"(42.821, 338.75]",1,4,-3
31270.0,2020-01-01,"(338.75, 633.5]",2,2,0
31270.0,2020-01-01,"(633.5, 928.25]",5,5,0
31270.0,2020-01-01,"(928.25, 1223.0]",3,5,-2
31271.0,2020-01-01,"(29.675, 362.25]",1,2,-1
31271.0,2020-01-01,"(693.5, 1024.75]",11,25,-14
31271.0,2020-01-01,"(1024.75, 1356.0]",9,18,-9
31272.0,2020-01-01,"(636.583, 741.25]",4,4,0
31272.0,2020-01-01,"(741.25, 845.5]",2,6,-4
31272.0,2020-01-01,"(949.75, 1054.0]",4,3,1
31273.0,2020-01-01,"(535.479, 666.25]",1,1,0
31273.0,2020-01-01,"(666.25, 796.5]",1,2,-1
31273.0,2020-01-01,"(796.5, 926.75]",9,20,-11
31273.0,2020-01-01,"(926.75, 1057.0]",8,10,-2
31274.0,2020-01-01,"(21.956, 284.0]",3,3,0
31274.0,2020-01-01,"(545.0, 806.0]",2,4,-2
31274.0,2020-01-01,"(806.0, 1067.0]",5,14,-9
31275.0,2020-01-01,"(134.833, 427.75]",2,3,-1
31275.0,2020-01-01,"(427.75, 719.5]",2,6,-4
31275.0,2020-01-01,"(719.5, 1011.25]",5,9,-4
31275.0,2020-01-01,"(1011.25, 1303.0]",6,8,-2
31276.0,2020-01-01,"(695.75, 866.5]",2,3,-1
31276.0,2020-01-01,"(866.5, 1037.25]",1,4,-3
31276.0,2020-01-01,"(1037.25, 1208.0]",4,1,3
31277.0,2020-01-01,"(536.162, 746.5]",5,9,-4
31277.0,2020-01-01,"(746.5, 956.0]",6,14,-8
31277.0,2020-01-01,"(956.0, 1165.5]",8,11,-3
31277.0,2020-01-01,"(1165.5, 1375.0]",3,4,-1
31278.0,2020-01-01,"(56.793, 359.75]",3,7,-4
31278.0,2020-01-01,"(359.75, 661.5]",4,5,-1
31278.0,2020-01-01,"(661.5, 963.25]",9,14,-5
31278.0,2020-01-01,"(963.25, 1265.0]",6,15,-9
31279.0,2020-01-01,"(628.0, 942.0]",1,1,0
31279.0,2020-01-01,"(942.0, 1256.0]",1,1,0
31280.0,2020-01-01,"(107.909, 381.75]",4,8,-4
31280.0,2020-01-01,"(381.75, 654.5]",4,7,-3
31280.0,2020-01-01,"(654.5, 927.25]",9,23,-14
31280.0,2020-01-01,"(927.25, 1200.0]",3,6,-3
31000.0,2020-01-02,"(599.347, 763.25]",1,2,-1
31000.0,2020-01-02,"(763.25, 926.5]",3,4,-1
31000.0,2020-01-02,"(926.5, 1089.75]",1,1,0
31000.0,2020-01-02,"(1089.75, 1253.0]",1,2,-1
31001.0,2020-01-02,"(809.701, 884.75]",1,1,0
31001.0,2020-01-02,"(959.5, 1034.25]",1,2,-1
31001.0,2020-01-02,"(1034.25, 1109.0]",2,2,0
31002.0,2020-01-02,"(472.399, 623.25]",2,5,-3
31002.0,2020-01-02,"(923.75, 1074.0]",3,4,-1
31003.0,2020-01-02,"(525.256, 712.0]",1,1,0
31003.0,2020-01-02,"(898.0, 1084.0]",2,1,1
31003.0,2020-01-02,"(1084.0, 1270.0]",1,7,-6
31004.0,2020-01-02,"(1017.5, 1090.0]",2,1,1
31005.0,2020-01-02,"(371.144, 586.0]",1,3,-2
31005.0,2020-01-02,"(800.0, 1014.0]",1,1,0
31005.0,2020-01-02,"(1014.0, 1228.0]",2,7,-5
31006.0,2020-01-02,"(915.734, 982.5]",2,4,-2
31006.0,2020-01-02,"(982.5, 1049.0]",3,5,-2
31006.0,2020-01-02,"(1115.5, 1182.0]",1,1,0
31007.0,2020-01-02,"(449.096, 676.0]",5,14,-9
31007.0,2020-01-02,"(676.0, 902.0]",3,4,-1
31007.0,2020-01-02,"(902.0, 1128.0]",4,12,-8
31007.0,2020-01-02,"(1128.0, 1354.0]",1,4,-3
31009.0,2020-01-02,"(476.112, 699.0]",3,3,0
31009.0,2020-01-02,"(699.0, 921.0]",2,4,-2
31009.0,2020-01-02,"(1143.0, 1365.0]",1,1,0
31010.0,2020-01-02,"(778.427, 922.25]",2,7,-5
31011.0,2020-01-02,"(328.983, 584.25]",3,5,-2
31011.0,2020-01-02,"(838.5, 1092.75]",3,9,-6
31012.0,2020-01-02,"(512.447, 651.25]",2,2,0
31013.0,2020-01-02,"(514.12, 735.0]",3,4,-1
31013.0,2020-01-02,"(955.0, 1175.0]",3,5,-2
31013.0,2020-01-02,"(1175.0, 1395.0]",2,4,-2
31014.0,2020-01-02,"(40.793, 343.75]",1,2,-1
31014.0,2020-01-02,"(343.75, 645.5]",12,16,-4
31014.0,2020-01-02,"(645.5, 947.25]",2,7,-5
31014.0,2020-01-02,"(947.25, 1249.0]",9,16,-7
31015.0,2020-01-02,"(304.903, 580.25]",11,11,0
31015.0,2020-01-02,"(580.25, 854.5]",4,5,-1
31015.0,2020-01-02,"(854.5, 1128.75]",3,6,-3
31015.0,2020-01-02,"(1128.75, 1403.0]",2,2,0
31016.0,2020-01-02,"(412.323, 582.25]",4,6,-2
31016.0,2020-01-02,"(751.5, 920.75]",1,1,0
31016.0,2020-01-02,"(920.75, 1090.0]",2,2,0
31017.0,2020-01-02,"(473.074, 705.5]",3,4,-1
31018.0,2020-01-02,"(631.75, 781.5]",1,4,-3
31018.0,2020-01-02,"(931.25, 1081.0]",2,2,0
31019.0,2020-01-02,"(890.5, 1107.75]",2,1,1
31020.0,2020-01-02,"(550.388, 704.0]",1,1,0
31020.0,2020-01-02,"(1010.0, 1163.0]",3,9,-6
31021.0,2020-01-02,"(600.75, 803.5]",1,5,-4
31021.0,2020-01-02,"(803.5, 1006.25]",1,4,-3
31021.0,2020-01-02,"(1006.25, 1209.0]",3,2,1
31022.0,2020-01-02,"(462.141, 677.75]",2,5,-3
31022.0,2020-01-02,"(677.75, 892.5]",1,4,-3
31022.0,2020-01-02,"(892.5, 1107.25]",5,7,-2
31022.0,2020-01-02,"(1107.25, 1322.0]",1,3,-2
31023.0,2020-01-02,"(593.532, 711.0]",3,3,0
31023.0,2020-01-02,"(945.0, 1062.0]",1,2,-1
31024.0,2020-01-02,"(411.212, 609.0]",5,9,-4
31024.0,2020-01-02,"(609.0, 806.0]",1,3,-2
31024.0,2020-01-02,"(806.0, 1003.0]",2,4,-2
31024.0,2020-01-02,"(1003.0, 1200.0]",2,8,-6
31025.0,2020-01-02,"(614.531, 732.25]",3,5,-2
31025.0,2020-01-02,"(849.5, 966.75]",2,4,-2
31025.0,2020-01-02,"(966.75, 1084.0]",1,2,-1
31026.0,2020-01-02,"(605.5, 803.0]",1,2,-1
31026.0,2020-01-02,"(803.0, 1000.5]",1,1,0
31026.0,2020-01-02,"(1000.5, 1198.0]",1,3,-2
31027.0,2020-01-02,"(502.257, 688.75]",1,3,-2
31027.0,2020-01-02,"(1060.25, 1246.0]",2,3,-1
31028.0,2020-01-02,"(427.347, 591.25]",1,1,0
31029.0,2020-01-02,"(686.5, 933.0]",2,3,-1
31029.0,2020-01-02,"(933.0, 1179.5]",4,3,1
31029.0,2020-01-02,"(1179.5, 1426.0]",2,5,-3
31030.0,2020-01-02,"(402.298, 578.5]",2,6,-4
31030.0,2020-01-02,"(929.5, 1105.0]",4,5,-1
31031.0,2020-01-02,"(890.0, 1085.5]",1,1,0
31031.0,2020-01-02,"(1085.5, 1281.0]",3,1,2
31032.0,2020-01-02,"(899.75, 1041.0]",1,1,0
31033.0,2020-01-02,"(1094.903, 1119.25]",1,1,0
31034.0,2020-01-02,"(464.195, 666.25]",5,8,-3
31034.0,2020-01-02,"(867.5, 1068.75]",1,1,0
31035.0,2020-01-02,"(406.994, 659.5]",1,5,-4
31035.0,2020-01-02,"(659.5, 911.0]",2,3,-1
31035.0,2020-01-02,"(911.0, 1162.5]",1,3,-2
31035.0,2020-01-02,"(1162.5, 1414.0]",3,3,0
31036.0,2020-01-02,"(466.16, 677.0]",1,3,-2
31036.0,2020-01-02,"(887.0, 1097.0]",3,4,-1
31036.0,2020-01-02,"(1097.0, 1307.0]",1,1,0
31037.0,2020-01-02,"(412.114, 634.5]",9,11,-2
31037.0,2020-01-02,"(634.5, 856.0]",3,5,-2
31037.0,2020-01-02,"(856.0, 1077.5]",5,11,-6
31037.0,2020-01-02,"(1077.5, 1299.0]",3,11,-8
31038.0,2020-01-02,"(452.489, 580.75]",1,2,-1
31039.0,2020-01-02,"(427.225, 621.75]",3,5,-2
31039.0,2020-01-02,"(621.75, 815.5]",3,4,-1
31039.0,2020-01-02,"(1009.25, 1203.0]",1,1,0
31040.0,2020-01-02,"(718.871, 751.25]",2,2,0
31041.0,2020-01-02,"(479.289, 657.75]",3,3,0
31041.0,2020-01-02,"(657.75, 835.5]",2,2,0
31041.0,2020-01-02,"(835.5, 1013.25]",3,11,-8
31041.0,2020-01-02,"(1013.25, 1191.0]",2,2,0
31042.0,2020-01-02,"(440.22, 636.0]",9,10,-1
31042.0,2020-01-02,"(636.0, 831.0]",1,2,-1
31042.0,2020-01-02,"(831.0, 1026.0]",1,5,-4
31042.0,2020-01-02,"(1026.0, 1221.0]",3,10,-7
31043.0,2020-01-02,"(432.17, 640.5]",2,6,-4
31043.0,2020-01-02,"(848.0, 1055.5]",2,3,-1
31043.0,2020-01-02,"(1055.5, 1263.0]",2,7,-5
31044.0,2020-01-02,"(417.151, 630.25]",1,2,-1
31044.0,2020-01-02,"(1054.75, 1267.0]",1,1,0
31045.0,2020-01-02,"(262.078, 493.5]",2,3,-1
31045.0,2020-01-02,"(493.5, 724.0]",1,2,-1
31045.0,2020-01-02,"(724.0, 954.5]",1,1,0
31045.0,2020-01-02,"(954.5, 1185.0]",1,2,-1
31046.0,2020-01-02,"(522.152, 735.0]",1,2,-1
31046.0,2020-01-02,"(947.0, 1159.0]",1,1,0
31046.0,2020-01-02,"(1159.0, 1371.0]",1,1,0
31047.0,2020-01-02,"(355.129, 573.75]",6,15,-9
31047.0,2020-01-02,"(573.75, 791.5]",2,2,0
31047.0,2020-01-02,"(791.5, 1009.25]",1,3,-2
31047.0,2020-01-02,"(1009.25, 1227.0]",6,14,-8
31048.0,2020-01-02,"(423.205, 622.75]",2,3,-1
31048.0,2020-01-02,"(1020.25, 1219.0]",2,7,-5
31049.0,2020-01-02,"(539.469, 672.75]",2,4,-2
31049.0,2020-01-02,"(672.75, 805.5]",1,2,-1
,,,,1.0,
,,,,1.0,
31051.0,2020-01-02,"(300.869, 584.75]",1,2,-1
31051.0,2020-01-02,"(584.75, 867.5]",2,3,-1
31051.0,2020-01-02,"(867.5, 1150.25]",2,3,-1
31051.0,2020-01-02,"(1150.25, 1433.0]",2,2,0
31052.0,2020-01-02,"(539.303, 714.25]",1,1,0
31052.0,2020-01-02,"(888.5, 1062.75]",1,2,-1
31052.0,2020-01-02,"(1062.75, 1237.0]",1,1,0
,,,,1.0,
,,,,2.0,
,,,,1.0,
,,,,2.0,
31055.0,2020-01-02,"(963.0, 1117.0]",3,1,2
31056.0,2020-01-02,"(959.5, 1189.75]",1,1,0
31056.0,2020-01-02,"(1189.75, 1420.0]",1,2,-1
31057.0,2020-01-02,"(575.542, 690.5]",1,2,-1
31057.0,2020-01-02,"(919.5, 1034.0]",1,2,-1
,,,,1.0,
,,,,1.0,
31059.0,2020-01-02,"(834.75, 1113.0]",2,1,1
31060.0,2020-01-02,"(556.149, 769.75]",1,1,0
31060.0,2020-01-02,"(769.75, 982.5]",1,1,0
,,,,2.0,
31062.0,2020-01-02,"(685.661, 770.75]",1,1,0
31062.0,2020-01-02,"(770.75, 855.5]",1,1,0
31062.0,2020-01-02,"(940.25, 1025.0]",1,1,0
31063.0,2020-01-02,"(847.789, 900.75]",1,2,-1
31063.0,2020-01-02,"(900.75, 953.5]",2,3,-1
31063.0,2020-01-02,"(1006.25, 1059.0]",1,1,0
31064.0,2020-01-02,"(517.354, 679.5]",1,2,-1
31064.0,2020-01-02,"(679.5, 841.0]",1,3,-2
31064.0,2020-01-02,"(841.0, 1002.5]",8,15,-7
31064.0,2020-01-02,"(1002.5, 1164.0]",2,4,-2
,,,,1.0,
,,,,1.0,
31066.0,2020-01-02,"(940.5, 1016.0]",1,1,0
31067.0,2020-01-02,"(558.189, 761.75]",1,2,-1
31067.0,2020-01-02,"(964.5, 1167.25]",2,1,1
31067.0,2020-01-02,"(1167.25, 1370.0]",1,4,-3
31068.0,2020-01-02,"(742.0, 914.0]",1,1,0
31068.0,2020-01-02,"(914.0, 1086.0]",1,1,0
31069.0,2020-01-02,"(611.75, 793.5]",2,3,-1
31069.0,2020-01-02,"(975.25, 1157.0]",4,2,2
31070.0,2020-01-02,"(647.5, 770.0]",1,2,-1
31070.0,2020-01-02,"(770.0, 892.5]",1,1,0
31071.0,2020-01-02,"(323.104, 548.0]",1,5,-4
31071.0,2020-01-02,"(548.0, 772.0]",4,4,0
31071.0,2020-01-02,"(772.0, 996.0]",4,6,-2
31071.0,2020-01-02,"(996.0, 1220.0]",6,8,-2
,,,,2.0,
31073.0,2020-01-02,"(494.963, 504.25]",1,1,0
31073.0,2020-01-02,"(522.75, 532.0]",1,2,-1
31074.0,2020-01-02,"(860.25, 1147.0]",1,1,0
31075.0,2020-01-02,"(968.0, 1110.0]",1,1,0
31076.0,2020-01-02,"(814.605, 913.75]",2,4,-2
31076.0,2020-01-02,"(1012.5, 1111.25]",1,1,0
31076.0,2020-01-02,"(1111.25, 1210.0]",1,2,-1
31077.0,2020-01-02,"(470.074, 702.5]",4,11,-7
31077.0,2020-01-02,"(702.5, 934.0]",1,3,-2
31077.0,2020-01-02,"(934.0, 1165.5]",3,8,-5
31077.0,2020-01-02,"(1165.5, 1397.0]",1,1,0
31078.0,2020-01-02,"(483.441, 623.75]",3,3,0
31078.0,2020-01-02,"(623.75, 763.5]",1,5,-4
31079.0,2020-01-02,"(811.5, 1004.75]",1,1,0
31079.0,2020-01-02,"(1004.75, 1198.0]",2,1,1
31080.0,2020-01-02,"(823.0, 976.5]",1,5,-4
31080.0,2020-01-02,"(976.5, 1130.0]",3,1,2
31081.0,2020-01-02,"(486.286, 665.5]",2,3,-1
31081.0,2020-01-02,"(844.0, 1022.5]",2,1,1
31081.0,2020-01-02,"(1022.5, 1201.0]",4,2,2
,,,,2.0,
,,,,1.0,
31083.0,2020-01-02,"(910.0, 1058.0]",1,1,0
31084.0,2020-01-02,"(255.055, 492.25]",1,2,-1
31084.0,2020-01-02,"(492.25, 728.5]",3,5,-2
31084.0,2020-01-02,"(728.5, 964.75]",1,2,-1
31084.0,2020-01-02,"(964.75, 1201.0]",1,5,-4
31085.0,2020-01-02,"(655.25, 803.5]",1,2,-1
31085.0,2020-01-02,"(951.75, 1100.0]",2,1,1
,,,,1.0,
,,,,1.0,
,,,,1.0,
31087.0,2020-01-02,"(855.0, 1140.0]",1,1,0
31088.0,2020-01-02,"(975.5, 1107.0]",2,1,1
31089.0,2020-01-02,"(453.201, 653.75]",4,10,-6
31089.0,2020-01-02,"(653.75, 853.5]",2,4,-2
31089.0,2020-01-02,"(853.5, 1053.25]",5,14,-9
31089.0,2020-01-02,"(1053.25, 1253.0]",3,7,-4
31090.0,2020-01-02,"(884.75, 1038.0]",2,1,1
31091.0,2020-01-02,"(918.5, 1160.25]",3,3,0
31091.0,2020-01-02,"(1160.25, 1402.0]",1,4,-3
31092.0,2020-01-02,"(1174.25, 1399.0]",1,1,0
31093.0,2020-01-02,"(845.75, 996.0]",1,1,0
,,,,2.0,
31095.0,2020-01-02,"(786.5, 811.0]",1,1,0
,,,,2.0,
31097.0,2020-01-02,"(492.164, 702.0]",2,2,0
31097.0,2020-01-02,"(1120.0, 1329.0]",1,2,-1
31098.0,2020-01-02,"(431.272, 614.0]",1,7,-6
31098.0,2020-01-02,"(796.0, 978.0]",2,1,1
31098.0,2020-01-02,"(978.0, 1160.0]",4,3,1
31099.0,2020-01-02,"(506.363, 666.25]",1,2,-1
31099.0,2020-01-02,"(666.25, 825.5]",2,5,-3
31099.0,2020-01-02,"(984.75, 1144.0]",2,1,1
31100.0,2020-01-02,"(343.5, 677.0]",7,1,6
31100.0,2020-01-02,"(677.0, 1010.5]",4,8,-4
31100.0,2020-01-02,"(1010.5, 1344.0]",1,8,-7
31101.0,2020-01-02,"(336.5, 671.0]",7,1,6
31101.0,2020-01-02,"(671.0, 1005.5]",19,24,-5
31101.0,2020-01-02,"(1005.5, 1340.0]",33,37,-4
31102.0,2020-01-02,"(323.964, 584.0]",1,14,-13
31102.0,2020-01-02,"(584.0, 843.0]",1,2,-1
31102.0,2020-01-02,"(843.0, 1102.0]",4,6,-2
31102.0,2020-01-02,"(1102.0, 1361.0]",5,9,-4
31103.0,2020-01-02,"(405.012, 653.0]",2,23,-21
31103.0,2020-01-02,"(653.0, 900.0]",2,13,-11
31103.0,2020-01-02,"(900.0, 1147.0]",7,18,-11
31103.0,2020-01-02,"(1147.0, 1394.0]",3,7,-4
31104.0,2020-01-02,"(16.653, 354.75]",1,1,0
31104.0,2020-01-02,"(354.75, 691.5]",6,20,-14
31104.0,2020-01-02,"(691.5, 1028.25]",13,29,-16
31104.0,2020-01-02,"(1028.25, 1365.0]",16,29,-13
31105.0,2020-01-02,"(986.0, 1313.0]",2,1,1
31106.0,2020-01-02,"(455.117, 676.75]",1,4,-3
31106.0,2020-01-02,"(897.5, 1118.25]",3,3,0
31106.0,2020-01-02,"(1118.25, 1339.0]",3,4,-1
31107.0,2020-01-02,"(336.905, 611.75]",2,19,-17
31107.0,2020-01-02,"(611.75, 885.5]",2,10,-8
31107.0,2020-01-02,"(885.5, 1159.25]",13,23,-10
31107.0,2020-01-02,"(1159.25, 1433.0]",7,11,-4
31108.0,2020-01-02,"(372.988, 627.0]",4,17,-13
31108.0,2020-01-02,"(627.0, 880.0]",6,16,-10
31108.0,2020-01-02,"(880.0, 1133.0]",22,32,-10
31108.0,2020-01-02,"(1133.0, 1386.0]",11,13,-2
31109.0,2020-01-02,"(333.006, 582.5]",7,20,-13
31109.0,2020-01-02,"(582.5, 831.0]",3,7,-4
31109.0,2020-01-02,"(831.0, 1079.5]",9,18,-9
31109.0,2020-01-02,"(1079.5, 1328.0]",14,20,-6
31110.0,2020-01-02,"(314.927, 584.25]",14,23,-9
31110.0,2020-01-02,"(584.25, 852.5]",7,18,-11
31110.0,2020-01-02,"(852.5, 1120.75]",17,36,-19
31110.0,2020-01-02,"(1120.75, 1389.0]",7,19,-12
31111.0,2020-01-02,"(330.0, 649.0]",7,2,5
31111.0,2020-01-02,"(649.0, 968.0]",4,15,-11
31111.0,2020-01-02,"(968.0, 1287.0]",18,11,7
31112.0,2020-01-02,"(632.5, 777.0]",2,1,1
31112.0,2020-01-02,"(921.5, 1066.0]",3,3,0
31113.0,2020-01-02,"(316.889, 595.75]",3,15,-12
31113.0,2020-01-02,"(595.75, 873.5]",5,10,-5
31113.0,2020-01-02,"(873.5, 1151.25]",4,6,-2
31113.0,2020-01-02,"(1151.25, 1429.0]",8,13,-5
31114.0,2020-01-02,"(55.648, 395.0]",3,4,-1
31114.0,2020-01-02,"(395.0, 733.0]",3,17,-14
31114.0,2020-01-02,"(733.0, 1071.0]",13,24,-11
31114.0,2020-01-02,"(1071.0, 1409.0]",12,23,-11
31115.0,2020-01-02,"(7.633, 350.75]",2,3,-1
31115.0,2020-01-02,"(350.75, 692.5]",2,16,-14
31115.0,2020-01-02,"(692.5, 1034.25]",2,5,-3
31115.0,2020-01-02,"(1034.25, 1376.0]",11,20,-9
31116.0,2020-01-02,"(370.974, 628.5]",5,13,-8
31116.0,2020-01-02,"(628.5, 885.0]",7,10,-3
31116.0,2020-01-02,"(885.0, 1141.5]",15,22,-7
31116.0,2020-01-02,"(1141.5, 1398.0]",2,8,-6
31117.0,2020-01-02,"(308.989, 562.75]",3,19,-16
31117.0,2020-01-02,"(562.75, 815.5]",2,10,-8
31117.0,2020-01-02,"(815.5, 1068.25]",6,14,-8
31117.0,2020-01-02,"(1068.25, 1321.0]",8,16,-8
31118.0,2020-01-02,"(425.018, 671.5]",1,9,-8
31118.0,2020-01-02,"(671.5, 917.0]",1,4,-3
31118.0,2020-01-02,"(917.0, 1162.5]",15,21,-6
31118.0,2020-01-02,"(1162.5, 1408.0]",5,8,-3
31119.0,2020-01-02,"(253.831, 547.25]",4,18,-14
31119.0,2020-01-02,"(547.25, 839.5]",11,20,-9
31119.0,2020-01-02,"(839.5, 1131.75]",18,31,-13
31119.0,2020-01-02,"(1131.75, 1424.0]",11,21,-10
31120.0,2020-01-02,"(611.25, 875.5]",1,11,-10
31120.0,2020-01-02,"(875.5, 1139.75]",6,7,-1
31120.0,2020-01-02,"(1139.75, 1404.0]",2,8,-6
31121.0,2020-01-02,"(392.056, 629.0]",13,17,-4
31121.0,2020-01-02,"(629.0, 865.0]",4,7,-3
31121.0,2020-01-02,"(865.0, 1101.0]",3,6,-3
31121.0,2020-01-02,"(1101.0, 1337.0]",1,2,-1
31122.0,2020-01-02,"(695.75, 916.5]",2,11,-9
31122.0,2020-01-02,"(916.5, 1137.25]",8,5,3
31122.0,2020-01-02,"(1137.25, 1358.0]",3,15,-12
31123.0,2020-01-02,"(407.047, 646.25]",1,14,-13
31123.0,2020-01-02,"(646.25, 884.5]",2,5,-3
31123.0,2020-01-02,"(884.5, 1122.75]",5,7,-2
31123.0,2020-01-02,"(1122.75, 1361.0]",8,16,-8
31124.0,2020-01-02,"(302.886, 582.5]",10,21,-11
31124.0,2020-01-02,"(582.5, 861.0]",13,35,-22
31124.0,2020-01-02,"(861.0, 1139.5]",11,28,-17
31124.0,2020-01-02,"(1139.5, 1418.0]",6,20,-14
31125.0,2020-01-02,"(354.971, 613.25]",3,24,-21
31125.0,2020-01-02,"(613.25, 870.5]",5,10,-5
31125.0,2020-01-02,"(870.5, 1127.75]",21,25,-4
31125.0,2020-01-02,"(1127.75, 1385.0]",8,11,-3
31126.0,2020-01-02,"(298.933, 566.75]",2,20,-18
31126.0,2020-01-02,"(566.75, 833.5]",1,2,-1
31126.0,2020-01-02,"(833.5, 1100.25]",11,17,-6
31126.0,2020-01-02,"(1100.25, 1367.0]",15,19,-4
,,,,2.0,
31128.0,2020-01-02,"(352.5, 678.0]",16,2,14
31128.0,2020-01-02,"(678.0, 1003.5]",13,21,-8
31128.0,2020-01-02,"(1003.5, 1329.0]",19,25,-6
31129.0,2020-01-02,"(426.086, 655.5]",10,15,-5
31129.0,2020-01-02,"(655.5, 884.0]",19,33,-14
31129.0,2020-01-02,"(884.0, 1112.5]",14,20,-6
31129.0,2020-01-02,"(1112.5, 1341.0]",6,15,-9
31130.0,2020-01-02,"(364.954, 627.5]",4,12,-8
31130.0,2020-01-02,"(627.5, 889.0]",4,9,-5
31130.0,2020-01-02,"(889.0, 1150.5]",2,10,-8
31130.0,2020-01-02,"(1150.5, 1412.0]",7,10,-3
31131.0,2020-01-02,"(936.5, 1169.25]",3,7,-4
31131.0,2020-01-02,"(1169.25, 1402.0]",4,1,3
31200.0,2020-01-02,"(337.955, 600.25]",17,28,-11
31200.0,2020-01-02,"(600.25, 861.5]",9,17,-8
31200.0,2020-01-02,"(861.5, 1122.75]",32,59,-27
31200.0,2020-01-02,"(1122.75, 1384.0]",16,31,-15
31201.0,2020-01-02,"(364.97, 623.5]",19,43,-24
31201.0,2020-01-02,"(623.5, 881.0]",23,48,-25
31201.0,2020-01-02,"(881.0, 1138.5]",32,56,-24
31201.0,2020-01-02,"(1138.5, 1396.0]",8,19,-11
31202.0,2020-01-02,"(406.019, 652.25]",7,17,-10
31202.0,2020-01-02,"(652.25, 897.5]",10,19,-9
31202.0,2020-01-02,"(897.5, 1142.75]",22,34,-12
31202.0,2020-01-02,"(1142.75, 1388.0]",11,18,-7
31203.0,2020-01-02,"(20.609, 369.75]",2,3,-1
31203.0,2020-01-02,"(369.75, 717.5]",11,27,-16
31203.0,2020-01-02,"(717.5, 1065.25]",17,31,-14
31203.0,2020-01-02,"(1065.25, 1413.0]",21,40,-19
31204.0,2020-01-02,"(422.17, 630.5]",5,5,0
31204.0,2020-01-02,"(630.5, 838.0]",3,9,-6
31204.0,2020-01-02,"(838.0, 1045.5]",1,2,-1
31204.0,2020-01-02,"(1045.5, 1253.0]",3,3,0
31205.0,2020-01-02,"(460.25, 733.5]",14,1,13
31205.0,2020-01-02,"(733.5, 1006.75]",3,18,-15
31205.0,2020-01-02,"(1006.75, 1280.0]",3,5,-2
31206.0,2020-01-02,"(401.367, 560.25]",5,5,0
31206.0,2020-01-02,"(560.25, 718.5]",1,3,-2
31206.0,2020-01-02,"(718.5, 876.75]",1,1,0
31206.0,2020-01-02,"(876.75, 1035.0]",1,5,-4
31207.0,2020-01-02,"(720.5, 906.75]",2,1,1
31207.0,2020-01-02,"(906.75, 1093.0]",4,1,3
31208.0,2020-01-02,"(386.182, 591.5]",8,9,-1
31208.0,2020-01-02,"(1000.5, 1205.0]",5,4,1
31209.0,2020-01-02,"(483.126, 702.5]",4,6,-2
31209.0,2020-01-02,"(921.0, 1139.5]",3,3,0
31211.0,2020-01-02,"(449.325, 618.75]",10,12,-2
31211.0,2020-01-02,"(618.75, 787.5]",1,3,-2
31211.0,2020-01-02,"(787.5, 956.25]",3,7,-4
31211.0,2020-01-02,"(956.25, 1125.0]",3,8,-5
31212.0,2020-01-02,"(40.682, 371.5]",1,2,-1
31212.0,2020-01-02,"(371.5, 701.0]",21,34,-13
31212.0,2020-01-02,"(701.0, 1030.5]",13,24,-11
31212.0,2020-01-02,"(1030.5, 1360.0]",11,30,-19
31213.0,2020-01-02,"(379.98, 636.0]",21,27,-6
31213.0,2020-01-02,"(636.0, 891.0]",10,22,-12
31213.0,2020-01-02,"(891.0, 1146.0]",6,11,-5
31213.0,2020-01-02,"(1146.0, 1401.0]",2,4,-2
31214.0,2020-01-02,"(402.75, 743.5]",11,1,10
31214.0,2020-01-02,"(743.5, 1084.25]",30,38,-8
31214.0,2020-01-02,"(1084.25, 1425.0]",15,49,-34
31215.0,2020-01-02,"(468.298, 644.5]",9,10,-1
31215.0,2020-01-02,"(644.5, 820.0]",6,10,-4
31215.0,2020-01-02,"(820.0, 995.5]",7,15,-8
31215.0,2020-01-02,"(995.5, 1171.0]",12,20,-8
31216.0,2020-01-02,"(37.788, 342.0]",3,3,0
31216.0,2020-01-02,"(342.0, 645.0]",17,17,0
31216.0,2020-01-02,"(645.0, 948.0]",9,19,-10
31216.0,2020-01-02,"(948.0, 1251.0]",5,14,-9
31217.0,2020-01-02,"(442.351, 605.25]",6,7,-1
31217.0,2020-01-02,"(605.25, 767.5]",7,7,0
31217.0,2020-01-02,"(767.5, 929.75]",2,6,-4
31217.0,2020-01-02,"(929.75, 1092.0]",3,11,-8
31218.0,2020-01-02,"(331.212, 529.0]",7,20,-13
31218.0,2020-01-02,"(529.0, 726.0]",8,14,-6
31218.0,2020-01-02,"(726.0, 923.0]",2,7,-5
31218.0,2020-01-02,"(923.0, 1120.0]",18,28,-10
31219.0,2020-01-02,"(361.265, 545.75]",6,6,0
31219.0,2020-01-02,"(545.75, 729.5]",4,4,0
31219.0,2020-01-02,"(729.5, 913.25]",4,10,-6
31219.0,2020-01-02,"(913.25, 1097.0]",6,13,-7
31220.0,2020-01-02,"(368.312, 541.0]",11,12,-1
31220.0,2020-01-02,"(713.0, 885.0]",5,2,3
31221.0,2020-01-02,"(453.134, 670.5]",22,26,-4
31221.0,2020-01-02,"(670.5, 887.0]",10,18,-8
31221.0,2020-01-02,"(887.0, 1103.5]",7,29,-22
31221.0,2020-01-02,"(1103.5, 1320.0]",6,11,-5
31222.0,2020-01-02,"(465.167, 674.25]",8,9,-1
31222.0,2020-01-02,"(674.25, 882.5]",2,4,-2
31222.0,2020-01-02,"(882.5, 1090.75]",3,16,-13
31223.0,2020-01-02,"(57.708, 382.0]",1,2,-1
31223.0,2020-01-02,"(382.0, 705.0]",8,28,-20
31223.0,2020-01-02,"(705.0, 1028.0]",5,13,-8
31223.0,2020-01-02,"(1028.0, 1351.0]",10,23,-13
31224.0,2020-01-02,"(436.204, 636.0]",14,18,-4
31224.0,2020-01-02,"(636.0, 835.0]",7,9,-2
31224.0,2020-01-02,"(835.0, 1034.0]",1,3,-2
31224.0,2020-01-02,"(1034.0, 1233.0]",6,14,-8
31225.0,2020-01-02,"(496.106, 720.5]",3,7,-4
31225.0,2020-01-02,"(720.5, 944.0]",2,4,-2
31225.0,2020-01-02,"(944.0, 1167.5]",6,15,-9
31225.0,2020-01-02,"(1167.5, 1391.0]",1,3,-2
31226.0,2020-01-02,"(463.18, 669.0]",2,4,-2
31226.0,2020-01-02,"(669.0, 874.0]",2,3,-1
31226.0,2020-01-02,"(874.0, 1079.0]",2,5,-3
31226.0,2020-01-02,"(1079.0, 1284.0]",2,4,-2
31227.0,2020-01-02,"(455.367, 614.25]",14,15,-1
31227.0,2020-01-02,"(772.5, 930.75]",1,3,-2
31227.0,2020-01-02,"(930.75, 1089.0]",3,19,-16
31228.0,2020-01-02,"(447.016, 694.0]",13,16,-3
31228.0,2020-01-02,"(694.0, 940.0]",21,39,-18
31228.0,2020-01-02,"(940.0, 1186.0]",27,53,-26
31228.0,2020-01-02,"(1186.0, 1432.0]",5,7,-2
31229.0,2020-01-02,"(64.639, 406.25]",3,5,-2
31229.0,2020-01-02,"(406.25, 746.5]",13,49,-36
31229.0,2020-01-02,"(746.5, 1086.75]",36,60,-24
31229.0,2020-01-02,"(1086.75, 1427.0]",15,31,-16
31230.0,2020-01-02,"(397.034, 639.5]",31,39,-8
31230.0,2020-01-02,"(639.5, 881.0]",17,24,-7
31230.0,2020-01-02,"(881.0, 1122.5]",25,47,-22
31230.0,2020-01-02,"(1122.5, 1364.0]",3,10,-7
31231.0,2020-01-02,"(377.958, 639.5]",14,15,-1
31231.0,2020-01-02,"(639.5, 900.0]",4,8,-4
31231.0,2020-01-02,"(900.0, 1160.5]",4,12,-8
31231.0,2020-01-02,"(1160.5, 1421.0]",2,3,-1
31232.0,2020-01-02,"(51.741, 367.75]",2,3,-1
31232.0,2020-01-02,"(367.75, 682.5]",15,16,-1
31232.0,2020-01-02,"(682.5, 997.25]",11,26,-15
31232.0,2020-01-02,"(997.25, 1312.0]",20,40,-20
31233.0,2020-01-02,"(315.036, 557.0]",18,20,-2
31233.0,2020-01-02,"(557.0, 798.0]",4,7,-3
31233.0,2020-01-02,"(798.0, 1039.0]",18,29,-11
31233.0,2020-01-02,"(1039.0, 1280.0]",12,29,-17
31234.0,2020-01-02,"(392.016, 639.0]",4,7,-3
31234.0,2020-01-02,"(639.0, 885.0]",8,16,-8
31234.0,2020-01-02,"(885.0, 1131.0]",8,14,-6
31234.0,2020-01-02,"(1131.0, 1377.0]",5,8,-3
31235.0,2020-01-02,"(501.411, 649.25]",11,11,0
31235.0,2020-01-02,"(796.5, 943.75]",1,5,-4
31235.0,2020-01-02,"(943.75, 1091.0]",11,20,-9
31236.0,2020-01-02,"(552.116, 774.0]",5,5,0
31236.0,2020-01-02,"(774.0, 995.0]",5,8,-3
31236.0,2020-01-02,"(995.0, 1216.0]",1,6,-5
31237.0,2020-01-02,"(188.912, 462.0]",1,4,-3
31237.0,2020-01-02,"(734.0, 1006.0]",10,4,6
31237.0,2020-01-02,"(1006.0, 1278.0]",14,16,-2
31238.0,2020-01-02,"(62.745, 377.75]",1,1,0
31238.0,2020-01-02,"(377.75, 691.5]",3,4,-1
31238.0,2020-01-02,"(691.5, 1005.25]",6,18,-12
31238.0,2020-01-02,"(1005.25, 1319.0]",11,28,-17
31239.0,2020-01-02,"(443.081, 673.75]",19,22,-3
31239.0,2020-01-02,"(673.75, 903.5]",6,11,-5
31239.0,2020-01-02,"(903.5, 1133.25]",8,27,-19
31239.0,2020-01-02,"(1133.25, 1363.0]",1,4,-3
31240.0,2020-01-02,"(687.318, 858.5]",4,13,-9
31240.0,2020-01-02,"(858.5, 1029.0]",19,32,-13
31240.0,2020-01-02,"(1029.0, 1199.5]",1,1,0
31241.0,2020-01-02,"(373.944, 639.0]",20,35,-15
31241.0,2020-01-02,"(639.0, 903.0]",11,23,-12
31241.0,2020-01-02,"(903.0, 1167.0]",14,31,-17
31241.0,2020-01-02,"(1167.0, 1431.0]",10,16,-6
31242.0,2020-01-02,"(387.161, 597.75]",19,22,-3
31242.0,2020-01-02,"(597.75, 807.5]",3,7,-4
31242.0,2020-01-02,"(807.5, 1017.25]",4,12,-8
31243.0,2020-01-02,"(379.039, 620.25]",16,21,-5
31243.0,2020-01-02,"(620.25, 860.5]",2,4,-2
31243.0,2020-01-02,"(860.5, 1100.75]",11,25,-14
31243.0,2020-01-02,"(1100.75, 1341.0]",3,10,-7
31244.0,2020-01-02,"(423.153, 635.75]",10,17,-7
31244.0,2020-01-02,"(635.75, 847.5]",7,13,-6
31244.0,2020-01-02,"(847.5, 1059.25]",3,18,-15
31244.0,2020-01-02,"(1059.25, 1271.0]",5,9,-4
31245.0,2020-01-02,"(340.944, 606.0]",14,29,-15
31245.0,2020-01-02,"(870.0, 1134.0]",10,3,7
31245.0,2020-01-02,"(1134.0, 1398.0]",7,19,-12
31246.0,2020-01-02,"(407.094, 634.5]",13,15,-2
31246.0,2020-01-02,"(634.5, 861.0]",8,12,-4
31246.0,2020-01-02,"(861.0, 1087.5]",14,26,-12
31246.0,2020-01-02,"(1087.5, 1314.0]",6,9,-3
31247.0,2020-01-02,"(433.062, 668.5]",17,32,-15
31247.0,2020-01-02,"(668.5, 903.0]",27,44,-17
31247.0,2020-01-02,"(903.0, 1137.5]",23,58,-35
31247.0,2020-01-02,"(1137.5, 1372.0]",7,11,-4
31248.0,2020-01-02,"(431.031, 674.25]",2,6,-4
31248.0,2020-01-02,"(674.25, 916.5]",20,42,-22
31248.0,2020-01-02,"(916.5, 1158.75]",23,52,-29
31248.0,2020-01-02,"(1158.75, 1401.0]",3,4,-1
31249.0,2020-01-02,"(416.13, 634.5]",10,14,-4
31249.0,2020-01-02,"(634.5, 852.0]",13,32,-19
31249.0,2020-01-02,"(852.0, 1069.5]",24,48,-24
31249.0,2020-01-02,"(1069.5, 1287.0]",4,8,-4
31250.0,2020-01-02,"(422.204, 622.0]",11,14,-3
31250.0,2020-01-02,"(622.0, 821.0]",1,4,-3
31250.0,2020-01-02,"(821.0, 1020.0]",3,10,-7
31250.0,2020-01-02,"(1020.0, 1219.0]",1,14,-13
31251.0,2020-01-02,"(34.802, 335.5]",2,2,0
31251.0,2020-01-02,"(335.5, 635.0]",9,23,-14
31251.0,2020-01-02,"(635.0, 934.5]",11,18,-7
31251.0,2020-01-02,"(934.5, 1234.0]",13,27,-14
31252.0,2020-01-02,"(479.327, 648.25]",12,13,-1
31252.0,2020-01-02,"(648.25, 816.5]",3,4,-1
31252.0,2020-01-02,"(816.5, 984.75]",1,1,0
31252.0,2020-01-02,"(984.75, 1153.0]",3,11,-8
31253.0,2020-01-02,"(369.5, 687.0]",13,1,12
31253.0,2020-01-02,"(687.0, 1004.5]",2,13,-11
31253.0,2020-01-02,"(1004.5, 1322.0]",4,8,-4
31254.0,2020-01-02,"(406.983, 662.25]",28,32,-4
31254.0,2020-01-02,"(662.25, 916.5]",10,24,-14
31254.0,2020-01-02,"(916.5, 1170.75]",4,18,-14
31254.0,2020-01-02,"(1170.75, 1425.0]",2,4,-2
31255.0,2020-01-02,"(382.111, 605.25]",12,18,-6
31255.0,2020-01-02,"(605.25, 827.5]",6,9,-3
31255.0,2020-01-02,"(827.5, 1049.75]",8,17,-9
31255.0,2020-01-02,"(1049.75, 1272.0]",2,7,-5
31256.0,2020-01-02,"(275.007, 524.25]",6,6,0
31256.0,2020-01-02,"(524.25, 772.5]",5,6,-1
31256.0,2020-01-02,"(772.5, 1020.75]",11,16,-5
31256.0,2020-01-02,"(1020.75, 1269.0]",7,16,-9
31257.0,2020-01-02,"(321.891, 600.25]",4,8,-4
31257.0,2020-01-02,"(600.25, 877.5]",7,15,-8
31257.0,2020-01-02,"(877.5, 1154.75]",11,16,-5
31257.0,2020-01-02,"(1154.75, 1432.0]",5,16,-11
31258.0,2020-01-02,"(477.105, 701.75]",28,47,-19
31258.0,2020-01-02,"(701.75, 925.5]",31,68,-37
31258.0,2020-01-02,"(925.5, 1149.25]",34,82,-48
31258.0,2020-01-02,"(1149.25, 1373.0]",6,13,-7
31259.0,2020-01-02,"(451.331, 619.25]",7,7,0
31259.0,2020-01-02,"(619.25, 786.5]",1,6,-5
31259.0,2020-01-02,"(953.75, 1121.0]",1,1,0
31260.0,2020-01-02,"(388.151, 601.25]",11,13,-2
31260.0,2020-01-02,"(601.25, 813.5]",2,5,-3
31260.0,2020-01-02,"(813.5, 1025.75]",2,17,-15
31260.0,2020-01-02,"(1025.75, 1238.0]",2,9,-7
31261.0,2020-01-02,"(401.098, 627.5]",9,9,0
31261.0,2020-01-02,"(1078.5, 1304.0]",2,2,0
31262.0,2020-01-02,"(443.116, 665.0]",5,6,-1
31262.0,2020-01-02,"(665.0, 886.0]",4,8,-4
31262.0,2020-01-02,"(886.0, 1107.0]",4,16,-12
31262.0,2020-01-02,"(1107.0, 1328.0]",2,8,-6
31263.0,2020-01-02,"(405.174, 612.5]",16,22,-6
31263.0,2020-01-02,"(612.5, 819.0]",9,13,-4
31263.0,2020-01-02,"(819.0, 1025.5]",6,14,-8
31263.0,2020-01-02,"(1025.5, 1232.0]",8,20,-12
31264.0,2020-01-02,"(453.055, 690.25]",4,5,-1
31264.0,2020-01-02,"(690.25, 926.5]",2,5,-3
31264.0,2020-01-02,"(926.5, 1162.75]",6,16,-10
31264.0,2020-01-02,"(1162.75, 1399.0]",1,3,-2
31265.0,2020-01-02,"(418.5, 747.0]",13,2,11
31265.0,2020-01-02,"(747.0, 1075.5]",26,33,-7
31265.0,2020-01-02,"(1075.5, 1404.0]",13,44,-31
31266.0,2020-01-02,"(44.725, 364.75]",1,3,-2
31266.0,2020-01-02,"(364.75, 683.5]",5,19,-14
31266.0,2020-01-02,"(683.5, 1002.25]",14,28,-14
31266.0,2020-01-02,"(1002.25, 1321.0]",20,38,-18
31267.0,2020-01-02,"(430.046, 669.5]",12,25,-13
31267.0,2020-01-02,"(669.5, 908.0]",4,7,-3
31267.0,2020-01-02,"(908.0, 1146.5]",13,20,-7
31267.0,2020-01-02,"(1146.5, 1385.0]",5,9,-4
31268.0,2020-01-02,"(329.941, 595.75]",7,24,-17
31268.0,2020-01-02,"(595.75, 860.5]",3,6,-3
31268.0,2020-01-02,"(860.5, 1125.25]",26,32,-6
31268.0,2020-01-02,"(1125.25, 1390.0]",12,17,-5
31269.0,2020-01-02,"(344.958, 606.5]",7,16,-9
31269.0,2020-01-02,"(606.5, 867.0]",10,24,-14
31269.0,2020-01-02,"(867.0, 1127.5]",7,21,-14
31269.0,2020-01-02,"(1127.5, 1388.0]",1,2,-1
31270.0,2020-01-02,"(464.228, 658.0]",13,19,-6
31270.0,2020-01-02,"(658.0, 851.0]",4,8,-4
31270.0,2020-01-02,"(851.0, 1044.0]",5,8,-3
31270.0,2020-01-02,"(1044.0, 1237.0]",7,14,-7
31271.0,2020-01-02,"(384.085, 613.75]",15,21,-6
31271.0,2020-01-02,"(613.75, 842.5]",7,17,-10
31271.0,2020-01-02,"(842.5, 1071.25]",19,44,-25
31271.0,2020-01-02,"(1071.25, 1300.0]",2,7,-5
31272.0,2020-01-02,"(32.903, 308.25]",1,2,-1
31272.0,2020-01-02,"(308.25, 582.5]",19,20,-1
31272.0,2020-01-02,"(582.5, 856.75]",6,9,-3
31272.0,2020-01-02,"(856.75, 1131.0]",9,37,-28
31273.0,2020-01-02,"(520.278, 701.5]",2,4,-2
31273.0,2020-01-02,"(882.0, 1062.5]",2,4,-2
31273.0,2020-01-02,"(1062.5, 1243.0]",1,2,-1
31274.0,2020-01-02,"(394.079, 625.25]",11,17,-6
31274.0,2020-01-02,"(625.25, 855.5]",10,16,-6
31274.0,2020-01-02,"(855.5, 1085.75]",3,12,-9
31274.0,2020-01-02,"(1085.75, 1316.0]",2,5,-3
31275.0,2020-01-02,"(175.765, 485.75]",6,11,-5
31275.0,2020-01-02,"(485.75, 794.5]",6,19,-13
31275.0,2020-01-02,"(794.5, 1103.25]",14,26,-12
31275.0,2020-01-02,"(1103.25, 1412.0]",2,5,-3
31276.0,2020-01-02,"(348.5, 692.0]",12,1,11
31276.0,2020-01-02,"(692.0, 1035.5]",7,16,-9
31276.0,2020-01-02,"(1035.5, 1379.0]",4,19,-15
31277.0,2020-01-02,"(426.162, 636.5]",24,28,-4
31277.0,2020-01-02,"(636.5, 846.0]",22,44,-22
31277.0,2020-01-02,"(846.0, 1055.5]",13,33,-20
31277.0,2020-01-02,"(1055.5, 1265.0]",8,23,-15
31278.0,2020-01-02,"(183.75, 497.5]",5,8,-3
31278.0,2020-01-02,"(497.5, 810.0]",8,18,-10
31278.0,2020-01-02,"(810.0, 1122.5]",16,23,-7
31278.0,2020-01-02,"(1122.5, 1435.0]",7,16,-9
31279.0,2020-01-02,"(391.139, 607.25]",10,11,-1
31279.0,2020-01-02,"(607.25, 822.5]",4,9,-5
31279.0,2020-01-02,"(822.5, 1037.75]",3,8,-5
31280.0,2020-01-02,"(349.106, 573.5]",6,18,-12
31280.0,2020-01-02,"(797.0, 1020.5]",4,2,2
31280.0,2020-01-02,"(1020.5, 1244.0]",12,7,5
31000.0,2020-01-03,"(702.75, 863.5]",1,1,0
31001.0,2020-01-03,"(1172.785, 1226.75]",1,1,0
31001.0,2020-01-03,"(1334.25, 1388.0]",1,2,-1
31002.0,2020-01-03,"(499.431, 642.25]",3,6,-3
31002.0,2020-01-03,"(642.25, 784.5]",1,1,0
31002.0,2020-01-03,"(784.5, 926.75]",3,3,0
31002.0,2020-01-03,"(926.75, 1069.0]",2,3,-1
31003.0,2020-01-03,"(425.046, 664.5]",2,2,0
31003.0,2020-01-03,"(903.0, 1141.5]",1,1,0
31004.0,2020-01-03,"(750.5, 893.75]",1,2,-1
31004.0,2020-01-03,"(893.75, 1037.0]",1,2,-1
31005.0,2020-01-03,"(371.086, 600.5]",4,5,-1
31005.0,2020-01-03,"(1057.5, 1286.0]",2,1,1
31006.0,2020-01-03,"(409.5, 546.0]",1,1,0
31007.0,2020-01-03,"(438.065, 672.75]",6,15,-9
31007.0,2020-01-03,"(672.75, 906.5]",2,3,-1
31007.0,2020-01-03,"(906.5, 1140.25]",4,6,-2
31009.0,2020-01-03,"(442.485, 571.75]",2,2,0
31009.0,2020-01-03,"(571.75, 700.5]",1,1,0
31010.0,2020-01-03,"(443.054, 680.5]",2,4,-2
31010.0,2020-01-03,"(680.5, 917.0]",1,2,-1
31010.0,2020-01-03,"(1153.5, 1390.0]",1,1,0
31011.0,2020-01-03,"(404.315, 576.25]",4,4,0
31011.0,2020-01-03,"(576.25, 747.5]",1,1,0
31011.0,2020-01-03,"(918.75, 1090.0]",1,1,0
31012.0,2020-01-03,"(440.0, 660.0]",2,1,1
31012.0,2020-01-03,"(660.0, 880.0]",1,2,-1
31013.0,2020-01-03,"(784.25, 981.5]",1,1,0
31013.0,2020-01-03,"(981.5, 1178.75]",1,1,0
31013.0,2020-01-03,"(1178.75, 1376.0]",1,1,0
31014.0,2020-01-03,"(484.093, 711.75]",10,16,-6
31014.0,2020-01-03,"(711.75, 938.5]",1,4,-3
31014.0,2020-01-03,"(938.5, 1165.25]",4,9,-5
31014.0,2020-01-03,"(1165.25, 1392.0]",4,4,0
31015.0,2020-01-03,"(427.051, 665.25]",10,10,0
31015.0,2020-01-03,"(665.25, 902.5]",1,3,-2
31015.0,2020-01-03,"(1139.75, 1377.0]",2,4,-2
31016.0,2020-01-03,"(630.75, 835.5]",2,4,-2
31016.0,2020-01-03,"(835.5, 1040.25]",2,2,0
31016.0,2020-01-03,"(1040.25, 1245.0]",2,4,-2
31017.0,2020-01-03,"(436.272, 619.0]",2,3,-1
31018.0,2020-01-03,"(763.0, 918.5]",2,2,0
31018.0,2020-01-03,"(918.5, 1074.0]",1,2,-1
31019.0,2020-01-03,"(922.5, 1146.75]",4,1,3
31020.0,2020-01-03,"(669.25, 683.0]",1,1,0
31021.0,2020-01-03,"(500.55, 613.5]",1,3,-2
31021.0,2020-01-03,"(613.5, 726.0]",1,1,0
31021.0,2020-01-03,"(726.0, 838.5]",1,2,-1
31022.0,2020-01-03,"(489.194, 691.5]",2,5,-3
31022.0,2020-01-03,"(691.5, 893.0]",2,2,0
31022.0,2020-01-03,"(893.0, 1094.5]",2,3,-1
31022.0,2020-01-03,"(1094.5, 1296.0]",1,6,-5
31023.0,2020-01-03,"(1192.0, 1332.0]",1,3,-2
31024.0,2020-01-03,"(414.203, 614.25]",4,8,-4
31024.0,2020-01-03,"(813.5, 1012.75]",1,1,0
31024.0,2020-01-03,"(1012.75, 1212.0]",1,1,0
31025.0,2020-01-03,"(577.75, 728.5]",1,1,0
31025.0,2020-01-03,"(879.25, 1030.0]",2,2,0
31026.0,2020-01-03,"(578.0, 746.0]",1,2,-1
31026.0,2020-01-03,"(746.0, 914.0]",1,2,-1
31026.0,2020-01-03,"(914.0, 1082.0]",4,1,3
31027.0,2020-01-03,"(812.0, 988.0]",1,1,0
31027.0,2020-01-03,"(1164.0, 1340.0]",1,1,0
,,,,1.0,
,,,,2.0,
31029.0,2020-01-03,"(601.0, 759.0]",1,5,-4
31029.0,2020-01-03,"(917.0, 1075.0]",2,2,0
31030.0,2020-01-03,"(922.0, 1148.5]",4,5,-1
31030.0,2020-01-03,"(1148.5, 1375.0]",2,1,1
,,,,1.0,
,,,,1.0,
,,,,1.0,
,,,,1.0,
31032.0,2020-01-03,"(905.25, 1050.0]",1,2,-1
31033.0,2020-01-03,"(526.862, 561.5]",1,1,0
31034.0,2020-01-03,"(506.18, 712.0]",3,4,-1
31035.0,2020-01-03,"(676.0, 886.0]",1,3,-2
31035.0,2020-01-03,"(886.0, 1096.0]",1,2,-1
31035.0,2020-01-03,"(1096.0, 1306.0]",1,1,0
31036.0,2020-01-03,"(746.0, 886.0]",1,4,-3
31036.0,2020-01-03,"(886.0, 1026.0]",1,1,0
31037.0,2020-01-03,"(416.0, 667.0]",11,12,-1
31037.0,2020-01-03,"(917.0, 1167.0]",4,9,-5
31038.0,2020-01-03,"(713.0, 780.0]",1,1,0
31039.0,2020-01-03,"(881.5, 1074.25]",2,3,-1
31040.0,2020-01-03,"(482.233, 674.75]",2,2,0
31040.0,2020-01-03,"(674.75, 866.5]",1,2,-1
31040.0,2020-01-03,"(866.5, 1058.25]",1,1,0
31041.0,2020-01-03,"(758.812, 806.0]",2,2,0
31042.0,2020-01-03,"(462.115, 684.25]",10,12,-2
31042.0,2020-01-03,"(1126.75, 1348.0]",2,3,-1
31043.0,2020-01-03,"(512.435, 654.25]",1,1,0
31043.0,2020-01-03,"(795.5, 936.75]",1,1,0
31044.0,2020-01-03,"(468.369, 626.75]",1,2,-1
31045.0,2020-01-03,"(882.0, 1068.5]",2,2,0
,,,,1.0,
,,,,2.0,
31047.0,2020-01-03,"(411.116, 633.0]",6,7,-1
31047.0,2020-01-03,"(633.0, 854.0]",4,5,-1
31047.0,2020-01-03,"(854.0, 1075.0]",2,3,-1
31047.0,2020-01-03,"(1075.0, 1296.0]",1,7,-6
31048.0,2020-01-03,"(455.121, 675.75]",1,5,-4
31048.0,2020-01-03,"(895.5, 1115.25]",3,3,0
31049.0,2020-01-03,"(519.101, 744.75]",2,2,0
31049.0,2020-01-03,"(744.75, 969.5]",2,3,-1
31049.0,2020-01-03,"(1194.25, 1419.0]",1,1,0
31050.0,2020-01-03,"(962.5, 1110.0]",1,1,0
31051.0,2020-01-03,"(726.5, 876.25]",1,2,-1
31051.0,2020-01-03,"(876.25, 1026.0]",3,1,2
31052.0,2020-01-03,"(507.41, 655.5]",3,4,-1
31052.0,2020-01-03,"(950.5, 1098.0]",2,5,-3
,,,,2.0,
,,,,1.0,
,,,,1.0,
31055.0,2020-01-03,"(437.25, 583.0]",1,1,0
31056.0,2020-01-03,"(829.25, 933.0]",1,2,-1
,,,,1.0,
,,,,2.0,
,,,,2.0,
31059.0,2020-01-03,"(723.75, 965.0]",1,1,0
31060.0,2020-01-03,"(557.424, 702.0]",2,2,0
31060.0,2020-01-03,"(990.0, 1134.0]",1,2,-1
31061.0,2020-01-03,"(507.75, 677.0]",1,1,0
31062.0,2020-01-03,"(489.552, 602.0]",2,4,-2
31062.0,2020-01-03,"(826.0, 938.0]",1,1,0
31063.0,2020-01-03,"(711.75, 949.0]",1,1,0
31064.0,2020-01-03,"(553.319, 724.25]",3,6,-3
31064.0,2020-01-03,"(894.5, 1064.75]",3,1,2
31064.0,2020-01-03,"(1064.75, 1235.0]",3,6,-3
31065.0,2020-01-03,"(504.523, 624.25]",1,1,0
31065.0,2020-01-03,"(743.5, 862.75]",1,1,0
31065.0,2020-01-03,"(862.75, 982.0]",3,6,-3
,,,,1.0,
,,,,1.0,
,,,,1.0,
31067.0,2020-01-03,"(514.869, 547.75]",1,3,-2
31068.0,2020-01-03,"(661.843, 701.25]",2,2,0
31069.0,2020-01-03,"(599.25, 762.5]",1,4,-3
31069.0,2020-01-03,"(762.5, 925.75]",2,2,0
31069.0,2020-01-03,"(925.75, 1089.0]",1,2,-1
31070.0,2020-01-03,"(506.18, 712.0]",1,2,-1
31070.0,2020-01-03,"(1122.0, 1327.0]",1,1,0
31071.0,2020-01-03,"(684.75, 886.5]",1,4,-3
31071.0,2020-01-03,"(886.5, 1088.25]",1,1,0
31071.0,2020-01-03,"(1088.25, 1290.0]",1,1,0
,,,,2.0,
31073.0,2020-01-03,"(495.546, 609.5]",2,3,-1
31073.0,2020-01-03,"(609.5, 723.0]",1,1,0
31073.0,2020-01-03,"(836.5, 950.0]",2,2,0
31074.0,2020-01-03,"(978.0, 1304.0]",4,1,3
,,,,1.0,
,,,,1.0,
31076.0,2020-01-03,"(922.25, 1063.0]",1,1,0
31077.0,2020-01-03,"(26.891, 305.25]",1,1,0
31077.0,2020-01-03,"(582.5, 859.75]",3,3,0
31077.0,2020-01-03,"(859.75, 1137.0]",6,6,0
31078.0,2020-01-03,"(474.523, 594.25]",5,5,0
31079.0,2020-01-03,"(441.278, 622.5]",1,1,0
31079.0,2020-01-03,"(983.5, 1164.0]",3,2,1
31080.0,2020-01-03,"(482.306, 656.5]",1,7,-6
31080.0,2020-01-03,"(1003.5, 1177.0]",1,2,-1
31081.0,2020-01-03,"(478.408, 627.0]",1,1,0
31081.0,2020-01-03,"(923.0, 1071.0]",1,2,-1
31082.0,2020-01-03,"(746.78, 802.0]",1,2,-1
31082.0,2020-01-03,"(802.0, 857.0]",1,1,0
31083.0,2020-01-03,"(949.5, 1093.0]",1,1,0
31084.0,2020-01-03,"(514.175, 721.25]",1,1,0
31084.0,2020-01-03,"(1133.75, 1340.0]",1,3,-2
31085.0,2020-01-03,"(541.822, 586.5]",1,2,-1
31085.0,2020-01-03,"(631.0, 675.5]",1,1,0
31086.0,2020-01-03,"(588.0, 784.0]",1,1,0
31087.0,2020-01-03,"(512.544, 627.0]",1,2,-1
31087.0,2020-01-03,"(855.0, 969.0]",1,1,0
31088.0,2020-01-03,"(600.75, 660.5]",1,1,0
31089.0,2020-01-03,"(475.405, 624.75]",3,4,-1
31089.0,2020-01-03,"(624.75, 773.5]",2,5,-3
31090.0,2020-01-03,"(873.5, 1026.0]",1,1,0
31091.0,2020-01-03,"(606.5, 815.0]",1,5,-4
31091.0,2020-01-03,"(1023.5, 1232.0]",3,2,1
,,,,1.0,
,,,,1.0,
,,,,1.0,
,,,,1.0,
,,,,2.0,
,,,,2.0,
,,,,2.0,
,,,,2.0,
31097.0,2020-01-03,"(500.295, 677.25]",1,3,-2
31097.0,2020-01-03,"(677.25, 853.5]",1,3,-2
31097.0,2020-01-03,"(853.5, 1029.75]",1,2,-1
31097.0,2020-01-03,"(1029.75, 1206.0]",1,1,0
31098.0,2020-01-03,"(464.413, 611.75]",1,5,-4
31098.0,2020-01-03,"(611.75, 758.5]",1,2,-1
31098.0,2020-01-03,"(758.5, 905.25]",1,1,0
31098.0,2020-01-03,"(905.25, 1052.0]",4,5,-1
31099.0,2020-01-03,"(737.738, 803.5]",1,2,-1
31099.0,2020-01-03,"(934.5, 1000.0]",1,3,-2
31100.0,2020-01-03,"(434.088, 663.0]",7,9,-2
31100.0,2020-01-03,"(663.0, 891.0]",4,8,-4
31100.0,2020-01-03,"(891.0, 1119.0]",2,5,-3
31100.0,2020-01-03,"(1119.0, 1347.0]",1,1,0
31101.0,2020-01-03,"(371.128, 590.0]",11,32,-21
31101.0,2020-01-03,"(590.0, 808.0]",15,22,-7
31101.0,2020-01-03,"(808.0, 1026.0]",12,20,-8
31101.0,2020-01-03,"(1026.0, 1244.0]",6,11,-5
31102.0,2020-01-03,"(335.973, 593.75]",1,9,-8
31102.0,2020-01-03,"(593.75, 850.5]",4,7,-3
31102.0,2020-01-03,"(1107.25, 1364.0]",2,3,-1
31103.0,2020-01-03,"(913.0, 1155.0]",9,15,-6
31103.0,2020-01-03,"(1155.0, 1397.0]",3,5,-2
31104.0,2020-01-03,"(346.25, 687.5]",7,1,6
31104.0,2020-01-03,"(687.5, 1028.75]",10,20,-10
31104.0,2020-01-03,"(1028.75, 1370.0]",9,22,-13
31105.0,2020-01-03,"(662.5, 889.0]",1,7,-6
31105.0,2020-01-03,"(889.0, 1115.5]",2,4,-2
31105.0,2020-01-03,"(1115.5, 1342.0]",4,5,-1
31106.0,2020-01-03,"(449.137, 665.75]",5,8,-3
31106.0,2020-01-03,"(665.75, 881.5]",6,7,-1
31106.0,2020-01-03,"(881.5, 1097.25]",3,4,-1
31106.0,2020-01-03,"(1097.25, 1313.0]",1,2,-1
31107.0,2020-01-03,"(429.994, 682.5]",1,19,-18
31107.0,2020-01-03,"(682.5, 934.0]",4,8,-4
31107.0,2020-01-03,"(934.0, 1185.5]",8,20,-12
31107.0,2020-01-03,"(1185.5, 1437.0]",3,3,0
31108.0,2020-01-03,"(7.612, 356.0]",1,1,0
31108.0,2020-01-03,"(356.0, 703.0]",3,17,-14
31108.0,2020-01-03,"(703.0, 1050.0]",10,20,-10
31108.0,2020-01-03,"(1050.0, 1397.0]",10,13,-3
31109.0,2020-01-03,"(405.999, 657.25]",7,26,-19
31109.0,2020-01-03,"(657.25, 907.5]",5,9,-4
31109.0,2020-01-03,"(907.5, 1157.75]",16,21,-5
31109.0,2020-01-03,"(1157.75, 1408.0]",3,6,-3
31110.0,2020-01-03,"(473.063, 708.25]",15,27,-12
31110.0,2020-01-03,"(708.25, 942.5]",8,18,-10
31110.0,2020-01-03,"(942.5, 1176.75]",10,20,-10
31110.0,2020-01-03,"(1176.75, 1411.0]",2,4,-2
31111.0,2020-01-03,"(384.75, 727.5]",6,1,5
31111.0,2020-01-03,"(727.5, 1070.25]",6,14,-8
31111.0,2020-01-03,"(1070.25, 1413.0]",11,16,-5
31112.0,2020-01-03,"(988.5, 1134.0]",3,1,2
31113.0,2020-01-03,"(376.25, 676.5]",1,1,0
31113.0,2020-01-03,"(976.75, 1277.0]",6,10,-4
31114.0,2020-01-03,"(343.25, 678.5]",1,1,0
31114.0,2020-01-03,"(678.5, 1013.75]",4,13,-9
31114.0,2020-01-03,"(1013.75, 1349.0]",14,9,5
31115.0,2020-01-03,"(435.036, 677.0]",1,11,-10
31115.0,2020-01-03,"(677.0, 918.0]",2,7,-5
31115.0,2020-01-03,"(918.0, 1159.0]",10,16,-6
31115.0,2020-01-03,"(1159.0, 1400.0]",3,8,-5
31116.0,2020-01-03,"(45.641, 386.75]",1,1,0
31116.0,2020-01-03,"(386.75, 726.5]",4,17,-13
31116.0,2020-01-03,"(726.5, 1066.25]",7,14,-7
31116.0,2020-01-03,"(1066.25, 1406.0]",14,22,-8
31117.0,2020-01-03,"(361.953, 624.75]",4,21,-17
31117.0,2020-01-03,"(624.75, 886.5]",11,26,-15
31117.0,2020-01-03,"(886.5, 1148.25]",4,13,-9
31117.0,2020-01-03,"(1148.25, 1410.0]",2,4,-2
31118.0,2020-01-03,"(644.5, 867.0]",2,11,-9
31118.0,2020-01-03,"(867.0, 1089.5]",5,7,-2
31118.0,2020-01-03,"(1089.5, 1312.0]",4,9,-5
31119.0,2020-01-03,"(7.593, 360.75]",2,3,-1
31119.0,2020-01-03,"(360.75, 712.5]",9,27,-18
31119.0,2020-01-03,"(712.5, 1064.25]",11,20,-9
31119.0,2020-01-03,"(1064.25, 1416.0]",13,24,-11
31120.0,2020-01-03,"(131.861, 417.75]",1,1,0
31120.0,2020-01-03,"(417.75, 702.5]",1,10,-9
31120.0,2020-01-03,"(702.5, 987.25]",1,1,0
31120.0,2020-01-03,"(987.25, 1272.0]",9,11,-2
31121.0,2020-01-03,"(420.077, 651.75]",2,4,-2
31121.0,2020-01-03,"(651.75, 882.5]",4,8,-4
31121.0,2020-01-03,"(882.5, 1113.25]",3,6,-3
31121.0,2020-01-03,"(1113.25, 1344.0]",2,5,-3
31122.0,2020-01-03,"(451.018, 697.5]",1,8,-7
31122.0,2020-01-03,"(697.5, 943.0]",2,4,-2
31122.0,2020-01-03,"(943.0, 1188.5]",5,9,-4
31122.0,2020-01-03,"(1188.5, 1434.0]",1,5,-4
31123.0,2020-01-03,"(377.004, 627.0]",2,8,-6
31123.0,2020-01-03,"(876.0, 1125.0]",2,4,-2
31123.0,2020-01-03,"(1125.0, 1374.0]",3,5,-2
31124.0,2020-01-03,"(352.98, 609.0]",10,18,-8
31124.0,2020-01-03,"(609.0, 864.0]",9,21,-12
31124.0,2020-01-03,"(864.0, 1119.0]",12,34,-22
31124.0,2020-01-03,"(1119.0, 1374.0]",4,10,-6
31125.0,2020-01-03,"(650.5, 886.0]",3,3,0
31125.0,2020-01-03,"(886.0, 1121.5]",9,7,2
31125.0,2020-01-03,"(1121.5, 1357.0]",3,13,-10
31126.0,2020-01-03,"(40.666, 375.5]",1,2,-1
31126.0,2020-01-03,"(375.5, 709.0]",5,26,-21
31126.0,2020-01-03,"(709.0, 1042.5]",5,13,-8
31126.0,2020-01-03,"(1042.5, 1376.0]",13,21,-8
,,,,2.0,
31128.0,2020-01-03,"(373.0, 624.0]",9,15,-6
31128.0,2020-01-03,"(624.0, 874.0]",12,16,-4
31128.0,2020-01-03,"(874.0, 1124.0]",8,13,-5
31128.0,2020-01-03,"(1124.0, 1374.0]",6,7,-1
31129.0,2020-01-03,"(462.35, 625.5]",13,18,-5
31129.0,2020-01-03,"(625.5, 788.0]",7,17,-10
31129.0,2020-01-03,"(788.0, 950.5]",4,4,0
31130.0,2020-01-03,"(424.009, 672.75]",5,11,-6
31130.0,2020-01-03,"(920.5, 1168.25]",13,1,12
31130.0,2020-01-03,"(1168.25, 1416.0]",8,18,-10
31131.0,2020-01-03,"(891.0, 1110.5]",1,9,-8
31131.0,2020-01-03,"(1110.5, 1330.0]",2,1,1
31200.0,2020-01-03,"(335.92, 607.0]",21,32,-11
31200.0,2020-01-03,"(607.0, 877.0]",20,32,-12
31200.0,2020-01-03,"(877.0, 1147.0]",16,34,-18
31200.0,2020-01-03,"(1147.0, 1417.0]",2,11,-9
31201.0,2020-01-03,"(20.64, 362.0]",2,3,-1
31201.0,2020-01-03,"(362.0, 702.0]",16,31,-15
31201.0,2020-01-03,"(702.0, 1042.0]",19,36,-17
31201.0,2020-01-03,"(1042.0, 1382.0]",25,50,-25
31202.0,2020-01-03,"(447.031, 690.25]",5,16,-11
31202.0,2020-01-03,"(690.25, 932.5]",8,16,-8
31202.0,2020-01-03,"(932.5, 1174.75]",18,27,-9
31202.0,2020-01-03,"(1174.75, 1417.0]",6,8,-2
31203.0,2020-01-03,"(-1.41, 352.5]",1,2,-1
31203.0,2020-01-03,"(352.5, 705.0]",11,23,-12
31203.0,2020-01-03,"(705.0, 1057.5]",19,34,-15
31203.0,2020-01-03,"(1057.5, 1410.0]",9,22,-13
31204.0,2020-01-03,"(437.298, 613.5]",7,7,0
31204.0,2020-01-03,"(613.5, 789.0]",1,3,-2
31205.0,2020-01-03,"(482.338, 648.5]",5,6,-1
31205.0,2020-01-03,"(648.5, 814.0]",1,3,-2
31206.0,2020-01-03,"(454.469, 587.75]",1,1,0
31206.0,2020-01-03,"(853.25, 986.0]",1,2,-1
31207.0,2020-01-03,"(350.121, 570.75]",1,6,-5
31207.0,2020-01-03,"(790.5, 1010.25]",4,2,2
31207.0,2020-01-03,"(1010.25, 1230.0]",1,4,-3
31208.0,2020-01-03,"(445.259, 631.25]",3,5,-2
31208.0,2020-01-03,"(631.25, 816.5]",4,6,-2
31208.0,2020-01-03,"(816.5, 1001.75]",2,5,-3
31208.0,2020-01-03,"(1001.75, 1187.0]",2,2,0
31209.0,2020-01-03,"(540.446, 679.5]",1,4,-3
31209.0,2020-01-03,"(679.5, 818.0]",1,1,0
31209.0,2020-01-03,"(818.0, 956.5]",1,1,0
31209.0,2020-01-03,"(956.5, 1095.0]",3,7,-4
31211.0,2020-01-03,"(471.435, 613.25]",4,6,-2
31211.0,2020-01-03,"(754.5, 895.75]",1,2,-1
31211.0,2020-01-03,"(895.75, 1037.0]",1,1,0
31212.0,2020-01-03,"(352.015, 599.25]",17,25,-8
31212.0,2020-01-03,"(599.25, 845.5]",10,13,-3
31212.0,2020-01-03,"(845.5, 1091.75]",5,10,-5
31212.0,2020-01-03,"(1091.75, 1338.0]",7,15,-8
31213.0,2020-01-03,"(344.75, 655.5]",20,1,19
31213.0,2020-01-03,"(655.5, 966.25]",10,29,-19
31213.0,2020-01-03,"(966.25, 1277.0]",21,16,5
31214.0,2020-01-03,"(9.596, 362.0]",3,4,-1
31214.0,2020-01-03,"(362.0, 713.0]",11,33,-22
31214.0,2020-01-03,"(713.0, 1064.0]",18,35,-17
31214.0,2020-01-03,"(1064.0, 1415.0]",10,17,-7
31215.0,2020-01-03,"(534.278, 715.5]",12,13,-1
31215.0,2020-01-03,"(715.5, 896.0]",3,3,0
31215.0,2020-01-03,"(896.0, 1076.5]",4,8,-4
31215.0,2020-01-03,"(1076.5, 1257.0]",3,9,-6
31216.0,2020-01-03,"(483.306, 657.5]",5,5,0
31216.0,2020-01-03,"(831.0, 1004.5]",3,3,0
31216.0,2020-01-03,"(1004.5, 1178.0]",1,5,-4
31217.0,2020-01-03,"(370.301, 545.75]",5,6,-1
31217.0,2020-01-03,"(720.5, 895.25]",2,3,-1
31217.0,2020-01-03,"(895.25, 1070.0]",1,3,-2
31218.0,2020-01-03,"(409.277, 590.75]",7,14,-7
31218.0,2020-01-03,"(771.5, 952.25]",10,1,9
31218.0,2020-01-03,"(952.25, 1133.0]",7,14,-7
31219.0,2020-01-03,"(365.197, 566.75]",5,5,0
31219.0,2020-01-03,"(566.75, 767.5]",4,4,0
31219.0,2020-01-03,"(767.5, 968.25]",2,5,-3
31219.0,2020-01-03,"(968.25, 1169.0]",1,9,-8
31220.0,2020-01-03,"(466.395, 618.25]",12,13,-1
31220.0,2020-01-03,"(618.25, 769.5]",2,6,-4
31220.0,2020-01-03,"(769.5, 920.75]",2,4,-2
31221.0,2020-01-03,"(449.02, 695.0]",20,22,-2
31221.0,2020-01-03,"(695.0, 940.0]",7,11,-4
31221.0,2020-01-03,"(940.0, 1185.0]",9,17,-8
31221.0,2020-01-03,"(1185.0, 1430.0]",1,1,0
31222.0,2020-01-03,"(464.194, 666.5]",19,21,-2
31222.0,2020-01-03,"(666.5, 868.0]",2,4,-2
31222.0,2020-01-03,"(868.0, 1069.5]",4,12,-8
31223.0,2020-01-03,"(378.5, 693.0]",9,2,7
31223.0,2020-01-03,"(693.0, 1007.5]",6,22,-16
31223.0,2020-01-03,"(1007.5, 1322.0]",6,18,-12
31224.0,2020-01-03,"(459.166, 668.5]",7,10,-3
31224.0,2020-01-03,"(668.5, 877.0]",3,4,-1
31224.0,2020-01-03,"(877.0, 1085.5]",3,6,-3
31224.0,2020-01-03,"(1085.5, 1294.0]",2,3,-1
31225.0,2020-01-03,"(483.282, 663.5]",6,8,-2
31225.0,2020-01-03,"(663.5, 843.0]",1,3,-2
31225.0,2020-01-03,"(843.0, 1022.5]",3,3,0
31225.0,2020-01-03,"(1022.5, 1202.0]",5,9,-4
31226.0,2020-01-03,"(468.374, 625.5]",2,5,-3
31226.0,2020-01-03,"(938.5, 1095.0]",4,1,3
31227.0,2020-01-03,"(408.333, 575.75]",18,22,-4
31227.0,2020-01-03,"(575.75, 742.5]",5,10,-5
31227.0,2020-01-03,"(742.5, 909.25]",5,7,-2
31227.0,2020-01-03,"(909.25, 1076.0]",1,9,-8
31228.0,2020-01-03,"(39.742, 355.5]",1,3,-2
31228.0,2020-01-03,"(355.5, 670.0]",14,19,-5
31228.0,2020-01-03,"(670.0, 984.5]",26,44,-18
31228.0,2020-01-03,"(984.5, 1299.0]",19,35,-16
31229.0,2020-01-03,"(60.707, 385.25]",1,3,-2
31229.0,2020-01-03,"(385.25, 708.5]",12,52,-40
31229.0,2020-01-03,"(708.5, 1031.75]",19,38,-19
31229.0,2020-01-03,"(1031.75, 1355.0]",15,27,-12
31230.0,2020-01-03,"(412.0, 702.0]",30,1,29
31230.0,2020-01-03,"(702.0, 992.0]",8,40,-32
31230.0,2020-01-03,"(992.0, 1282.0]",10,16,-6
31231.0,2020-01-03,"(510.248, 699.0]",14,17,-3
31231.0,2020-01-03,"(699.0, 887.0]",5,7,-2
31231.0,2020-01-03,"(887.0, 1075.0]",5,9,-4
31231.0,2020-01-03,"(1075.0, 1263.0]",2,3,-1
31232.0,2020-01-03,"(53.722, 374.5]",2,6,-4
31232.0,2020-01-03,"(374.5, 694.0]",22,29,-7
31232.0,2020-01-03,"(694.0, 1013.5]",17,31,-14
31232.0,2020-01-03,"(1013.5, 1333.0]",10,22,-12
31233.0,2020-01-03,"(467.106, 691.5]",23,24,-1
31233.0,2020-01-03,"(691.5, 915.0]",4,9,-5
31233.0,2020-01-03,"(915.0, 1138.5]",9,13,-4
31234.0,2020-01-03,"(66.717, 388.75]",2,2,0
31234.0,2020-01-03,"(388.75, 709.5]",10,20,-10
31234.0,2020-01-03,"(709.5, 1030.25]",11,16,-5
31234.0,2020-01-03,"(1030.25, 1351.0]",7,14,-7
31235.0,2020-01-03,"(517.409, 665.75]",5,5,0
31235.0,2020-01-03,"(665.75, 813.5]",2,5,-3
31235.0,2020-01-03,"(961.25, 1109.0]",1,3,-2
31236.0,2020-01-03,"(466.082, 696.5]",8,8,0
31236.0,2020-01-03,"(696.5, 926.0]",1,1,0
31236.0,2020-01-03,"(926.0, 1155.5]",3,10,-7
31237.0,2020-01-03,"(479.134, 696.5]",4,10,-6
31237.0,2020-01-03,"(696.5, 913.0]",4,9,-5
31237.0,2020-01-03,"(913.0, 1129.5]",7,9,-2
31237.0,2020-01-03,"(1129.5, 1346.0]",4,11,-7
31238.0,2020-01-03,"(68.745, 383.75]",1,1,0
31238.0,2020-01-03,"(383.75, 697.5]",14,18,-4
31238.0,2020-01-03,"(697.5, 1011.25]",6,11,-5
31238.0,2020-01-03,"(1011.25, 1325.0]",4,19,-15
31239.0,2020-01-03,"(38.768, 348.0]",1,2,-1
31239.0,2020-01-03,"(348.0, 656.0]",14,17,-3
31239.0,2020-01-03,"(656.0, 964.0]",14,19,-5
31239.0,2020-01-03,"(964.0, 1272.0]",6,16,-10
31240.0,2020-01-03,"(596.53, 714.5]",5,8,-3
31240.0,2020-01-03,"(949.5, 1067.0]",1,1,0
31241.0,2020-01-03,"(374.75, 664.5]",18,2,16
31241.0,2020-01-03,"(664.5, 954.25]",15,45,-30
31241.0,2020-01-03,"(954.25, 1244.0]",8,25,-17
31242.0,2020-01-03,"(427.301, 602.75]",12,13,-1
31242.0,2020-01-03,"(602.75, 777.5]",1,4,-3
31242.0,2020-01-03,"(777.5, 952.25]",2,4,-2
31242.0,2020-01-03,"(952.25, 1127.0]",1,9,-8
31243.0,2020-01-03,"(414.024, 659.0]",10,12,-2
31243.0,2020-01-03,"(659.0, 903.0]",14,20,-6
31243.0,2020-01-03,"(903.0, 1147.0]",4,14,-10
31243.0,2020-01-03,"(1147.0, 1391.0]",4,8,-4
31244.0,2020-01-03,"(4.643, 345.25]",1,2,-1
31244.0,2020-01-03,"(345.25, 684.5]",6,11,-5
31244.0,2020-01-03,"(684.5, 1023.75]",9,17,-8
31244.0,2020-01-03,"(1023.75, 1363.0]",3,7,-4
31245.0,2020-01-03,"(429.093, 656.75]",8,19,-11
31245.0,2020-01-03,"(656.75, 883.5]",2,6,-4
31245.0,2020-01-03,"(883.5, 1110.25]",7,11,-4
31245.0,2020-01-03,"(1110.25, 1337.0]",4,7,-3
31246.0,2020-01-03,"(376.0, 693.0]",15,1,14
31246.0,2020-01-03,"(693.0, 1010.0]",10,20,-10
31246.0,2020-01-03,"(1010.0, 1327.0]",10,17,-7
31247.0,2020-01-03,"(470.128, 689.0]",20,26,-6
31247.0,2020-01-03,"(689.0, 907.0]",8,20,-12
31247.0,2020-01-03,"(907.0, 1125.0]",3,13,-10
31247.0,2020-01-03,"(1125.0, 1343.0]",1,3,-2
31248.0,2020-01-03,"(357.253, 544.75]",5,10,-5
31248.0,2020-01-03,"(544.75, 731.5]",10,17,-7
31248.0,2020-01-03,"(731.5, 918.25]",16,27,-11
31248.0,2020-01-03,"(918.25, 1105.0]",7,17,-10
31249.0,2020-01-03,"(414.283, 594.25]",2,3,-1
31249.0,2020-01-03,"(594.25, 773.5]",5,11,-6
31249.0,2020-01-03,"(773.5, 952.75]",1,4,-3
31249.0,2020-01-03,"(952.75, 1132.0]",5,12,-7
31250.0,2020-01-03,"(450.197, 651.75]",6,8,-2
31250.0,2020-01-03,"(651.75, 852.5]",4,7,-3
31250.0,2020-01-03,"(852.5, 1053.25]",1,3,-2
31250.0,2020-01-03,"(1053.25, 1254.0]",4,8,-4
31251.0,2020-01-03,"(68.646, 408.5]",2,2,0
31251.0,2020-01-03,"(408.5, 747.0]",5,14,-9
31251.0,2020-01-03,"(747.0, 1085.5]",5,9,-4
31251.0,2020-01-03,"(1085.5, 1424.0]",7,12,-5
31252.0,2020-01-03,"(466.231, 659.25]",8,10,-2
31252.0,2020-01-03,"(851.5, 1043.75]",1,2,-1
31252.0,2020-01-03,"(1043.75, 1236.0]",7,4,3
31253.0,2020-01-03,"(405.084, 635.0]",11,12,-1
31253.0,2020-01-03,"(635.0, 864.0]",4,7,-3
31253.0,2020-01-03,"(864.0, 1093.0]",6,13,-7
31254.0,2020-01-03,"(413.058, 649.5]",13,15,-2
31254.0,2020-01-03,"(649.5, 885.0]",9,19,-10
31254.0,2020-01-03,"(885.0, 1120.5]",4,11,-7
31255.0,2020-01-03,"(431.238, 622.5]",9,16,-7
31255.0,2020-01-03,"(622.5, 813.0]",4,7,-3
31255.0,2020-01-03,"(813.0, 1003.5]",3,8,-5
31255.0,2020-01-03,"(1003.5, 1194.0]",2,7,-5
31256.0,2020-01-03,"(263.956, 526.0]",5,6,-1
31256.0,2020-01-03,"(526.0, 787.0]",2,4,-2
31256.0,2020-01-03,"(787.0, 1048.0]",10,19,-9
31256.0,2020-01-03,"(1048.0, 1309.0]",2,12,-10
31257.0,2020-01-03,"(420.067, 654.25]",14,20,-6
31257.0,2020-01-03,"(654.25, 887.5]",6,8,-2
31257.0,2020-01-03,"(887.5, 1120.75]",9,16,-7
31257.0,2020-01-03,"(1120.75, 1354.0]",1,3,-2
31258.0,2020-01-03,"(498.154, 710.5]",7,11,-4
31258.0,2020-01-03,"(710.5, 922.0]",5,10,-5
31258.0,2020-01-03,"(922.0, 1133.5]",10,19,-9
31258.0,2020-01-03,"(1133.5, 1345.0]",3,3,0
31259.0,2020-01-03,"(456.335, 623.25]",6,6,0
31259.0,2020-01-03,"(623.25, 789.5]",1,1,0
31260.0,2020-01-03,"(350.983, 606.25]",9,11,-2
31260.0,2020-01-03,"(606.25, 860.5]",4,5,-1
31260.0,2020-01-03,"(860.5, 1114.75]",1,8,-7
31260.0,2020-01-03,"(1114.75, 1369.0]",1,4,-3
31261.0,2020-01-03,"(90.891, 369.25]",3,3,0
31261.0,2020-01-03,"(369.25, 646.5]",8,8,0
31261.0,2020-01-03,"(923.75, 1201.0]",1,1,0
31262.0,2020-01-03,"(410.001, 660.75]",12,12,0
31262.0,2020-01-03,"(660.75, 910.5]",2,4,-2
31262.0,2020-01-03,"(910.5, 1160.25]",3,12,-9
31262.0,2020-01-03,"(1160.25, 1410.0]",2,3,-1
31263.0,2020-01-03,"(503.229, 696.75]",22,31,-9
31263.0,2020-01-03,"(696.75, 889.5]",7,11,-4
31263.0,2020-01-03,"(889.5, 1082.25]",3,7,-4
31264.0,2020-01-03,"(459.145, 673.75]",11,15,-4
31264.0,2020-01-03,"(673.75, 887.5]",6,11,-5
31264.0,2020-01-03,"(887.5, 1101.25]",2,14,-12
31264.0,2020-01-03,"(1101.25, 1315.0]",1,3,-2
31265.0,2020-01-03,"(444.013, 691.75]",19,37,-18
31265.0,2020-01-03,"(691.75, 938.5]",15,27,-12
31265.0,2020-01-03,"(938.5, 1185.25]",18,35,-17
31265.0,2020-01-03,"(1185.25, 1432.0]",4,8,-4
31266.0,2020-01-03,"(53.666, 388.5]",3,7,-4
31266.0,2020-01-03,"(388.5, 722.0]",8,29,-21
31266.0,2020-01-03,"(722.0, 1055.5]",13,24,-11
31266.0,2020-01-03,"(1055.5, 1389.0]",14,24,-10
31267.0,2020-01-03,"(438.089, 666.75]",12,27,-15
31267.0,2020-01-03,"(666.75, 894.5]",6,20,-14
31267.0,2020-01-03,"(894.5, 1122.25]",6,14,-8
31267.0,2020-01-03,"(1122.25, 1350.0]",2,2,0
31268.0,2020-01-03,"(16.584, 372.0]",1,1,0
31268.0,2020-01-03,"(372.0, 726.0]",10,32,-22
31268.0,2020-01-03,"(726.0, 1080.0]",16,19,-3
31268.0,2020-01-03,"(1080.0, 1434.0]",6,13,-7
31269.0,2020-01-03,"(415.107, 639.25]",3,6,-3
31269.0,2020-01-03,"(639.25, 862.5]",6,13,-7
31269.0,2020-01-03,"(862.5, 1085.75]",3,7,-4
31270.0,2020-01-03,"(263.919, 535.25]",5,8,-3
31270.0,2020-01-03,"(535.25, 805.5]",13,21,-8
31270.0,2020-01-03,"(805.5, 1075.75]",5,15,-10
31270.0,2020-01-03,"(1075.75, 1346.0]",1,4,-3
31271.0,2020-01-03,"(474.291, 652.25]",12,14,-2
31271.0,2020-01-03,"(652.25, 829.5]",10,15,-5
31271.0,2020-01-03,"(829.5, 1006.75]",6,17,-11
31271.0,2020-01-03,"(1006.75, 1184.0]",3,8,-5
31272.0,2020-01-03,"(454.084, 684.0]",17,21,-4
31272.0,2020-01-03,"(684.0, 913.0]",25,39,-14
31272.0,2020-01-03,"(913.0, 1142.0]",2,11,-9
31272.0,2020-01-03,"(1142.0, 1371.0]",3,7,-4
,,,,2.0,
31274.0,2020-01-03,"(451.045, 690.75]",9,12,-3
31274.0,2020-01-03,"(690.75, 929.5]",1,2,-1
31274.0,2020-01-03,"(929.5, 1168.25]",2,4,-2
31275.0,2020-01-03,"(359.942, 625.5]",9,15,-6
31275.0,2020-01-03,"(625.5, 890.0]",1,8,-7
31275.0,2020-01-03,"(890.0, 1154.5]",9,15,-6
31275.0,2020-01-03,"(1154.5, 1419.0]",5,7,-2
31276.0,2020-01-03,"(466.161, 676.75]",18,21,-3
31276.0,2020-01-03,"(676.75, 886.5]",11,16,-5
31276.0,2020-01-03,"(886.5, 1096.25]",4,14,-10
31276.0,2020-01-03,"(1096.25, 1306.0]",1,2,-1
31277.0,2020-01-03,"(274.02, 520.0]",10,12,-2
31277.0,2020-01-03,"(520.0, 765.0]",17,21,-4
31277.0,2020-01-03,"(765.0, 1010.0]",3,8,-5
31277.0,2020-01-03,"(1010.0, 1255.0]",16,33,-17
31278.0,2020-01-03,"(22.644, 363.0]",1,1,0
31278.0,2020-01-03,"(363.0, 702.0]",9,28,-19
31278.0,2020-01-03,"(702.0, 1041.0]",6,16,-10
31278.0,2020-01-03,"(1041.0, 1380.0]",10,14,-4
31279.0,2020-01-03,"(460.23, 653.5]",14,15,-1
31279.0,2020-01-03,"(653.5, 846.0]",6,10,-4
31279.0,2020-01-03,"(846.0, 1038.5]",1,8,-7
31279.0,2020-01-03,"(1038.5, 1231.0]",1,6,-5
31280.0,2020-01-03,"(95.67, 429.5]",2,3,-1
31280.0,2020-01-03,"(429.5, 762.0]",8,22,-14
31280.0,2020-01-03,"(762.0, 1094.5]",3,5,-2
31280.0,2020-01-03,"(1094.5, 1427.0]",13,17,-4
31000.0,2020-01-04,"(582.0, 776.0]",1,1,0
31001.0,2020-01-04,"(755.75, 882.5]",2,2,0
31002.0,2020-01-04,"(680.726, 749.5]",2,2,0
31002.0,2020-01-04,"(886.5, 955.0]",1,2,-1
31003.0,2020-01-04,"(652.801, 702.75]",3,4,-1
31004.0,2020-01-04,"(713.347, 877.25]",1,2,-1
31004.0,2020-01-04,"(1203.75, 1367.0]",1,1,0
31005.0,2020-01-04,"(568.206, 767.5]",4,8,-4
31005.0,2020-01-04,"(767.5, 966.0]",3,6,-3
31005.0,2020-01-04,"(966.0, 1164.5]",1,2,-1
31006.0,2020-01-04,"(622.0, 758.0]",1,1,0
31006.0,2020-01-04,"(894.0, 1030.0]",1,3,-2
31007.0,2020-01-04,"(466.0, 663.5]",2,1,1
31007.0,2020-01-04,"(663.5, 861.0]",3,4,-1
31009.0,2020-01-04,"(712.287, 891.25]",1,1,0
31010.0,2020-01-04,"(620.0, 707.0]",1,1,0
31010.0,2020-01-04,"(794.0, 881.0]",1,2,-1
31011.0,2020-01-04,"(415.46, 551.0]",2,2,0
31011.0,2020-01-04,"(551.0, 686.0]",1,2,-1
31011.0,2020-01-04,"(686.0, 821.0]",2,3,-1
31011.0,2020-01-04,"(821.0, 956.0]",1,2,-1
,,,,2.0,
31013.0,2020-01-04,"(71.711, 395.25]",1,1,0
31013.0,2020-01-04,"(717.5, 1039.75]",2,1,1
31013.0,2020-01-04,"(1039.75, 1362.0]",2,5,-3
31014.0,2020-01-04,"(486.087, 715.25]",5,7,-2
31014.0,2020-01-04,"(715.25, 943.5]",1,4,-3
31014.0,2020-01-04,"(1171.75, 1400.0]",1,1,0
31015.0,2020-01-04,"(545.395, 697.25]",2,2,0
31015.0,2020-01-04,"(848.5, 999.75]",1,1,0
31015.0,2020-01-04,"(999.75, 1151.0]",2,2,0
31016.0,2020-01-04,"(489.085, 718.75]",2,5,-3
31016.0,2020-01-04,"(718.75, 947.5]",5,10,-5
31016.0,2020-01-04,"(1176.25, 1405.0]",2,2,0
,,,,2.0,
,,,,1.0,
,,,,2.0,
31018.0,2020-01-04,"(643.716, 715.0]",1,1,0
31018.0,2020-01-04,"(857.0, 928.0]",1,1,0
31019.0,2020-01-04,"(429.5, 757.0]",2,2,0
31019.0,2020-01-04,"(757.0, 1084.5]",1,2,-1
31020.0,2020-01-04,"(837.5, 905.0]",1,1,0
31021.0,2020-01-04,"(655.316, 827.0]",1,2,-1
31021.0,2020-01-04,"(827.0, 998.0]",2,3,-1
31022.0,2020-01-04,"(441.056, 678.0]",3,3,0
31022.0,2020-01-04,"(678.0, 914.0]",5,13,-8
31022.0,2020-01-04,"(914.0, 1150.0]",1,5,-4
31022.0,2020-01-04,"(1150.0, 1386.0]",1,1,0
31023.0,2020-01-04,"(441.204, 641.0]",1,2,-1
31023.0,2020-01-04,"(1039.0, 1238.0]",1,2,-1
31024.0,2020-01-04,"(453.258, 639.5]",1,3,-2
31024.0,2020-01-04,"(639.5, 825.0]",4,6,-2
31024.0,2020-01-04,"(825.0, 1010.5]",2,3,-1
31025.0,2020-01-04,"(854.912, 877.0]",1,1,0
31025.0,2020-01-04,"(899.0, 921.0]",1,1,0
31026.0,2020-01-04,"(473.374, 630.5]",1,2,-1
31026.0,2020-01-04,"(943.5, 1100.0]",1,1,0
,,,,1.0,
,,,,1.0,
,,,,1.0,
,,,,1.0,
31029.0,2020-01-04,"(889.0, 1069.5]",2,2,0
31029.0,2020-01-04,"(1069.5, 1250.0]",1,4,-3
31030.0,2020-01-04,"(104.18, 310.0]",1,1,0
31030.0,2020-01-04,"(720.0, 925.0]",2,3,-1
31031.0,2020-01-04,"(614.75, 729.5]",1,1,0
31031.0,2020-01-04,"(844.25, 959.0]",1,1,0
31032.0,2020-01-04,"(738.5, 839.75]",1,2,-1
31032.0,2020-01-04,"(839.75, 941.0]",2,1,1
31033.0,2020-01-04,"(558.275, 740.25]",2,3,-1
31033.0,2020-01-04,"(921.5, 1102.75]",1,2,-1
31033.0,2020-01-04,"(1102.75, 1284.0]",1,1,0
31034.0,2020-01-04,"(799.637, 890.75]",1,2,-1
31035.0,2020-01-04,"(425.628, 519.0]",1,2,-1
31036.0,2020-01-04,"(749.64, 840.0]",1,3,-2
31036.0,2020-01-04,"(840.0, 930.0]",1,1,0
31036.0,2020-01-04,"(1020.0, 1110.0]",1,1,0
31037.0,2020-01-04,"(195.977, 452.75]",1,1,0
31037.0,2020-01-04,"(708.5, 964.25]",5,9,-4
31037.0,2020-01-04,"(964.25, 1220.0]",6,7,-1
,,,,2.0,
31039.0,2020-01-04,"(737.806, 786.5]",2,3,-1
31039.0,2020-01-04,"(786.5, 835.0]",1,2,-1
31039.0,2020-01-04,"(883.5, 932.0]",1,2,-1
31040.0,2020-01-04,"(540.626, 634.5]",1,1,0
31041.0,2020-01-04,"(802.443, 942.25]",2,4,-2
31042.0,2020-01-04,"(626.0, 703.5]",1,2,-1
31043.0,2020-01-04,"(660.779, 716.25]",1,1,0
31044.0,2020-01-04,"(715.792, 768.0]",1,1,0
31044.0,2020-01-04,"(768.0, 820.0]",1,1,0
31044.0,2020-01-04,"(872.0, 924.0]",2,6,-4
31045.0,2020-01-04,"(168.212, 366.0]",1,1,0
31045.0,2020-01-04,"(563.0, 760.0]",1,1,0
31045.0,2020-01-04,"(760.0, 957.0]",3,6,-3
31046.0,2020-01-04,"(718.0, 918.0]",2,1,1
31046.0,2020-01-04,"(1118.0, 1318.0]",1,4,-3
31047.0,2020-01-04,"(589.185, 793.75]",2,3,-1
31047.0,2020-01-04,"(793.75, 997.5]",1,1,0
31048.0,2020-01-04,"(825.927, 844.25]",1,1,0
31049.0,2020-01-04,"(731.0, 880.5]",2,2,0
31049.0,2020-01-04,"(880.5, 1030.0]",1,4,-3
,,,,2.0,
31051.0,2020-01-04,"(666.0, 893.0]",1,4,-3
31051.0,2020-01-04,"(893.0, 1120.0]",1,1,0
31051.0,2020-01-04,"(1120.0, 1347.0]",1,1,0
31052.0,2020-01-04,"(634.5, 846.0]",1,1,0
31053.0,2020-01-04,"(640.5, 854.0]",2,1,1
,,,,2.0,
31055.0,2020-01-04,"(558.589, 661.75]",1,2,-1
31055.0,2020-01-04,"(661.75, 764.5]",1,2,-1
31055.0,2020-01-04,"(764.5, 867.25]",1,1,0
31056.0,2020-01-04,"(483.511, 606.25]",1,2,-1
31056.0,2020-01-04,"(606.25, 728.5]",1,2,-1
31056.0,2020-01-04,"(850.75, 973.0]",1,1,0
31057.0,2020-01-04,"(698.25, 931.0]",1,1,0
,,,,2.0,
,,,,1.0,
31059.0,2020-01-04,"(1272.75, 1318.0]",1,1,0
31060.0,2020-01-04,"(552.239, 743.25]",1,2,-1
31060.0,2020-01-04,"(1123.75, 1314.0]",1,1,0
31061.0,2020-01-04,"(526.5, 702.0]",1,1,0
31062.0,2020-01-04,"(492.391, 645.25]",9,13,-4
31062.0,2020-01-04,"(645.25, 797.5]",1,1,0
31062.0,2020-01-04,"(797.5, 949.75]",4,14,-10
31062.0,2020-01-04,"(949.75, 1102.0]",11,15,-4
31063.0,2020-01-04,"(507.75, 677.0]",1,1,0
31064.0,2020-01-04,"(345.75, 554.5]",1,1,0
31064.0,2020-01-04,"(554.5, 763.25]",5,1,4
31064.0,2020-01-04,"(763.25, 972.0]",7,11,-4
31065.0,2020-01-04,"(884.0, 927.0]",1,1,0
,,,,2.0,
31067.0,2020-01-04,"(606.78, 662.0]",1,2,-1
31067.0,2020-01-04,"(772.0, 827.0]",1,1,0
31068.0,2020-01-04,"(935.914, 957.5]",1,1,0
31068.0,2020-01-04,"(1000.5, 1022.0]",1,1,0
31069.0,2020-01-04,"(1139.25, 1306.0]",1,1,0
31070.0,2020-01-04,"(571.492, 699.0]",1,3,-2
31070.0,2020-01-04,"(953.0, 1080.0]",1,1,0
31071.0,2020-01-04,"(410.272, 593.0]",1,3,-2
31071.0,2020-01-04,"(593.0, 775.0]",3,4,-1
31071.0,2020-01-04,"(775.0, 957.0]",2,6,-4
31071.0,2020-01-04,"(957.0, 1139.0]",1,1,0
,,,,2.0,
31073.0,2020-01-04,"(926.25, 943.0]",1,1,0
31074.0,2020-01-04,"(434.486, 563.5]",1,2,-1
31074.0,2020-01-04,"(820.5, 949.0]",1,1,0
,,,,1.0,
,,,,1.0,
,,,,2.0,
31077.0,2020-01-04,"(468.517, 589.75]",2,2,0
31077.0,2020-01-04,"(589.75, 710.5]",1,3,-2
31077.0,2020-01-04,"(831.25, 952.0]",2,1,1
,,,,2.0,
31079.0,2020-01-04,"(436.034, 678.5]",2,2,0
31079.0,2020-01-04,"(678.5, 920.0]",2,5,-3
31079.0,2020-01-04,"(920.0, 1161.5]",3,5,-2
31079.0,2020-01-04,"(1161.5, 1403.0]",3,3,0
31080.0,2020-01-04,"(552.212, 750.0]",2,4,-2
31080.0,2020-01-04,"(947.0, 1144.0]",1,1,0
31080.0,2020-01-04,"(1144.0, 1341.0]",2,2,0
31081.0,2020-01-04,"(529.556, 641.0]",1,2,-1
31081.0,2020-01-04,"(863.0, 974.0]",2,4,-2
,,,,2.0,
,,,,2.0,
31084.0,2020-01-04,"(806.875, 838.25]",1,1,0
31084.0,2020-01-04,"(900.75, 932.0]",1,2,-1
31085.0,2020-01-04,"(759.25, 797.0]",3,1,2
31086.0,2020-01-04,"(377.5, 690.0]",1,1,0
31086.0,2020-01-04,"(690.0, 1002.5]",1,1,0
31086.0,2020-01-04,"(1002.5, 1315.0]",1,2,-1
31087.0,2020-01-04,"(52.5, 70.0]",1,1,0
31088.0,2020-01-04,"(828.75, 989.5]",2,4,-2
31089.0,2020-01-04,"(481.081, 711.75]",3,5,-2
31089.0,2020-01-04,"(711.75, 941.5]",1,5,-4
31089.0,2020-01-04,"(1171.25, 1401.0]",2,3,-1
31090.0,2020-01-04,"(461.478, 592.5]",1,1,0
31090.0,2020-01-04,"(723.0, 853.5]",1,1,0
31090.0,2020-01-04,"(853.5, 984.0]",3,2,1
31091.0,2020-01-04,"(121.411, 269.25]",1,2,-1
31091.0,2020-01-04,"(563.75, 711.0]",2,3,-1
31092.0,2020-01-04,"(751.5, 974.0]",1,2,-1
31092.0,2020-01-04,"(1196.5, 1419.0]",1,2,-1
31093.0,2020-01-04,"(894.949, 907.75]",1,1,0
31094.0,2020-01-04,"(154.5, 206.0]",1,1,0
,,,,2.0,
31096.0,2020-01-04,"(544.175, 751.25]",3,6,-3
31096.0,2020-01-04,"(751.25, 957.5]",1,2,-1
31096.0,2020-01-04,"(1163.75, 1370.0]",1,1,0
31097.0,2020-01-04,"(137.742, 453.5]",1,2,-1
31097.0,2020-01-04,"(1082.5, 1397.0]",2,1,1
,,,,1.0,
,,,,1.0,
,,,,1.0,
,,,,1.0,
,,,,2.0,
31100.0,2020-01-04,"(423.512, 546.0]",1,2,-1
31100.0,2020-01-04,"(668.0, 790.0]",3,3,0
31100.0,2020-01-04,"(790.0, 912.0]",2,2,0
31101.0,2020-01-04,"(0.578, 357.5]",2,6,-4
31101.0,2020-01-04,"(357.5, 713.0]",27,40,-13
31101.0,2020-01-04,"(713.0, 1068.5]",34,57,-23
31101.0,2020-01-04,"(1068.5, 1424.0]",10,22,-12
31102.0,2020-01-04,"(387.25, 680.5]",3,1,2
31102.0,2020-01-04,"(680.5, 973.75]",2,5,-3
31102.0,2020-01-04,"(973.75, 1267.0]",2,4,-2
31103.0,2020-01-04,"(552.298, 728.5]",3,16,-13
31103.0,2020-01-04,"(1079.5, 1255.0]",3,4,-1
31104.0,2020-01-04,"(59.653, 397.75]",1,1,0
31104.0,2020-01-04,"(397.75, 734.5]",12,26,-14
31104.0,2020-01-04,"(734.5, 1071.25]",11,26,-15
31104.0,2020-01-04,"(1071.25, 1408.0]",5,9,-4
31105.0,2020-01-04,"(536.151, 749.25]",1,5,-4
31105.0,2020-01-04,"(749.25, 961.5]",2,14,-12
31105.0,2020-01-04,"(1173.75, 1386.0]",2,1,1
31106.0,2020-01-04,"(528.28, 709.0]",2,2,0
31106.0,2020-01-04,"(709.0, 889.0]",1,4,-3
31106.0,2020-01-04,"(889.0, 1069.0]",1,2,-1
31106.0,2020-01-04,"(1069.0, 1249.0]",1,2,-1
31107.0,2020-01-04,"(344.918, 616.5]",3,15,-12
31107.0,2020-01-04,"(616.5, 887.0]",3,17,-14
31107.0,2020-01-04,"(887.0, 1157.5]",3,5,-2
31107.0,2020-01-04,"(1157.5, 1428.0]",4,9,-5
31108.0,2020-01-04,"(97.674, 430.5]",1,2,-1
31108.0,2020-01-04,"(430.5, 762.0]",9,19,-10
31108.0,2020-01-04,"(762.0, 1093.5]",10,23,-13
31108.0,2020-01-04,"(1093.5, 1425.0]",4,7,-3
31109.0,2020-01-04,"(354.25, 697.5]",9,1,8
31109.0,2020-01-04,"(697.5, 1040.75]",16,18,-2
31109.0,2020-01-04,"(1040.75, 1384.0]",8,27,-19
31110.0,2020-01-04,"(455.039, 696.25]",8,14,-6
31110.0,2020-01-04,"(696.25, 936.5]",12,22,-10
31110.0,2020-01-04,"(936.5, 1176.75]",4,7,-3
31110.0,2020-01-04,"(1176.75, 1417.0]",2,5,-3
31111.0,2020-01-04,"(13.585, 368.75]",2,4,-2
31111.0,2020-01-04,"(368.75, 722.5]",2,3,-1
31111.0,2020-01-04,"(722.5, 1076.25]",5,11,-6
31111.0,2020-01-04,"(1076.25, 1430.0]",2,7,-5
31112.0,2020-01-04,"(680.263, 865.25]",1,7,-6
31112.0,2020-01-04,"(865.25, 1049.5]",3,5,-2
31112.0,2020-01-04,"(1049.5, 1233.75]",2,4,-2
31112.0,2020-01-04,"(1233.75, 1418.0]",1,1,0
31113.0,2020-01-04,"(4.616, 352.0]",1,5,-4
31113.0,2020-01-04,"(352.0, 698.0]",3,12,-9
31113.0,2020-01-04,"(698.0, 1044.0]",5,20,-15
31113.0,2020-01-04,"(1044.0, 1390.0]",2,4,-2
31114.0,2020-01-04,"(7.571, 366.25]",1,1,0
31114.0,2020-01-04,"(366.25, 723.5]",6,16,-10
31114.0,2020-01-04,"(723.5, 1080.75]",12,20,-8
31114.0,2020-01-04,"(1080.75, 1438.0]",7,17,-10
31115.0,2020-01-04,"(381.25, 718.5]",5,2,3
31115.0,2020-01-04,"(718.5, 1055.75]",8,18,-10
31115.0,2020-01-04,"(1055.75, 1393.0]",6,16,-10
31116.0,2020-01-04,"(54.683, 385.25]",1,1,0
31116.0,2020-01-04,"(385.25, 714.5]",12,27,-15
31116.0,2020-01-04,"(714.5, 1043.75]",17,23,-6
31116.0,2020-01-04,"(1043.75, 1373.0]",3,6,-3
31117.0,2020-01-04,"(449.112, 672.0]",2,13,-11
31117.0,2020-01-04,"(672.0, 894.0]",2,5,-3
31117.0,2020-01-04,"(894.0, 1116.0]",2,7,-5
31117.0,2020-01-04,"(1116.0, 1338.0]",1,5,-4
31118.0,2020-01-04,"(50.771, 359.25]",1,1,0
31118.0,2020-01-04,"(359.25, 666.5]",1,4,-3
31118.0,2020-01-04,"(666.5, 973.75]",7,16,-9
31118.0,2020-01-04,"(973.75, 1281.0]",3,5,-2
31119.0,2020-01-04,"(6.569, 365.75]",1,4,-3
31119.0,2020-01-04,"(365.75, 723.5]",11,25,-14
31119.0,2020-01-04,"(723.5, 1081.25]",8,17,-9
31119.0,2020-01-04,"(1081.25, 1439.0]",6,10,-4
31120.0,2020-01-04,"(425.25, 747.5]",1,1,0
31120.0,2020-01-04,"(747.5, 1069.75]",8,6,2
31120.0,2020-01-04,"(1069.75, 1392.0]",2,13,-11
31121.0,2020-01-04,"(398.033, 640.75]",2,5,-3
31121.0,2020-01-04,"(640.75, 882.5]",4,9,-5
31121.0,2020-01-04,"(882.5, 1124.25]",1,3,-2
31121.0,2020-01-04,"(1124.25, 1366.0]",3,4,-1
31122.0,2020-01-04,"(24.627, 369.25]",1,2,-1
31122.0,2020-01-04,"(369.25, 712.5]",4,9,-5
31122.0,2020-01-04,"(712.5, 1055.75]",2,4,-2
31122.0,2020-01-04,"(1055.75, 1399.0]",3,4,-1
31123.0,2020-01-04,"(12.759, 324.25]",1,1,0
31123.0,2020-01-04,"(324.25, 634.5]",2,6,-4
31123.0,2020-01-04,"(634.5, 944.75]",8,20,-12
31124.0,2020-01-04,"(363.5, 715.0]",17,3,14
31124.0,2020-01-04,"(715.0, 1066.5]",16,42,-26
31124.0,2020-01-04,"(1066.5, 1418.0]",10,46,-36
31125.0,2020-01-04,"(35.611, 384.25]",1,3,-2
31125.0,2020-01-04,"(384.25, 731.5]",10,25,-15
31125.0,2020-01-04,"(731.5, 1078.75]",21,51,-30
31125.0,2020-01-04,"(1078.75, 1426.0]",5,7,-2
31126.0,2020-01-04,"(85.665, 420.75]",2,2,0
31126.0,2020-01-04,"(420.75, 754.5]",8,25,-17
31126.0,2020-01-04,"(754.5, 1088.25]",7,20,-13
31126.0,2020-01-04,"(1088.25, 1422.0]",4,8,-4
,,,,2.0,
31128.0,2020-01-04,"(349.25, 660.5]",5,3,2
31128.0,2020-01-04,"(660.5, 971.75]",5,6,-1
31128.0,2020-01-04,"(971.75, 1283.0]",5,17,-12
31129.0,2020-01-04,"(376.975, 634.25]",1,1,0
31129.0,2020-01-04,"(634.25, 890.5]",13,24,-11
31129.0,2020-01-04,"(890.5, 1146.75]",2,3,-1
31129.0,2020-01-04,"(1146.75, 1403.0]",3,4,-1
31130.0,2020-01-04,"(708.0, 951.0]",5,6,-1
31130.0,2020-01-04,"(951.0, 1194.0]",2,9,-7
31130.0,2020-01-04,"(1194.0, 1437.0]",4,4,0
31131.0,2020-01-04,"(342.054, 579.5]",1,5,-4
31131.0,2020-01-04,"(579.5, 816.0]",1,1,0
31131.0,2020-01-04,"(816.0, 1052.5]",1,2,-1
31131.0,2020-01-04,"(1052.5, 1289.0]",1,2,-1
31200.0,2020-01-04,"(140.722, 461.5]",3,3,0
31200.0,2020-01-04,"(461.5, 781.0]",14,32,-18
31200.0,2020-01-04,"(781.0, 1100.5]",19,24,-5
31200.0,2020-01-04,"(1100.5, 1420.0]",4,7,-3
31201.0,2020-01-04,"(501.085, 730.75]",21,35,-14
31201.0,2020-01-04,"(730.75, 959.5]",29,57,-28
31201.0,2020-01-04,"(959.5, 1188.25]",5,12,-7
31201.0,2020-01-04,"(1188.25, 1417.0]",4,11,-7
31202.0,2020-01-04,"(36.638, 378.5]",1,3,-2
31202.0,2020-01-04,"(378.5, 719.0]",17,30,-13
31202.0,2020-01-04,"(719.0, 1059.5]",19,34,-15
31202.0,2020-01-04,"(1059.5, 1400.0]",9,18,-9
31203.0,2020-01-04,"(43.645, 383.75]",2,7,-5
31203.0,2020-01-04,"(383.75, 722.5]",14,19,-5
31203.0,2020-01-04,"(722.5, 1061.25]",18,38,-20
31203.0,2020-01-04,"(1061.25, 1400.0]",8,21,-13
31204.0,2020-01-04,"(595.188, 799.0]",3,4,-1
31204.0,2020-01-04,"(799.0, 1002.0]",1,3,-2
31204.0,2020-01-04,"(1205.0, 1408.0]",1,3,-2
31205.0,2020-01-04,"(406.523, 526.25]",1,1,0
31205.0,2020-01-04,"(526.25, 645.5]",1,1,0
31205.0,2020-01-04,"(764.75, 884.0]",2,1,1
31206.0,2020-01-04,"(899.25, 1002.0]",2,1,1
31207.0,2020-01-04,"(616.75, 736.5]",1,1,0
31207.0,2020-01-04,"(856.25, 976.0]",1,1,0
31208.0,2020-01-04,"(419.0, 621.5]",1,1,0
31208.0,2020-01-04,"(621.5, 824.0]",4,1,3
31209.0,2020-01-04,"(538.29, 716.5]",5,10,-5
31209.0,2020-01-04,"(716.5, 894.0]",7,10,-3
31209.0,2020-01-04,"(894.0, 1071.5]",2,3,-1
31209.0,2020-01-04,"(1071.5, 1249.0]",1,1,0
31211.0,2020-01-04,"(751.477, 882.75]",3,4,-1
31212.0,2020-01-04,"(464.061, 699.75]",5,11,-6
31212.0,2020-01-04,"(699.75, 934.5]",10,20,-10
31212.0,2020-01-04,"(934.5, 1169.25]",5,8,-3
31212.0,2020-01-04,"(1169.25, 1404.0]",2,3,-1
31213.0,2020-01-04,"(322.25, 612.5]",3,1,2
31213.0,2020-01-04,"(612.5, 902.75]",6,3,3
31213.0,2020-01-04,"(902.75, 1193.0]",2,10,-8
31214.0,2020-01-04,"(20.585, 375.75]",3,4,-1
31214.0,2020-01-04,"(375.75, 729.5]",14,31,-17
31214.0,2020-01-04,"(729.5, 1083.25]",13,27,-14
31214.0,2020-01-04,"(1083.25, 1437.0]",6,12,-6
31215.0,2020-01-04,"(490.412, 638.0]",4,5,-1
31215.0,2020-01-04,"(638.0, 785.0]",4,5,-1
31215.0,2020-01-04,"(785.0, 932.0]",6,7,-1
31215.0,2020-01-04,"(932.0, 1079.0]",3,4,-1
31216.0,2020-01-04,"(719.423, 864.25]",6,9,-3
31216.0,2020-01-04,"(864.25, 1008.5]",2,5,-3
31216.0,2020-01-04,"(1152.75, 1297.0]",2,2,0
31217.0,2020-01-04,"(530.543, 645.25]",1,3,-2
31217.0,2020-01-04,"(759.5, 873.75]",3,5,-2
31217.0,2020-01-04,"(873.75, 988.0]",3,3,0
31218.0,2020-01-04,"(748.75, 845.0]",2,2,0
31219.0,2020-01-04,"(689.75, 767.5]",1,1,0
31219.0,2020-01-04,"(767.5, 845.25]",8,1,7
31219.0,2020-01-04,"(845.25, 923.0]",1,8,-7
31220.0,2020-01-04,"(281.25, 375.0]",1,1,0
31221.0,2020-01-04,"(129.825, 424.75]",2,3,-1
31221.0,2020-01-04,"(424.75, 718.5]",4,6,-2
31221.0,2020-01-04,"(718.5, 1012.25]",4,8,-4
31221.0,2020-01-04,"(1012.25, 1306.0]",1,2,-1
31222.0,2020-01-04,"(743.811, 791.25]",5,5,0
31222.0,2020-01-04,"(791.25, 838.5]",1,2,-1
31222.0,2020-01-04,"(885.75, 933.0]",6,2,4
31223.0,2020-01-04,"(41.611, 390.25]",1,4,-3
31223.0,2020-01-04,"(390.25, 737.5]",5,10,-5
31223.0,2020-01-04,"(737.5, 1084.75]",13,20,-7
31223.0,2020-01-04,"(1084.75, 1432.0]",4,10,-6
31224.0,2020-01-04,"(553.176, 760.0]",4,11,-7
31224.0,2020-01-04,"(760.0, 966.0]",3,8,-5
31224.0,2020-01-04,"(966.0, 1172.0]",3,3,0
31224.0,2020-01-04,"(1172.0, 1378.0]",4,7,-3
31225.0,2020-01-04,"(351.954, 614.5]",2,2,0
31225.0,2020-01-04,"(614.5, 876.0]",6,7,-1
31225.0,2020-01-04,"(876.0, 1137.5]",5,7,-2
31226.0,2020-01-04,"(710.534, 827.5]",2,2,0
31226.0,2020-01-04,"(944.0, 1060.5]",1,5,-4
31227.0,2020-01-04,"(458.25, 766.5]",3,1,2
31227.0,2020-01-04,"(766.5, 1074.75]",3,6,-3
31228.0,2020-01-04,"(378.0, 732.0]",12,1,11
31228.0,2020-01-04,"(732.0, 1086.0]",26,17,9
31228.0,2020-01-04,"(1086.0, 1440.0]",2,34,-32
31229.0,2020-01-04,"(7.571, 366.25]",4,6,-2
31229.0,2020-01-04,"(366.25, 723.5]",20,45,-25
31229.0,2020-01-04,"(723.5, 1080.75]",28,59,-31
31229.0,2020-01-04,"(1080.75, 1438.0]",6,17,-11
31230.0,2020-01-04,"(452.205, 651.75]",3,6,-3
31230.0,2020-01-04,"(651.75, 850.5]",5,8,-3
31230.0,2020-01-04,"(850.5, 1049.25]",9,15,-6
31230.0,2020-01-04,"(1049.25, 1248.0]",2,2,0
,,,,1.0,
,,,,1.0,
,,,,1.0,
31232.0,2020-01-04,"(58.701, 384.75]",2,3,-1
31232.0,2020-01-04,"(384.75, 709.5]",6,9,-3
31232.0,2020-01-04,"(709.5, 1034.25]",16,27,-11
31232.0,2020-01-04,"(1034.25, 1359.0]",9,15,-6
31233.0,2020-01-04,"(613.0, 901.0]",8,1,7
31233.0,2020-01-04,"(901.0, 1189.0]",4,1,3
31234.0,2020-01-04,"(409.75, 741.5]",6,2,4
31234.0,2020-01-04,"(741.5, 1073.25]",5,14,-9
31234.0,2020-01-04,"(1073.25, 1405.0]",2,10,-8
31235.0,2020-01-04,"(705.462, 840.5]",1,1,0
31235.0,2020-01-04,"(1109.5, 1244.0]",2,1,1
31236.0,2020-01-04,"(490.098, 716.5]",3,3,0
31236.0,2020-01-04,"(716.5, 942.0]",3,5,-2
31236.0,2020-01-04,"(942.0, 1167.5]",1,2,-1
31237.0,2020-01-04,"(16.626, 361.5]",1,1,0
31237.0,2020-01-04,"(361.5, 705.0]",4,8,-4
31237.0,2020-01-04,"(705.0, 1048.5]",9,16,-7
31237.0,2020-01-04,"(1048.5, 1392.0]",3,5,-2
31238.0,2020-01-04,"(49.634, 392.5]",2,2,0
31238.0,2020-01-04,"(392.5, 734.0]",4,6,-2
31238.0,2020-01-04,"(734.0, 1075.5]",7,8,-1
31238.0,2020-01-04,"(1075.5, 1417.0]",2,6,-4
31239.0,2020-01-04,"(379.75, 708.5]",11,1,10
31239.0,2020-01-04,"(708.5, 1037.25]",6,14,-8
31239.0,2020-01-04,"(1037.25, 1366.0]",4,15,-11
31240.0,2020-01-04,"(590.264, 775.0]",7,15,-8
31240.0,2020-01-04,"(775.0, 959.0]",6,10,-4
31240.0,2020-01-04,"(959.0, 1143.0]",1,2,-1
31240.0,2020-01-04,"(1143.0, 1327.0]",1,2,-1
31241.0,2020-01-04,"(89.655, 427.25]",1,3,-2
31241.0,2020-01-04,"(427.25, 763.5]",6,26,-20
31241.0,2020-01-04,"(763.5, 1099.75]",11,16,-5
31241.0,2020-01-04,"(1099.75, 1436.0]",10,16,-6
31242.0,2020-01-04,"(509.126, 728.5]",1,1,0
31242.0,2020-01-04,"(728.5, 947.0]",2,5,-3
31242.0,2020-01-04,"(1165.5, 1384.0]",1,2,-1
31243.0,2020-01-04,"(1.717, 323.75]",1,1,0
31243.0,2020-01-04,"(323.75, 644.5]",2,2,0
31243.0,2020-01-04,"(644.5, 965.25]",14,23,-9
31244.0,2020-01-04,"(629.429, 772.75]",2,4,-2
31244.0,2020-01-04,"(772.75, 915.5]",3,5,-2
31244.0,2020-01-04,"(1058.25, 1201.0]",1,2,-1
31245.0,2020-01-04,"(46.653, 384.75]",1,1,0
31245.0,2020-01-04,"(384.75, 721.5]",9,19,-10
31245.0,2020-01-04,"(721.5, 1058.25]",17,28,-11
31245.0,2020-01-04,"(1058.25, 1395.0]",1,3,-2
31246.0,2020-01-04,"(394.25, 740.5]",18,1,17
31246.0,2020-01-04,"(740.5, 1086.75]",13,25,-12
31246.0,2020-01-04,"(1086.75, 1433.0]",5,24,-19
31247.0,2020-01-04,"(93.886, 373.5]",1,1,0
31247.0,2020-01-04,"(373.5, 652.0]",8,11,-3
31247.0,2020-01-04,"(652.0, 930.5]",17,31,-14
31247.0,2020-01-04,"(930.5, 1209.0]",11,17,-6
31248.0,2020-01-04,"(549.507, 673.25]",7,17,-10
31248.0,2020-01-04,"(673.25, 796.5]",3,8,-5
31248.0,2020-01-04,"(796.5, 919.75]",14,19,-5
31248.0,2020-01-04,"(919.75, 1043.0]",1,2,-1
31249.0,2020-01-04,"(547.427, 691.25]",2,3,-1
31249.0,2020-01-04,"(691.25, 834.5]",9,17,-8
31249.0,2020-01-04,"(834.5, 977.75]",10,20,-10
31249.0,2020-01-04,"(977.75, 1121.0]",2,4,-2
31250.0,2020-01-04,"(388.0, 724.0]",6,1,5
31250.0,2020-01-04,"(724.0, 1060.0]",4,7,-3
31250.0,2020-01-04,"(1060.0, 1396.0]",2,6,-4
31251.0,2020-01-04,"(342.001, 592.75]",1,2,-1
31251.0,2020-01-04,"(592.75, 842.5]",9,19,-10
31251.0,2020-01-04,"(842.5, 1092.25]",1,2,-1
31251.0,2020-01-04,"(1092.25, 1342.0]",3,6,-3
31252.0,2020-01-04,"(712.5, 764.0]",1,1,0
31252.0,2020-01-04,"(815.5, 867.0]",1,2,-1
31253.0,2020-01-04,"(495.096, 722.0]",4,4,0
31253.0,2020-01-04,"(722.0, 948.0]",5,9,-4
31253.0,2020-01-04,"(948.0, 1174.0]",1,1,0
31254.0,2020-01-04,"(661.506, 785.5]",2,2,0
31254.0,2020-01-04,"(785.5, 909.0]",1,2,-1
31254.0,2020-01-04,"(1032.5, 1156.0]",1,1,0
31255.0,2020-01-04,"(556.261, 741.75]",4,7,-3
31255.0,2020-01-04,"(1111.25, 1296.0]",1,1,0
31256.0,2020-01-04,"(552.163, 762.25]",4,5,-1
31256.0,2020-01-04,"(762.25, 971.5]",8,13,-5
31256.0,2020-01-04,"(971.5, 1180.75]",1,1,0
31256.0,2020-01-04,"(1180.75, 1390.0]",1,2,-1
31257.0,2020-01-04,"(483.089, 711.75]",4,8,-4
31257.0,2020-01-04,"(711.75, 939.5]",7,15,-8
31257.0,2020-01-04,"(1167.25, 1395.0]",6,2,4
31258.0,2020-01-04,"(590.341, 755.75]",9,21,-12
31258.0,2020-01-04,"(755.75, 920.5]",25,49,-24
31258.0,2020-01-04,"(920.5, 1085.25]",9,22,-13
31258.0,2020-01-04,"(1085.25, 1250.0]",4,4,0
31259.0,2020-01-04,"(730.433, 872.75]",1,1,0
31259.0,2020-01-04,"(872.75, 1014.5]",1,2,-1
31259.0,2020-01-04,"(1156.25, 1298.0]",1,2,-1
31260.0,2020-01-04,"(690.75, 921.0]",1,1,0
31261.0,2020-01-04,"(673.339, 839.25]",4,8,-4
31261.0,2020-01-04,"(839.25, 1004.5]",2,6,-4
31261.0,2020-01-04,"(1169.75, 1335.0]",1,1,0
31262.0,2020-01-04,"(154.816, 452.0]",1,1,0
31262.0,2020-01-04,"(452.0, 748.0]",2,3,-1
31262.0,2020-01-04,"(748.0, 1044.0]",7,18,-11
31263.0,2020-01-04,"(451.157, 662.75]",5,7,-2
31263.0,2020-01-04,"(662.75, 873.5]",7,11,-4
31263.0,2020-01-04,"(873.5, 1084.25]",4,6,-2
31263.0,2020-01-04,"(1084.25, 1295.0]",1,4,-3
31264.0,2020-01-04,"(607.202, 807.5]",3,4,-1
31264.0,2020-01-04,"(807.5, 1007.0]",8,11,-3
31264.0,2020-01-04,"(1007.0, 1206.5]",1,2,-1
31265.0,2020-01-04,"(81.655, 419.25]",1,2,-1
31265.0,2020-01-04,"(419.25, 755.5]",10,18,-8
31265.0,2020-01-04,"(755.5, 1091.75]",11,23,-12
31265.0,2020-01-04,"(1091.75, 1428.0]",4,7,-3
31266.0,2020-01-04,"(59.668, 394.0]",1,4,-3
31266.0,2020-01-04,"(394.0, 727.0]",13,30,-17
31266.0,2020-01-04,"(727.0, 1060.0]",21,39,-18
31266.0,2020-01-04,"(1060.0, 1393.0]",9,15,-6
31267.0,2020-01-04,"(117.687, 447.25]",3,4,-1
31267.0,2020-01-04,"(447.25, 775.5]",8,16,-8
31267.0,2020-01-04,"(775.5, 1103.75]",6,14,-8
31267.0,2020-01-04,"(1103.75, 1432.0]",4,7,-3
31268.0,2020-01-04,"(47.622, 393.5]",1,4,-3
31268.0,2020-01-04,"(393.5, 738.0]",7,11,-4
31268.0,2020-01-04,"(738.0, 1082.5]",7,14,-7
31268.0,2020-01-04,"(1082.5, 1427.0]",5,17,-12
31269.0,2020-01-04,"(416.979, 673.25]",8,15,-7
31269.0,2020-01-04,"(673.25, 928.5]",6,18,-12
31269.0,2020-01-04,"(928.5, 1183.75]",3,6,-3
31269.0,2020-01-04,"(1183.75, 1439.0]",4,7,-3
31270.0,2020-01-04,"(263.907, 538.25]",1,2,-1
31270.0,2020-01-04,"(538.25, 811.5]",12,16,-4
31270.0,2020-01-04,"(811.5, 1084.75]",6,13,-7
31270.0,2020-01-04,"(1084.75, 1358.0]",1,5,-4
31271.0,2020-01-04,"(659.775, 716.25]",2,2,0
31271.0,2020-01-04,"(716.25, 772.5]",3,3,0
31271.0,2020-01-04,"(772.5, 828.75]",1,2,-1
31271.0,2020-01-04,"(828.75, 885.0]",2,3,-1
31272.0,2020-01-04,"(631.603, 731.25]",13,17,-4
31272.0,2020-01-04,"(731.25, 830.5]",6,8,-2
31272.0,2020-01-04,"(830.5, 929.75]",6,15,-9
31273.0,2020-01-04,"(499.558, 610.5]",1,2,-1
31273.0,2020-01-04,"(721.0, 831.5]",1,2,-1
31273.0,2020-01-04,"(831.5, 942.0]",2,5,-3
31274.0,2020-01-04,"(590.79, 643.5]",2,2,0
31274.0,2020-01-04,"(696.0, 748.5]",3,2,1
31275.0,2020-01-04,"(316.115, 538.25]",3,5,-2
31275.0,2020-01-04,"(538.25, 759.5]",2,5,-3
31275.0,2020-01-04,"(759.5, 980.75]",1,3,-2
31275.0,2020-01-04,"(980.75, 1202.0]",4,6,-2
31276.0,2020-01-04,"(414.062, 649.5]",3,3,0
31276.0,2020-01-04,"(649.5, 884.0]",3,4,-1
31276.0,2020-01-04,"(884.0, 1118.5]",3,5,-2
31276.0,2020-01-04,"(1118.5, 1353.0]",1,1,0
31277.0,2020-01-04,"(275.005, 524.75]",1,1,0
31277.0,2020-01-04,"(524.75, 773.5]",4,9,-5
31277.0,2020-01-04,"(773.5, 1022.25]",14,22,-8
31277.0,2020-01-04,"(1022.25, 1271.0]",3,5,-2
31278.0,2020-01-04,"(387.957, 649.75]",4,7,-3
31278.0,2020-01-04,"(649.75, 910.5]",6,17,-11
31278.0,2020-01-04,"(910.5, 1171.25]",6,7,-1
31278.0,2020-01-04,"(1171.25, 1432.0]",6,8,-2
31279.0,2020-01-04,"(935.0, 986.0]",4,2,2
31279.0,2020-01-04,"(986.0, 1037.0]",3,7,-4
31280.0,2020-01-04,"(501.1, 727.0]",13,19,-6
31280.0,2020-01-04,"(727.0, 952.0]",7,14,-7
31280.0,2020-01-04,"(952.0, 1177.0]",3,5,-2
31280.0,2020-01-04,"(1177.0, 1402.0]",2,7,-5
31000.0,2020-01-05,"(644.396, 796.0]",3,8,-5
31000.0,2020-01-05,"(796.0, 947.0]",2,2,0
31000.0,2020-01-05,"(1098.0, 1249.0]",1,1,0
31001.0,2020-01-05,"(368.25, 639.5]",1,1,0
31001.0,2020-01-05,"(910.75, 1182.0]",2,1,1
31002.0,2020-01-05,"(886.995, 888.25]",1,1,0
31003.0,2020-01-05,"(812.726, 881.5]",1,2,-1
31003.0,2020-01-05,"(881.5, 950.0]",1,1,0
31003.0,2020-01-05,"(1018.5, 1087.0]",1,1,0
,,,,2.0,
31005.0,2020-01-05,"(641.258, 827.5]",2,5,-3
31005.0,2020-01-05,"(1198.5, 1384.0]",1,1,0
31006.0,2020-01-05,"(542.276, 724.0]",2,3,-1
31006.0,2020-01-05,"(724.0, 905.0]",1,1,0
31006.0,2020-01-05,"(905.0, 1086.0]",2,3,-1
31006.0,2020-01-05,"(1086.0, 1267.0]",1,3,-2
31007.0,2020-01-05,"(530.347, 694.25]",1,3,-2
31007.0,2020-01-05,"(1020.75, 1184.0]",1,3,-2
31009.0,2020-01-05,"(527.0, 790.5]",1,1,0
31009.0,2020-01-05,"(790.5, 1054.0]",1,1,0
31010.0,2020-01-05,"(979.56, 1090.0]",1,1,0
31010.0,2020-01-05,"(1090.0, 1200.0]",1,1,0
31011.0,2020-01-05,"(478.053, 715.75]",2,3,-1
31011.0,2020-01-05,"(715.75, 952.5]",3,4,-1
31011.0,2020-01-05,"(1189.25, 1426.0]",1,1,0
,,,,2.0,
31013.0,2020-01-05,"(757.687, 836.25]",1,1,0
31013.0,2020-01-05,"(992.75, 1071.0]",2,1,1
31014.0,2020-01-05,"(51.625, 396.75]",1,2,-1
31014.0,2020-01-05,"(396.75, 740.5]",3,3,0
31014.0,2020-01-05,"(740.5, 1084.25]",4,4,0
31014.0,2020-01-05,"(1084.25, 1428.0]",5,6,-1
31015.0,2020-01-05,"(703.75, 888.5]",1,1,0
31015.0,2020-01-05,"(888.5, 1073.25]",5,3,2
31015.0,2020-01-05,"(1073.25, 1258.0]",1,6,-5
31016.0,2020-01-05,"(0.864, 286.0]",1,1,0
31016.0,2020-01-05,"(286.0, 570.0]",2,2,0
31016.0,2020-01-05,"(570.0, 854.0]",4,8,-4
31016.0,2020-01-05,"(854.0, 1138.0]",2,6,-4
31017.0,2020-01-05,"(740.623, 835.25]",1,2,-1
31018.0,2020-01-05,"(754.5, 1006.0]",1,1,0
31019.0,2020-01-05,"(743.435, 885.25]",1,3,-2
31019.0,2020-01-05,"(885.25, 1026.5]",2,5,-3
31019.0,2020-01-05,"(1026.5, 1167.75]",2,3,-1
31020.0,2020-01-05,"(584.472, 717.0]",1,2,-1
31020.0,2020-01-05,"(981.0, 1113.0]",1,1,0
31021.0,2020-01-05,"(612.447, 751.25]",2,4,-2
31021.0,2020-01-05,"(751.25, 889.5]",1,1,0
31021.0,2020-01-05,"(1027.75, 1166.0]",2,3,-1
31022.0,2020-01-05,"(599.429, 742.75]",3,3,0
31022.0,2020-01-05,"(742.75, 885.5]",1,3,-2
31022.0,2020-01-05,"(885.5, 1028.25]",1,3,-2
31022.0,2020-01-05,"(1028.25, 1171.0]",1,2,-1
31023.0,2020-01-05,"(733.5, 1048.75]",1,1,0
31024.0,2020-01-05,"(28.656, 366.0]",1,1,0
31024.0,2020-01-05,"(702.0, 1038.0]",4,2,2
31024.0,2020-01-05,"(1038.0, 1374.0]",1,6,-5
31025.0,2020-01-05,"(896.0, 1041.0]",1,1,0
31026.0,2020-01-05,"(580.53, 698.5]",1,2,-1
31026.0,2020-01-05,"(816.0, 933.5]",2,3,-1
31026.0,2020-01-05,"(933.5, 1051.0]",1,2,-1
31027.0,2020-01-05,"(1090.25, 1142.5]",1,3,-2
31027.0,2020-01-05,"(1194.75, 1247.0]",2,2,0
31028.0,2020-01-05,"(592.474, 724.5]",1,2,-1
31028.0,2020-01-05,"(856.0, 987.5]",1,1,0
31028.0,2020-01-05,"(987.5, 1119.0]",1,2,-1
31029.0,2020-01-05,"(666.606, 765.5]",1,2,-1
31029.0,2020-01-05,"(864.0, 962.5]",2,1,1
31029.0,2020-01-05,"(962.5, 1061.0]",1,2,-1
31030.0,2020-01-05,"(657.0, 693.5]",1,2,-1
31031.0,2020-01-05,"(614.0, 791.0]",1,2,-1
31031.0,2020-01-05,"(968.0, 1145.0]",1,1,0
,,,,1.0,
,,,,2.0,
,,,,2.0,
31034.0,2020-01-05,"(105.95, 369.5]",1,1,0
31034.0,2020-01-05,"(632.0, 894.5]",1,1,0
31034.0,2020-01-05,"(894.5, 1157.0]",1,2,-1
31035.0,2020-01-05,"(364.5, 702.0]",1,1,0
31035.0,2020-01-05,"(1039.5, 1377.0]",2,2,0
31036.0,2020-01-05,"(563.5, 845.25]",3,1,2
31036.0,2020-01-05,"(845.25, 1127.0]",4,3,1
31037.0,2020-01-05,"(631.511, 754.25]",1,4,-3
31037.0,2020-01-05,"(754.25, 876.5]",1,1,0
31037.0,2020-01-05,"(876.5, 998.75]",1,1,0
31038.0,2020-01-05,"(383.018, 629.5]",2,2,0
31039.0,2020-01-05,"(484.351, 647.25]",1,3,-2
31039.0,2020-01-05,"(647.25, 809.5]",2,4,-2
31039.0,2020-01-05,"(809.5, 971.75]",1,1,0
31039.0,2020-01-05,"(971.75, 1134.0]",1,3,-2
31040.0,2020-01-05,"(363.0, 631.0]",1,1,0
31040.0,2020-01-05,"(631.0, 899.0]",1,1,0
31040.0,2020-01-05,"(899.0, 1167.0]",1,3,-2
31041.0,2020-01-05,"(107.049, 345.75]",1,2,-1
31042.0,2020-01-05,"(8.908, 283.0]",1,1,0
31042.0,2020-01-05,"(556.0, 829.0]",1,2,-1
31042.0,2020-01-05,"(829.0, 1102.0]",4,9,-5
,,,,2.0,
31044.0,2020-01-05,"(595.909, 618.75]",1,1,0
31045.0,2020-01-05,"(739.5, 986.0]",1,1,0
31046.0,2020-01-05,"(849.25, 981.0]",1,1,0
31047.0,2020-01-05,"(776.0, 799.0]",1,2,-1
31047.0,2020-01-05,"(822.0, 845.0]",1,1,0
,,,,1.0,
,,,,1.0,
31049.0,2020-01-05,"(696.25, 787.5]",1,2,-1
31050.0,2020-01-05,"(1088.75, 1144.0]",2,1,1
31051.0,2020-01-05,"(880.5, 961.0]",1,1,0
31052.0,2020-01-05,"(929.779, 985.25]",1,1,0
31052.0,2020-01-05,"(985.25, 1040.5]",1,1,0
,,,,2.0,
,,,,2.0,
31055.0,2020-01-05,"(596.574, 703.5]",1,1,0
31055.0,2020-01-05,"(916.5, 1023.0]",1,2,-1
,,,,2.0,
31057.0,2020-01-05,"(647.998, 648.5]",1,1,0
,,,,2.0,
31059.0,2020-01-05,"(796.5, 1062.0]",1,1,0
31060.0,2020-01-05,"(550.485, 679.75]",1,1,0
31060.0,2020-01-05,"(808.5, 937.25]",2,3,-1
31061.0,2020-01-05,"(441.0, 588.0]",1,1,0
31062.0,2020-01-05,"(404.261, 589.75]",2,3,-1
31062.0,2020-01-05,"(589.75, 774.5]",2,3,-1
31062.0,2020-01-05,"(774.5, 959.25]",1,4,-3
31062.0,2020-01-05,"(959.25, 1144.0]",2,2,0
31063.0,2020-01-05,"(904.25, 916.0]",1,1,0
31064.0,2020-01-05,"(558.445, 697.75]",1,2,-1
31064.0,2020-01-05,"(697.75, 836.5]",2,4,-2
31064.0,2020-01-05,"(836.5, 975.25]",7,14,-7
31064.0,2020-01-05,"(975.25, 1114.0]",1,2,-1
,,,,2.0,
31066.0,2020-01-05,"(870.25, 929.0]",1,2,-1
31067.0,2020-01-05,"(586.719, 657.25]",1,1,0
31068.0,2020-01-05,"(957.0, 1066.0]",2,1,1
,,,,2.0,
31070.0,2020-01-05,"(626.57, 734.5]",2,4,-2
31070.0,2020-01-05,"(949.5, 1057.0]",2,1,1
31071.0,2020-01-05,"(473.157, 684.75]",1,2,-1
31071.0,2020-01-05,"(684.75, 895.5]",1,2,-1
31071.0,2020-01-05,"(1106.25, 1317.0]",2,2,0
,,,,1.0,
,,,,1.0,
,,,,2.0,
31074.0,2020-01-05,"(110.908, 385.0]",1,1,0
31074.0,2020-01-05,"(658.0, 931.0]",1,1,0
31074.0,2020-01-05,"(931.0, 1204.0]",1,2,-1
31075.0,2020-01-05,"(800.25, 874.0]",1,1,0
31076.0,2020-01-05,"(851.25, 1135.0]",1,1,0
31077.0,2020-01-05,"(559.75, 793.5]",3,1,2
31077.0,2020-01-05,"(1027.25, 1261.0]",2,3,-1
31078.0,2020-01-05,"(885.821, 930.75]",1,1,0
31079.0,2020-01-05,"(607.462, 742.5]",1,3,-2
31079.0,2020-01-05,"(877.0, 1011.5]",2,2,0
31079.0,2020-01-05,"(1011.5, 1146.0]",1,2,-1
31080.0,2020-01-05,"(1017.0, 1173.0]",1,1,0
31080.0,2020-01-05,"(1173.0, 1329.0]",1,1,0
31081.0,2020-01-05,"(899.818, 945.5]",2,3,-1
31081.0,2020-01-05,"(991.0, 1036.5]",1,1,0
31081.0,2020-01-05,"(1036.5, 1082.0]",1,1,0
31082.0,2020-01-05,"(903.898, 929.5]",1,1,0
,,,,2.0,
,,,,1.0,
,,,,2.0,
31085.0,2020-01-05,"(727.0, 771.0]",1,2,-1
31085.0,2020-01-05,"(815.0, 859.0]",2,1,1
31086.0,2020-01-05,"(196.0, 392.0]",1,1,0
31086.0,2020-01-05,"(588.0, 784.0]",1,1,0
31087.0,2020-01-05,"(671.821, 716.75]",2,4,-2
31087.0,2020-01-05,"(806.25, 851.0]",1,2,-1
31088.0,2020-01-05,"(111.202, 311.5]",1,1,0
31088.0,2020-01-05,"(511.0, 710.5]",2,3,-1
31088.0,2020-01-05,"(710.5, 910.0]",3,4,-1
31089.0,2020-01-05,"(716.5, 948.0]",2,3,-1
31089.0,2020-01-05,"(948.0, 1179.5]",4,9,-5
31089.0,2020-01-05,"(1179.5, 1411.0]",2,7,-5
31090.0,2020-01-05,"(101.203, 301.25]",1,1,0
31090.0,2020-01-05,"(699.75, 899.0]",2,1,1
31091.0,2020-01-05,"(631.252, 819.0]",1,1,0
31091.0,2020-01-05,"(1006.0, 1193.0]",1,1,0
31091.0,2020-01-05,"(1193.0, 1380.0]",1,3,-2
31092.0,2020-01-05,"(795.25, 892.0]",1,1,0
,,,,1.0,
,,,,2.0,
,,,,1.0,
,,,,1.0,
31095.0,2020-01-05,"(1027.75, 1037.0]",1,1,0
,,,,1.0,
,,,,1.0,
31097.0,2020-01-05,"(708.674, 790.5]",1,1,0
31097.0,2020-01-05,"(790.5, 872.0]",1,1,0
31097.0,2020-01-05,"(953.5, 1035.0]",1,1,0
,,,,2.0,
31099.0,2020-01-05,"(633.601, 733.75]",2,4,-2
31099.0,2020-01-05,"(833.5, 933.25]",1,2,-1
,,,,1.0,
,,,,3.0,
,,,,3.0,
31101.0,2020-01-05,"(16.678, 348.5]",2,5,-3
31101.0,2020-01-05,"(348.5, 679.0]",13,21,-8
31101.0,2020-01-05,"(679.0, 1009.5]",35,63,-28
31101.0,2020-01-05,"(1009.5, 1340.0]",15,33,-18
31102.0,2020-01-05,"(82.839, 374.25]",2,3,-1
31102.0,2020-01-05,"(374.25, 664.5]",3,8,-5
31102.0,2020-01-05,"(664.5, 954.75]",4,10,-6
31102.0,2020-01-05,"(954.75, 1245.0]",7,13,-6
31103.0,2020-01-05,"(16.592, 370.0]",2,2,0
31103.0,2020-01-05,"(370.0, 722.0]",6,15,-9
31103.0,2020-01-05,"(722.0, 1074.0]",5,25,-20
31103.0,2020-01-05,"(1074.0, 1426.0]",3,7,-4
31104.0,2020-01-05,"(8.703, 334.25]",3,8,-5
31104.0,2020-01-05,"(334.25, 658.5]",1,10,-9
31104.0,2020-01-05,"(658.5, 982.75]",14,32,-18
31104.0,2020-01-05,"(982.75, 1307.0]",6,16,-10
31105.0,2020-01-05,"(670.0, 987.5]",1,1,0
31105.0,2020-01-05,"(987.5, 1305.0]",2,2,0
31106.0,2020-01-05,"(1110.75, 1207.0]",1,2,-1
31107.0,2020-01-05,"(93.668, 428.0]",1,1,0
31107.0,2020-01-05,"(428.0, 761.0]",2,11,-9
31107.0,2020-01-05,"(761.0, 1094.0]",13,30,-17
31107.0,2020-01-05,"(1094.0, 1427.0]",10,19,-9
31108.0,2020-01-05,"(13.649, 352.75]",3,4,-1
31108.0,2020-01-05,"(352.75, 690.5]",7,12,-5
31108.0,2020-01-05,"(690.5, 1028.25]",12,22,-10
31108.0,2020-01-05,"(1028.25, 1366.0]",7,10,-3
31109.0,2020-01-05,"(102.758, 414.5]",2,8,-6
31109.0,2020-01-05,"(414.5, 725.0]",6,12,-6
31109.0,2020-01-05,"(725.0, 1035.5]",11,20,-9
31109.0,2020-01-05,"(1035.5, 1346.0]",7,17,-10
31110.0,2020-01-05,"(14.742, 330.5]",3,4,-1
31110.0,2020-01-05,"(330.5, 645.0]",12,18,-6
31110.0,2020-01-05,"(645.0, 959.5]",14,27,-13
31110.0,2020-01-05,"(959.5, 1274.0]",6,15,-9
31111.0,2020-01-05,"(12.649, 351.75]",2,8,-6
31111.0,2020-01-05,"(351.75, 689.5]",3,3,0
31111.0,2020-01-05,"(689.5, 1027.25]",6,13,-7
31111.0,2020-01-05,"(1027.25, 1365.0]",7,12,-5
31112.0,2020-01-05,"(622.598, 723.5]",1,1,0
31112.0,2020-01-05,"(824.0, 924.5]",2,1,1
31113.0,2020-01-05,"(573.75, 794.5]",4,4,0
31113.0,2020-01-05,"(794.5, 1015.25]",5,13,-8
31113.0,2020-01-05,"(1015.25, 1236.0]",1,12,-11
31114.0,2020-01-05,"(2.589, 356.75]",7,11,-4
31114.0,2020-01-05,"(356.75, 709.5]",6,12,-6
31114.0,2020-01-05,"(709.5, 1062.25]",14,23,-9
31114.0,2020-01-05,"(1062.25, 1415.0]",5,9,-4
31115.0,2020-01-05,"(494.115, 716.25]",3,9,-6
31115.0,2020-01-05,"(716.25, 937.5]",2,5,-3
31115.0,2020-01-05,"(937.5, 1158.75]",5,9,-4
31115.0,2020-01-05,"(1158.75, 1380.0]",5,8,-3
31116.0,2020-01-05,"(607.331, 775.25]",3,13,-10
31116.0,2020-01-05,"(775.25, 942.5]",7,10,-3
31116.0,2020-01-05,"(942.5, 1109.75]",7,14,-7
31116.0,2020-01-05,"(1109.75, 1277.0]",4,5,-1
31117.0,2020-01-05,"(75.645, 415.75]",1,1,0
31117.0,2020-01-05,"(415.75, 754.5]",3,21,-18
31117.0,2020-01-05,"(754.5, 1093.25]",9,31,-22
31117.0,2020-01-05,"(1093.25, 1432.0]",4,7,-3
31118.0,2020-01-05,"(103.763, 414.25]",1,1,0
31118.0,2020-01-05,"(723.5, 1032.75]",7,4,3
31118.0,2020-01-05,"(1032.75, 1342.0]",3,16,-13
31119.0,2020-01-05,"(12.645, 352.75]",2,2,0
31119.0,2020-01-05,"(352.75, 691.5]",4,11,-7
31119.0,2020-01-05,"(691.5, 1030.25]",13,21,-8
31119.0,2020-01-05,"(1030.25, 1369.0]",10,20,-10
31120.0,2020-01-05,"(37.645, 377.75]",1,1,0
31120.0,2020-01-05,"(377.75, 716.5]",6,8,-2
31120.0,2020-01-05,"(716.5, 1055.25]",1,14,-13
31120.0,2020-01-05,"(1055.25, 1394.0]",5,10,-5
31121.0,2020-01-05,"(649.0, 815.0]",3,2,1
31121.0,2020-01-05,"(815.0, 981.0]",6,8,-2
31121.0,2020-01-05,"(981.0, 1147.0]",4,9,-5
31122.0,2020-01-05,"(367.0, 703.0]",3,1,2
31122.0,2020-01-05,"(703.0, 1039.0]",3,3,0
31122.0,2020-01-05,"(1039.0, 1375.0]",2,9,-7
31123.0,2020-01-05,"(38.715, 361.25]",2,2,0
31123.0,2020-01-05,"(361.25, 682.5]",3,13,-10
31123.0,2020-01-05,"(682.5, 1003.75]",3,14,-11
31123.0,2020-01-05,"(1003.75, 1325.0]",4,6,-2
31124.0,2020-01-05,"(369.25, 725.5]",11,5,6
31124.0,2020-01-05,"(725.5, 1081.75]",13,22,-9
31124.0,2020-01-05,"(1081.75, 1438.0]",6,34,-28
31125.0,2020-01-05,"(14.592, 368.0]",5,5,0
31125.0,2020-01-05,"(368.0, 720.0]",9,22,-13
31125.0,2020-01-05,"(720.0, 1072.0]",9,23,-14
31125.0,2020-01-05,"(1072.0, 1424.0]",12,14,-2
31126.0,2020-01-05,"(7.755, 320.25]",2,3,-1
31126.0,2020-01-05,"(631.5, 942.75]",5,10,-5
31126.0,2020-01-05,"(942.75, 1254.0]",7,18,-11
,,,,2.0,
31128.0,2020-01-05,"(41.632, 385.0]",1,5,-4
31128.0,2020-01-05,"(385.0, 727.0]",11,19,-8
31128.0,2020-01-05,"(727.0, 1069.0]",11,18,-7
31128.0,2020-01-05,"(1069.0, 1411.0]",1,7,-6
31129.0,2020-01-05,"(629.539, 745.25]",3,6,-3
31129.0,2020-01-05,"(745.25, 860.5]",8,8,0
31129.0,2020-01-05,"(860.5, 975.75]",1,2,-1
31129.0,2020-01-05,"(975.75, 1091.0]",4,8,-4
31130.0,2020-01-05,"(17.851, 306.25]",1,4,-3
31130.0,2020-01-05,"(593.5, 880.75]",1,10,-9
31130.0,2020-01-05,"(880.75, 1168.0]",10,13,-3
31131.0,2020-01-05,"(167.939, 434.25]",2,2,0
31131.0,2020-01-05,"(434.25, 699.5]",2,6,-4
31131.0,2020-01-05,"(964.75, 1230.0]",3,1,2
31200.0,2020-01-05,"(46.66, 383.0]",1,4,-3
31200.0,2020-01-05,"(383.0, 718.0]",31,44,-13
31200.0,2020-01-05,"(718.0, 1053.0]",33,51,-18
31200.0,2020-01-05,"(1053.0, 1388.0]",12,24,-12
31201.0,2020-01-05,"(7.628, 352.0]",2,7,-5
31201.0,2020-01-05,"(352.0, 695.0]",22,33,-11
31201.0,2020-01-05,"(695.0, 1038.0]",47,85,-38
31201.0,2020-01-05,"(1038.0, 1381.0]",12,29,-17
31202.0,2020-01-05,"(2.66, 339.0]",3,4,-1
31202.0,2020-01-05,"(339.0, 674.0]",4,7,-3
31202.0,2020-01-05,"(674.0, 1009.0]",16,35,-19
31202.0,2020-01-05,"(1009.0, 1344.0]",16,31,-15
31203.0,2020-01-05,"(1.626, 346.5]",3,7,-4
31203.0,2020-01-05,"(346.5, 690.0]",11,15,-4
31203.0,2020-01-05,"(690.0, 1033.5]",20,36,-16
31203.0,2020-01-05,"(1033.5, 1377.0]",13,19,-6
31204.0,2020-01-05,"(348.25, 657.5]",1,1,0
31204.0,2020-01-05,"(657.5, 966.75]",2,2,0
31204.0,2020-01-05,"(966.75, 1276.0]",4,6,-2
31205.0,2020-01-05,"(502.105, 726.75]",4,4,0
31205.0,2020-01-05,"(726.75, 950.5]",4,6,-2
31205.0,2020-01-05,"(950.5, 1174.25]",5,6,-1
31205.0,2020-01-05,"(1174.25, 1398.0]",1,1,0
31206.0,2020-01-05,"(707.25, 943.0]",1,1,0
31207.0,2020-01-05,"(11.775, 319.25]",3,3,0
31207.0,2020-01-05,"(625.5, 931.75]",1,1,0
31207.0,2020-01-05,"(931.75, 1238.0]",3,4,-1
31208.0,2020-01-05,"(20.765, 330.75]",1,1,0
31208.0,2020-01-05,"(330.75, 639.5]",1,1,0
31208.0,2020-01-05,"(639.5, 948.25]",2,5,-3
31208.0,2020-01-05,"(948.25, 1257.0]",4,4,0
31209.0,2020-01-05,"(537.5, 799.75]",2,2,0
31209.0,2020-01-05,"(799.75, 1062.0]",5,5,0
31211.0,2020-01-05,"(627.3, 803.0]",3,4,-1
31211.0,2020-01-05,"(978.0, 1153.0]",1,1,0
31212.0,2020-01-05,"(345.952, 609.0]",2,6,-4
31212.0,2020-01-05,"(609.0, 871.0]",10,15,-5
31212.0,2020-01-05,"(871.0, 1133.0]",10,16,-6
31212.0,2020-01-05,"(1133.0, 1395.0]",2,7,-5
31213.0,2020-01-05,"(636.57, 744.5]",3,4,-1
31213.0,2020-01-05,"(744.5, 852.0]",3,3,0
31213.0,2020-01-05,"(852.0, 959.5]",2,2,0
31214.0,2020-01-05,"(36.687, 366.25]",2,4,-2
31214.0,2020-01-05,"(366.25, 694.5]",5,14,-9
31214.0,2020-01-05,"(694.5, 1022.75]",30,63,-33
31214.0,2020-01-05,"(1022.75, 1351.0]",15,25,-10
31215.0,2020-01-05,"(589.501, 714.75]",4,5,-1
31215.0,2020-01-05,"(714.75, 839.5]",5,9,-4
31215.0,2020-01-05,"(839.5, 964.25]",7,8,-1
31215.0,2020-01-05,"(964.25, 1089.0]",4,9,-5
31216.0,2020-01-05,"(666.521, 786.75]",3,5,-2
31216.0,2020-01-05,"(906.5, 1026.25]",5,7,-2
31217.0,2020-01-05,"(1033.0, 1039.0]",1,2,-1
31218.0,2020-01-05,"(66.844, 357.0]",2,2,0
31218.0,2020-01-05,"(357.0, 646.0]",1,1,0
31218.0,2020-01-05,"(646.0, 935.0]",2,4,-2
31218.0,2020-01-05,"(935.0, 1224.0]",1,3,-2
31219.0,2020-01-05,"(669.668, 753.0]",2,2,0
31219.0,2020-01-05,"(753.0, 836.0]",3,6,-3
31219.0,2020-01-05,"(836.0, 919.0]",3,4,-1
31219.0,2020-01-05,"(919.0, 1002.0]",3,4,-1
31220.0,2020-01-05,"(1005.75, 1341.0]",1,1,0
31221.0,2020-01-05,"(62.7, 389.0]",1,2,-1
31221.0,2020-01-05,"(389.0, 714.0]",2,2,0
31221.0,2020-01-05,"(714.0, 1039.0]",4,6,-2
31221.0,2020-01-05,"(1039.0, 1364.0]",1,4,-3
31222.0,2020-01-05,"(792.822, 837.5]",1,1,0
31222.0,2020-01-05,"(926.5, 971.0]",1,2,-1
31223.0,2020-01-05,"(397.5, 724.0]",4,2,2
31223.0,2020-01-05,"(724.0, 1050.5]",16,7,9
31223.0,2020-01-05,"(1050.5, 1377.0]",6,26,-20
31224.0,2020-01-05,"(572.386, 726.5]",3,6,-3
31224.0,2020-01-05,"(880.0, 1033.5]",3,2,1
31224.0,2020-01-05,"(1033.5, 1187.0]",1,4,-3
31225.0,2020-01-05,"(353.25, 673.5]",2,1,1
31225.0,2020-01-05,"(673.5, 993.75]",7,2,5
31225.0,2020-01-05,"(993.75, 1314.0]",6,22,-16
31226.0,2020-01-05,"(242.967, 502.25]",1,2,-1
31226.0,2020-01-05,"(760.5, 1018.75]",3,2,1
31226.0,2020-01-05,"(1018.75, 1277.0]",1,4,-3
31227.0,2020-01-05,"(574.279, 755.25]",3,3,0
31227.0,2020-01-05,"(755.25, 935.5]",5,9,-4
31227.0,2020-01-05,"(935.5, 1115.75]",1,2,-1
31227.0,2020-01-05,"(1115.75, 1296.0]",1,3,-2
31228.0,2020-01-05,"(470.25, 763.5]",11,1,10
31228.0,2020-01-05,"(763.5, 1056.75]",16,14,2
31228.0,2020-01-05,"(1056.75, 1350.0]",6,34,-28
31229.0,2020-01-05,"(43.62, 390.0]",4,8,-4
31229.0,2020-01-05,"(390.0, 735.0]",17,34,-17
31229.0,2020-01-05,"(735.0, 1080.0]",39,71,-32
31229.0,2020-01-05,"(1080.0, 1425.0]",10,20,-10
31230.0,2020-01-05,"(653.378, 809.5]",11,14,-3
31230.0,2020-01-05,"(809.5, 965.0]",7,11,-4
31230.0,2020-01-05,"(965.0, 1120.5]",2,3,-1
31231.0,2020-01-05,"(618.512, 741.0]",1,2,-1
31232.0,2020-01-05,"(15.641, 356.75]",1,2,-1
31232.0,2020-01-05,"(356.75, 696.5]",4,4,0
31232.0,2020-01-05,"(696.5, 1036.25]",18,29,-11
31232.0,2020-01-05,"(1036.25, 1376.0]",10,21,-11
31233.0,2020-01-05,"(557.312, 730.0]",2,3,-1
31233.0,2020-01-05,"(730.0, 902.0]",1,2,-1
31233.0,2020-01-05,"(902.0, 1074.0]",1,1,0
31233.0,2020-01-05,"(1074.0, 1246.0]",3,5,-2
31234.0,2020-01-05,"(8.759, 320.25]",3,3,0
31234.0,2020-01-05,"(630.5, 940.75]",3,3,0
31234.0,2020-01-05,"(940.75, 1251.0]",15,6,9
31235.0,2020-01-05,"(756.0, 834.0]",2,1,1
31235.0,2020-01-05,"(834.0, 912.0]",1,2,-1
31235.0,2020-01-05,"(912.0, 990.0]",2,1,1
31236.0,2020-01-05,"(484.273, 666.75]",4,5,-1
31236.0,2020-01-05,"(666.75, 848.5]",7,11,-4
31236.0,2020-01-05,"(848.5, 1030.25]",4,10,-6
31236.0,2020-01-05,"(1030.25, 1212.0]",1,4,-3
31237.0,2020-01-05,"(351.5, 680.0]",3,1,2
31237.0,2020-01-05,"(680.0, 1008.5]",10,8,2
31237.0,2020-01-05,"(1008.5, 1337.0]",11,17,-6
31238.0,2020-01-05,"(70.794, 373.5]",2,3,-1
31238.0,2020-01-05,"(675.0, 976.5]",3,1,2
31238.0,2020-01-05,"(976.5, 1278.0]",4,7,-3
31239.0,2020-01-05,"(181.866, 466.5]",1,2,-1
31239.0,2020-01-05,"(466.5, 750.0]",5,9,-4
31239.0,2020-01-05,"(750.0, 1033.5]",13,23,-10
31239.0,2020-01-05,"(1033.5, 1317.0]",3,12,-9
31240.0,2020-01-05,"(525.532, 643.0]",1,1,0
31240.0,2020-01-05,"(760.0, 877.0]",2,4,-2
31240.0,2020-01-05,"(877.0, 994.0]",2,4,-2
31241.0,2020-01-05,"(6.609, 355.75]",1,5,-4
31241.0,2020-01-05,"(355.75, 703.5]",6,13,-7
31241.0,2020-01-05,"(703.5, 1051.25]",10,22,-12
31241.0,2020-01-05,"(1051.25, 1399.0]",6,15,-9
31242.0,2020-01-05,"(471.068, 705.0]",1,2,-1
31242.0,2020-01-05,"(705.0, 938.0]",4,4,0
31242.0,2020-01-05,"(938.0, 1171.0]",3,5,-2
31242.0,2020-01-05,"(1171.0, 1404.0]",2,5,-3
31243.0,2020-01-05,"(701.5, 879.0]",6,1,5
31243.0,2020-01-05,"(879.0, 1056.5]",4,7,-3
31243.0,2020-01-05,"(1056.5, 1234.0]",1,4,-3
31244.0,2020-01-05,"(343.067, 577.25]",1,2,-1
31244.0,2020-01-05,"(577.25, 810.5]",1,4,-3
31244.0,2020-01-05,"(810.5, 1043.75]",2,6,-4
31244.0,2020-01-05,"(1043.75, 1277.0]",7,9,-2
31245.0,2020-01-05,"(582.205, 781.75]",7,13,-6
31245.0,2020-01-05,"(781.75, 980.5]",10,22,-12
31245.0,2020-01-05,"(980.5, 1179.25]",4,12,-8
31245.0,2020-01-05,"(1179.25, 1378.0]",2,8,-6
31246.0,2020-01-05,"(35.644, 376.0]",1,2,-1
31246.0,2020-01-05,"(376.0, 715.0]",14,19,-5
31246.0,2020-01-05,"(715.0, 1054.0]",13,27,-14
31246.0,2020-01-05,"(1054.0, 1393.0]",9,16,-7
31247.0,2020-01-05,"(591.438, 732.5]",10,16,-6
31247.0,2020-01-05,"(732.5, 873.0]",7,12,-5
31247.0,2020-01-05,"(873.0, 1013.5]",3,12,-9
31247.0,2020-01-05,"(1013.5, 1154.0]",3,9,-6
31248.0,2020-01-05,"(18.698, 345.5]",1,2,-1
31248.0,2020-01-05,"(345.5, 671.0]",5,5,0
31248.0,2020-01-05,"(671.0, 996.5]",10,22,-12
31248.0,2020-01-05,"(996.5, 1322.0]",11,20,-9
31249.0,2020-01-05,"(567.75, 747.5]",1,1,0
31249.0,2020-01-05,"(747.5, 927.25]",2,2,0
31249.0,2020-01-05,"(927.25, 1107.0]",1,4,-3
31250.0,2020-01-05,"(512.19, 715.5]",1,3,-2
31250.0,2020-01-05,"(715.5, 918.0]",5,8,-3
31250.0,2020-01-05,"(918.0, 1120.5]",2,5,-3
31250.0,2020-01-05,"(1120.5, 1323.0]",1,3,-2
31251.0,2020-01-05,"(458.099, 684.25]",4,7,-3
31251.0,2020-01-05,"(684.25, 909.5]",4,12,-8
31251.0,2020-01-05,"(909.5, 1134.75]",2,7,-5
31251.0,2020-01-05,"(1134.75, 1360.0]",3,4,-1
31252.0,2020-01-05,"(668.474, 800.5]",1,2,-1
31253.0,2020-01-05,"(349.035, 591.25]",2,2,0
31253.0,2020-01-05,"(591.25, 832.5]",1,1,0
31253.0,2020-01-05,"(832.5, 1073.75]",2,3,-1
31254.0,2020-01-05,"(98.938, 365.5]",1,1,0
31254.0,2020-01-05,"(631.0, 896.5]",4,7,-3
31254.0,2020-01-05,"(896.5, 1162.0]",1,2,-1
31255.0,2020-01-05,"(553.35, 716.5]",4,6,-2
31255.0,2020-01-05,"(716.5, 879.0]",3,6,-3
31255.0,2020-01-05,"(879.0, 1041.5]",2,5,-3
31255.0,2020-01-05,"(1041.5, 1204.0]",1,3,-2
31256.0,2020-01-05,"(425.081, 655.75]",1,2,-1
31256.0,2020-01-05,"(655.75, 885.5]",4,5,-1
31256.0,2020-01-05,"(885.5, 1115.25]",7,11,-4
31256.0,2020-01-05,"(1115.25, 1345.0]",1,2,-1
31257.0,2020-01-05,"(-1.2, 300.0]",3,4,-1
31257.0,2020-01-05,"(600.0, 900.0]",1,4,-3
31257.0,2020-01-05,"(900.0, 1200.0]",8,13,-5
31258.0,2020-01-05,"(459.402, 609.5]",1,1,0
31258.0,2020-01-05,"(609.5, 759.0]",7,13,-6
31258.0,2020-01-05,"(759.0, 908.5]",4,9,-5
31258.0,2020-01-05,"(908.5, 1058.0]",12,20,-8
31259.0,2020-01-05,"(789.75, 1053.0]",2,1,1
31260.0,2020-01-05,"(935.25, 1050.0]",2,2,0
31261.0,2020-01-05,"(589.523, 709.25]",2,2,0
31261.0,2020-01-05,"(947.75, 1067.0]",4,2,2
31262.0,2020-01-05,"(685.692, 763.0]",2,2,0
31262.0,2020-01-05,"(763.0, 840.0]",3,6,-3
31262.0,2020-01-05,"(917.0, 994.0]",1,4,-3
31263.0,2020-01-05,"(485.204, 685.0]",7,12,-5
31263.0,2020-01-05,"(685.0, 884.0]",8,11,-3
31263.0,2020-01-05,"(884.0, 1083.0]",4,6,-2
31263.0,2020-01-05,"(1083.0, 1282.0]",3,5,-2
31264.0,2020-01-05,"(668.383, 823.25]",5,8,-3
31264.0,2020-01-05,"(823.25, 977.5]",3,3,0
31264.0,2020-01-05,"(977.5, 1131.75]",4,4,0
31264.0,2020-01-05,"(1131.75, 1286.0]",3,5,-2
31265.0,2020-01-05,"(488.136, 705.0]",6,11,-5
31265.0,2020-01-05,"(705.0, 921.0]",5,12,-7
31265.0,2020-01-05,"(921.0, 1137.0]",7,13,-6
31265.0,2020-01-05,"(1137.0, 1353.0]",3,9,-6
31266.0,2020-01-05,"(38.626, 383.5]",1,4,-3
31266.0,2020-01-05,"(383.5, 727.0]",8,20,-12
31266.0,2020-01-05,"(727.0, 1070.5]",14,27,-13
31266.0,2020-01-05,"(1070.5, 1414.0]",6,13,-7
31267.0,2020-01-05,"(-0.409, 353.25]",1,2,-1
31267.0,2020-01-05,"(353.25, 705.5]",5,8,-3
31267.0,2020-01-05,"(705.5, 1057.75]",4,11,-7
31267.0,2020-01-05,"(1057.75, 1410.0]",4,6,-2
31268.0,2020-01-05,"(74.716, 397.0]",2,3,-1
31268.0,2020-01-05,"(397.0, 718.0]",10,14,-4
31268.0,2020-01-05,"(718.0, 1039.0]",10,20,-10
31268.0,2020-01-05,"(1039.0, 1360.0]",5,11,-6
31269.0,2020-01-05,"(332.5, 639.0]",3,2,1
31269.0,2020-01-05,"(639.0, 945.5]",1,5,-4
31269.0,2020-01-05,"(945.5, 1252.0]",2,11,-9
31270.0,2020-01-05,"(521.0, 774.0]",3,1,2
31270.0,2020-01-05,"(774.0, 1027.0]",8,5,3
31270.0,2020-01-05,"(1027.0, 1280.0]",2,14,-12
31271.0,2020-01-05,"(503.404, 653.0]",1,1,0
31271.0,2020-01-05,"(653.0, 802.0]",1,1,0
31271.0,2020-01-05,"(802.0, 951.0]",2,10,-8
31271.0,2020-01-05,"(951.0, 1100.0]",3,8,-5
31272.0,2020-01-05,"(544.436, 686.0]",2,3,-1
31272.0,2020-01-05,"(686.0, 827.0]",5,5,0
31272.0,2020-01-05,"(827.0, 968.0]",3,3,0
31272.0,2020-01-05,"(968.0, 1109.0]",5,9,-4
31273.0,2020-01-05,"(480.21, 678.5]",4,7,-3
31273.0,2020-01-05,"(876.0, 1073.5]",1,2,-1
31273.0,2020-01-05,"(1073.5, 1271.0]",1,1,0
31274.0,2020-01-05,"(597.241, 787.75]",5,11,-6
31274.0,2020-01-05,"(787.75, 977.5]",2,3,-1
31274.0,2020-01-05,"(977.5, 1167.25]",1,1,0
31274.0,2020-01-05,"(1167.25, 1357.0]",1,1,0
31275.0,2020-01-05,"(413.1, 639.0]",2,4,-2
31275.0,2020-01-05,"(639.0, 864.0]",4,6,-2
31275.0,2020-01-05,"(864.0, 1089.0]",8,12,-4
31275.0,2020-01-05,"(1089.0, 1314.0]",2,7,-5
31276.0,2020-01-05,"(530.39, 683.5]",3,3,0
31276.0,2020-01-05,"(988.5, 1141.0]",1,1,0
31277.0,2020-01-05,"(278.053, 515.75]",1,2,-1
31277.0,2020-01-05,"(515.75, 752.5]",2,8,-6
31277.0,2020-01-05,"(752.5, 989.25]",4,9,-5
31277.0,2020-01-05,"(989.25, 1226.0]",1,1,0
31278.0,2020-01-05,"(383.75, 712.5]",6,1,5
31278.0,2020-01-05,"(712.5, 1041.25]",11,10,1
31278.0,2020-01-05,"(1041.25, 1370.0]",8,20,-12
31279.0,2020-01-05,"(579.382, 734.5]",1,2,-1
31279.0,2020-01-05,"(1043.5, 1198.0]",1,1,0
31280.0,2020-01-05,"(23.589, 377.75]",3,4,-1
31280.0,2020-01-05,"(377.75, 730.5]",6,17,-11
31280.0,2020-01-05,"(730.5, 1083.25]",9,19,-10
31280.0,2020-01-05,"(1083.25, 1436.0]",2,7,-5
31000.0,2020-01-06,"(882.25, 1011.0]",1,1,0
31001.0,2020-01-06,"(1086.767, 1145.25]",1,2,-1
31001.0,2020-01-06,"(1261.75, 1320.0]",1,1,0
31002.0,2020-01-06,"(280.0, 548.0]",1,1,0
31002.0,2020-01-06,"(548.0, 816.0]",3,3,0
31002.0,2020-01-06,"(816.0, 1084.0]",5,5,0
31003.0,2020-01-06,"(376.998, 628.5]",3,6,-3
31003.0,2020-01-06,"(628.5, 879.0]",1,2,-1
31003.0,2020-01-06,"(879.0, 1129.5]",5,9,-4
31003.0,2020-01-06,"(1129.5, 1380.0]",3,5,-2
31004.0,2020-01-06,"(876.5, 1070.75]",1,2,-1
31004.0,2020-01-06,"(1070.75, 1265.0]",4,1,3
31005.0,2020-01-06,"(326.0, 640.0]",5,1,4
31005.0,2020-01-06,"(640.0, 954.0]",1,5,-4
31005.0,2020-01-06,"(954.0, 1268.0]",7,2,5
31006.0,2020-01-06,"(771.0, 960.5]",1,1,0
31006.0,2020-01-06,"(960.5, 1150.0]",1,1,0
31007.0,2020-01-06,"(357.042, 597.5]",6,16,-10
31007.0,2020-01-06,"(597.5, 837.0]",5,6,-1
31007.0,2020-01-06,"(837.0, 1076.5]",10,23,-13
31007.0,2020-01-06,"(1076.5, 1316.0]",4,11,-7
31009.0,2020-01-06,"(488.411, 636.25]",5,5,0
31009.0,2020-01-06,"(930.75, 1078.0]",1,4,-3
31010.0,2020-01-06,"(439.512, 562.0]",1,1,0
31010.0,2020-01-06,"(684.0, 806.0]",1,1,0
31011.0,2020-01-06,"(408.008, 657.0]",7,8,-1
31011.0,2020-01-06,"(657.0, 905.0]",2,4,-2
31011.0,2020-01-06,"(905.0, 1153.0]",2,5,-3
31011.0,2020-01-06,"(1153.0, 1401.0]",2,2,0
31012.0,2020-01-06,"(360.111, 583.25]",2,2,0
31012.0,2020-01-06,"(583.25, 805.5]",1,2,-1
31012.0,2020-01-06,"(1027.75, 1250.0]",2,6,-4
31013.0,2020-01-06,"(762.25, 927.5]",1,1,0
31013.0,2020-01-06,"(927.5, 1092.75]",2,2,0
31013.0,2020-01-06,"(1092.75, 1258.0]",2,3,-1
31014.0,2020-01-06,"(320.165, 529.75]",13,14,-1
31014.0,2020-01-06,"(529.75, 738.5]",6,10,-4
31014.0,2020-01-06,"(738.5, 947.25]",1,3,-2
31014.0,2020-01-06,"(947.25, 1156.0]",9,23,-14
31015.0,2020-01-06,"(307.094, 534.5]",13,14,-1
31015.0,2020-01-06,"(534.5, 761.0]",1,1,0
31015.0,2020-01-06,"(761.0, 987.5]",1,5,-4
31015.0,2020-01-06,"(987.5, 1214.0]",6,11,-5
31016.0,2020-01-06,"(366.13, 584.5]",7,12,-5
31016.0,2020-01-06,"(584.5, 802.0]",3,4,-1
31016.0,2020-01-06,"(802.0, 1019.5]",6,8,-2
31016.0,2020-01-06,"(1019.5, 1237.0]",4,10,-6
31017.0,2020-01-06,"(465.057, 701.75]",3,5,-2
31017.0,2020-01-06,"(937.5, 1173.25]",2,3,-1
31017.0,2020-01-06,"(1173.25, 1409.0]",1,6,-5
31018.0,2020-01-06,"(402.279, 583.25]",1,8,-7
31018.0,2020-01-06,"(763.5, 943.75]",1,1,0
31018.0,2020-01-06,"(943.75, 1124.0]",2,2,0
31019.0,2020-01-06,"(1045.5, 1244.0]",1,1,0
31020.0,2020-01-06,"(703.588, 807.0]",1,2,-1
31020.0,2020-01-06,"(910.0, 1013.0]",1,1,0
31021.0,2020-01-06,"(293.964, 554.0]",1,4,-3
31021.0,2020-01-06,"(554.0, 813.0]",1,2,-1
31021.0,2020-01-06,"(813.0, 1072.0]",2,3,-1
31021.0,2020-01-06,"(1072.0, 1331.0]",1,5,-4
31022.0,2020-01-06,"(405.173, 612.75]",2,7,-5
31022.0,2020-01-06,"(612.75, 819.5]",4,7,-3
31022.0,2020-01-06,"(1026.25, 1233.0]",2,2,0
31023.0,2020-01-06,"(944.618, 1040.5]",3,4,-1
31023.0,2020-01-06,"(1040.5, 1136.0]",2,3,-1
31024.0,2020-01-06,"(412.15, 625.5]",9,17,-8
31024.0,2020-01-06,"(625.5, 838.0]",3,3,0
31024.0,2020-01-06,"(838.0, 1050.5]",4,8,-4
31024.0,2020-01-06,"(1050.5, 1263.0]",3,11,-8
31025.0,2020-01-06,"(1050.75, 1229.0]",1,1,0
31026.0,2020-01-06,"(796.0, 989.5]",1,2,-1
31026.0,2020-01-06,"(989.5, 1183.0]",2,1,1
31027.0,2020-01-06,"(559.344, 724.0]",2,5,-3
31027.0,2020-01-06,"(888.0, 1052.0]",1,3,-2
31027.0,2020-01-06,"(1052.0, 1216.0]",1,1,0
31028.0,2020-01-06,"(508.5, 765.0]",2,1,1
31028.0,2020-01-06,"(765.0, 1021.5]",1,4,-3
31028.0,2020-01-06,"(1021.5, 1278.0]",3,5,-2
31029.0,2020-01-06,"(1026.5, 1214.0]",8,8,0
31030.0,2020-01-06,"(533.362, 693.5]",1,5,-4
31030.0,2020-01-06,"(693.5, 853.0]",1,1,0
31030.0,2020-01-06,"(1012.5, 1172.0]",5,6,-1
31031.0,2020-01-06,"(1023.5, 1250.0]",4,4,0
,,,,1.0,
,,,,1.0,
,,,,2.0,
31034.0,2020-01-06,"(427.334, 594.5]",5,8,-3
31034.0,2020-01-06,"(927.5, 1094.0]",2,1,1
31035.0,2020-01-06,"(407.989, 661.75]",3,9,-6
31035.0,2020-01-06,"(661.75, 914.5]",1,5,-4
31035.0,2020-01-06,"(914.5, 1167.25]",5,8,-3
31035.0,2020-01-06,"(1167.25, 1420.0]",2,4,-2
31036.0,2020-01-06,"(583.0, 754.0]",1,3,-2
31036.0,2020-01-06,"(925.0, 1096.0]",7,2,5
31037.0,2020-01-06,"(401.009, 649.75]",10,17,-7
31037.0,2020-01-06,"(897.5, 1145.25]",3,3,0
31037.0,2020-01-06,"(1145.25, 1393.0]",1,20,-19
31038.0,2020-01-06,"(398.359, 559.25]",1,5,-4
31038.0,2020-01-06,"(559.25, 719.5]",1,1,0
31038.0,2020-01-06,"(719.5, 879.75]",2,4,-2
31039.0,2020-01-06,"(289.146, 503.5]",1,3,-2
31039.0,2020-01-06,"(503.5, 717.0]",3,6,-3
31039.0,2020-01-06,"(717.0, 930.5]",1,2,-1
31039.0,2020-01-06,"(930.5, 1144.0]",6,11,-5
31040.0,2020-01-06,"(442.384, 597.0]",4,5,-1
31040.0,2020-01-06,"(905.0, 1059.0]",3,1,2
31041.0,2020-01-06,"(466.192, 669.0]",4,4,0
31041.0,2020-01-06,"(871.0, 1073.0]",1,3,-2
31041.0,2020-01-06,"(1073.0, 1275.0]",1,1,0
31042.0,2020-01-06,"(446.313, 618.75]",11,12,-1
31042.0,2020-01-06,"(618.75, 790.5]",1,4,-3
31042.0,2020-01-06,"(790.5, 962.25]",1,2,-1
31042.0,2020-01-06,"(962.25, 1134.0]",3,14,-11
31043.0,2020-01-06,"(456.199, 657.25]",2,4,-2
31043.0,2020-01-06,"(857.5, 1057.75]",2,4,-2
31043.0,2020-01-06,"(1057.75, 1258.0]",1,2,-1
31044.0,2020-01-06,"(473.234, 665.5]",1,2,-1
31044.0,2020-01-06,"(857.0, 1048.5]",3,4,-1
31044.0,2020-01-06,"(1048.5, 1240.0]",1,3,-2
31045.0,2020-01-06,"(791.0, 960.5]",1,1,0
31045.0,2020-01-06,"(960.5, 1130.0]",2,3,-1
31046.0,2020-01-06,"(651.75, 869.0]",1,1,0
31047.0,2020-01-06,"(352.04, 593.0]",9,21,-12
31047.0,2020-01-06,"(593.0, 833.0]",2,4,-2
31047.0,2020-01-06,"(833.0, 1073.0]",7,13,-6
31047.0,2020-01-06,"(1073.0, 1313.0]",4,12,-8
31048.0,2020-01-06,"(517.395, 669.25]",1,5,-4
31048.0,2020-01-06,"(820.5, 971.75]",1,2,-1
31048.0,2020-01-06,"(971.75, 1123.0]",5,8,-3
31049.0,2020-01-06,"(432.397, 583.75]",3,4,-1
31049.0,2020-01-06,"(734.5, 885.25]",1,3,-2
31049.0,2020-01-06,"(885.25, 1036.0]",1,3,-2
31050.0,2020-01-06,"(835.5, 1030.25]",1,4,-3
31050.0,2020-01-06,"(1030.25, 1225.0]",1,2,-1
31051.0,2020-01-06,"(746.5, 967.75]",1,5,-4
31051.0,2020-01-06,"(967.75, 1189.0]",4,3,1
31052.0,2020-01-06,"(511.428, 655.0]",3,4,-1
31052.0,2020-01-06,"(941.0, 1084.0]",1,4,-3
31053.0,2020-01-06,"(1027.75, 1142.0]",1,1,0
,,,,2.0,
31055.0,2020-01-06,"(966.25, 1126.0]",3,1,2
31056.0,2020-01-06,"(51.817, 348.75]",1,1,0
31056.0,2020-01-06,"(940.25, 1236.0]",1,3,-2
31057.0,2020-01-06,"(383.25, 511.0]",1,1,0
31058.0,2020-01-06,"(778.5, 1038.0]",1,1,0
31059.0,2020-01-06,"(606.75, 809.0]",1,1,0
31060.0,2020-01-06,"(337.75, 633.5]",1,1,0
31060.0,2020-01-06,"(929.25, 1225.0]",3,1,2
,,,,2.0,
31062.0,2020-01-06,"(617.562, 727.5]",1,2,-1
31062.0,2020-01-06,"(837.0, 946.5]",1,3,-2
31062.0,2020-01-06,"(946.5, 1056.0]",2,2,0
31063.0,2020-01-06,"(711.75, 949.0]",1,1,0
31064.0,2020-01-06,"(503.263, 688.25]",1,2,-1
31064.0,2020-01-06,"(688.25, 872.5]",5,8,-3
31064.0,2020-01-06,"(872.5, 1056.75]",7,17,-10
31064.0,2020-01-06,"(1056.75, 1241.0]",6,12,-6
31065.0,2020-01-06,"(807.0, 992.5]",2,1,1
31065.0,2020-01-06,"(992.5, 1178.0]",1,2,-1
,,,,1.0,
,,,,1.0,
31067.0,2020-01-06,"(420.145, 634.75]",1,3,-2
31067.0,2020-01-06,"(848.5, 1062.25]",1,1,0
31067.0,2020-01-06,"(1062.25, 1276.0]",2,3,-1
31068.0,2020-01-06,"(732.25, 937.5]",2,3,-1
31068.0,2020-01-06,"(1142.75, 1348.0]",2,2,0
31069.0,2020-01-06,"(515.39, 668.5]",1,1,0
31069.0,2020-01-06,"(668.5, 821.0]",1,3,-2
31069.0,2020-01-06,"(821.0, 973.5]",3,3,0
31069.0,2020-01-06,"(973.5, 1126.0]",1,1,0
31070.0,2020-01-06,"(584.413, 731.75]",1,4,-3
31070.0,2020-01-06,"(878.5, 1025.25]",2,1,1
31070.0,2020-01-06,"(1025.25, 1172.0]",1,4,-3
31071.0,2020-01-06,"(405.153, 617.75]",1,4,-3
31071.0,2020-01-06,"(617.75, 829.5]",2,4,-2
31071.0,2020-01-06,"(829.5, 1041.25]",2,6,-4
31071.0,2020-01-06,"(1041.25, 1253.0]",9,11,-2
,,,,1.0,
,,,,1.0,
31073.0,2020-01-06,"(489.456, 626.0]",3,6,-3
31073.0,2020-01-06,"(762.0, 898.0]",1,2,-1
31073.0,2020-01-06,"(898.0, 1034.0]",2,2,0
31074.0,2020-01-06,"(684.75, 883.5]",3,1,2
31074.0,2020-01-06,"(883.5, 1082.25]",2,5,-3
31074.0,2020-01-06,"(1082.25, 1281.0]",2,5,-3
31075.0,2020-01-06,"(975.75, 1123.0]",2,1,1
31076.0,2020-01-06,"(823.5, 1098.0]",2,1,1
31077.0,2020-01-06,"(572.5, 756.0]",5,1,4
31077.0,2020-01-06,"(939.5, 1123.0]",5,6,-1
31078.0,2020-01-06,"(474.399, 625.25]",5,6,-1
31078.0,2020-01-06,"(925.75, 1076.0]",2,11,-9
31079.0,2020-01-06,"(679.0, 898.0]",3,5,-2
31079.0,2020-01-06,"(898.0, 1117.0]",3,5,-2
31079.0,2020-01-06,"(1117.0, 1336.0]",3,5,-2
31080.0,2020-01-06,"(241.848, 531.0]",1,5,-4
31080.0,2020-01-06,"(531.0, 819.0]",1,1,0
31080.0,2020-01-06,"(819.0, 1107.0]",6,8,-2
31080.0,2020-01-06,"(1107.0, 1395.0]",4,5,-1
31081.0,2020-01-06,"(466.327, 635.25]",2,2,0
31081.0,2020-01-06,"(803.5, 971.75]",1,1,0
31082.0,2020-01-06,"(912.898, 938.5]",1,2,-1
31083.0,2020-01-06,"(881.75, 1040.0]",1,1,0
31084.0,2020-01-06,"(604.479, 735.25]",3,3,0
31084.0,2020-01-06,"(735.25, 865.5]",1,1,0
31084.0,2020-01-06,"(865.5, 995.75]",1,3,-2
31084.0,2020-01-06,"(995.75, 1126.0]",1,6,-5
31085.0,2020-01-06,"(950.5, 1099.0]",1,1,0
31086.0,2020-01-06,"(741.75, 849.0]",1,2,-1
31087.0,2020-01-06,"(779.584, 884.0]",1,1,0
31088.0,2020-01-06,"(674.75, 824.5]",1,1,0
31088.0,2020-01-06,"(974.25, 1124.0]",4,2,2
31089.0,2020-01-06,"(252.05, 490.5]",4,4,0
31089.0,2020-01-06,"(490.5, 728.0]",7,10,-3
31089.0,2020-01-06,"(728.0, 965.5]",2,6,-4
31089.0,2020-01-06,"(965.5, 1203.0]",4,16,-12
31090.0,2020-01-06,"(905.5, 1062.0]",2,1,1
31091.0,2020-01-06,"(13.625, 358.75]",1,1,0
31091.0,2020-01-06,"(702.5, 1046.25]",3,5,-2
31091.0,2020-01-06,"(1046.25, 1390.0]",3,4,-1
31092.0,2020-01-06,"(891.5, 1138.25]",3,3,0
31092.0,2020-01-06,"(1138.25, 1385.0]",1,4,-3
31093.0,2020-01-06,"(585.601, 685.75]",1,2,-1
31094.0,2020-01-06,"(505.766, 564.5]",1,1,0
31095.0,2020-01-06,"(824.25, 949.0]",1,1,0
,,,,2.0,
31097.0,2020-01-06,"(524.208, 723.0]",4,4,0
31097.0,2020-01-06,"(723.0, 921.0]",2,2,0
31097.0,2020-01-06,"(1119.0, 1317.0]",1,2,-1
31098.0,2020-01-06,"(438.17, 646.5]",4,10,-6
31098.0,2020-01-06,"(646.5, 854.0]",2,2,0
31098.0,2020-01-06,"(854.0, 1061.5]",4,7,-3
31098.0,2020-01-06,"(1061.5, 1269.0]",4,9,-5
31099.0,2020-01-06,"(938.5, 1021.75]",2,1,1
31099.0,2020-01-06,"(1021.75, 1105.0]",1,3,-2
31100.0,2020-01-06,"(392.015, 639.25]",6,6,0
31100.0,2020-01-06,"(885.5, 1131.75]",6,1,5
31100.0,2020-01-06,"(1131.75, 1378.0]",1,19,-18
31101.0,2020-01-06,"(422.034, 664.5]",12,37,-25
31101.0,2020-01-06,"(664.5, 906.0]",3,5,-2
31101.0,2020-01-06,"(906.0, 1147.5]",44,61,-17
31101.0,2020-01-06,"(1147.5, 1389.0]",11,22,-11
31102.0,2020-01-06,"(321.5, 638.0]",2,1,1
31102.0,2020-01-06,"(954.5, 1271.0]",12,17,-5
31103.0,2020-01-06,"(373.942, 639.5]",2,28,-26
31103.0,2020-01-06,"(904.0, 1168.5]",10,7,3
31103.0,2020-01-06,"(1168.5, 1433.0]",5,23,-18
31104.0,2020-01-06,"(425.03, 668.5]",2,10,-8
31104.0,2020-01-06,"(668.5, 911.0]",3,7,-4
31104.0,2020-01-06,"(911.0, 1153.5]",13,26,-13
31104.0,2020-01-06,"(1153.5, 1396.0]",7,14,-7
31105.0,2020-01-06,"(6.592, 360.0]",1,1,0
31105.0,2020-01-06,"(712.0, 1064.0]",4,11,-7
31105.0,2020-01-06,"(1064.0, 1416.0]",6,10,-4
31106.0,2020-01-06,"(602.0, 794.0]",1,11,-10
31106.0,2020-01-06,"(794.0, 986.0]",1,1,0
31106.0,2020-01-06,"(986.0, 1178.0]",6,2,4
31107.0,2020-01-06,"(296.903, 572.25]",2,15,-13
31107.0,2020-01-06,"(572.25, 846.5]",2,9,-7
31107.0,2020-01-06,"(846.5, 1120.75]",12,23,-11
31107.0,2020-01-06,"(1120.75, 1395.0]",12,18,-6
31108.0,2020-01-06,"(217.967, 477.25]",2,9,-7
31108.0,2020-01-06,"(477.25, 735.5]",11,23,-12
31108.0,2020-01-06,"(735.5, 993.75]",8,16,-8
31108.0,2020-01-06,"(993.75, 1252.0]",20,31,-11
31109.0,2020-01-06,"(90.705, 415.75]",2,2,0
31109.0,2020-01-06,"(415.75, 739.5]",7,24,-17
31109.0,2020-01-06,"(739.5, 1063.25]",9,16,-7
31109.0,2020-01-06,"(1063.25, 1387.0]",22,34,-12
31110.0,2020-01-06,"(311.994, 564.5]",8,23,-15
31110.0,2020-01-06,"(564.5, 816.0]",9,18,-9
31110.0,2020-01-06,"(816.0, 1067.5]",9,21,-12
31110.0,2020-01-06,"(1067.5, 1319.0]",21,34,-13
31111.0,2020-01-06,"(428.157, 639.75]",2,14,-12
31111.0,2020-01-06,"(850.5, 1061.25]",5,8,-3
31111.0,2020-01-06,"(1061.25, 1272.0]",8,14,-6
31112.0,2020-01-06,"(362.099, 588.25]",1,4,-3
31112.0,2020-01-06,"(813.5, 1038.75]",2,3,-1
31112.0,2020-01-06,"(1038.75, 1264.0]",3,5,-2
31113.0,2020-01-06,"(311.971, 570.25]",1,17,-16
31113.0,2020-01-06,"(827.5, 1084.75]",5,6,-1
31113.0,2020-01-06,"(1084.75, 1342.0]",9,10,-1
31114.0,2020-01-06,"(312.014, 559.5]",4,23,-19
31114.0,2020-01-06,"(559.5, 806.0]",3,5,-2
31114.0,2020-01-06,"(806.0, 1052.5]",9,16,-7
31114.0,2020-01-06,"(1052.5, 1299.0]",15,26,-11
31115.0,2020-01-06,"(868.0, 1130.5]",12,14,-2
31115.0,2020-01-06,"(1130.5, 1393.0]",6,14,-8
31116.0,2020-01-06,"(384.011, 632.25]",1,19,-18
31116.0,2020-01-06,"(632.25, 879.5]",4,6,-2
31116.0,2020-01-06,"(879.5, 1126.75]",15,21,-6
31116.0,2020-01-06,"(1126.75, 1374.0]",12,19,-7
31117.0,2020-01-06,"(154.809, 453.75]",4,13,-9
31117.0,2020-01-06,"(453.75, 751.5]",3,13,-10
31117.0,2020-01-06,"(751.5, 1049.25]",6,15,-9
31117.0,2020-01-06,"(1049.25, 1347.0]",16,25,-9
31118.0,2020-01-06,"(381.181, 586.75]",4,16,-12
31118.0,2020-01-06,"(586.75, 791.5]",1,2,-1
31118.0,2020-01-06,"(791.5, 996.25]",1,1,0
31118.0,2020-01-06,"(996.25, 1201.0]",19,24,-5
31119.0,2020-01-06,"(23.781, 329.75]",1,3,-2
31119.0,2020-01-06,"(329.75, 634.5]",8,22,-14
31119.0,2020-01-06,"(634.5, 939.25]",7,9,-2
31119.0,2020-01-06,"(939.25, 1244.0]",15,30,-15
31120.0,2020-01-06,"(432.014, 679.5]",2,9,-7
31120.0,2020-01-06,"(679.5, 926.0]",2,4,-2
31120.0,2020-01-06,"(926.0, 1172.5]",9,14,-5
31120.0,2020-01-06,"(1172.5, 1419.0]",6,10,-4
31121.0,2020-01-06,"(387.964, 648.0]",14,20,-6
31121.0,2020-01-06,"(648.0, 907.0]",2,7,-5
31121.0,2020-01-06,"(907.0, 1166.0]",5,12,-7
31121.0,2020-01-06,"(1166.0, 1425.0]",2,2,0
31122.0,2020-01-06,"(608.5, 879.0]",3,14,-11
31122.0,2020-01-06,"(879.0, 1149.5]",2,4,-2
31122.0,2020-01-06,"(1149.5, 1420.0]",6,6,0
31123.0,2020-01-06,"(374.944, 640.0]",1,14,-13
31123.0,2020-01-06,"(640.0, 904.0]",1,1,0
31123.0,2020-01-06,"(904.0, 1168.0]",9,12,-3
31123.0,2020-01-06,"(1168.0, 1432.0]",6,11,-5
31124.0,2020-01-06,"(366.934, 634.5]",16,47,-31
31124.0,2020-01-06,"(634.5, 901.0]",6,18,-12
31124.0,2020-01-06,"(901.0, 1167.5]",14,48,-34
31124.0,2020-01-06,"(1167.5, 1434.0]",8,18,-10
31125.0,2020-01-06,"(48.799, 350.25]",1,1,0
31125.0,2020-01-06,"(350.25, 650.5]",9,28,-19
31125.0,2020-01-06,"(650.5, 950.75]",3,14,-11
31125.0,2020-01-06,"(950.75, 1251.0]",36,50,-14
31126.0,2020-01-06,"(362.992, 616.0]",4,17,-13
31126.0,2020-01-06,"(616.0, 868.0]",2,4,-2
31126.0,2020-01-06,"(868.0, 1120.0]",15,18,-3
31126.0,2020-01-06,"(1120.0, 1372.0]",9,13,-4
,,,,2.0,
31128.0,2020-01-06,"(55.625, 400.75]",1,2,-1
31128.0,2020-01-06,"(400.75, 744.5]",27,38,-11
31128.0,2020-01-06,"(744.5, 1088.25]",29,49,-20
31128.0,2020-01-06,"(1088.25, 1432.0]",14,29,-15
31129.0,2020-01-06,"(418.327, 587.25]",14,16,-2
31129.0,2020-01-06,"(587.25, 755.5]",4,10,-6
31129.0,2020-01-06,"(755.5, 923.75]",7,11,-4
31129.0,2020-01-06,"(923.75, 1092.0]",10,19,-9
31130.0,2020-01-06,"(368.75, 677.5]",1,2,-1
31130.0,2020-01-06,"(677.5, 986.25]",4,11,-7
31130.0,2020-01-06,"(986.25, 1295.0]",10,8,2
31131.0,2020-01-06,"(760.5, 958.25]",2,12,-10
31131.0,2020-01-06,"(958.25, 1156.0]",2,3,-1
31200.0,2020-01-06,"(332.932, 601.0]",30,41,-11
31200.0,2020-01-06,"(601.0, 868.0]",16,24,-8
31200.0,2020-01-06,"(868.0, 1135.0]",11,32,-21
31200.0,2020-01-06,"(1135.0, 1402.0]",11,22,-11
31201.0,2020-01-06,"(40.644, 381.0]",5,6,-1
31201.0,2020-01-06,"(381.0, 720.0]",22,52,-30
31201.0,2020-01-06,"(720.0, 1059.0]",30,49,-19
31201.0,2020-01-06,"(1059.0, 1398.0]",26,69,-43
31202.0,2020-01-06,"(393.002, 643.5]",7,16,-9
31202.0,2020-01-06,"(643.5, 893.0]",4,7,-3
31202.0,2020-01-06,"(893.0, 1142.5]",23,35,-12
31202.0,2020-01-06,"(1142.5, 1392.0]",3,13,-10
31203.0,2020-01-06,"(0.571, 359.25]",2,3,-1
31203.0,2020-01-06,"(359.25, 716.5]",7,26,-19
31203.0,2020-01-06,"(716.5, 1073.75]",28,43,-15
31203.0,2020-01-06,"(1073.75, 1431.0]",16,34,-18
31204.0,2020-01-06,"(446.162, 656.5]",14,17,-3
31204.0,2020-01-06,"(656.5, 866.0]",6,11,-5
31204.0,2020-01-06,"(1075.5, 1285.0]",3,9,-6
31205.0,2020-01-06,"(58.787, 363.25]",2,2,0
31205.0,2020-01-06,"(363.25, 666.5]",14,18,-4
31205.0,2020-01-06,"(666.5, 969.75]",14,22,-8
31205.0,2020-01-06,"(969.75, 1273.0]",10,31,-21
31206.0,2020-01-06,"(519.165, 728.75]",5,5,0
31206.0,2020-01-06,"(728.75, 937.5]",1,2,-1
31206.0,2020-01-06,"(937.5, 1146.25]",1,6,-5
31206.0,2020-01-06,"(1146.25, 1355.0]",1,1,0
31207.0,2020-01-06,"(826.5, 1059.25]",2,6,-4
31207.0,2020-01-06,"(1059.25, 1292.0]",5,3,2
31208.0,2020-01-06,"(358.116, 580.0]",10,12,-2
31208.0,2020-01-06,"(580.0, 801.0]",2,4,-2
31208.0,2020-01-06,"(801.0, 1022.0]",1,6,-5
31208.0,2020-01-06,"(1022.0, 1243.0]",6,12,-6
31209.0,2020-01-06,"(524.235, 716.25]",5,6,-1
31209.0,2020-01-06,"(716.25, 907.5]",2,4,-2
31209.0,2020-01-06,"(907.5, 1098.75]",5,6,-1
31209.0,2020-01-06,"(1098.75, 1290.0]",3,3,0
31211.0,2020-01-06,"(435.09, 663.5]",10,10,0
31211.0,2020-01-06,"(663.5, 891.0]",1,3,-2
31211.0,2020-01-06,"(891.0, 1118.5]",5,13,-8
31211.0,2020-01-06,"(1118.5, 1346.0]",4,8,-4
31212.0,2020-01-06,"(341.014, 588.5]",23,34,-11
31212.0,2020-01-06,"(588.5, 835.0]",3,8,-5
31212.0,2020-01-06,"(835.0, 1081.5]",7,17,-10
31212.0,2020-01-06,"(1081.5, 1328.0]",4,15,-11
31213.0,2020-01-06,"(351.004, 601.0]",19,32,-13
31213.0,2020-01-06,"(601.0, 850.0]",9,16,-7
31213.0,2020-01-06,"(850.0, 1099.0]",6,24,-18
31213.0,2020-01-06,"(1099.0, 1348.0]",5,13,-8
31214.0,2020-01-06,"(339.25, 675.5]",10,1,9
31214.0,2020-01-06,"(675.5, 1011.75]",20,30,-10
31214.0,2020-01-06,"(1011.75, 1348.0]",36,32,4
31215.0,2020-01-06,"(472.236, 664.0]",15,17,-2
31215.0,2020-01-06,"(664.0, 855.0]",2,3,-1
31215.0,2020-01-06,"(855.0, 1046.0]",3,8,-5
31215.0,2020-01-06,"(1046.0, 1237.0]",6,13,-7
31216.0,2020-01-06,"(331.003, 581.25]",8,10,-2
31216.0,2020-01-06,"(830.5, 1079.75]",3,1,2
31216.0,2020-01-06,"(1079.75, 1329.0]",3,14,-11
31217.0,2020-01-06,"(377.296, 554.0]",11,13,-2
31217.0,2020-01-06,"(730.0, 906.0]",1,1,0
31217.0,2020-01-06,"(906.0, 1082.0]",8,2,6
31218.0,2020-01-06,"(374.23, 567.5]",9,24,-15
31218.0,2020-01-06,"(567.5, 760.0]",4,6,-2
31218.0,2020-01-06,"(760.0, 952.5]",9,14,-5
31218.0,2020-01-06,"(952.5, 1145.0]",4,10,-6
31219.0,2020-01-06,"(376.246, 565.5]",9,10,-1
31219.0,2020-01-06,"(565.5, 754.0]",6,6,0
31219.0,2020-01-06,"(754.0, 942.5]",1,2,-1
31220.0,2020-01-06,"(380.351, 543.25]",18,23,-5
31220.0,2020-01-06,"(705.5, 867.75]",5,11,-6
31220.0,2020-01-06,"(867.75, 1030.0]",3,20,-17
31221.0,2020-01-06,"(453.066, 687.5]",22,25,-3
31221.0,2020-01-06,"(687.5, 921.0]",3,7,-4
31221.0,2020-01-06,"(921.0, 1154.5]",9,35,-26
31221.0,2020-01-06,"(1154.5, 1388.0]",1,5,-4
31222.0,2020-01-06,"(376.985, 631.75]",20,23,-3
31222.0,2020-01-06,"(631.75, 885.5]",1,3,-2
31222.0,2020-01-06,"(885.5, 1139.25]",1,8,-7
31222.0,2020-01-06,"(1139.25, 1393.0]",2,6,-4
31223.0,2020-01-06,"(36.631, 380.25]",2,3,-1
31223.0,2020-01-06,"(380.25, 722.5]",8,32,-24
31223.0,2020-01-06,"(722.5, 1064.75]",9,21,-12
31223.0,2020-01-06,"(1064.75, 1407.0]",12,23,-11
31224.0,2020-01-06,"(406.132, 624.0]",5,6,-1
31224.0,2020-01-06,"(624.0, 841.0]",1,3,-2
31224.0,2020-01-06,"(841.0, 1058.0]",4,15,-11
31224.0,2020-01-06,"(1058.0, 1275.0]",2,6,-4
31225.0,2020-01-06,"(494.116, 716.0]",9,13,-4
31225.0,2020-01-06,"(716.0, 937.0]",3,6,-3
31225.0,2020-01-06,"(937.0, 1158.0]",4,18,-14
31225.0,2020-01-06,"(1158.0, 1379.0]",2,3,-1
31226.0,2020-01-06,"(320.068, 554.0]",5,8,-3
31226.0,2020-01-06,"(554.0, 787.0]",3,5,-2
31226.0,2020-01-06,"(787.0, 1020.0]",2,5,-3
31226.0,2020-01-06,"(1020.0, 1253.0]",4,11,-7
31227.0,2020-01-06,"(419.087, 648.25]",17,20,-3
31227.0,2020-01-06,"(648.25, 876.5]",4,8,-4
31227.0,2020-01-06,"(876.5, 1104.75]",4,21,-17
31227.0,2020-01-06,"(1104.75, 1333.0]",2,14,-12
31228.0,2020-01-06,"(361.036, 603.0]",20,28,-8
31228.0,2020-01-06,"(603.0, 844.0]",10,19,-9
31228.0,2020-01-06,"(844.0, 1085.0]",15,36,-21
31228.0,2020-01-06,"(1085.0, 1326.0]",13,32,-19
31229.0,2020-01-06,"(347.946, 612.5]",12,51,-39
31229.0,2020-01-06,"(612.5, 876.0]",8,13,-5
31229.0,2020-01-06,"(876.0, 1139.5]",34,52,-18
31229.0,2020-01-06,"(1139.5, 1403.0]",8,20,-12
31230.0,2020-01-06,"(359.057, 595.75]",53,63,-10
31230.0,2020-01-06,"(595.75, 831.5]",16,22,-6
31230.0,2020-01-06,"(831.5, 1067.25]",11,19,-8
31230.0,2020-01-06,"(1067.25, 1303.0]",7,29,-22
31231.0,2020-01-06,"(324.911, 598.25]",20,23,-3
31231.0,2020-01-06,"(598.25, 870.5]",3,6,-3
31231.0,2020-01-06,"(870.5, 1142.75]",13,44,-31
31231.0,2020-01-06,"(1142.75, 1415.0]",1,5,-4
31232.0,2020-01-06,"(55.758, 367.5]",1,2,-1
31232.0,2020-01-06,"(367.5, 678.0]",12,16,-4
31232.0,2020-01-06,"(678.0, 988.5]",14,25,-11
31232.0,2020-01-06,"(988.5, 1299.0]",16,41,-25
31233.0,2020-01-06,"(455.074, 687.5]",30,34,-4
31233.0,2020-01-06,"(687.5, 919.0]",3,6,-3
31233.0,2020-01-06,"(919.0, 1150.5]",16,41,-25
31233.0,2020-01-06,"(1150.5, 1382.0]",1,8,-7
31234.0,2020-01-06,"(363.75, 707.5]",14,1,13
31234.0,2020-01-06,"(707.5, 1051.25]",8,27,-19
31234.0,2020-01-06,"(1051.25, 1395.0]",15,20,-5
31235.0,2020-01-06,"(387.333, 554.75]",5,6,-1
31235.0,2020-01-06,"(554.75, 721.5]",7,7,0
31235.0,2020-01-06,"(721.5, 888.25]",2,3,-1
31235.0,2020-01-06,"(888.25, 1055.0]",2,3,-1
31236.0,2020-01-06,"(424.99, 678.5]",7,9,-2
31236.0,2020-01-06,"(678.5, 931.0]",7,10,-3
31236.0,2020-01-06,"(931.0, 1183.5]",2,13,-11
31237.0,2020-01-06,"(348.928, 618.0]",9,17,-8
31237.0,2020-01-06,"(618.0, 886.0]",9,19,-10
31237.0,2020-01-06,"(886.0, 1154.0]",5,10,-5
31237.0,2020-01-06,"(1154.0, 1422.0]",5,10,-5
31238.0,2020-01-06,"(53.837, 345.75]",1,1,0
31238.0,2020-01-06,"(345.75, 636.5]",8,11,-3
31238.0,2020-01-06,"(636.5, 927.25]",2,5,-3
31238.0,2020-01-06,"(927.25, 1218.0]",4,24,-20
31239.0,2020-01-06,"(90.731, 409.25]",2,3,-1
31239.0,2020-01-06,"(409.25, 726.5]",19,25,-6
31239.0,2020-01-06,"(726.5, 1043.75]",8,17,-9
31239.0,2020-01-06,"(1043.75, 1361.0]",10,25,-15
31240.0,2020-01-06,"(671.0, 895.0]",1,1,0
31240.0,2020-01-06,"(895.0, 1119.0]",6,2,4
31240.0,2020-01-06,"(1119.0, 1343.0]",1,12,-11
31241.0,2020-01-06,"(22.675, 355.25]",2,2,0
31241.0,2020-01-06,"(355.25, 686.5]",52,75,-23
31241.0,2020-01-06,"(686.5, 1017.75]",10,25,-15
31241.0,2020-01-06,"(1017.75, 1349.0]",26,52,-26
31242.0,2020-01-06,"(414.146, 628.5]",15,20,-5
31242.0,2020-01-06,"(628.5, 842.0]",2,7,-5
31242.0,2020-01-06,"(842.0, 1055.5]",6,16,-10
31242.0,2020-01-06,"(1055.5, 1269.0]",2,15,-13
31243.0,2020-01-06,"(350.994, 603.5]",20,24,-4
31243.0,2020-01-06,"(603.5, 855.0]",6,6,0
31243.0,2020-01-06,"(855.0, 1106.5]",10,36,-26
31243.0,2020-01-06,"(1106.5, 1358.0]",4,12,-8
31244.0,2020-01-06,"(64.77, 373.5]",2,3,-1
31244.0,2020-01-06,"(373.5, 681.0]",22,32,-10
31244.0,2020-01-06,"(681.0, 988.5]",11,23,-12
31244.0,2020-01-06,"(988.5, 1296.0]",9,22,-13
31245.0,2020-01-06,"(48.689, 377.75]",1,3,-2
31245.0,2020-01-06,"(377.75, 705.5]",9,22,-13
31245.0,2020-01-06,"(705.5, 1033.25]",4,7,-3
31245.0,2020-01-06,"(1033.25, 1361.0]",6,12,-6
31246.0,2020-01-06,"(13.596, 366.0]",1,2,-1
31246.0,2020-01-06,"(366.0, 717.0]",11,14,-3
31246.0,2020-01-06,"(717.0, 1068.0]",17,38,-21
31246.0,2020-01-06,"(1068.0, 1419.0]",13,25,-12
31247.0,2020-01-06,"(420.228, 614.0]",7,8,-1
31247.0,2020-01-06,"(614.0, 807.0]",13,20,-7
31247.0,2020-01-06,"(807.0, 1000.0]",5,8,-3
31247.0,2020-01-06,"(1000.0, 1193.0]",8,20,-12
31248.0,2020-01-06,"(388.075, 620.25]",9,15,-6
31248.0,2020-01-06,"(620.25, 851.5]",7,13,-6
31248.0,2020-01-06,"(851.5, 1082.75]",20,30,-10
31248.0,2020-01-06,"(1082.75, 1314.0]",1,8,-7
31249.0,2020-01-06,"(418.019, 664.25]",7,13,-6
31249.0,2020-01-06,"(664.25, 909.5]",9,17,-8
31249.0,2020-01-06,"(909.5, 1154.75]",16,30,-14
31249.0,2020-01-06,"(1154.75, 1400.0]",5,10,-5
31250.0,2020-01-06,"(415.044, 655.0]",10,12,-2
31250.0,2020-01-06,"(655.0, 894.0]",5,10,-5
31250.0,2020-01-06,"(894.0, 1133.0]",4,20,-16
31250.0,2020-01-06,"(1133.0, 1372.0]",1,2,-1
31251.0,2020-01-06,"(241.837, 533.75]",8,19,-11
31251.0,2020-01-06,"(533.75, 824.5]",23,39,-16
31251.0,2020-01-06,"(824.5, 1115.25]",9,27,-18
31251.0,2020-01-06,"(1115.25, 1406.0]",11,17,-6
31252.0,2020-01-06,"(492.213, 689.75]",12,14,-2
31252.0,2020-01-06,"(689.75, 886.5]",3,6,-3
31252.0,2020-01-06,"(886.5, 1083.25]",4,12,-8
31252.0,2020-01-06,"(1083.25, 1280.0]",2,8,-6
31253.0,2020-01-06,"(344.032, 587.0]",9,10,-1
31253.0,2020-01-06,"(587.0, 829.0]",14,17,-3
31253.0,2020-01-06,"(829.0, 1071.0]",8,19,-11
31253.0,2020-01-06,"(1071.0, 1313.0]",1,11,-10
31254.0,2020-01-06,"(348.107, 572.25]",8,10,-2
31254.0,2020-01-06,"(572.25, 795.5]",3,8,-5
31254.0,2020-01-06,"(795.5, 1018.75]",9,18,-9
31254.0,2020-01-06,"(1018.75, 1242.0]",5,23,-18
31255.0,2020-01-06,"(294.101, 519.75]",10,12,-2
31255.0,2020-01-06,"(519.75, 744.5]",2,4,-2
31255.0,2020-01-06,"(744.5, 969.25]",2,9,-7
31255.0,2020-01-06,"(969.25, 1194.0]",11,24,-13
31256.0,2020-01-06,"(253.006, 502.5]",6,6,0
31256.0,2020-01-06,"(502.5, 751.0]",7,7,0
31256.0,2020-01-06,"(751.0, 999.5]",3,6,-3
31256.0,2020-01-06,"(999.5, 1248.0]",9,22,-13
31257.0,2020-01-06,"(375.995, 628.25]",14,28,-14
31257.0,2020-01-06,"(628.25, 879.5]",6,12,-6
31257.0,2020-01-06,"(879.5, 1130.75]",11,23,-12
31257.0,2020-01-06,"(1130.75, 1382.0]",4,9,-5
31258.0,2020-01-06,"(445.052, 683.0]",9,19,-10
31258.0,2020-01-06,"(683.0, 920.0]",14,35,-21
31258.0,2020-01-06,"(920.0, 1157.0]",10,20,-10
31258.0,2020-01-06,"(1157.0, 1394.0]",7,12,-5
31259.0,2020-01-06,"(453.343, 618.25]",11,11,0
31259.0,2020-01-06,"(782.5, 946.75]",2,1,1
31260.0,2020-01-06,"(369.973, 627.75]",17,18,-1
31260.0,2020-01-06,"(884.5, 1141.25]",3,20,-17
31260.0,2020-01-06,"(1141.25, 1398.0]",1,2,-1
31261.0,2020-01-06,"(388.272, 571.0]",9,9,0
31261.0,2020-01-06,"(571.0, 753.0]",6,13,-7
31261.0,2020-01-06,"(753.0, 935.0]",1,4,-3
31261.0,2020-01-06,"(935.0, 1117.0]",2,12,-10
31262.0,2020-01-06,"(421.209, 619.75]",10,12,-2
31262.0,2020-01-06,"(619.75, 817.5]",1,4,-3
31262.0,2020-01-06,"(817.5, 1015.25]",3,5,-2
31262.0,2020-01-06,"(1015.25, 1213.0]",6,19,-13
31263.0,2020-01-06,"(363.097, 589.75]",19,31,-12
31263.0,2020-01-06,"(589.75, 815.5]",8,20,-12
31263.0,2020-01-06,"(815.5, 1041.25]",7,27,-20
31263.0,2020-01-06,"(1041.25, 1267.0]",8,20,-12
31264.0,2020-01-06,"(415.239, 606.25]",12,17,-5
31264.0,2020-01-06,"(606.25, 796.5]",5,11,-6
31264.0,2020-01-06,"(796.5, 986.75]",5,9,-4
31264.0,2020-01-06,"(986.75, 1177.0]",10,23,-13
31265.0,2020-01-06,"(287.864, 573.0]",14,31,-17
31265.0,2020-01-06,"(573.0, 857.0]",8,19,-11
31265.0,2020-01-06,"(857.0, 1141.0]",15,34,-19
31265.0,2020-01-06,"(1141.0, 1425.0]",12,17,-5
31266.0,2020-01-06,"(56.705, 381.75]",1,6,-5
31266.0,2020-01-06,"(381.75, 705.5]",8,17,-9
31266.0,2020-01-06,"(705.5, 1029.25]",7,15,-8
31266.0,2020-01-06,"(1029.25, 1353.0]",19,27,-8
31267.0,2020-01-06,"(3.73, 322.5]",1,1,0
31267.0,2020-01-06,"(322.5, 640.0]",30,46,-16
31267.0,2020-01-06,"(640.0, 957.5]",5,14,-9
31267.0,2020-01-06,"(957.5, 1275.0]",21,34,-13
31268.0,2020-01-06,"(343.993, 596.75]",10,40,-30
31268.0,2020-01-06,"(596.75, 848.5]",4,5,-1
31268.0,2020-01-06,"(848.5, 1100.25]",11,16,-5
31268.0,2020-01-06,"(1100.25, 1352.0]",26,36,-10
31269.0,2020-01-06,"(311.026, 555.5]",5,8,-3
31269.0,2020-01-06,"(555.5, 799.0]",5,8,-3
31269.0,2020-01-06,"(799.0, 1042.5]",11,20,-9
31269.0,2020-01-06,"(1042.5, 1286.0]",5,16,-11
31270.0,2020-01-06,"(385.036, 627.0]",17,26,-9
31270.0,2020-01-06,"(627.0, 868.0]",8,12,-4
31270.0,2020-01-06,"(868.0, 1109.0]",9,24,-15
31270.0,2020-01-06,"(1109.0, 1350.0]",2,5,-3
31271.0,2020-01-06,"(461.135, 678.25]",16,18,-2
31271.0,2020-01-06,"(678.25, 894.5]",4,11,-7
31271.0,2020-01-06,"(894.5, 1110.75]",6,25,-19
31271.0,2020-01-06,"(1110.75, 1327.0]",4,8,-4
31272.0,2020-01-06,"(294.905, 569.75]",16,18,-2
31272.0,2020-01-06,"(569.75, 843.5]",2,4,-2
31272.0,2020-01-06,"(843.5, 1117.25]",7,24,-17
31272.0,2020-01-06,"(1117.25, 1391.0]",3,11,-8
31273.0,2020-01-06,"(644.75, 765.5]",1,4,-3
31273.0,2020-01-06,"(765.5, 886.25]",1,2,-1
31273.0,2020-01-06,"(886.25, 1007.0]",4,2,2
31274.0,2020-01-06,"(377.25, 699.5]",12,1,11
31274.0,2020-01-06,"(699.5, 1021.75]",2,15,-13
31274.0,2020-01-06,"(1021.75, 1344.0]",3,5,-2
31275.0,2020-01-06,"(364.989, 618.75]",12,20,-8
31275.0,2020-01-06,"(618.75, 871.5]",6,11,-5
31275.0,2020-01-06,"(871.5, 1124.25]",16,29,-13
31275.0,2020-01-06,"(1124.25, 1377.0]",7,10,-3
31276.0,2020-01-06,"(427.047, 666.25]",17,17,0
31276.0,2020-01-06,"(666.25, 904.5]",5,11,-6
31276.0,2020-01-06,"(904.5, 1142.75]",5,24,-19
31276.0,2020-01-06,"(1142.75, 1381.0]",1,8,-7
31277.0,2020-01-06,"(414.179, 620.25]",29,33,-4
31277.0,2020-01-06,"(620.25, 825.5]",4,11,-7
31277.0,2020-01-06,"(825.5, 1030.75]",9,20,-11
31277.0,2020-01-06,"(1030.75, 1236.0]",4,23,-19
31278.0,2020-01-06,"(304.895, 582.25]",6,25,-19
31278.0,2020-01-06,"(582.25, 858.5]",6,11,-5
31278.0,2020-01-06,"(858.5, 1134.75]",9,19,-10
31278.0,2020-01-06,"(1134.75, 1411.0]",14,19,-5
31279.0,2020-01-06,"(396.173, 603.75]",16,18,-2
31279.0,2020-01-06,"(603.75, 810.5]",1,3,-2
31279.0,2020-01-06,"(810.5, 1017.25]",6,13,-7
31279.0,2020-01-06,"(1017.25, 1224.0]",3,24,-21
31280.0,2020-01-06,"(63.725, 383.75]",1,4,-3
31280.0,2020-01-06,"(383.75, 702.5]",7,19,-12
31280.0,2020-01-06,"(702.5, 1021.25]",6,8,-2
31280.0,2020-01-06,"(1021.25, 1340.0]",18,23,-5
31000.0,2020-01-07,"(798.473, 930.75]",1,1,0
31000.0,2020-01-07,"(1194.25, 1326.0]",1,2,-1
31001.0,2020-01-07,"(476.25, 635.0]",1,1,0
31002.0,2020-01-07,"(336.015, 583.25]",5,12,-7
31002.0,2020-01-07,"(829.5, 1075.75]",1,1,0
31002.0,2020-01-07,"(1075.75, 1322.0]",2,3,-1
31003.0,2020-01-07,"(402.241, 592.75]",3,5,-2
31003.0,2020-01-07,"(592.75, 782.5]",1,2,-1
31003.0,2020-01-07,"(972.25, 1162.0]",1,3,-2
31004.0,2020-01-07,"(787.966, 796.5]",1,2,-1
31004.0,2020-01-07,"(813.5, 822.0]",1,1,0
31005.0,2020-01-07,"(410.153, 622.75]",4,4,0
31006.0,2020-01-07,"(754.25, 877.0]",2,1,1
31007.0,2020-01-07,"(393.194, 595.5]",6,13,-7
31007.0,2020-01-07,"(595.5, 797.0]",5,9,-4
31007.0,2020-01-07,"(797.0, 998.5]",3,3,0
31007.0,2020-01-07,"(998.5, 1200.0]",1,5,-4
31009.0,2020-01-07,"(485.28, 666.0]",3,5,-2
31009.0,2020-01-07,"(1026.0, 1206.0]",1,1,0
31010.0,2020-01-07,"(396.0, 557.5]",2,1,1
31010.0,2020-01-07,"(557.5, 719.0]",1,2,-1
31011.0,2020-01-07,"(78.029, 321.75]",1,1,0
31011.0,2020-01-07,"(321.75, 564.5]",5,7,-2
31011.0,2020-01-07,"(564.5, 807.25]",2,2,0
31012.0,2020-01-07,"(396.458, 532.5]",2,4,-2
31012.0,2020-01-07,"(532.5, 668.0]",1,1,0
31013.0,2020-01-07,"(624.5, 895.25]",1,1,0
31013.0,2020-01-07,"(895.25, 1166.0]",1,1,0
31014.0,2020-01-07,"(337.99, 591.5]",20,26,-6
31014.0,2020-01-07,"(591.5, 844.0]",2,6,-4
31014.0,2020-01-07,"(844.0, 1096.5]",4,6,-2
31014.0,2020-01-07,"(1096.5, 1349.0]",2,5,-3
31015.0,2020-01-07,"(69.837, 361.75]",3,3,0
31015.0,2020-01-07,"(361.75, 652.5]",13,14,-1
31015.0,2020-01-07,"(652.5, 943.25]",2,3,-1
31015.0,2020-01-07,"(943.25, 1234.0]",2,4,-2
31016.0,2020-01-07,"(426.587, 530.25]",2,5,-3
31016.0,2020-01-07,"(530.25, 633.5]",5,7,-2
31016.0,2020-01-07,"(633.5, 736.75]",1,1,0
31016.0,2020-01-07,"(736.75, 840.0]",1,3,-2
31017.0,2020-01-07,"(255.5, 498.0]",1,1,0
31017.0,2020-01-07,"(498.0, 740.5]",3,1,2
31018.0,2020-01-07,"(759.5, 933.75]",1,4,-3
31018.0,2020-01-07,"(933.75, 1108.0]",1,1,0
31019.0,2020-01-07,"(672.75, 891.5]",2,2,0
31020.0,2020-01-07,"(394.557, 505.75]",1,1,0
31021.0,2020-01-07,"(469.166, 678.5]",2,6,-4
31021.0,2020-01-07,"(678.5, 887.0]",2,4,-2
31022.0,2020-01-07,"(492.653, 579.75]",2,8,-6
31022.0,2020-01-07,"(666.5, 753.25]",1,1,0
31023.0,2020-01-07,"(466.146, 680.5]",3,6,-3
31023.0,2020-01-07,"(680.5, 894.0]",1,1,0
31024.0,2020-01-07,"(352.991, 606.25]",9,16,-7
31024.0,2020-01-07,"(606.25, 858.5]",2,3,-1
31025.0,2020-01-07,"(560.436, 702.0]",1,2,-1
31025.0,2020-01-07,"(984.0, 1125.0]",1,1,0
31026.0,2020-01-07,"(407.285, 586.75]",1,3,-2
31027.0,2020-01-07,"(498.344, 663.0]",1,4,-3
31027.0,2020-01-07,"(663.0, 827.0]",1,1,0
31027.0,2020-01-07,"(827.0, 991.0]",1,1,0
31027.0,2020-01-07,"(991.0, 1155.0]",1,1,0
31028.0,2020-01-07,"(446.879, 477.25]",1,1,0
31029.0,2020-01-07,"(628.25, 814.5]",2,8,-6
31029.0,2020-01-07,"(1000.75, 1187.0]",2,3,-1
31030.0,2020-01-07,"(459.14, 675.0]",1,12,-11
31030.0,2020-01-07,"(675.0, 890.0]",3,3,0
31030.0,2020-01-07,"(1105.0, 1320.0]",1,1,0
31031.0,2020-01-07,"(952.0, 1127.0]",1,3,-2
,,,,1.0,
,,,,1.0,
,,,,1.0,
,,,,2.0,
31034.0,2020-01-07,"(355.068, 589.0]",4,7,-3
31034.0,2020-01-07,"(822.0, 1055.0]",1,2,-1
31034.0,2020-01-07,"(1055.0, 1288.0]",1,2,-1
31035.0,2020-01-07,"(513.5, 609.0]",1,1,0
31035.0,2020-01-07,"(704.5, 800.0]",3,1,2
31036.0,2020-01-07,"(569.75, 722.5]",1,3,-2
31036.0,2020-01-07,"(722.5, 875.25]",1,2,-1
31036.0,2020-01-07,"(875.25, 1028.0]",3,2,1
31037.0,2020-01-07,"(421.098, 647.5]",14,20,-6
31037.0,2020-01-07,"(647.5, 873.0]",5,7,-2
31038.0,2020-01-07,"(670.607, 769.25]",1,1,0
31038.0,2020-01-07,"(867.5, 965.75]",3,3,0
31039.0,2020-01-07,"(439.596, 541.0]",2,6,-4
31039.0,2020-01-07,"(541.0, 642.0]",1,2,-1
31039.0,2020-01-07,"(642.0, 743.0]",3,3,0
31039.0,2020-01-07,"(743.0, 844.0]",1,5,-4
31040.0,2020-01-07,"(468.651, 556.25]",3,4,-1
31041.0,2020-01-07,"(476.5, 714.75]",1,1,0
31041.0,2020-01-07,"(714.75, 953.0]",1,1,0
31042.0,2020-01-07,"(444.467, 578.25]",10,11,-1
31042.0,2020-01-07,"(844.75, 978.0]",1,1,0
31043.0,2020-01-07,"(410.521, 530.75]",1,2,-1
31043.0,2020-01-07,"(530.75, 650.5]",1,1,0
31043.0,2020-01-07,"(650.5, 770.25]",1,2,-1
31044.0,2020-01-07,"(548.0, 619.0]",1,1,0
31045.0,2020-01-07,"(580.283, 760.25]",1,3,-2
31045.0,2020-01-07,"(760.25, 939.5]",2,2,0
31045.0,2020-01-07,"(1118.75, 1298.0]",1,1,0
31046.0,2020-01-07,"(398.506, 522.5]",1,2,-1
31046.0,2020-01-07,"(769.5, 893.0]",1,1,0
31047.0,2020-01-07,"(396.16, 607.0]",14,25,-11
31047.0,2020-01-07,"(607.0, 817.0]",4,7,-3
31047.0,2020-01-07,"(817.0, 1027.0]",2,3,-1
31048.0,2020-01-07,"(448.621, 543.75]",4,8,-4
31048.0,2020-01-07,"(638.5, 733.25]",1,2,-1
31048.0,2020-01-07,"(733.25, 828.0]",1,2,-1
,,,,2.0,
31050.0,2020-01-07,"(844.75, 952.0]",1,1,0
31051.0,2020-01-07,"(535.25, 769.5]",1,4,-3
31051.0,2020-01-07,"(769.5, 1003.75]",4,2,2
31051.0,2020-01-07,"(1003.75, 1238.0]",2,5,-3
31052.0,2020-01-07,"(512.0, 528.0]",1,1,0
,,,,1.0,
,,,,1.0,
,,,,2.0,
31055.0,2020-01-07,"(643.5, 726.0]",1,1,0
31056.0,2020-01-07,"(909.0, 1096.5]",1,1,0
31056.0,2020-01-07,"(1096.5, 1284.0]",1,1,0
,,,,2.0,
,,,,2.0,
31059.0,2020-01-07,"(582.75, 777.0]",1,1,0
31060.0,2020-01-07,"(545.275, 727.25]",1,1,0
31060.0,2020-01-07,"(727.25, 908.5]",1,2,-1
,,,,1.0,
,,,,1.0,
31062.0,2020-01-07,"(588.5, 714.0]",1,2,-1
31062.0,2020-01-07,"(714.0, 839.0]",1,2,-1
,,,,2.0,
31064.0,2020-01-07,"(455.698, 531.5]",3,6,-3
31064.0,2020-01-07,"(682.5, 758.0]",1,1,0
31065.0,2020-01-07,"(577.5, 715.0]",1,3,-2
31065.0,2020-01-07,"(852.5, 990.0]",2,2,0
31066.0,2020-01-07,"(901.0, 1037.0]",1,2,-1
31067.0,2020-01-07,"(487.699, 563.25]",1,1,0
31068.0,2020-01-07,"(699.0, 800.5]",1,2,-1
31068.0,2020-01-07,"(800.5, 902.0]",1,1,0
31069.0,2020-01-07,"(435.102, 660.5]",1,5,-4
31069.0,2020-01-07,"(660.5, 885.0]",2,4,-2
31069.0,2020-01-07,"(1109.5, 1334.0]",1,1,0
31070.0,2020-01-07,"(684.25, 756.0]",1,2,-1
31071.0,2020-01-07,"(328.067, 562.25]",1,4,-3
31071.0,2020-01-07,"(562.25, 795.5]",2,5,-3
31071.0,2020-01-07,"(795.5, 1028.75]",1,1,0
31071.0,2020-01-07,"(1028.75, 1262.0]",2,2,0
,,,,2.0,
31073.0,2020-01-07,"(500.986, 504.5]",1,1,0
31073.0,2020-01-07,"(511.5, 515.0]",1,2,-1
31074.0,2020-01-07,"(481.108, 705.0]",1,3,-2
31074.0,2020-01-07,"(705.0, 928.0]",1,1,0
31074.0,2020-01-07,"(1151.0, 1374.0]",1,1,0
31075.0,2020-01-07,"(739.25, 807.0]",1,1,0
,,,,1.0,
,,,,1.0,
,,,,1.0,
31077.0,2020-01-07,"(408.222, 603.5]",4,6,-2
31078.0,2020-01-07,"(483.708, 557.0]",6,6,0
31079.0,2020-01-07,"(748.0, 849.0]",2,3,-1
31080.0,2020-01-07,"(636.25, 875.5]",1,7,-6
31080.0,2020-01-07,"(875.5, 1114.75]",1,1,0
31080.0,2020-01-07,"(1114.75, 1354.0]",2,1,1
31081.0,2020-01-07,"(468.254, 655.5]",2,2,0
31081.0,2020-01-07,"(655.5, 842.0]",1,1,0
,,,,2.0,
31083.0,2020-01-07,"(680.25, 775.0]",1,3,-2
31084.0,2020-01-07,"(562.673, 644.75]",3,3,0
31084.0,2020-01-07,"(644.75, 726.5]",1,1,0
31084.0,2020-01-07,"(808.25, 890.0]",1,1,0
31085.0,2020-01-07,"(398.438, 539.5]",1,5,-4
31086.0,2020-01-07,"(591.5, 659.25]",2,1,1
31087.0,2020-01-07,"(735.25, 835.0]",1,3,-2
,,,,1.0,
,,,,1.0,
31089.0,2020-01-07,"(465.117, 686.75]",9,12,-3
31089.0,2020-01-07,"(686.75, 907.5]",3,13,-10
31089.0,2020-01-07,"(1128.25, 1349.0]",2,2,0
31090.0,2020-01-07,"(694.5, 824.75]",1,1,0
31090.0,2020-01-07,"(824.75, 955.0]",2,1,1
31091.0,2020-01-07,"(88.884, 369.0]",1,1,0
31091.0,2020-01-07,"(927.0, 1206.0]",2,5,-3
,,,,1.0,
,,,,3.0,
,,,,1.0,
,,,,2.0,
,,,,1.0,
31094.0,2020-01-07,"(519.75, 693.0]",1,1,0
,,,,2.0,
31096.0,2020-01-07,"(1006.75, 1078.0]",1,1,0
31097.0,2020-01-07,"(501.261, 686.75]",5,7,-2
31097.0,2020-01-07,"(1056.25, 1241.0]",1,2,-1
31098.0,2020-01-07,"(420.476, 552.0]",5,9,-4
31098.0,2020-01-07,"(552.0, 683.0]",1,1,0
31098.0,2020-01-07,"(683.0, 814.0]",1,3,-2
31098.0,2020-01-07,"(814.0, 945.0]",1,2,-1
31099.0,2020-01-07,"(691.5, 811.25]",2,1,1
31099.0,2020-01-07,"(811.25, 931.0]",1,3,-2
31100.0,2020-01-07,"(394.069, 627.75]",10,11,-1
31100.0,2020-01-07,"(627.75, 860.5]",1,3,-2
31101.0,2020-01-07,"(3.613, 351.75]",1,2,-1
31101.0,2020-01-07,"(351.75, 698.5]",11,38,-27
31101.0,2020-01-07,"(698.5, 1045.25]",12,19,-7
31101.0,2020-01-07,"(1045.25, 1392.0]",14,25,-11
31102.0,2020-01-07,"(358.183, 563.25]",1,9,-8
31102.0,2020-01-07,"(767.5, 971.75]",1,1,0
31102.0,2020-01-07,"(971.75, 1176.0]",2,4,-2
31103.0,2020-01-07,"(10.605, 360.75]",1,2,-1
31103.0,2020-01-07,"(360.75, 709.5]",1,34,-33
31103.0,2020-01-07,"(709.5, 1058.25]",4,14,-10
31103.0,2020-01-07,"(1058.25, 1407.0]",4,10,-6
31104.0,2020-01-07,"(330.976, 588.0]",3,12,-9
31104.0,2020-01-07,"(588.0, 844.0]",7,10,-3
31104.0,2020-01-07,"(844.0, 1100.0]",3,6,-3
31104.0,2020-01-07,"(1100.0, 1356.0]",1,4,-3
31105.0,2020-01-07,"(613.75, 861.5]",3,8,-5
31105.0,2020-01-07,"(861.5, 1109.25]",1,3,-2
31105.0,2020-01-07,"(1109.25, 1357.0]",1,2,-1
31106.0,2020-01-07,"(429.043, 669.25]",1,6,-5
31106.0,2020-01-07,"(908.5, 1147.75]",1,1,0
31106.0,2020-01-07,"(1147.75, 1387.0]",2,3,-1
31107.0,2020-01-07,"(341.004, 591.0]",1,15,-14
31107.0,2020-01-07,"(591.0, 840.0]",9,12,-3
31107.0,2020-01-07,"(840.0, 1089.0]",4,6,-2
31107.0,2020-01-07,"(1089.0, 1338.0]",5,8,-3
31108.0,2020-01-07,"(371.947, 636.25]",8,32,-24
31108.0,2020-01-07,"(636.25, 899.5]",11,19,-8
31108.0,2020-01-07,"(899.5, 1162.75]",6,12,-6
31108.0,2020-01-07,"(1162.75, 1426.0]",7,8,-1
31109.0,2020-01-07,"(402.08, 633.0]",5,21,-16
31109.0,2020-01-07,"(633.0, 863.0]",4,6,-2
31109.0,2020-01-07,"(863.0, 1093.0]",3,5,-2
31109.0,2020-01-07,"(1093.0, 1323.0]",6,9,-3
31110.0,2020-01-07,"(314.928, 584.0]",10,26,-16
31110.0,2020-01-07,"(584.0, 852.0]",6,13,-7
31110.0,2020-01-07,"(852.0, 1120.0]",9,14,-5
31110.0,2020-01-07,"(1120.0, 1388.0]",4,10,-6
31111.0,2020-01-07,"(164.83, 458.5]",5,8,-3
31111.0,2020-01-07,"(458.5, 751.0]",4,17,-13
31111.0,2020-01-07,"(751.0, 1043.5]",5,7,-2
31111.0,2020-01-07,"(1043.5, 1336.0]",10,20,-10
31112.0,2020-01-07,"(360.113, 582.75]",1,2,-1
31112.0,2020-01-07,"(582.75, 804.5]",1,2,-1
31112.0,2020-01-07,"(804.5, 1026.25]",2,3,-1
31112.0,2020-01-07,"(1026.25, 1248.0]",2,2,0
31113.0,2020-01-07,"(307.073, 539.75]",2,20,-18
31113.0,2020-01-07,"(539.75, 771.5]",2,5,-3
31113.0,2020-01-07,"(771.5, 1003.25]",1,1,0
31113.0,2020-01-07,"(1003.25, 1235.0]",1,3,-2
31114.0,2020-01-07,"(8.684, 339.0]",1,2,-1
31114.0,2020-01-07,"(339.0, 668.0]",6,21,-15
31114.0,2020-01-07,"(668.0, 997.0]",10,10,0
31114.0,2020-01-07,"(997.0, 1326.0]",7,13,-6
31115.0,2020-01-07,"(401.037, 642.75]",2,19,-17
31115.0,2020-01-07,"(642.75, 883.5]",1,2,-1
31115.0,2020-01-07,"(1124.25, 1365.0]",6,3,3
31116.0,2020-01-07,"(306.936, 574.0]",9,34,-25
31116.0,2020-01-07,"(574.0, 840.0]",8,11,-3
31116.0,2020-01-07,"(840.0, 1106.0]",8,9,-1
31116.0,2020-01-07,"(1106.0, 1372.0]",6,11,-5
31117.0,2020-01-07,"(348.956, 611.0]",2,19,-17
31117.0,2020-01-07,"(611.0, 872.0]",2,2,0
31117.0,2020-01-07,"(872.0, 1133.0]",4,8,-4
31117.0,2020-01-07,"(1133.0, 1394.0]",5,9,-4
31118.0,2020-01-07,"(320.951, 584.25]",4,23,-19
31118.0,2020-01-07,"(584.25, 846.5]",6,8,-2
31118.0,2020-01-07,"(846.5, 1108.75]",2,3,-1
31118.0,2020-01-07,"(1108.75, 1371.0]",3,5,-2
31119.0,2020-01-07,"(348.939, 615.25]",7,27,-20
31119.0,2020-01-07,"(615.25, 880.5]",7,10,-3
31119.0,2020-01-07,"(880.5, 1145.75]",12,18,-6
31119.0,2020-01-07,"(1145.75, 1411.0]",4,12,-8
31120.0,2020-01-07,"(409.044, 649.0]",1,10,-9
31120.0,2020-01-07,"(649.0, 888.0]",4,4,0
31120.0,2020-01-07,"(888.0, 1127.0]",2,2,0
31120.0,2020-01-07,"(1127.0, 1366.0]",8,9,-1
31121.0,2020-01-07,"(299.907, 574.25]",14,24,-10
31121.0,2020-01-07,"(574.25, 847.5]",4,13,-9
31121.0,2020-01-07,"(847.5, 1120.75]",3,6,-3
31121.0,2020-01-07,"(1120.75, 1394.0]",3,5,-2
31122.0,2020-01-07,"(546.127, 765.25]",2,3,-1
31122.0,2020-01-07,"(765.25, 983.5]",1,1,0
31122.0,2020-01-07,"(983.5, 1201.75]",1,1,0
31122.0,2020-01-07,"(1201.75, 1420.0]",4,7,-3
31123.0,2020-01-07,"(9.699, 336.25]",3,4,-1
31123.0,2020-01-07,"(661.5, 986.75]",1,10,-9
31123.0,2020-01-07,"(986.75, 1312.0]",3,2,1
31124.0,2020-01-07,"(294.87, 578.5]",14,39,-25
31124.0,2020-01-07,"(578.5, 861.0]",6,29,-23
31124.0,2020-01-07,"(861.0, 1143.5]",3,10,-7
31124.0,2020-01-07,"(1143.5, 1426.0]",8,22,-14
31125.0,2020-01-07,"(394.965, 654.75]",6,30,-24
31125.0,2020-01-07,"(654.75, 913.5]",9,13,-4
31125.0,2020-01-07,"(913.5, 1172.25]",6,12,-6
31125.0,2020-01-07,"(1172.25, 1431.0]",5,8,-3
31126.0,2020-01-07,"(291.993, 544.75]",3,23,-20
31126.0,2020-01-07,"(544.75, 796.5]",3,7,-4
31126.0,2020-01-07,"(796.5, 1048.25]",6,11,-5
31126.0,2020-01-07,"(1048.25, 1300.0]",7,10,-3
,,,,2.0,
31128.0,2020-01-07,"(-0.434, 359.5]",1,3,-2
31128.0,2020-01-07,"(359.5, 718.0]",19,28,-9
31128.0,2020-01-07,"(718.0, 1076.5]",5,9,-4
31128.0,2020-01-07,"(1076.5, 1435.0]",9,20,-11
31129.0,2020-01-07,"(421.632, 514.0]",5,5,0
31129.0,2020-01-07,"(514.0, 606.0]",5,7,-2
31129.0,2020-01-07,"(606.0, 698.0]",2,3,-1
31129.0,2020-01-07,"(698.0, 790.0]",1,4,-3
31130.0,2020-01-07,"(336.5, 642.0]",6,1,5
31130.0,2020-01-07,"(642.0, 947.5]",3,17,-14
31131.0,2020-01-07,"(990.0, 1320.0]",1,1,0
31200.0,2020-01-07,"(41.727, 361.25]",3,4,-1
31200.0,2020-01-07,"(361.25, 679.5]",28,40,-12
31200.0,2020-01-07,"(679.5, 997.75]",13,20,-7
31200.0,2020-01-07,"(997.75, 1316.0]",8,18,-10
31201.0,2020-01-07,"(298.921, 569.75]",22,43,-21
31201.0,2020-01-07,"(569.75, 839.5]",13,26,-13
31201.0,2020-01-07,"(839.5, 1109.25]",10,12,-2
31201.0,2020-01-07,"(1109.25, 1379.0]",16,37,-21
31202.0,2020-01-07,"(350.936, 618.0]",17,35,-18
31202.0,2020-01-07,"(618.0, 884.0]",8,17,-9
31202.0,2020-01-07,"(884.0, 1150.0]",4,8,-4
31202.0,2020-01-07,"(1150.0, 1416.0]",7,13,-6
31203.0,2020-01-07,"(174.755, 487.25]",3,13,-10
31203.0,2020-01-07,"(487.25, 798.5]",12,31,-19
31203.0,2020-01-07,"(798.5, 1109.75]",9,18,-9
31203.0,2020-01-07,"(1109.75, 1421.0]",6,14,-8
31204.0,2020-01-07,"(396.5, 702.0]",13,1,12
31204.0,2020-01-07,"(702.0, 1007.5]",1,18,-17
31204.0,2020-01-07,"(1007.5, 1313.0]",1,7,-6
31205.0,2020-01-07,"(2.658, 339.5]",1,2,-1
31205.0,2020-01-07,"(339.5, 675.0]",30,37,-7
31205.0,2020-01-07,"(675.0, 1010.5]",8,15,-7
31205.0,2020-01-07,"(1010.5, 1346.0]",2,8,-6
31206.0,2020-01-07,"(511.718, 582.5]",3,3,0
31207.0,2020-01-07,"(350.233, 542.75]",1,5,-4
31207.0,2020-01-07,"(542.75, 734.5]",1,1,0
31207.0,2020-01-07,"(734.5, 926.25]",1,1,0
31207.0,2020-01-07,"(926.25, 1118.0]",3,3,0
31208.0,2020-01-07,"(352.991, 606.25]",6,8,-2
31208.0,2020-01-07,"(606.25, 858.5]",4,16,-12
31208.0,2020-01-07,"(1110.75, 1363.0]",1,3,-2
31209.0,2020-01-07,"(487.128, 706.0]",7,9,-2
31209.0,2020-01-07,"(706.0, 924.0]",4,5,-1
31209.0,2020-01-07,"(1142.0, 1360.0]",2,2,0
31211.0,2020-01-07,"(315.99, 569.5]",11,14,-3
31211.0,2020-01-07,"(569.5, 822.0]",8,11,-3
31211.0,2020-01-07,"(1074.5, 1327.0]",1,6,-5
31212.0,2020-01-07,"(310.906, 585.5]",24,38,-14
31212.0,2020-01-07,"(585.5, 859.0]",17,28,-11
31212.0,2020-01-07,"(859.0, 1132.5]",6,12,-6
31212.0,2020-01-07,"(1132.5, 1406.0]",4,9,-5
31213.0,2020-01-07,"(334.062, 569.5]",27,39,-12
31213.0,2020-01-07,"(569.5, 804.0]",6,13,-7
31213.0,2020-01-07,"(804.0, 1038.5]",2,4,-2
31213.0,2020-01-07,"(1038.5, 1273.0]",8,16,-8
31214.0,2020-01-07,"(354.963, 615.25]",6,30,-24
31214.0,2020-01-07,"(615.25, 874.5]",9,18,-9
31214.0,2020-01-07,"(874.5, 1133.75]",8,13,-5
31214.0,2020-01-07,"(1133.75, 1393.0]",13,18,-5
31215.0,2020-01-07,"(340.75, 680.5]",16,1,15
31215.0,2020-01-07,"(1020.25, 1360.0]",2,17,-15
31216.0,2020-01-07,"(337.374, 494.5]",4,5,-1
31216.0,2020-01-07,"(494.5, 651.0]",15,15,0
31216.0,2020-01-07,"(651.0, 807.5]",3,5,-2
31217.0,2020-01-07,"(328.115, 550.25]",12,13,-1
31217.0,2020-01-07,"(771.5, 992.75]",1,1,0
31218.0,2020-01-07,"(327.191, 530.25]",19,38,-19
31218.0,2020-01-07,"(530.25, 732.5]",7,14,-7
31218.0,2020-01-07,"(732.5, 934.75]",5,12,-7
31218.0,2020-01-07,"(934.75, 1137.0]",2,3,-1
31219.0,2020-01-07,"(364.446, 503.5]",6,6,0
31219.0,2020-01-07,"(503.5, 642.0]",7,7,0
31219.0,2020-01-07,"(642.0, 780.5]",3,6,-3
31220.0,2020-01-07,"(319.918, 591.5]",19,23,-4
31220.0,2020-01-07,"(862.0, 1132.5]",1,9,-8
31221.0,2020-01-07,"(417.154, 629.5]",24,29,-5
31221.0,2020-01-07,"(629.5, 841.0]",10,22,-12
31221.0,2020-01-07,"(841.0, 1052.5]",4,10,-6
31221.0,2020-01-07,"(1052.5, 1264.0]",3,6,-3
31222.0,2020-01-07,"(436.195, 638.25]",11,13,-2
31222.0,2020-01-07,"(638.25, 839.5]",2,8,-6
31222.0,2020-01-07,"(839.5, 1040.75]",1,7,-6
31223.0,2020-01-07,"(18.689, 347.75]",1,3,-2
31223.0,2020-01-07,"(347.75, 675.5]",18,46,-28
31223.0,2020-01-07,"(675.5, 1003.25]",6,14,-8
31223.0,2020-01-07,"(1003.25, 1331.0]",6,13,-7
31224.0,2020-01-07,"(402.33, 570.5]",10,10,0
31224.0,2020-01-07,"(570.5, 738.0]",1,3,-2
31224.0,2020-01-07,"(738.0, 905.5]",2,4,-2
31225.0,2020-01-07,"(326.024, 571.0]",10,12,-2
31225.0,2020-01-07,"(571.0, 815.0]",1,1,0
31225.0,2020-01-07,"(1059.0, 1303.0]",3,3,0
31226.0,2020-01-07,"(363.5, 693.0]",3,1,2
31226.0,2020-01-07,"(693.0, 1022.5]",1,6,-5
31226.0,2020-01-07,"(1022.5, 1352.0]",1,1,0
31227.0,2020-01-07,"(443.222, 638.5]",30,38,-8
31227.0,2020-01-07,"(638.5, 833.0]",2,9,-7
31227.0,2020-01-07,"(833.0, 1027.5]",4,6,-2
31228.0,2020-01-07,"(352.046, 591.5]",12,17,-5
31228.0,2020-01-07,"(591.5, 830.0]",11,24,-13
31228.0,2020-01-07,"(830.0, 1068.5]",2,5,-3
31228.0,2020-01-07,"(1068.5, 1307.0]",5,13,-8
31229.0,2020-01-07,"(33.619, 380.25]",6,12,-6
31229.0,2020-01-07,"(380.25, 725.5]",18,60,-42
31229.0,2020-01-07,"(725.5, 1070.75]",16,21,-5
31229.0,2020-01-07,"(1070.75, 1416.0]",12,27,-15
31230.0,2020-01-07,"(374.118, 595.5]",35,35,0
31230.0,2020-01-07,"(595.5, 816.0]",9,14,-5
31230.0,2020-01-07,"(816.0, 1036.5]",3,3,0
31230.0,2020-01-07,"(1036.5, 1257.0]",2,17,-15
31231.0,2020-01-07,"(320.506, 444.5]",5,6,-1
31231.0,2020-01-07,"(444.5, 568.0]",15,16,-1
31231.0,2020-01-07,"(568.0, 691.5]",1,5,-4
31231.0,2020-01-07,"(691.5, 815.0]",5,17,-12
31232.0,2020-01-07,"(123.824, 419.0]",6,9,-3
31232.0,2020-01-07,"(419.0, 713.0]",16,22,-6
31232.0,2020-01-07,"(713.0, 1007.0]",7,12,-5
31232.0,2020-01-07,"(1007.0, 1301.0]",6,9,-3
31233.0,2020-01-07,"(324.921, 595.75]",47,48,-1
31233.0,2020-01-07,"(595.75, 865.5]",16,26,-10
31233.0,2020-01-07,"(865.5, 1135.25]",2,6,-4
31233.0,2020-01-07,"(1135.25, 1405.0]",2,4,-2
31234.0,2020-01-07,"(388.037, 629.75]",8,16,-8
31234.0,2020-01-07,"(629.75, 870.5]",2,6,-4
31234.0,2020-01-07,"(870.5, 1111.25]",3,8,-5
31234.0,2020-01-07,"(1111.25, 1352.0]",4,5,-1
31235.0,2020-01-07,"(504.747, 568.25]",9,9,0
31235.0,2020-01-07,"(568.25, 631.5]",2,2,0
31236.0,2020-01-07,"(5.776, 313.0]",1,2,-1
31236.0,2020-01-07,"(313.0, 619.0]",9,10,-1
31236.0,2020-01-07,"(619.0, 925.0]",3,3,0
31237.0,2020-01-07,"(72.0, 323.0]",1,1,0
31237.0,2020-01-07,"(323.0, 573.0]",8,16,-8
31237.0,2020-01-07,"(573.0, 823.0]",7,14,-7
31237.0,2020-01-07,"(823.0, 1073.0]",1,2,-1
31238.0,2020-01-07,"(25.914, 298.5]",1,1,0
31238.0,2020-01-07,"(298.5, 570.0]",18,19,-1
31238.0,2020-01-07,"(570.0, 841.5]",5,11,-6
31238.0,2020-01-07,"(841.5, 1113.0]",1,9,-8
31239.0,2020-01-07,"(375.037, 616.75]",20,22,-2
31239.0,2020-01-07,"(616.75, 857.5]",5,12,-7
31239.0,2020-01-07,"(857.5, 1098.25]",1,2,-1
31239.0,2020-01-07,"(1098.25, 1339.0]",6,10,-4
31240.0,2020-01-07,"(144.846, 434.5]",2,4,-2
31240.0,2020-01-07,"(434.5, 723.0]",1,3,-2
31240.0,2020-01-07,"(723.0, 1011.5]",4,4,0
31241.0,2020-01-07,"(326.949, 590.75]",23,48,-25
31241.0,2020-01-07,"(590.75, 853.5]",8,10,-2
31241.0,2020-01-07,"(853.5, 1116.25]",2,7,-5
31241.0,2020-01-07,"(1116.25, 1379.0]",6,13,-7
31242.0,2020-01-07,"(398.109, 621.75]",23,28,-5
31242.0,2020-01-07,"(621.75, 844.5]",6,17,-11
31243.0,2020-01-07,"(376.273, 558.75]",37,42,-5
31243.0,2020-01-07,"(558.75, 740.5]",2,9,-7
31243.0,2020-01-07,"(740.5, 922.25]",4,14,-10
31244.0,2020-01-07,"(347.043, 587.25]",15,25,-10
31244.0,2020-01-07,"(587.25, 826.5]",3,17,-14
31244.0,2020-01-07,"(826.5, 1065.75]",2,5,-3
31244.0,2020-01-07,"(1065.75, 1305.0]",3,6,-3
31245.0,2020-01-07,"(387.974, 645.5]",12,28,-16
31245.0,2020-01-07,"(645.5, 902.0]",5,9,-4
31245.0,2020-01-07,"(902.0, 1158.5]",5,6,-1
31245.0,2020-01-07,"(1158.5, 1415.0]",3,8,-5
31246.0,2020-01-07,"(322.912, 596.0]",18,26,-8
31246.0,2020-01-07,"(596.0, 868.0]",4,9,-5
31246.0,2020-01-07,"(868.0, 1140.0]",2,4,-2
31246.0,2020-01-07,"(1140.0, 1412.0]",7,12,-5
31247.0,2020-01-07,"(418.02, 664.0]",7,10,-3
31247.0,2020-01-07,"(664.0, 909.0]",4,6,-2
31248.0,2020-01-07,"(350.346, 514.5]",7,12,-5
31248.0,2020-01-07,"(514.5, 678.0]",2,3,-1
31248.0,2020-01-07,"(678.0, 841.5]",6,11,-5
31248.0,2020-01-07,"(841.5, 1005.0]",2,5,-3
31249.0,2020-01-07,"(349.539, 465.25]",5,8,-3
31249.0,2020-01-07,"(465.25, 580.5]",4,10,-6
31249.0,2020-01-07,"(580.5, 695.75]",3,6,-3
31249.0,2020-01-07,"(695.75, 811.0]",5,10,-5
31250.0,2020-01-07,"(412.204, 612.0]",14,16,-2
31250.0,2020-01-07,"(612.0, 811.0]",2,6,-4
31250.0,2020-01-07,"(811.0, 1010.0]",1,1,0
31250.0,2020-01-07,"(1010.0, 1209.0]",1,10,-9
31251.0,2020-01-07,"(240.879, 522.25]",8,16,-8
31251.0,2020-01-07,"(522.25, 802.5]",14,27,-13
31251.0,2020-01-07,"(802.5, 1082.75]",4,7,-3
31251.0,2020-01-07,"(1082.75, 1363.0]",6,11,-5
31252.0,2020-01-07,"(456.35, 619.5]",15,18,-3
31252.0,2020-01-07,"(619.5, 782.0]",7,10,-3
31253.0,2020-01-07,"(394.002, 644.5]",16,20,-4
31253.0,2020-01-07,"(644.5, 894.0]",2,9,-7
31253.0,2020-01-07,"(894.0, 1143.5]",2,4,-2
31254.0,2020-01-07,"(414.228, 608.0]",26,27,-1
31254.0,2020-01-07,"(608.0, 801.0]",3,9,-6
31254.0,2020-01-07,"(801.0, 994.0]",1,4,-3
31255.0,2020-01-07,"(374.095, 601.25]",17,27,-10
31255.0,2020-01-07,"(601.25, 827.5]",2,7,-5
31255.0,2020-01-07,"(827.5, 1053.75]",2,8,-6
31255.0,2020-01-07,"(1053.75, 1280.0]",2,2,0
31256.0,2020-01-07,"(37.697, 364.75]",3,4,-1
31256.0,2020-01-07,"(364.75, 690.5]",15,18,-3
31256.0,2020-01-07,"(690.5, 1016.25]",1,5,-4
31256.0,2020-01-07,"(1016.25, 1342.0]",3,5,-2
31257.0,2020-01-07,"(321.899, 598.25]",13,23,-10
31257.0,2020-01-07,"(598.25, 873.5]",9,17,-8
31257.0,2020-01-07,"(873.5, 1148.75]",3,8,-5
31257.0,2020-01-07,"(1148.75, 1424.0]",2,5,-3
31258.0,2020-01-07,"(441.479, 572.25]",2,4,-2
31258.0,2020-01-07,"(572.25, 702.5]",1,2,-1
31258.0,2020-01-07,"(702.5, 832.75]",2,10,-8
31258.0,2020-01-07,"(832.75, 963.0]",4,8,-4
31259.0,2020-01-07,"(394.582, 499.5]",5,6,-1
31259.0,2020-01-07,"(499.5, 604.0]",7,7,0
31259.0,2020-01-07,"(604.0, 708.5]",2,2,0
31259.0,2020-01-07,"(708.5, 813.0]",2,5,-3
31260.0,2020-01-07,"(379.595, 481.25]",4,4,0
31260.0,2020-01-07,"(481.25, 582.5]",10,10,0
31260.0,2020-01-07,"(582.5, 683.75]",1,3,-2
31260.0,2020-01-07,"(683.75, 785.0]",1,8,-7
31261.0,2020-01-07,"(388.265, 572.75]",11,11,0
31261.0,2020-01-07,"(572.75, 756.5]",2,6,-4
31262.0,2020-01-07,"(432.043, 672.25]",10,14,-4
31262.0,2020-01-07,"(672.25, 911.5]",2,6,-4
31262.0,2020-01-07,"(1150.75, 1390.0]",3,1,2
31263.0,2020-01-07,"(330.009, 578.75]",17,28,-11
31263.0,2020-01-07,"(578.75, 826.5]",11,24,-13
31263.0,2020-01-07,"(826.5, 1074.25]",1,5,-4
31263.0,2020-01-07,"(1074.25, 1322.0]",1,2,-1
31264.0,2020-01-07,"(418.261, 603.75]",12,16,-4
31264.0,2020-01-07,"(603.75, 788.5]",4,7,-3
31264.0,2020-01-07,"(973.25, 1158.0]",1,2,-1
31265.0,2020-01-07,"(21.588, 376.0]",2,4,-2
31265.0,2020-01-07,"(376.0, 729.0]",15,36,-21
31265.0,2020-01-07,"(729.0, 1082.0]",7,12,-5
31265.0,2020-01-07,"(1082.0, 1435.0]",6,13,-7
31266.0,2020-01-07,"(10.586, 365.5]",1,7,-6
31266.0,2020-01-07,"(365.5, 719.0]",11,27,-16
31266.0,2020-01-07,"(719.0, 1072.5]",8,14,-6
31266.0,2020-01-07,"(1072.5, 1426.0]",6,14,-8
31267.0,2020-01-07,"(322.935, 590.25]",20,40,-20
31267.0,2020-01-07,"(590.25, 856.5]",8,16,-8
31267.0,2020-01-07,"(856.5, 1122.75]",4,19,-15
31267.0,2020-01-07,"(1122.75, 1389.0]",4,10,-6
31268.0,2020-01-07,"(4.655, 342.25]",1,2,-1
31268.0,2020-01-07,"(342.25, 678.5]",18,47,-29
31268.0,2020-01-07,"(678.5, 1014.75]",7,11,-4
31268.0,2020-01-07,"(1014.75, 1351.0]",6,11,-5
31269.0,2020-01-07,"(391.206, 590.5]",2,5,-3
31269.0,2020-01-07,"(590.5, 789.0]",4,8,-4
31269.0,2020-01-07,"(789.0, 987.5]",1,3,-2
31269.0,2020-01-07,"(987.5, 1186.0]",3,5,-2
31270.0,2020-01-07,"(363.033, 605.75]",14,20,-6
31270.0,2020-01-07,"(605.75, 847.5]",5,11,-6
31270.0,2020-01-07,"(847.5, 1089.25]",1,3,-2
31270.0,2020-01-07,"(1089.25, 1331.0]",2,4,-2
31271.0,2020-01-07,"(454.24, 645.0]",14,16,-2
31271.0,2020-01-07,"(645.0, 835.0]",8,15,-7
31271.0,2020-01-07,"(835.0, 1025.0]",1,1,0
31271.0,2020-01-07,"(1025.0, 1215.0]",1,2,-1
31272.0,2020-01-07,"(294.868, 579.0]",17,18,-1
31272.0,2020-01-07,"(579.0, 862.0]",5,14,-9
31272.0,2020-01-07,"(862.0, 1145.0]",1,2,-1
31272.0,2020-01-07,"(1145.0, 1428.0]",1,4,-3
31273.0,2020-01-07,"(699.25, 873.5]",2,2,0
31273.0,2020-01-07,"(1047.75, 1222.0]",1,3,-2
31274.0,2020-01-07,"(394.983, 650.25]",18,19,-1
31274.0,2020-01-07,"(650.25, 904.5]",2,6,-4
31275.0,2020-01-07,"(231.819, 528.25]",10,18,-8
31275.0,2020-01-07,"(528.25, 823.5]",9,16,-7
31275.0,2020-01-07,"(1118.75, 1414.0]",7,6,1
31276.0,2020-01-07,"(407.024, 652.0]",27,33,-6
31276.0,2020-01-07,"(652.0, 896.0]",5,10,-5
31276.0,2020-01-07,"(896.0, 1140.0]",1,5,-4
31277.0,2020-01-07,"(322.013, 569.75]",33,36,-3
31277.0,2020-01-07,"(569.75, 816.5]",6,20,-14
31277.0,2020-01-07,"(816.5, 1063.25]",1,4,-3
31277.0,2020-01-07,"(1063.25, 1310.0]",1,3,-2
31278.0,2020-01-07,"(-1.357, 339.25]",2,3,-1
31278.0,2020-01-07,"(339.25, 678.5]",14,38,-24
31278.0,2020-01-07,"(678.5, 1017.75]",4,6,-2
31278.0,2020-01-07,"(1017.75, 1357.0]",12,16,-4
31279.0,2020-01-07,"(337.122, 557.5]",24,26,-2
31279.0,2020-01-07,"(557.5, 777.0]",2,8,-6
31279.0,2020-01-07,"(777.0, 996.5]",4,8,-4
31279.0,2020-01-07,"(996.5, 1216.0]",1,4,-3
31280.0,2020-01-07,"(52.799, 354.25]",1,1,0
31280.0,2020-01-07,"(354.25, 654.5]",4,22,-18
31280.0,2020-01-07,"(654.5, 954.75]",4,5,-1
31280.0,2020-01-07,"(954.75, 1255.0]",1,5,-4
31000.0,2020-01-08,"(958.0, 1027.0]",1,1,0
31000.0,2020-01-08,"(1027.0, 1096.0]",2,1,1
31001.0,2020-01-08,"(887.0, 1063.0]",1,1,0
31001.0,2020-01-08,"(1063.0, 1239.0]",4,1,3
31002.0,2020-01-08,"(463.342, 628.5]",5,7,-2
31002.0,2020-01-08,"(793.0, 957.5]",1,1,0
31002.0,2020-01-08,"(957.5, 1122.0]",3,1,2
31003.0,2020-01-08,"(380.217, 576.75]",2,5,-3
31003.0,2020-01-08,"(576.75, 772.5]",1,1,0
31003.0,2020-01-08,"(772.5, 968.25]",3,5,-2
31003.0,2020-01-08,"(968.25, 1164.0]",5,9,-4
31004.0,2020-01-08,"(940.5, 1089.0]",1,2,-1
31005.0,2020-01-08,"(440.133, 657.75]",6,6,0
31005.0,2020-01-08,"(657.75, 874.5]",1,1,0
31005.0,2020-01-08,"(874.5, 1091.25]",2,6,-4
31005.0,2020-01-08,"(1091.25, 1308.0]",1,7,-6
31006.0,2020-01-08,"(1056.75, 1216.0]",1,2,-1
31007.0,2020-01-08,"(421.129, 639.75]",6,12,-6
31007.0,2020-01-08,"(639.75, 857.5]",1,3,-2
31007.0,2020-01-08,"(857.5, 1075.25]",3,6,-3
31007.0,2020-01-08,"(1075.25, 1293.0]",3,7,-4
31009.0,2020-01-08,"(552.494, 679.5]",2,2,0
31009.0,2020-01-08,"(932.5, 1059.0]",1,1,0
31010.0,2020-01-08,"(955.592, 1058.0]",1,2,-1
31011.0,2020-01-08,"(507.33, 675.5]",3,4,-1
31011.0,2020-01-08,"(675.5, 843.0]",1,2,-1
31011.0,2020-01-08,"(1010.5, 1178.0]",4,9,-5
31012.0,2020-01-08,"(385.395, 537.25]",1,2,-1
31012.0,2020-01-08,"(537.25, 688.5]",1,1,0
31012.0,2020-01-08,"(839.75, 991.0]",1,1,0
31013.0,2020-01-08,"(589.23, 782.5]",1,2,-1
31013.0,2020-01-08,"(975.0, 1167.5]",1,2,-1
31014.0,2020-01-08,"(399.107, 623.25]",16,23,-7
31014.0,2020-01-08,"(623.25, 846.5]",1,1,0
31014.0,2020-01-08,"(846.5, 1069.75]",13,15,-2
31014.0,2020-01-08,"(1069.75, 1293.0]",10,13,-3
31015.0,2020-01-08,"(430.186, 634.5]",9,9,0
31015.0,2020-01-08,"(838.0, 1041.5]",3,1,2
31015.0,2020-01-08,"(1041.5, 1245.0]",3,7,-4
31016.0,2020-01-08,"(428.314, 600.5]",2,5,-3
31016.0,2020-01-08,"(600.5, 772.0]",1,1,0
31016.0,2020-01-08,"(772.0, 943.5]",1,2,-1
31016.0,2020-01-08,"(943.5, 1115.0]",4,7,-3
31017.0,2020-01-08,"(474.221, 669.75]",1,2,-1
31017.0,2020-01-08,"(669.75, 864.5]",1,1,0
31017.0,2020-01-08,"(864.5, 1059.25]",1,2,-1
31017.0,2020-01-08,"(1059.25, 1254.0]",1,3,-2
31018.0,2020-01-08,"(893.0, 1134.0]",2,6,-4
31018.0,2020-01-08,"(1134.0, 1375.0]",2,2,0
31019.0,2020-01-08,"(629.75, 804.5]",1,1,0
31019.0,2020-01-08,"(804.5, 979.25]",1,2,-1
,,,,1.0,
,,,,1.0,
,,,,1.0,
,,,,3.0,
31021.0,2020-01-08,"(378.099, 604.25]",1,5,-4
31021.0,2020-01-08,"(604.25, 829.5]",1,1,0
31021.0,2020-01-08,"(829.5, 1054.75]",1,3,-2
31021.0,2020-01-08,"(1054.75, 1280.0]",3,6,-3
31022.0,2020-01-08,"(481.112, 704.0]",2,4,-2
31022.0,2020-01-08,"(704.0, 926.0]",3,6,-3
31022.0,2020-01-08,"(926.0, 1148.0]",2,5,-3
31023.0,2020-01-08,"(954.609, 1052.75]",1,1,0
31023.0,2020-01-08,"(1052.75, 1150.5]",1,1,0
31024.0,2020-01-08,"(457.085, 686.75]",6,8,-2
31024.0,2020-01-08,"(915.5, 1144.25]",3,1,2
31024.0,2020-01-08,"(1144.25, 1373.0]",1,7,-6
,,,,1.0,
,,,,1.0,
,,,,1.0,
31026.0,2020-01-08,"(489.326, 658.5]",2,2,0
31026.0,2020-01-08,"(658.5, 827.0]",1,3,-2
31026.0,2020-01-08,"(827.0, 995.5]",1,2,-1
31026.0,2020-01-08,"(995.5, 1164.0]",1,6,-5
31027.0,2020-01-08,"(863.75, 957.0]",1,1,0
31028.0,2020-01-08,"(372.095, 599.25]",1,2,-1
31028.0,2020-01-08,"(825.5, 1051.75]",1,3,-2
31028.0,2020-01-08,"(1051.75, 1278.0]",2,5,-3
31029.0,2020-01-08,"(450.192, 653.0]",1,8,-7
31029.0,2020-01-08,"(855.0, 1057.0]",3,1,2
31029.0,2020-01-08,"(1057.0, 1259.0]",2,4,-2
31030.0,2020-01-08,"(746.5, 912.75]",2,3,-1
31030.0,2020-01-08,"(912.75, 1079.0]",4,2,2
31031.0,2020-01-08,"(1185.5, 1423.0]",2,2,0
31032.0,2020-01-08,"(918.0, 1224.0]",1,1,0
31033.0,2020-01-08,"(560.602, 660.5]",1,1,0
31033.0,2020-01-08,"(859.5, 959.0]",1,1,0
31034.0,2020-01-08,"(516.734, 583.5]",3,4,-1
31034.0,2020-01-08,"(716.5, 783.0]",1,2,-1
31035.0,2020-01-08,"(648.5, 854.0]",1,3,-2
31035.0,2020-01-08,"(854.0, 1059.5]",2,2,0
31035.0,2020-01-08,"(1059.5, 1265.0]",3,3,0
31036.0,2020-01-08,"(454.377, 610.75]",1,4,-3
31036.0,2020-01-08,"(766.5, 922.25]",1,1,0
31036.0,2020-01-08,"(922.25, 1078.0]",4,1,3
31037.0,2020-01-08,"(398.996, 651.0]",12,14,-2
31037.0,2020-01-08,"(651.0, 902.0]",1,2,-1
31037.0,2020-01-08,"(902.0, 1153.0]",4,20,-16
31037.0,2020-01-08,"(1153.0, 1404.0]",2,5,-3
31038.0,2020-01-08,"(981.25, 1176.0]",1,1,0
31039.0,2020-01-08,"(903.0, 1138.5]",5,6,-1
31039.0,2020-01-08,"(1138.5, 1374.0]",1,8,-7
31040.0,2020-01-08,"(429.394, 581.5]",2,2,0
31040.0,2020-01-08,"(884.5, 1036.0]",1,3,-2
31041.0,2020-01-08,"(470.503, 595.25]",2,2,0
31041.0,2020-01-08,"(595.25, 719.5]",1,1,0
31041.0,2020-01-08,"(719.5, 843.75]",1,2,-1
31042.0,2020-01-08,"(446.09, 674.5]",5,6,-1
31042.0,2020-01-08,"(902.0, 1129.5]",2,9,-7
31043.0,2020-01-08,"(491.218, 687.5]",4,6,-2
31043.0,2020-01-08,"(883.0, 1078.5]",1,3,-2
31043.0,2020-01-08,"(1078.5, 1274.0]",1,1,0
31044.0,2020-01-08,"(382.33, 550.5]",1,2,-1
31044.0,2020-01-08,"(550.5, 718.0]",2,2,0
31044.0,2020-01-08,"(885.5, 1053.0]",1,1,0
31045.0,2020-01-08,"(622.355, 784.25]",1,4,-3
31045.0,2020-01-08,"(1106.75, 1268.0]",2,1,1
,,,,2.0,
31047.0,2020-01-08,"(410.101, 635.75]",6,13,-7
31047.0,2020-01-08,"(635.75, 860.5]",2,3,-1
31047.0,2020-01-08,"(860.5, 1085.25]",8,19,-11
31047.0,2020-01-08,"(1085.25, 1310.0]",2,5,-3
31048.0,2020-01-08,"(517.325, 686.75]",1,2,-1
31048.0,2020-01-08,"(855.5, 1024.25]",3,1,2
31048.0,2020-01-08,"(1024.25, 1193.0]",4,4,0
31049.0,2020-01-08,"(1023.936, 1040.0]",1,1,0
31049.0,2020-01-08,"(1072.0, 1088.0]",1,1,0
31050.0,2020-01-08,"(538.43, 681.5]",1,2,-1
31050.0,2020-01-08,"(966.5, 1109.0]",1,1,0
31051.0,2020-01-08,"(633.5, 839.0]",2,5,-3
31051.0,2020-01-08,"(839.0, 1044.5]",1,2,-1
31051.0,2020-01-08,"(1044.5, 1250.0]",4,1,3
31052.0,2020-01-08,"(511.274, 693.5]",2,3,-1
31052.0,2020-01-08,"(875.0, 1056.5]",1,1,0
31052.0,2020-01-08,"(1056.5, 1238.0]",1,2,-1
31053.0,2020-01-08,"(971.25, 1103.0]",1,1,0
31054.0,2020-01-08,"(856.5, 1142.0]",1,1,0
31055.0,2020-01-08,"(935.0, 1171.5]",2,1,1
31055.0,2020-01-08,"(1171.5, 1408.0]",1,3,-2
31056.0,2020-01-08,"(982.5, 1196.75]",2,1,1
31056.0,2020-01-08,"(1196.75, 1411.0]",2,3,-1
31057.0,2020-01-08,"(1020.49, 1021.0]",1,2,-1
31058.0,2020-01-08,"(772.5, 1030.0]",1,1,0
,,,,1.0,
,,,,1.0,
31060.0,2020-01-08,"(554.414, 701.5]",1,1,0
31060.0,2020-01-08,"(848.0, 994.5]",1,1,0
31060.0,2020-01-08,"(994.5, 1141.0]",2,3,-1
31061.0,2020-01-08,"(690.558, 801.5]",1,1,0
31062.0,2020-01-08,"(730.625, 824.75]",1,1,0
31062.0,2020-01-08,"(824.75, 918.5]",1,1,0
31062.0,2020-01-08,"(918.5, 1012.25]",1,2,-1
31062.0,2020-01-08,"(1012.25, 1106.0]",1,2,-1
31063.0,2020-01-08,"(652.5, 870.0]",1,1,0
31064.0,2020-01-08,"(478.367, 637.25]",3,5,-2
31064.0,2020-01-08,"(795.5, 953.75]",1,1,0
31064.0,2020-01-08,"(953.75, 1112.0]",7,1,6
31065.0,2020-01-08,"(774.0, 950.0]",2,2,0
31065.0,2020-01-08,"(950.0, 1126.0]",2,3,-1
,,,,1.0,
,,,,2.0,
31067.0,2020-01-08,"(813.0, 1003.0]",1,1,0
31067.0,2020-01-08,"(1003.0, 1193.0]",2,1,1
31067.0,2020-01-08,"(1193.0, 1383.0]",1,2,-1
31068.0,2020-01-08,"(558.196, 760.0]",1,4,-3
31068.0,2020-01-08,"(1162.0, 1363.0]",1,2,-1
31069.0,2020-01-08,"(417.4, 568.0]",1,4,-3
31069.0,2020-01-08,"(868.0, 1018.0]",1,1,0
31070.0,2020-01-08,"(522.29, 700.5]",1,3,-2
31070.0,2020-01-08,"(700.5, 878.0]",1,1,0
31070.0,2020-01-08,"(878.0, 1055.5]",1,2,-1
31070.0,2020-01-08,"(1055.5, 1233.0]",2,2,0
31071.0,2020-01-08,"(672.0, 861.0]",2,4,-2
31071.0,2020-01-08,"(861.0, 1050.0]",2,4,-2
31071.0,2020-01-08,"(1050.0, 1239.0]",7,3,4
,,,,2.0,
31073.0,2020-01-08,"(260.75, 521.5]",1,1,0
31073.0,2020-01-08,"(782.25, 1043.0]",1,1,0
31074.0,2020-01-08,"(1040.75, 1125.5]",1,2,-1
31074.0,2020-01-08,"(1210.25, 1295.0]",1,2,-1
,,,,2.0,
31076.0,2020-01-08,"(286.0, 572.0]",1,1,0
31076.0,2020-01-08,"(858.0, 1144.0]",2,1,1
31077.0,2020-01-08,"(678.75, 846.5]",1,2,-1
31077.0,2020-01-08,"(846.5, 1014.25]",2,2,0
31077.0,2020-01-08,"(1014.25, 1182.0]",3,3,0
31078.0,2020-01-08,"(467.368, 626.0]",5,5,0
31078.0,2020-01-08,"(942.0, 1100.0]",1,4,-3
31079.0,2020-01-08,"(469.222, 664.5]",3,7,-4
31079.0,2020-01-08,"(664.5, 859.0]",2,4,-2
31079.0,2020-01-08,"(859.0, 1053.5]",1,2,-1
31079.0,2020-01-08,"(1053.5, 1248.0]",3,4,-1
31080.0,2020-01-08,"(881.5, 1132.25]",5,4,1
31080.0,2020-01-08,"(1132.25, 1383.0]",2,7,-5
31081.0,2020-01-08,"(477.326, 646.5]",1,1,0
31081.0,2020-01-08,"(983.5, 1152.0]",1,4,-3
31082.0,2020-01-08,"(1026.0, 1368.0]",1,1,0
31083.0,2020-01-08,"(768.5, 950.25]",1,3,-2
31083.0,2020-01-08,"(950.25, 1132.0]",5,1,4
31084.0,2020-01-08,"(562.284, 742.0]",5,6,-1
31084.0,2020-01-08,"(742.0, 921.0]",1,1,0
31085.0,2020-01-08,"(883.75, 1013.0]",2,2,0
31086.0,2020-01-08,"(1012.25, 1206.0]",4,1,3
31087.0,2020-01-08,"(799.5, 1066.0]",3,1,2
31088.0,2020-01-08,"(899.75, 1065.0]",2,1,1
31089.0,2020-01-08,"(418.296, 595.0]",4,7,-3
31089.0,2020-01-08,"(595.0, 771.0]",1,1,0
31089.0,2020-01-08,"(771.0, 947.0]",2,6,-4
31089.0,2020-01-08,"(947.0, 1123.0]",4,19,-15
31090.0,2020-01-08,"(1003.0, 1192.0]",2,1,1
31091.0,2020-01-08,"(670.75, 902.5]",1,3,-2
31091.0,2020-01-08,"(902.5, 1134.25]",3,1,2
31091.0,2020-01-08,"(1134.25, 1366.0]",4,3,1
31092.0,2020-01-08,"(680.25, 887.5]",1,1,0
31092.0,2020-01-08,"(887.5, 1094.75]",1,1,0
31093.0,2020-01-08,"(937.5, 1115.0]",1,2,-1
31094.0,2020-01-08,"(1159.794, 1211.5]",1,1,0
31094.0,2020-01-08,"(1263.0, 1314.5]",1,1,0
,,,,1.0,
,,,,1.0,
31096.0,2020-01-08,"(592.0, 650.5]",1,1,0
31096.0,2020-01-08,"(650.5, 709.0]",1,1,0
31097.0,2020-01-08,"(502.198, 703.5]",2,2,0
31098.0,2020-01-08,"(386.25, 574.5]",1,9,-8
31098.0,2020-01-08,"(574.5, 762.0]",1,2,-1
31098.0,2020-01-08,"(762.0, 949.5]",1,1,0
31098.0,2020-01-08,"(949.5, 1137.0]",6,11,-5
31099.0,2020-01-08,"(890.25, 1003.0]",1,3,-2
31100.0,2020-01-08,"(396.064, 631.0]",8,11,-3
31100.0,2020-01-08,"(631.0, 865.0]",1,5,-4
31100.0,2020-01-08,"(865.0, 1099.0]",7,15,-8
31100.0,2020-01-08,"(1099.0, 1333.0]",1,4,-3
31101.0,2020-01-08,"(341.948, 606.0]",5,19,-14
31101.0,2020-01-08,"(606.0, 869.0]",9,17,-8
31101.0,2020-01-08,"(869.0, 1132.0]",33,49,-16
31101.0,2020-01-08,"(1132.0, 1395.0]",14,32,-18
31102.0,2020-01-08,"(832.0, 1073.5]",4,12,-8
31102.0,2020-01-08,"(1073.5, 1315.0]",10,5,5
31103.0,2020-01-08,"(476.75, 784.5]",1,5,-4
31103.0,2020-01-08,"(784.5, 1092.25]",5,24,-19
31103.0,2020-01-08,"(1092.25, 1400.0]",13,15,-2
31104.0,2020-01-08,"(414.117, 635.75]",5,22,-17
31104.0,2020-01-08,"(635.75, 856.5]",4,9,-5
31104.0,2020-01-08,"(856.5, 1077.25]",6,13,-7
31104.0,2020-01-08,"(1077.25, 1298.0]",15,26,-11
31105.0,2020-01-08,"(340.996, 593.0]",1,12,-11
31105.0,2020-01-08,"(593.0, 844.0]",3,5,-2
31105.0,2020-01-08,"(844.0, 1095.0]",3,6,-3
31105.0,2020-01-08,"(1095.0, 1346.0]",2,5,-3
31106.0,2020-01-08,"(456.162, 666.5]",1,4,-3
31106.0,2020-01-08,"(1085.5, 1295.0]",3,2,1
31107.0,2020-01-08,"(401.025, 645.75]",5,28,-23
31107.0,2020-01-08,"(645.75, 889.5]",3,9,-6
31107.0,2020-01-08,"(889.5, 1133.25]",15,23,-8
31107.0,2020-01-08,"(1133.25, 1377.0]",5,8,-3
31108.0,2020-01-08,"(368.971, 627.25]",9,32,-23
31108.0,2020-01-08,"(627.25, 884.5]",9,16,-7
31108.0,2020-01-08,"(884.5, 1141.75]",18,30,-12
31108.0,2020-01-08,"(1141.75, 1399.0]",11,11,0
31109.0,2020-01-08,"(333.895, 611.25]",3,15,-12
31109.0,2020-01-08,"(611.25, 887.5]",5,8,-3
31109.0,2020-01-08,"(887.5, 1163.75]",19,27,-8
31109.0,2020-01-08,"(1163.75, 1440.0]",3,7,-4
31110.0,2020-01-08,"(309.887, 589.25]",13,26,-13
31110.0,2020-01-08,"(589.25, 867.5]",9,18,-9
31110.0,2020-01-08,"(867.5, 1145.75]",21,39,-18
31110.0,2020-01-08,"(1145.75, 1424.0]",8,23,-15
31111.0,2020-01-08,"(319.029, 562.75]",6,10,-4
31111.0,2020-01-08,"(805.5, 1048.25]",8,5,3
31111.0,2020-01-08,"(1048.25, 1291.0]",11,10,1
31112.0,2020-01-08,"(360.125, 579.75]",1,2,-1
31112.0,2020-01-08,"(1017.25, 1236.0]",5,6,-1
31113.0,2020-01-08,"(564.5, 812.0]",3,12,-9
31113.0,2020-01-08,"(812.0, 1059.5]",6,10,-4
31113.0,2020-01-08,"(1059.5, 1307.0]",8,9,-1
31114.0,2020-01-08,"(254.942, 520.5]",3,21,-18
31114.0,2020-01-08,"(520.5, 785.0]",3,13,-10
31114.0,2020-01-08,"(785.0, 1049.5]",5,10,-5
31114.0,2020-01-08,"(1049.5, 1314.0]",29,43,-14
31115.0,2020-01-08,"(602.75, 857.5]",1,11,-10
31115.0,2020-01-08,"(857.5, 1112.25]",8,6,2
31115.0,2020-01-08,"(1112.25, 1367.0]",12,15,-3
31116.0,2020-01-08,"(309.967, 569.25]",7,30,-23
31116.0,2020-01-08,"(569.25, 827.5]",3,5,-2
31116.0,2020-01-08,"(827.5, 1085.75]",15,19,-4
31116.0,2020-01-08,"(1085.75, 1344.0]",12,22,-10
31117.0,2020-01-08,"(371.971, 630.25]",4,19,-15
31117.0,2020-01-08,"(630.25, 887.5]",3,5,-2
31117.0,2020-01-08,"(887.5, 1144.75]",10,23,-13
31117.0,2020-01-08,"(1144.75, 1402.0]",7,11,-4
31118.0,2020-01-08,"(321.027, 565.25]",2,12,-10
31118.0,2020-01-08,"(808.5, 1051.75]",3,5,-2
31118.0,2020-01-08,"(1051.75, 1295.0]",13,5,8
31119.0,2020-01-08,"(306.934, 574.5]",8,25,-17
31119.0,2020-01-08,"(574.5, 841.0]",6,16,-10
31119.0,2020-01-08,"(841.0, 1107.5]",12,20,-8
31119.0,2020-01-08,"(1107.5, 1374.0]",17,30,-13
31120.0,2020-01-08,"(350.0, 601.0]",3,14,-11
31120.0,2020-01-08,"(601.0, 851.0]",3,6,-3
31120.0,2020-01-08,"(851.0, 1101.0]",7,14,-7
31120.0,2020-01-08,"(1101.0, 1351.0]",8,8,0
31121.0,2020-01-08,"(349.056, 586.0]",19,25,-6
31121.0,2020-01-08,"(822.0, 1058.0]",3,1,2
31121.0,2020-01-08,"(1058.0, 1294.0]",5,9,-4
31122.0,2020-01-08,"(18.672, 352.0]",1,1,0
31122.0,2020-01-08,"(352.0, 684.0]",2,12,-10
31122.0,2020-01-08,"(684.0, 1016.0]",3,11,-8
31122.0,2020-01-08,"(1016.0, 1348.0]",8,15,-7
31123.0,2020-01-08,"(1009.5, 1224.0]",4,8,-4
31124.0,2020-01-08,"(361.937, 628.75]",9,33,-24
31124.0,2020-01-08,"(628.75, 894.5]",4,9,-5
31124.0,2020-01-08,"(894.5, 1160.25]",18,46,-28
31124.0,2020-01-08,"(1160.25, 1426.0]",6,27,-21
31125.0,2020-01-08,"(363.061, 598.75]",4,24,-20
31125.0,2020-01-08,"(598.75, 833.5]",2,4,-2
31125.0,2020-01-08,"(833.5, 1068.25]",12,14,-2
31125.0,2020-01-08,"(1068.25, 1303.0]",13,20,-7
31126.0,2020-01-08,"(33.69, 362.5]",2,4,-2
31126.0,2020-01-08,"(362.5, 690.0]",6,25,-19
31126.0,2020-01-08,"(690.0, 1017.5]",13,27,-14
31126.0,2020-01-08,"(1017.5, 1345.0]",18,28,-10
,,,,2.0,
31128.0,2020-01-08,"(61.631, 405.25]",2,3,-1
31128.0,2020-01-08,"(405.25, 747.5]",26,38,-12
31128.0,2020-01-08,"(747.5, 1089.75]",23,32,-9
31128.0,2020-01-08,"(1089.75, 1432.0]",5,12,-7
31129.0,2020-01-08,"(409.126, 628.5]",11,13,-2
31129.0,2020-01-08,"(628.5, 847.0]",2,7,-5
31129.0,2020-01-08,"(847.0, 1065.5]",4,6,-2
31129.0,2020-01-08,"(1065.5, 1284.0]",2,5,-3
31130.0,2020-01-08,"(288.971, 547.25]",2,14,-12
31130.0,2020-01-08,"(547.25, 804.5]",2,7,-5
31130.0,2020-01-08,"(804.5, 1061.75]",1,5,-4
31130.0,2020-01-08,"(1061.75, 1319.0]",11,11,0
31131.0,2020-01-08,"(279.0, 530.0]",1,7,-6
31131.0,2020-01-08,"(1030.0, 1280.0]",3,2,1
31200.0,2020-01-08,"(344.25, 680.5]",27,2,25
31200.0,2020-01-08,"(680.5, 1016.75]",16,44,-28
31200.0,2020-01-08,"(1016.75, 1353.0]",15,26,-11
31201.0,2020-01-08,"(298.861, 584.75]",20,43,-23
31201.0,2020-01-08,"(584.75, 869.5]",15,27,-12
31201.0,2020-01-08,"(869.5, 1154.25]",37,61,-24
31201.0,2020-01-08,"(1154.25, 1439.0]",15,34,-19
31202.0,2020-01-08,"(336.927, 606.25]",7,19,-12
31202.0,2020-01-08,"(606.25, 874.5]",6,10,-4
31202.0,2020-01-08,"(874.5, 1142.75]",18,29,-11
31202.0,2020-01-08,"(1142.75, 1411.0]",6,15,-9
31203.0,2020-01-08,"(332.972, 591.0]",7,13,-6
31203.0,2020-01-08,"(591.0, 848.0]",5,12,-7
31203.0,2020-01-08,"(848.0, 1105.0]",15,22,-7
31203.0,2020-01-08,"(1105.0, 1362.0]",25,35,-10
31204.0,2020-01-08,"(400.256, 587.0]",9,10,-1
31204.0,2020-01-08,"(587.0, 773.0]",3,7,-4
31204.0,2020-01-08,"(773.0, 959.0]",2,4,-2
31204.0,2020-01-08,"(959.0, 1145.0]",2,12,-10
31205.0,2020-01-08,"(337.5, 668.0]",17,2,15
31205.0,2020-01-08,"(668.0, 998.5]",12,19,-7
31205.0,2020-01-08,"(998.5, 1329.0]",6,18,-12
31206.0,2020-01-08,"(398.35, 561.5]",3,3,0
31206.0,2020-01-08,"(724.0, 886.5]",1,1,0
31206.0,2020-01-08,"(886.5, 1049.0]",2,1,1
31207.0,2020-01-08,"(883.5, 1112.25]",2,5,-3
31207.0,2020-01-08,"(1112.25, 1341.0]",2,2,0
31208.0,2020-01-08,"(386.132, 604.0]",13,16,-3
31208.0,2020-01-08,"(821.0, 1038.0]",1,10,-9
31208.0,2020-01-08,"(1038.0, 1255.0]",2,6,-4
31209.0,2020-01-08,"(492.313, 664.75]",1,4,-3
31209.0,2020-01-08,"(664.75, 836.5]",1,2,-1
31209.0,2020-01-08,"(836.5, 1008.25]",2,2,0
31209.0,2020-01-08,"(1008.25, 1180.0]",2,2,0
31211.0,2020-01-08,"(541.195, 743.25]",6,7,-1
31211.0,2020-01-08,"(743.25, 944.5]",2,4,-2
31211.0,2020-01-08,"(944.5, 1145.75]",2,6,-4
31211.0,2020-01-08,"(1145.75, 1347.0]",6,12,-6
31212.0,2020-01-08,"(381.964, 642.0]",28,37,-9
31212.0,2020-01-08,"(642.0, 901.0]",11,18,-7
31212.0,2020-01-08,"(901.0, 1160.0]",12,25,-13
31212.0,2020-01-08,"(1160.0, 1419.0]",5,11,-6
31213.0,2020-01-08,"(20.651, 359.25]",1,2,-1
31213.0,2020-01-08,"(359.25, 696.5]",29,40,-11
31213.0,2020-01-08,"(696.5, 1033.75]",12,25,-13
31213.0,2020-01-08,"(1033.75, 1371.0]",15,30,-15
31214.0,2020-01-08,"(26.673, 359.75]",1,1,0
31214.0,2020-01-08,"(359.75, 691.5]",4,21,-17
31214.0,2020-01-08,"(691.5, 1023.25]",7,15,-8
31214.0,2020-01-08,"(1023.25, 1355.0]",26,44,-18
31215.0,2020-01-08,"(438.069, 671.75]",17,21,-4
31215.0,2020-01-08,"(671.75, 904.5]",4,6,-2
31215.0,2020-01-08,"(904.5, 1137.25]",6,15,-9
31215.0,2020-01-08,"(1137.25, 1370.0]",3,9,-6
31216.0,2020-01-08,"(357.213, 554.75]",16,16,0
31216.0,2020-01-08,"(554.75, 751.5]",1,2,-1
31216.0,2020-01-08,"(751.5, 948.25]",3,8,-5
31216.0,2020-01-08,"(948.25, 1145.0]",3,18,-15
31217.0,2020-01-08,"(625.29, 803.5]",1,2,-1
31217.0,2020-01-08,"(1158.5, 1336.0]",2,2,0
31218.0,2020-01-08,"(378.214, 575.5]",11,21,-10
31218.0,2020-01-08,"(575.5, 772.0]",4,5,-1
31218.0,2020-01-08,"(772.0, 968.5]",3,4,-1
31218.0,2020-01-08,"(968.5, 1165.0]",11,19,-8
31219.0,2020-01-08,"(452.327, 621.25]",10,10,0
31219.0,2020-01-08,"(621.25, 789.5]",9,11,-2
31219.0,2020-01-08,"(789.5, 957.75]",2,4,-2
31219.0,2020-01-08,"(957.75, 1126.0]",1,9,-8
31220.0,2020-01-08,"(380.31, 553.5]",18,23,-5
31220.0,2020-01-08,"(726.0, 898.5]",2,2,0
31220.0,2020-01-08,"(898.5, 1071.0]",1,2,-1
31221.0,2020-01-08,"(344.25, 660.5]",29,1,28
31221.0,2020-01-08,"(660.5, 976.75]",8,32,-24
31221.0,2020-01-08,"(976.75, 1293.0]",10,17,-7
31222.0,2020-01-08,"(484.235, 676.25]",11,11,0
31222.0,2020-01-08,"(867.5, 1058.75]",1,12,-11
31222.0,2020-01-08,"(1058.75, 1250.0]",2,13,-11
31223.0,2020-01-08,"(33.767, 343.25]",1,2,-1
31223.0,2020-01-08,"(343.25, 651.5]",8,24,-16
31223.0,2020-01-08,"(651.5, 959.75]",5,9,-4
31223.0,2020-01-08,"(959.75, 1268.0]",13,29,-16
31224.0,2020-01-08,"(374.986, 629.5]",5,6,-1
31224.0,2020-01-08,"(629.5, 883.0]",3,5,-2
31224.0,2020-01-08,"(883.0, 1136.5]",4,15,-11
31224.0,2020-01-08,"(1136.5, 1390.0]",4,11,-7
31225.0,2020-01-08,"(336.123, 556.25]",4,8,-4
31225.0,2020-01-08,"(556.25, 775.5]",5,7,-2
31225.0,2020-01-08,"(775.5, 994.75]",1,3,-2
31225.0,2020-01-08,"(994.75, 1214.0]",6,13,-7
31226.0,2020-01-08,"(313.5, 616.0]",4,1,3
31226.0,2020-01-08,"(616.0, 918.5]",4,10,-6
31226.0,2020-01-08,"(918.5, 1221.0]",11,9,2
31227.0,2020-01-08,"(420.034, 662.5]",17,21,-4
31227.0,2020-01-08,"(662.5, 904.0]",1,3,-2
31227.0,2020-01-08,"(904.0, 1145.5]",6,23,-17
31228.0,2020-01-08,"(355.057, 591.75]",19,33,-14
31228.0,2020-01-08,"(591.75, 827.5]",15,23,-8
31228.0,2020-01-08,"(827.5, 1063.25]",13,23,-10
31228.0,2020-01-08,"(1063.25, 1299.0]",15,26,-11
31229.0,2020-01-08,"(281.871, 565.25]",11,45,-34
31229.0,2020-01-08,"(565.25, 847.5]",10,31,-21
31229.0,2020-01-08,"(847.5, 1129.75]",28,46,-18
31229.0,2020-01-08,"(1129.75, 1412.0]",9,18,-9
31230.0,2020-01-08,"(371.03, 614.5]",35,42,-7
31230.0,2020-01-08,"(614.5, 857.0]",9,13,-4
31230.0,2020-01-08,"(857.0, 1099.5]",16,30,-14
31230.0,2020-01-08,"(1099.5, 1342.0]",8,27,-19
31231.0,2020-01-08,"(333.242, 523.5]",7,8,-1
31231.0,2020-01-08,"(523.5, 713.0]",7,9,-2
31231.0,2020-01-08,"(713.0, 902.5]",2,4,-2
31231.0,2020-01-08,"(902.5, 1092.0]",2,12,-10
31232.0,2020-01-08,"(70.774, 378.5]",4,4,0
31232.0,2020-01-08,"(378.5, 685.0]",20,27,-7
31232.0,2020-01-08,"(685.0, 991.5]",2,6,-4
31232.0,2020-01-08,"(991.5, 1298.0]",10,23,-13
31233.0,2020-01-08,"(1.563, 362.25]",2,2,0
31233.0,2020-01-08,"(362.25, 721.5]",44,51,-7
31233.0,2020-01-08,"(721.5, 1080.75]",23,45,-22
31233.0,2020-01-08,"(1080.75, 1440.0]",9,17,-8
31234.0,2020-01-08,"(404.125, 623.75]",15,31,-16
31234.0,2020-01-08,"(623.75, 842.5]",10,13,-3
31234.0,2020-01-08,"(842.5, 1061.25]",8,17,-9
31234.0,2020-01-08,"(1061.25, 1280.0]",14,28,-14
31235.0,2020-01-08,"(387.307, 561.25]",3,4,-1
31235.0,2020-01-08,"(907.75, 1081.0]",4,10,-6
31236.0,2020-01-08,"(441.148, 655.0]",7,11,-4
31236.0,2020-01-08,"(655.0, 868.0]",3,8,-5
31236.0,2020-01-08,"(868.0, 1081.0]",5,17,-12
31236.0,2020-01-08,"(1081.0, 1294.0]",4,20,-16
31237.0,2020-01-08,"(319.914, 592.5]",7,14,-7
31237.0,2020-01-08,"(592.5, 864.0]",5,9,-4
31237.0,2020-01-08,"(864.0, 1135.5]",5,13,-8
31237.0,2020-01-08,"(1135.5, 1407.0]",4,11,-7
31238.0,2020-01-08,"(41.656, 379.0]",2,2,0
31238.0,2020-01-08,"(379.0, 715.0]",8,10,-2
31238.0,2020-01-08,"(715.0, 1051.0]",7,22,-15
31238.0,2020-01-08,"(1051.0, 1387.0]",2,15,-13
31239.0,2020-01-08,"(287.895, 565.25]",29,38,-9
31239.0,2020-01-08,"(565.25, 841.5]",2,6,-4
31239.0,2020-01-08,"(841.5, 1117.75]",9,28,-19
31239.0,2020-01-08,"(1117.75, 1394.0]",4,16,-12
31240.0,2020-01-08,"(919.75, 925.0]",1,1,0
31241.0,2020-01-08,"(67.669, 401.75]",2,3,-1
31241.0,2020-01-08,"(401.75, 734.5]",30,55,-25
31241.0,2020-01-08,"(734.5, 1067.25]",11,32,-21
31241.0,2020-01-08,"(1067.25, 1400.0]",14,29,-15
31242.0,2020-01-08,"(403.092, 631.0]",13,16,-3
31242.0,2020-01-08,"(631.0, 858.0]",4,9,-5
31242.0,2020-01-08,"(858.0, 1085.0]",2,19,-17
31242.0,2020-01-08,"(1085.0, 1312.0]",2,11,-9
31243.0,2020-01-08,"(342.162, 552.5]",17,22,-5
31243.0,2020-01-08,"(762.0, 971.5]",8,3,5
31243.0,2020-01-08,"(971.5, 1181.0]",5,18,-13
31244.0,2020-01-08,"(428.123, 648.25]",17,23,-6
31244.0,2020-01-08,"(648.25, 867.5]",5,10,-5
31244.0,2020-01-08,"(867.5, 1086.75]",8,24,-16
31244.0,2020-01-08,"(1086.75, 1306.0]",3,9,-6
31245.0,2020-01-08,"(359.966, 619.5]",11,25,-14
31245.0,2020-01-08,"(619.5, 878.0]",4,8,-4
31245.0,2020-01-08,"(878.0, 1136.5]",11,20,-9
31245.0,2020-01-08,"(1136.5, 1395.0]",6,11,-5
31246.0,2020-01-08,"(2.594, 355.5]",2,3,-1
31246.0,2020-01-08,"(355.5, 707.0]",13,18,-5
31246.0,2020-01-08,"(707.0, 1058.5]",6,15,-9
31246.0,2020-01-08,"(1058.5, 1410.0]",14,27,-13
31247.0,2020-01-08,"(425.254, 612.5]",9,13,-4
31247.0,2020-01-08,"(612.5, 799.0]",6,11,-5
31247.0,2020-01-08,"(799.0, 985.5]",8,12,-4
31247.0,2020-01-08,"(985.5, 1172.0]",9,20,-11
31248.0,2020-01-08,"(371.271, 554.25]",10,15,-5
31248.0,2020-01-08,"(554.25, 736.5]",3,6,-3
31248.0,2020-01-08,"(736.5, 918.75]",1,2,-1
31248.0,2020-01-08,"(918.75, 1101.0]",5,12,-7
31249.0,2020-01-08,"(429.146, 643.5]",5,9,-4
31249.0,2020-01-08,"(857.0, 1070.5]",7,13,-6
31249.0,2020-01-08,"(1070.5, 1284.0]",3,5,-2
31250.0,2020-01-08,"(421.093, 648.75]",11,13,-2
31250.0,2020-01-08,"(648.75, 875.5]",6,12,-6
31250.0,2020-01-08,"(875.5, 1102.25]",2,15,-13
31250.0,2020-01-08,"(1102.25, 1329.0]",1,6,-5
31251.0,2020-01-08,"(13.707, 338.25]",2,3,-1
31251.0,2020-01-08,"(338.25, 661.5]",16,27,-11
31251.0,2020-01-08,"(661.5, 984.75]",8,18,-10
31251.0,2020-01-08,"(984.75, 1308.0]",11,27,-16
31252.0,2020-01-08,"(463.058, 699.5]",21,23,-2
31252.0,2020-01-08,"(699.5, 935.0]",3,8,-5
31252.0,2020-01-08,"(935.0, 1170.5]",3,19,-16
31252.0,2020-01-08,"(1170.5, 1406.0]",2,4,-2
31253.0,2020-01-08,"(396.983, 652.25]",31,31,0
31253.0,2020-01-08,"(652.25, 906.5]",4,9,-5
31253.0,2020-01-08,"(906.5, 1160.75]",2,17,-15
31253.0,2020-01-08,"(1160.75, 1415.0]",1,4,-3
31254.0,2020-01-08,"(435.143, 650.25]",24,27,-3
31254.0,2020-01-08,"(650.25, 864.5]",8,12,-4
31254.0,2020-01-08,"(864.5, 1078.75]",4,17,-13
31254.0,2020-01-08,"(1078.75, 1293.0]",1,2,-1
31255.0,2020-01-08,"(353.148, 567.0]",11,18,-7
31255.0,2020-01-08,"(567.0, 780.0]",3,4,-1
31255.0,2020-01-08,"(780.0, 993.0]",1,4,-3
31255.0,2020-01-08,"(993.0, 1206.0]",10,19,-9
31256.0,2020-01-08,"(258.852, 547.0]",11,12,-1
31256.0,2020-01-08,"(547.0, 834.0]",5,6,-1
31256.0,2020-01-08,"(834.0, 1121.0]",4,12,-8
31256.0,2020-01-08,"(1121.0, 1408.0]",2,12,-10
31257.0,2020-01-08,"(318.063, 553.25]",15,27,-12
31257.0,2020-01-08,"(553.25, 787.5]",3,7,-4
31257.0,2020-01-08,"(787.5, 1021.75]",4,8,-4
31257.0,2020-01-08,"(1021.75, 1256.0]",8,25,-17
31258.0,2020-01-08,"(26.763, 337.25]",4,7,-3
31258.0,2020-01-08,"(337.25, 646.5]",10,26,-16
31258.0,2020-01-08,"(646.5, 955.75]",16,29,-13
31258.0,2020-01-08,"(955.75, 1265.0]",2,5,-3
31259.0,2020-01-08,"(452.342, 617.5]",1,1,0
31259.0,2020-01-08,"(946.5, 1111.0]",1,1,0
31260.0,2020-01-08,"(358.194, 560.5]",19,21,-2
31260.0,2020-01-08,"(560.5, 762.0]",3,5,-2
31260.0,2020-01-08,"(762.0, 963.5]",1,3,-2
31260.0,2020-01-08,"(963.5, 1165.0]",4,20,-16
31261.0,2020-01-08,"(391.13, 609.5]",6,6,0
31261.0,2020-01-08,"(827.0, 1044.5]",2,1,1
31262.0,2020-01-08,"(63.749, 377.75]",3,3,0
31262.0,2020-01-08,"(377.75, 690.5]",18,21,-3
31262.0,2020-01-08,"(690.5, 1003.25]",2,4,-2
31263.0,2020-01-08,"(366.982, 622.5]",26,36,-10
31263.0,2020-01-08,"(622.5, 877.0]",8,14,-6
31263.0,2020-01-08,"(877.0, 1131.5]",9,29,-20
31263.0,2020-01-08,"(1131.5, 1386.0]",1,8,-7
31264.0,2020-01-08,"(458.068, 692.0]",6,9,-3
31264.0,2020-01-08,"(692.0, 925.0]",3,8,-5
31264.0,2020-01-08,"(925.0, 1158.0]",6,17,-11
31264.0,2020-01-08,"(1158.0, 1391.0]",1,6,-5
31265.0,2020-01-08,"(363.97, 622.5]",17,32,-15
31265.0,2020-01-08,"(622.5, 880.0]",2,8,-6
31265.0,2020-01-08,"(880.0, 1137.5]",15,26,-11
31265.0,2020-01-08,"(1137.5, 1395.0]",10,14,-4
31266.0,2020-01-08,"(65.678, 397.5]",1,11,-10
31266.0,2020-01-08,"(397.5, 728.0]",6,20,-14
31266.0,2020-01-08,"(728.0, 1058.5]",9,15,-6
31266.0,2020-01-08,"(1058.5, 1389.0]",21,33,-12
31267.0,2020-01-08,"(21.7, 348.0]",1,2,-1
31267.0,2020-01-08,"(348.0, 673.0]",29,52,-23
31267.0,2020-01-08,"(673.0, 998.0]",12,24,-12
31267.0,2020-01-08,"(998.0, 1323.0]",14,28,-14
31268.0,2020-01-08,"(334.967, 594.25]",12,37,-25
31268.0,2020-01-08,"(594.25, 852.5]",4,10,-6
31268.0,2020-01-08,"(852.5, 1110.75]",16,25,-9
31268.0,2020-01-08,"(1110.75, 1369.0]",13,16,-3
31269.0,2020-01-08,"(350.984, 606.0]",7,15,-8
31269.0,2020-01-08,"(606.0, 860.0]",5,8,-3
31269.0,2020-01-08,"(860.0, 1114.0]",7,18,-11
31269.0,2020-01-08,"(1114.0, 1368.0]",2,7,-5
31270.0,2020-01-08,"(264.982, 520.5]",8,13,-5
31270.0,2020-01-08,"(520.5, 775.0]",11,16,-5
31270.0,2020-01-08,"(775.0, 1029.5]",7,13,-6
31270.0,2020-01-08,"(1029.5, 1284.0]",7,13,-6
31271.0,2020-01-08,"(417.253, 604.75]",7,9,-2
31271.0,2020-01-08,"(604.75, 791.5]",1,2,-1
31271.0,2020-01-08,"(791.5, 978.25]",2,5,-3
31271.0,2020-01-08,"(978.25, 1165.0]",5,16,-11
31272.0,2020-01-08,"(295.076, 527.0]",10,12,-2
31272.0,2020-01-08,"(527.0, 758.0]",14,17,-3
31272.0,2020-01-08,"(758.0, 989.0]",9,14,-5
31272.0,2020-01-08,"(989.0, 1220.0]",3,21,-18
31273.0,2020-01-08,"(667.75, 798.5]",1,2,-1
31273.0,2020-01-08,"(929.25, 1060.0]",1,1,0
31274.0,2020-01-08,"(459.086, 688.5]",6,7,-1
31274.0,2020-01-08,"(688.5, 917.0]",1,3,-2
31274.0,2020-01-08,"(917.0, 1145.5]",5,13,-8
31274.0,2020-01-08,"(1145.5, 1374.0]",1,5,-4
31275.0,2020-01-08,"(399.101, 624.75]",10,19,-9
31275.0,2020-01-08,"(624.75, 849.5]",5,12,-7
31275.0,2020-01-08,"(849.5, 1074.25]",11,25,-14
31275.0,2020-01-08,"(1074.25, 1299.0]",9,14,-5
31276.0,2020-01-08,"(408.179, 614.25]",18,19,-1
31276.0,2020-01-08,"(614.25, 819.5]",3,6,-3
31276.0,2020-01-08,"(819.5, 1024.75]",2,8,-6
31276.0,2020-01-08,"(1024.75, 1230.0]",1,18,-17
31277.0,2020-01-08,"(276.012, 524.0]",21,25,-4
31277.0,2020-01-08,"(524.0, 771.0]",19,24,-5
31277.0,2020-01-08,"(771.0, 1018.0]",8,17,-9
31278.0,2020-01-08,"(313.989, 567.75]",6,24,-18
31278.0,2020-01-08,"(567.75, 820.5]",6,14,-8
31278.0,2020-01-08,"(820.5, 1073.25]",7,15,-8
31278.0,2020-01-08,"(1073.25, 1326.0]",18,24,-6
31279.0,2020-01-08,"(436.22, 632.0]",8,10,-2
31279.0,2020-01-08,"(632.0, 827.0]",2,6,-4
31279.0,2020-01-08,"(827.0, 1022.0]",7,13,-6
31279.0,2020-01-08,"(1022.0, 1217.0]",4,27,-23
31280.0,2020-01-08,"(370.154, 582.5]",3,10,-7
31280.0,2020-01-08,"(582.5, 794.0]",1,2,-1
31280.0,2020-01-08,"(794.0, 1005.5]",3,3,0
31280.0,2020-01-08,"(1005.5, 1217.0]",4,7,-3
,,,,1.0,
,,,,1.0,
31001.0,2020-01-09,"(1160.25, 1253.0]",1,1,0
31002.0,2020-01-09,"(365.182, 570.5]",1,6,-5
31002.0,2020-01-09,"(570.5, 775.0]",1,1,0
31002.0,2020-01-09,"(775.0, 979.5]",1,2,-1
31002.0,2020-01-09,"(979.5, 1184.0]",1,4,-3
31003.0,2020-01-09,"(500.375, 657.25]",2,3,-1
31003.0,2020-01-09,"(657.25, 813.5]",1,3,-2
31003.0,2020-01-09,"(813.5, 969.75]",1,1,0
31003.0,2020-01-09,"(969.75, 1126.0]",2,4,-2
,,,,1.0,
,,,,1.0,
31005.0,2020-01-09,"(390.201, 590.75]",5,7,-2
31005.0,2020-01-09,"(990.25, 1190.0]",1,7,-6
31006.0,2020-01-09,"(1081.902, 1106.5]",1,1,0
31006.0,2020-01-09,"(1155.5, 1180.0]",1,2,-1
31007.0,2020-01-09,"(482.251, 670.25]",5,8,-3
31007.0,2020-01-09,"(670.25, 857.5]",2,5,-3
31007.0,2020-01-09,"(1044.75, 1232.0]",6,1,5
31009.0,2020-01-09,"(490.514, 612.5]",1,2,-1
31009.0,2020-01-09,"(855.5, 977.0]",1,1,0
31010.0,2020-01-09,"(697.712, 770.0]",1,2,-1
31010.0,2020-01-09,"(914.0, 986.0]",4,1,3
31011.0,2020-01-09,"(374.114, 596.5]",5,8,-3
31011.0,2020-01-09,"(596.5, 818.0]",2,3,-1
31011.0,2020-01-09,"(818.0, 1039.5]",1,2,-1
31011.0,2020-01-09,"(1039.5, 1261.0]",3,5,-2
31012.0,2020-01-09,"(369.405, 518.75]",2,2,0
31013.0,2020-01-09,"(1035.5, 1180.0]",1,1,0
31014.0,2020-01-09,"(156.9, 433.0]",3,4,-1
31014.0,2020-01-09,"(433.0, 708.0]",16,24,-8
31014.0,2020-01-09,"(708.0, 983.0]",5,15,-10
31014.0,2020-01-09,"(983.0, 1258.0]",19,29,-10
31015.0,2020-01-09,"(372.112, 595.0]",12,13,-1
31015.0,2020-01-09,"(595.0, 817.0]",1,3,-2
31015.0,2020-01-09,"(817.0, 1039.0]",2,4,-2
31015.0,2020-01-09,"(1039.0, 1261.0]",4,6,-2
31016.0,2020-01-09,"(425.345, 589.75]",3,7,-4
31016.0,2020-01-09,"(589.75, 753.5]",1,3,-2
31016.0,2020-01-09,"(753.5, 917.25]",1,3,-2
31016.0,2020-01-09,"(917.25, 1081.0]",6,8,-2
31017.0,2020-01-09,"(490.079, 721.25]",4,6,-2
31017.0,2020-01-09,"(721.25, 951.5]",1,5,-4
31017.0,2020-01-09,"(951.5, 1181.75]",1,6,-5
31018.0,2020-01-09,"(687.5, 938.0]",1,5,-4
31018.0,2020-01-09,"(938.0, 1188.5]",3,1,2
31018.0,2020-01-09,"(1188.5, 1439.0]",1,3,-2
31019.0,2020-01-09,"(664.5, 873.0]",2,1,1
31019.0,2020-01-09,"(873.0, 1081.5]",1,2,-1
31019.0,2020-01-09,"(1081.5, 1290.0]",1,3,-2
31020.0,2020-01-09,"(996.75, 1165.0]",1,1,0
31021.0,2020-01-09,"(399.214, 596.5]",1,1,0
31021.0,2020-01-09,"(596.5, 793.0]",1,2,-1
31021.0,2020-01-09,"(793.0, 989.5]",2,5,-3
31021.0,2020-01-09,"(989.5, 1186.0]",2,6,-4
31022.0,2020-01-09,"(382.042, 622.5]",1,4,-3
31022.0,2020-01-09,"(622.5, 862.0]",3,4,-1
31022.0,2020-01-09,"(862.0, 1101.5]",5,10,-5
31023.0,2020-01-09,"(690.5, 842.0]",1,1,0
31023.0,2020-01-09,"(842.0, 993.5]",1,1,0
31023.0,2020-01-09,"(993.5, 1145.0]",2,1,1
31024.0,2020-01-09,"(409.057, 645.75]",5,9,-4
31024.0,2020-01-09,"(645.75, 881.5]",4,5,-1
31024.0,2020-01-09,"(881.5, 1117.25]",2,8,-6
31024.0,2020-01-09,"(1117.25, 1353.0]",3,6,-3
31025.0,2020-01-09,"(988.856, 1025.0]",2,2,0
31025.0,2020-01-09,"(1097.0, 1133.0]",1,1,0
31026.0,2020-01-09,"(752.0, 923.0]",1,1,0
31026.0,2020-01-09,"(923.0, 1094.0]",1,3,-2
31027.0,2020-01-09,"(742.75, 929.5]",2,1,1
31027.0,2020-01-09,"(1116.25, 1303.0]",1,2,-1
31028.0,2020-01-09,"(511.24, 702.0]",2,4,-2
31028.0,2020-01-09,"(702.0, 892.0]",2,3,-1
31028.0,2020-01-09,"(892.0, 1082.0]",1,2,-1
31028.0,2020-01-09,"(1082.0, 1272.0]",2,8,-6
31029.0,2020-01-09,"(907.5, 1102.25]",3,9,-6
31029.0,2020-01-09,"(1102.25, 1297.0]",2,5,-3
31030.0,2020-01-09,"(822.5, 1006.25]",2,3,-1
31030.0,2020-01-09,"(1006.25, 1190.0]",4,2,2
31031.0,2020-01-09,"(797.0, 972.0]",1,3,-2
31031.0,2020-01-09,"(972.0, 1147.0]",1,2,-1
31032.0,2020-01-09,"(443.363, 603.25]",1,3,-2
31032.0,2020-01-09,"(762.5, 921.75]",1,1,0
31032.0,2020-01-09,"(921.75, 1081.0]",2,2,0
31033.0,2020-01-09,"(315.99, 318.5]",1,1,0
31034.0,2020-01-09,"(392.082, 622.5]",3,6,-3
31034.0,2020-01-09,"(1081.5, 1311.0]",2,4,-2
31035.0,2020-01-09,"(439.182, 644.5]",3,4,-1
31035.0,2020-01-09,"(849.0, 1053.5]",1,2,-1
31035.0,2020-01-09,"(1053.5, 1258.0]",6,2,4
31036.0,2020-01-09,"(399.212, 597.0]",1,5,-4
31036.0,2020-01-09,"(991.0, 1188.0]",6,2,4
31037.0,2020-01-09,"(404.066, 638.5]",12,15,-3
31037.0,2020-01-09,"(638.5, 872.0]",5,9,-4
31037.0,2020-01-09,"(872.0, 1105.5]",3,12,-9
31037.0,2020-01-09,"(1105.5, 1339.0]",1,9,-8
31038.0,2020-01-09,"(394.352, 557.0]",1,1,0
31038.0,2020-01-09,"(557.0, 719.0]",1,2,-1
31038.0,2020-01-09,"(719.0, 881.0]",1,2,-1
31039.0,2020-01-09,"(464.158, 675.5]",5,11,-6
31039.0,2020-01-09,"(675.5, 886.0]",2,4,-2
31039.0,2020-01-09,"(886.0, 1096.5]",2,5,-3
31039.0,2020-01-09,"(1096.5, 1307.0]",2,6,-4
31040.0,2020-01-09,"(395.252, 583.0]",3,5,-2
31040.0,2020-01-09,"(583.0, 770.0]",2,3,-1
31040.0,2020-01-09,"(957.0, 1144.0]",1,4,-3
31041.0,2020-01-09,"(538.619, 634.25]",2,2,0
31041.0,2020-01-09,"(824.75, 920.0]",1,2,-1
31042.0,2020-01-09,"(441.307, 615.25]",9,10,-1
31042.0,2020-01-09,"(615.25, 788.5]",1,3,-2
31042.0,2020-01-09,"(788.5, 961.75]",1,4,-3
31042.0,2020-01-09,"(961.75, 1135.0]",2,7,-5
31043.0,2020-01-09,"(410.324, 580.0]",1,2,-1
31043.0,2020-01-09,"(918.0, 1087.0]",2,1,1
31044.0,2020-01-09,"(436.339, 602.25]",1,2,-1
31045.0,2020-01-09,"(501.136, 718.0]",3,6,-3
31045.0,2020-01-09,"(718.0, 934.0]",1,4,-3
31045.0,2020-01-09,"(934.0, 1150.0]",2,3,-1
31045.0,2020-01-09,"(1150.0, 1366.0]",1,1,0
31046.0,2020-01-09,"(757.0, 873.0]",1,1,0
31047.0,2020-01-09,"(400.163, 610.25]",10,17,-7
31047.0,2020-01-09,"(610.25, 819.5]",4,4,0
31047.0,2020-01-09,"(819.5, 1028.75]",1,2,-1
31047.0,2020-01-09,"(1028.75, 1238.0]",4,17,-13
31048.0,2020-01-09,"(492.248, 681.0]",1,5,-4
31048.0,2020-01-09,"(869.0, 1057.0]",1,1,0
31048.0,2020-01-09,"(1057.0, 1245.0]",1,3,-2
31049.0,2020-01-09,"(1191.5, 1245.0]",1,3,-2
,,,,1.0,
,,,,2.0,
31051.0,2020-01-09,"(711.5, 921.0]",1,4,-3
31051.0,2020-01-09,"(921.0, 1130.5]",4,1,3
31051.0,2020-01-09,"(1130.5, 1340.0]",2,5,-3
31052.0,2020-01-09,"(516.331, 684.25]",3,5,-2
31052.0,2020-01-09,"(851.5, 1018.75]",1,1,0
31053.0,2020-01-09,"(509.155, 721.25]",1,2,-1
31053.0,2020-01-09,"(932.5, 1143.75]",1,1,0
,,,,2.0,
31055.0,2020-01-09,"(747.5, 880.75]",1,1,0
31056.0,2020-01-09,"(982.0, 1127.0]",1,1,0
31057.0,2020-01-09,"(849.0, 1132.0]",1,1,0
31058.0,2020-01-09,"(505.5, 758.25]",1,1,0
31058.0,2020-01-09,"(758.25, 1011.0]",1,1,0
31059.0,2020-01-09,"(325.5, 330.0]",1,1,0
31060.0,2020-01-09,"(546.387, 700.25]",1,1,0
31060.0,2020-01-09,"(853.5, 1006.75]",2,4,-2
,,,,2.0,
31062.0,2020-01-09,"(560.717, 631.75]",1,2,-1
31062.0,2020-01-09,"(702.5, 773.25]",1,2,-1
31062.0,2020-01-09,"(773.25, 844.0]",1,3,-2
,,,,2.0,
31064.0,2020-01-09,"(498.487, 627.25]",1,2,-1
31064.0,2020-01-09,"(627.25, 755.5]",2,4,-2
31064.0,2020-01-09,"(883.75, 1012.0]",2,3,-1
31065.0,2020-01-09,"(718.0, 849.5]",1,1,0
31065.0,2020-01-09,"(849.5, 981.0]",1,1,0
31066.0,2020-01-09,"(810.0, 1080.0]",1,1,0
31067.0,2020-01-09,"(483.213, 680.75]",1,4,-3
31067.0,2020-01-09,"(877.5, 1074.25]",1,1,0
31067.0,2020-01-09,"(1074.25, 1271.0]",3,1,2
31068.0,2020-01-09,"(639.75, 707.5]",1,1,0
31068.0,2020-01-09,"(707.5, 775.25]",1,2,-1
31069.0,2020-01-09,"(895.0, 1128.5]",1,2,-1
31069.0,2020-01-09,"(1128.5, 1362.0]",1,2,-1
31070.0,2020-01-09,"(571.472, 704.0]",1,3,-2
31070.0,2020-01-09,"(968.0, 1100.0]",1,1,0
31071.0,2020-01-09,"(422.154, 634.5]",3,8,-5
31071.0,2020-01-09,"(634.5, 846.0]",2,4,-2
31071.0,2020-01-09,"(846.0, 1057.5]",3,5,-2
31071.0,2020-01-09,"(1057.5, 1269.0]",5,6,-1
,,,,2.0,
31073.0,2020-01-09,"(1275.25, 1361.0]",1,1,0
31074.0,2020-01-09,"(845.25, 1004.0]",1,1,0
31075.0,2020-01-09,"(971.5, 1118.0]",1,1,0
31076.0,2020-01-09,"(780.0, 1040.0]",1,1,0
31077.0,2020-01-09,"(751.5, 911.25]",1,2,-1
31077.0,2020-01-09,"(911.25, 1071.0]",1,1,0
31078.0,2020-01-09,"(444.529, 562.75]",6,6,0
31078.0,2020-01-09,"(562.75, 680.5]",1,1,0
31079.0,2020-01-09,"(714.0, 948.0]",1,8,-7
31079.0,2020-01-09,"(948.0, 1182.0]",3,3,0
31079.0,2020-01-09,"(1182.0, 1416.0]",4,3,1
31080.0,2020-01-09,"(349.001, 599.75]",1,9,-8
31080.0,2020-01-09,"(849.5, 1099.25]",2,1,1
31080.0,2020-01-09,"(1099.25, 1349.0]",6,5,1
31081.0,2020-01-09,"(463.237, 654.75]",2,2,0
31081.0,2020-01-09,"(845.5, 1036.25]",1,2,-1
31081.0,2020-01-09,"(1036.25, 1227.0]",2,4,-2
31082.0,2020-01-09,"(908.25, 1211.0]",1,1,0
31083.0,2020-01-09,"(1030.75, 1198.0]",4,2,2
31084.0,2020-01-09,"(537.178, 743.5]",6,6,0
31084.0,2020-01-09,"(743.5, 949.0]",3,4,-1
31085.0,2020-01-09,"(1016.25, 1181.0]",2,2,0
31086.0,2020-01-09,"(710.0, 795.0]",1,2,-1
31087.0,2020-01-09,"(704.75, 782.0]",1,1,0
31088.0,2020-01-09,"(504.299, 680.25]",1,4,-3
31088.0,2020-01-09,"(855.5, 1030.75]",1,1,0
31088.0,2020-01-09,"(1030.75, 1206.0]",3,3,0
31089.0,2020-01-09,"(477.141, 692.75]",7,8,-1
31089.0,2020-01-09,"(692.75, 907.5]",1,6,-5
31089.0,2020-01-09,"(907.5, 1122.25]",2,11,-9
31090.0,2020-01-09,"(589.0, 750.0]",1,1,0
31090.0,2020-01-09,"(911.0, 1072.0]",1,2,-1
31091.0,2020-01-09,"(848.0, 1053.0]",3,7,-4
31091.0,2020-01-09,"(1053.0, 1258.0]",4,3,1
31092.0,2020-01-09,"(897.5, 1107.25]",1,1,0
31092.0,2020-01-09,"(1107.25, 1317.0]",1,1,0
,,,,1.0,
,,,,1.0,
,,,,1.0,
,,,,3.0,
31094.0,2020-01-09,"(973.989, 976.75]",1,1,0
31095.0,2020-01-09,"(597.75, 797.0]",1,1,0
31096.0,2020-01-09,"(578.0, 598.0]",1,1,0
31096.0,2020-01-09,"(598.0, 618.0]",1,1,0
31097.0,2020-01-09,"(533.291, 711.25]",3,3,0
31097.0,2020-01-09,"(1065.75, 1243.0]",2,1,1
31098.0,2020-01-09,"(432.33, 600.5]",5,10,-5
31098.0,2020-01-09,"(935.5, 1103.0]",7,1,6
31099.0,2020-01-09,"(947.0, 1184.5]",2,1,1
31100.0,2020-01-09,"(387.129, 605.75]",8,10,-2
31100.0,2020-01-09,"(605.75, 823.5]",2,4,-2
31100.0,2020-01-09,"(1041.25, 1259.0]",1,4,-3
31101.0,2020-01-09,"(402.987, 657.25]",6,27,-21
31101.0,2020-01-09,"(657.25, 910.5]",7,10,-3
31101.0,2020-01-09,"(910.5, 1163.75]",32,42,-10
31101.0,2020-01-09,"(1163.75, 1417.0]",13,26,-13
31102.0,2020-01-09,"(2.577, 359.75]",1,2,-1
31102.0,2020-01-09,"(359.75, 715.5]",2,13,-11
31102.0,2020-01-09,"(715.5, 1071.25]",1,1,0
31102.0,2020-01-09,"(1071.25, 1427.0]",9,14,-5
31103.0,2020-01-09,"(435.029, 678.75]",1,21,-20
31103.0,2020-01-09,"(678.75, 921.5]",1,5,-4
31103.0,2020-01-09,"(921.5, 1164.25]",7,18,-11
31103.0,2020-01-09,"(1164.25, 1407.0]",4,11,-7
31104.0,2020-01-09,"(337.943, 603.25]",3,20,-17
31104.0,2020-01-09,"(603.25, 867.5]",2,4,-2
31104.0,2020-01-09,"(867.5, 1131.75]",19,31,-12
31104.0,2020-01-09,"(1131.75, 1396.0]",8,25,-17
31105.0,2020-01-09,"(595.25, 839.5]",1,11,-10
31105.0,2020-01-09,"(839.5, 1083.75]",2,2,0
31105.0,2020-01-09,"(1083.75, 1328.0]",4,2,2
31106.0,2020-01-09,"(856.5, 1056.75]",2,6,-4
31106.0,2020-01-09,"(1056.75, 1257.0]",7,4,3
31107.0,2020-01-09,"(395.992, 649.0]",3,21,-18
31107.0,2020-01-09,"(649.0, 901.0]",3,10,-7
31107.0,2020-01-09,"(901.0, 1153.0]",12,27,-15
31107.0,2020-01-09,"(1153.0, 1405.0]",13,18,-5
31108.0,2020-01-09,"(415.037, 656.75]",5,20,-15
31108.0,2020-01-09,"(656.75, 897.5]",7,14,-7
31108.0,2020-01-09,"(897.5, 1138.25]",12,24,-12
31108.0,2020-01-09,"(1138.25, 1379.0]",7,9,-2
31109.0,2020-01-09,"(382.953, 645.75]",4,18,-14
31109.0,2020-01-09,"(645.75, 907.5]",2,4,-2
31109.0,2020-01-09,"(907.5, 1169.25]",15,19,-4
31109.0,2020-01-09,"(1169.25, 1431.0]",2,6,-4
31110.0,2020-01-09,"(324.941, 590.75]",10,26,-16
31110.0,2020-01-09,"(590.75, 855.5]",8,14,-6
31110.0,2020-01-09,"(855.5, 1120.25]",19,35,-16
31110.0,2020-01-09,"(1120.25, 1385.0]",8,21,-13
31111.0,2020-01-09,"(334.981, 590.75]",5,13,-8
31111.0,2020-01-09,"(845.5, 1100.25]",7,3,4
31111.0,2020-01-09,"(1100.25, 1355.0]",15,15,0
31112.0,2020-01-09,"(369.269, 552.75]",1,4,-3
31112.0,2020-01-09,"(735.5, 918.25]",1,2,-1
31112.0,2020-01-09,"(918.25, 1101.0]",2,3,-1
31113.0,2020-01-09,"(556.25, 803.5]",3,20,-17
31113.0,2020-01-09,"(803.5, 1050.75]",2,12,-10
31113.0,2020-01-09,"(1050.75, 1298.0]",6,3,3
31114.0,2020-01-09,"(314.918, 586.5]",4,24,-20
31114.0,2020-01-09,"(586.5, 857.0]",2,8,-6
31114.0,2020-01-09,"(857.0, 1127.5]",14,18,-4
31114.0,2020-01-09,"(1127.5, 1398.0]",17,28,-11
31115.0,2020-01-09,"(246.856, 534.0]",2,16,-14
31115.0,2020-01-09,"(534.0, 820.0]",2,7,-5
31115.0,2020-01-09,"(820.0, 1106.0]",6,15,-9
31115.0,2020-01-09,"(1106.0, 1392.0]",11,19,-8
31116.0,2020-01-09,"(322.075, 554.25]",8,30,-22
31116.0,2020-01-09,"(554.25, 785.5]",3,4,-1
31116.0,2020-01-09,"(785.5, 1016.75]",6,12,-6
31116.0,2020-01-09,"(1016.75, 1248.0]",21,27,-6
31117.0,2020-01-09,"(339.01, 587.5]",1,14,-13
31117.0,2020-01-09,"(587.5, 835.0]",1,14,-13
31117.0,2020-01-09,"(835.0, 1082.5]",4,12,-8
31117.0,2020-01-09,"(1082.5, 1330.0]",5,8,-3
31118.0,2020-01-09,"(434.054, 671.5]",2,18,-16
31118.0,2020-01-09,"(908.0, 1144.5]",9,10,-1
31118.0,2020-01-09,"(1144.5, 1381.0]",7,7,0
31119.0,2020-01-09,"(5.614, 353.5]",1,1,0
31119.0,2020-01-09,"(353.5, 700.0]",8,26,-18
31119.0,2020-01-09,"(700.0, 1046.5]",9,14,-5
31119.0,2020-01-09,"(1046.5, 1393.0]",17,27,-10
31120.0,2020-01-09,"(427.996, 680.0]",3,14,-11
31120.0,2020-01-09,"(680.0, 931.0]",6,10,-4
31120.0,2020-01-09,"(931.0, 1182.0]",7,12,-5
31120.0,2020-01-09,"(1182.0, 1433.0]",8,10,-2
31121.0,2020-01-09,"(356.947, 621.25]",15,22,-7
31121.0,2020-01-09,"(621.25, 884.5]",2,7,-5
31121.0,2020-01-09,"(884.5, 1147.75]",6,21,-15
31121.0,2020-01-09,"(1147.75, 1411.0]",3,6,-3
31122.0,2020-01-09,"(408.02, 654.0]",1,6,-5
31122.0,2020-01-09,"(654.0, 899.0]",1,1,0
31122.0,2020-01-09,"(899.0, 1144.0]",5,9,-4
31122.0,2020-01-09,"(1144.0, 1389.0]",6,7,-1
31123.0,2020-01-09,"(867.0, 1119.0]",7,12,-5
31123.0,2020-01-09,"(1119.0, 1371.0]",4,9,-5
31124.0,2020-01-09,"(369.952, 633.0]",17,46,-29
31124.0,2020-01-09,"(633.0, 895.0]",6,15,-9
31124.0,2020-01-09,"(895.0, 1157.0]",19,41,-22
31124.0,2020-01-09,"(1157.0, 1419.0]",9,31,-22
31125.0,2020-01-09,"(296.952, 560.0]",5,25,-20
31125.0,2020-01-09,"(560.0, 822.0]",1,4,-3
31125.0,2020-01-09,"(822.0, 1084.0]",15,21,-6
31125.0,2020-01-09,"(1084.0, 1346.0]",7,11,-4
31126.0,2020-01-09,"(8.675, 341.25]",1,1,0
31126.0,2020-01-09,"(341.25, 672.5]",3,20,-17
31126.0,2020-01-09,"(672.5, 1003.75]",1,5,-4
31126.0,2020-01-09,"(1003.75, 1335.0]",22,31,-9
,,,,2.0,
31128.0,2020-01-09,"(129.695, 457.25]",5,6,-1
31128.0,2020-01-09,"(457.25, 783.5]",17,30,-13
31128.0,2020-01-09,"(783.5, 1109.75]",18,31,-13
31128.0,2020-01-09,"(1109.75, 1436.0]",7,12,-5
31129.0,2020-01-09,"(421.18, 627.0]",11,13,-2
31129.0,2020-01-09,"(627.0, 832.0]",4,7,-3
31129.0,2020-01-09,"(832.0, 1037.0]",4,5,-1
31129.0,2020-01-09,"(1037.0, 1242.0]",1,4,-3
31130.0,2020-01-09,"(440.137, 656.75]",2,12,-10
31130.0,2020-01-09,"(656.75, 872.5]",2,4,-2
31130.0,2020-01-09,"(872.5, 1088.25]",2,7,-5
31130.0,2020-01-09,"(1088.25, 1304.0]",10,17,-7
31131.0,2020-01-09,"(28.842, 319.5]",2,2,0
31131.0,2020-01-09,"(609.0, 898.5]",1,12,-11
31131.0,2020-01-09,"(898.5, 1188.0]",2,1,1
31200.0,2020-01-09,"(341.989, 595.75]",22,32,-10
31200.0,2020-01-09,"(595.75, 848.5]",10,17,-7
31200.0,2020-01-09,"(848.5, 1101.25]",23,47,-24
31200.0,2020-01-09,"(1101.25, 1354.0]",16,32,-16
31201.0,2020-01-09,"(298.91, 572.5]",17,31,-14
31201.0,2020-01-09,"(572.5, 845.0]",12,24,-12
31201.0,2020-01-09,"(845.0, 1117.5]",25,49,-24
31201.0,2020-01-09,"(1117.5, 1390.0]",20,40,-20
31202.0,2020-01-09,"(324.95, 588.5]",5,18,-13
31202.0,2020-01-09,"(588.5, 851.0]",9,15,-6
31202.0,2020-01-09,"(851.0, 1113.5]",20,28,-8
31202.0,2020-01-09,"(1113.5, 1376.0]",5,12,-7
31203.0,2020-01-09,"(365.931, 634.25]",6,27,-21
31203.0,2020-01-09,"(634.25, 901.5]",3,10,-7
31203.0,2020-01-09,"(901.5, 1168.75]",24,33,-9
31203.0,2020-01-09,"(1168.75, 1436.0]",8,15,-7
31204.0,2020-01-09,"(436.096, 663.0]",15,16,-1
31204.0,2020-01-09,"(663.0, 889.0]",3,6,-3
31204.0,2020-01-09,"(889.0, 1115.0]",1,12,-11
31204.0,2020-01-09,"(1115.0, 1341.0]",1,1,0
31205.0,2020-01-09,"(115.766, 425.5]",1,2,-1
31205.0,2020-01-09,"(425.5, 734.0]",35,38,-3
31205.0,2020-01-09,"(734.0, 1042.5]",6,11,-5
31205.0,2020-01-09,"(1042.5, 1351.0]",4,17,-13
31206.0,2020-01-09,"(387.206, 586.5]",5,6,-1
31206.0,2020-01-09,"(785.0, 983.5]",2,1,1
31206.0,2020-01-09,"(983.5, 1182.0]",1,4,-3
31207.0,2020-01-09,"(942.5, 1143.0]",2,5,-3
31208.0,2020-01-09,"(387.055, 624.25]",12,15,-3
31208.0,2020-01-09,"(624.25, 860.5]",1,1,0
31208.0,2020-01-09,"(1096.75, 1333.0]",2,9,-7
31209.0,2020-01-09,"(439.151, 652.25]",3,5,-2
31209.0,2020-01-09,"(652.25, 864.5]",1,2,-1
31209.0,2020-01-09,"(864.5, 1076.75]",2,2,0
31209.0,2020-01-09,"(1076.75, 1289.0]",3,5,-2
31211.0,2020-01-09,"(317.963, 578.25]",11,13,-2
31211.0,2020-01-09,"(578.25, 837.5]",1,3,-2
31211.0,2020-01-09,"(837.5, 1096.75]",8,13,-5
31211.0,2020-01-09,"(1096.75, 1356.0]",5,9,-4
31212.0,2020-01-09,"(343.938, 610.5]",26,37,-11
31212.0,2020-01-09,"(610.5, 876.0]",1,3,-2
31212.0,2020-01-09,"(876.0, 1141.5]",9,17,-8
31212.0,2020-01-09,"(1141.5, 1407.0]",4,9,-5
31213.0,2020-01-09,"(385.141, 600.75]",18,27,-9
31213.0,2020-01-09,"(600.75, 815.5]",1,2,-1
31213.0,2020-01-09,"(815.5, 1030.25]",5,10,-5
31213.0,2020-01-09,"(1030.25, 1245.0]",10,19,-9
31214.0,2020-01-09,"(458.03, 701.5]",8,34,-26
31214.0,2020-01-09,"(701.5, 944.0]",1,2,-1
31214.0,2020-01-09,"(944.0, 1186.5]",24,39,-15
31214.0,2020-01-09,"(1186.5, 1429.0]",9,13,-4
31215.0,2020-01-09,"(436.186, 640.5]",18,18,0
31215.0,2020-01-09,"(640.5, 844.0]",8,9,-1
31215.0,2020-01-09,"(844.0, 1047.5]",3,8,-5
31215.0,2020-01-09,"(1047.5, 1251.0]",2,10,-8
31216.0,2020-01-09,"(484.241, 674.75]",15,15,0
31216.0,2020-01-09,"(674.75, 864.5]",6,12,-6
31216.0,2020-01-09,"(864.5, 1054.25]",1,3,-2
31216.0,2020-01-09,"(1054.25, 1244.0]",1,12,-11
31217.0,2020-01-09,"(323.161, 533.75]",6,6,0
31217.0,2020-01-09,"(533.75, 743.5]",3,3,0
31217.0,2020-01-09,"(743.5, 953.25]",2,6,-4
31217.0,2020-01-09,"(953.25, 1163.0]",9,13,-4
31218.0,2020-01-09,"(357.921, 628.75]",13,27,-14
31218.0,2020-01-09,"(628.75, 898.5]",6,10,-4
31218.0,2020-01-09,"(898.5, 1168.25]",15,26,-11
31219.0,2020-01-09,"(354.148, 568.0]",8,9,-1
31219.0,2020-01-09,"(568.0, 781.0]",2,3,-1
31219.0,2020-01-09,"(781.0, 994.0]",5,12,-7
31219.0,2020-01-09,"(994.0, 1207.0]",1,4,-3
31220.0,2020-01-09,"(323.218, 519.5]",13,14,-1
31220.0,2020-01-09,"(519.5, 715.0]",5,7,-2
31220.0,2020-01-09,"(715.0, 910.5]",1,3,-2
31220.0,2020-01-09,"(910.5, 1106.0]",1,16,-15
31221.0,2020-01-09,"(380.119, 601.25]",30,34,-4
31221.0,2020-01-09,"(601.25, 821.5]",7,10,-3
31221.0,2020-01-09,"(821.5, 1041.75]",10,26,-16
31221.0,2020-01-09,"(1041.75, 1262.0]",6,22,-16
31222.0,2020-01-09,"(503.192, 706.0]",22,26,-4
31222.0,2020-01-09,"(706.0, 908.0]",3,5,-2
31222.0,2020-01-09,"(908.0, 1110.0]",2,16,-14
31222.0,2020-01-09,"(1110.0, 1312.0]",2,7,-5
31223.0,2020-01-09,"(22.745, 337.75]",1,3,-2
31223.0,2020-01-09,"(337.75, 651.5]",14,35,-21
31223.0,2020-01-09,"(651.5, 965.25]",2,11,-9
31223.0,2020-01-09,"(965.25, 1279.0]",17,28,-11
31224.0,2020-01-09,"(462.103, 687.25]",11,12,-1
31224.0,2020-01-09,"(687.25, 911.5]",10,16,-6
31224.0,2020-01-09,"(911.5, 1135.75]",2,13,-11
31225.0,2020-01-09,"(424.21, 622.5]",8,16,-8
31225.0,2020-01-09,"(622.5, 820.0]",3,4,-1
31225.0,2020-01-09,"(1017.5, 1215.0]",4,1,3
31226.0,2020-01-09,"(161.82, 458.0]",1,2,-1
31226.0,2020-01-09,"(458.0, 753.0]",6,15,-9
31226.0,2020-01-09,"(753.0, 1048.0]",3,8,-5
31226.0,2020-01-09,"(1048.0, 1343.0]",5,7,-2
31227.0,2020-01-09,"(445.122, 665.5]",21,27,-6
31227.0,2020-01-09,"(665.5, 885.0]",3,7,-4
31227.0,2020-01-09,"(885.0, 1104.5]",6,16,-10
31227.0,2020-01-09,"(1104.5, 1324.0]",4,15,-11
31228.0,2020-01-09,"(44.617, 391.75]",3,3,0
31228.0,2020-01-09,"(391.75, 737.5]",24,31,-7
31228.0,2020-01-09,"(737.5, 1083.25]",19,41,-22
31228.0,2020-01-09,"(1083.25, 1429.0]",13,27,-14
31229.0,2020-01-09,"(338.938, 605.5]",11,57,-46
31229.0,2020-01-09,"(605.5, 871.0]",10,19,-9
31229.0,2020-01-09,"(871.0, 1136.5]",20,35,-15
31229.0,2020-01-09,"(1136.5, 1402.0]",13,26,-13
31230.0,2020-01-09,"(347.25, 674.5]",35,1,34
31230.0,2020-01-09,"(674.5, 1001.75]",14,45,-31
31230.0,2020-01-09,"(1001.75, 1329.0]",8,16,-8
31231.0,2020-01-09,"(326.912, 600.0]",14,17,-3
31231.0,2020-01-09,"(600.0, 872.0]",11,18,-7
31231.0,2020-01-09,"(872.0, 1144.0]",6,18,-12
31232.0,2020-01-09,"(80.739, 397.25]",3,3,0
31232.0,2020-01-09,"(397.25, 712.5]",9,11,-2
31232.0,2020-01-09,"(712.5, 1027.75]",12,21,-9
31232.0,2020-01-09,"(1027.75, 1343.0]",12,21,-9
31233.0,2020-01-09,"(370.75, 680.5]",28,1,27
31233.0,2020-01-09,"(680.5, 990.25]",12,32,-20
31233.0,2020-01-09,"(990.25, 1300.0]",19,20,-1
31234.0,2020-01-09,"(41.643, 382.25]",2,3,-1
31234.0,2020-01-09,"(382.25, 721.5]",19,35,-16
31234.0,2020-01-09,"(721.5, 1060.75]",7,14,-7
31234.0,2020-01-09,"(1060.75, 1400.0]",11,22,-11
31235.0,2020-01-09,"(493.444, 633.0]",12,12,0
31235.0,2020-01-09,"(633.0, 772.0]",5,5,0
31236.0,2020-01-09,"(426.019, 672.25]",20,24,-4
31236.0,2020-01-09,"(672.25, 917.5]",10,14,-4
31236.0,2020-01-09,"(917.5, 1162.75]",7,26,-19
31236.0,2020-01-09,"(1162.75, 1408.0]",1,10,-9
31237.0,2020-01-09,"(119.804, 420.0]",2,2,0
31237.0,2020-01-09,"(420.0, 719.0]",9,18,-9
31237.0,2020-01-09,"(719.0, 1018.0]",8,14,-6
31237.0,2020-01-09,"(1018.0, 1317.0]",8,17,-9
31238.0,2020-01-09,"(28.841, 319.75]",1,1,0
31238.0,2020-01-09,"(319.75, 609.5]",20,22,-2
31238.0,2020-01-09,"(609.5, 899.25]",5,11,-6
31238.0,2020-01-09,"(899.25, 1189.0]",5,25,-20
31239.0,2020-01-09,"(382.065, 616.75]",25,30,-5
31239.0,2020-01-09,"(616.75, 850.5]",12,16,-4
31239.0,2020-01-09,"(850.5, 1084.25]",5,16,-11
31239.0,2020-01-09,"(1084.25, 1318.0]",6,25,-19
31240.0,2020-01-09,"(515.503, 640.25]",2,4,-2
31240.0,2020-01-09,"(888.75, 1013.0]",4,8,-4
31241.0,2020-01-09,"(324.891, 603.25]",36,65,-29
31241.0,2020-01-09,"(603.25, 880.5]",10,16,-6
31241.0,2020-01-09,"(880.5, 1157.75]",13,30,-17
31241.0,2020-01-09,"(1157.75, 1435.0]",6,15,-9
31242.0,2020-01-09,"(328.0, 619.0]",26,1,25
31242.0,2020-01-09,"(619.0, 910.0]",7,29,-22
31242.0,2020-01-09,"(910.0, 1201.0]",3,15,-12
31243.0,2020-01-09,"(352.967, 612.25]",22,31,-9
31243.0,2020-01-09,"(870.5, 1128.75]",7,1,6
31243.0,2020-01-09,"(1128.75, 1387.0]",1,22,-21
31244.0,2020-01-09,"(412.079, 643.25]",17,22,-5
31244.0,2020-01-09,"(643.25, 873.5]",3,6,-3
31244.0,2020-01-09,"(873.5, 1103.75]",6,20,-14
31244.0,2020-01-09,"(1103.75, 1334.0]",5,12,-7
31245.0,2020-01-09,"(387.082, 617.5]",9,19,-10
31245.0,2020-01-09,"(617.5, 847.0]",3,7,-4
31245.0,2020-01-09,"(847.0, 1076.5]",8,13,-5
31245.0,2020-01-09,"(1076.5, 1306.0]",8,16,-8
31246.0,2020-01-09,"(397.111, 620.25]",12,16,-4
31246.0,2020-01-09,"(620.25, 842.5]",5,9,-4
31246.0,2020-01-09,"(842.5, 1064.75]",8,13,-5
31246.0,2020-01-09,"(1064.75, 1287.0]",9,18,-9
31247.0,2020-01-09,"(425.334, 592.5]",8,13,-5
31247.0,2020-01-09,"(592.5, 759.0]",3,8,-5
31247.0,2020-01-09,"(759.0, 925.5]",10,16,-6
31247.0,2020-01-09,"(925.5, 1092.0]",7,10,-3
31248.0,2020-01-09,"(356.202, 556.5]",3,9,-6
31248.0,2020-01-09,"(556.5, 756.0]",3,3,0
31248.0,2020-01-09,"(756.0, 955.5]",8,14,-6
31248.0,2020-01-09,"(955.5, 1155.0]",4,10,-6
31249.0,2020-01-09,"(356.234, 548.5]",4,8,-4
31249.0,2020-01-09,"(548.5, 740.0]",7,12,-5
31249.0,2020-01-09,"(740.0, 931.5]",1,2,-1
31249.0,2020-01-09,"(931.5, 1123.0]",7,13,-6
31250.0,2020-01-09,"(412.042, 652.5]",18,21,-3
31250.0,2020-01-09,"(652.5, 892.0]",4,8,-4
31250.0,2020-01-09,"(892.0, 1131.5]",1,16,-15
31250.0,2020-01-09,"(1131.5, 1371.0]",2,7,-5
31251.0,2020-01-09,"(472.22, 668.0]",15,23,-8
31251.0,2020-01-09,"(668.0, 863.0]",6,10,-4
31251.0,2020-01-09,"(863.0, 1058.0]",4,10,-6
31251.0,2020-01-09,"(1058.0, 1253.0]",8,16,-8
31252.0,2020-01-09,"(489.253, 676.75]",17,18,-1
31252.0,2020-01-09,"(676.75, 863.5]",4,8,-4
31252.0,2020-01-09,"(1050.25, 1237.0]",2,8,-6
31253.0,2020-01-09,"(386.032, 629.0]",18,20,-2
31253.0,2020-01-09,"(629.0, 871.0]",1,7,-6
31253.0,2020-01-09,"(871.0, 1113.0]",5,17,-12
31253.0,2020-01-09,"(1113.0, 1355.0]",1,9,-8
31254.0,2020-01-09,"(409.098, 635.5]",28,31,-3
31254.0,2020-01-09,"(635.5, 861.0]",10,18,-8
31254.0,2020-01-09,"(861.0, 1086.5]",2,19,-17
31254.0,2020-01-09,"(1086.5, 1312.0]",1,4,-3
31255.0,2020-01-09,"(366.983, 622.25]",11,21,-10
31255.0,2020-01-09,"(622.25, 876.5]",3,8,-5
31255.0,2020-01-09,"(876.5, 1130.75]",8,29,-21
31255.0,2020-01-09,"(1130.75, 1385.0]",5,7,-2
31256.0,2020-01-09,"(265.903, 541.25]",13,14,-1
31256.0,2020-01-09,"(815.5, 1089.75]",2,8,-6
31256.0,2020-01-09,"(1089.75, 1364.0]",3,11,-8
31257.0,2020-01-09,"(331.972, 590.0]",17,29,-12
31257.0,2020-01-09,"(590.0, 847.0]",9,17,-8
31257.0,2020-01-09,"(847.0, 1104.0]",12,22,-10
31257.0,2020-01-09,"(1104.0, 1361.0]",6,15,-9
31258.0,2020-01-09,"(438.131, 656.25]",4,8,-4
31258.0,2020-01-09,"(656.25, 873.5]",2,6,-4
31258.0,2020-01-09,"(873.5, 1090.75]",5,12,-7
31258.0,2020-01-09,"(1090.75, 1308.0]",3,6,-3
31259.0,2020-01-09,"(398.287, 577.25]",10,11,-1
31259.0,2020-01-09,"(933.75, 1112.0]",1,1,0
31260.0,2020-01-09,"(372.155, 584.25]",17,20,-3
31260.0,2020-01-09,"(584.25, 795.5]",1,5,-4
31260.0,2020-01-09,"(795.5, 1006.75]",3,11,-8
31260.0,2020-01-09,"(1006.75, 1218.0]",3,14,-11
31261.0,2020-01-09,"(391.084, 621.0]",7,7,0
31261.0,2020-01-09,"(621.0, 850.0]",1,2,-1
31261.0,2020-01-09,"(850.0, 1079.0]",1,10,-9
31262.0,2020-01-09,"(417.059, 653.25]",11,11,0
31262.0,2020-01-09,"(653.25, 888.5]",3,6,-3
31262.0,2020-01-09,"(888.5, 1123.75]",1,6,-5
31263.0,2020-01-09,"(361.999, 613.25]",17,27,-10
31263.0,2020-01-09,"(613.25, 863.5]",8,17,-9
31263.0,2020-01-09,"(863.5, 1113.75]",13,31,-18
31263.0,2020-01-09,"(1113.75, 1364.0]",5,10,-5
31264.0,2020-01-09,"(455.064, 690.0]",14,17,-3
31264.0,2020-01-09,"(690.0, 924.0]",3,9,-6
31264.0,2020-01-09,"(924.0, 1158.0]",6,22,-16
31264.0,2020-01-09,"(1158.0, 1392.0]",1,3,-2
31265.0,2020-01-09,"(359.25, 714.5]",11,1,10
31265.0,2020-01-09,"(714.5, 1069.75]",11,25,-14
31265.0,2020-01-09,"(1069.75, 1425.0]",17,26,-9
31266.0,2020-01-09,"(75.737, 392.75]",1,6,-5
31266.0,2020-01-09,"(392.75, 708.5]",7,23,-16
31266.0,2020-01-09,"(708.5, 1024.25]",11,24,-13
31266.0,2020-01-09,"(1024.25, 1340.0]",23,33,-10
31267.0,2020-01-09,"(408.066, 642.5]",20,33,-13
31267.0,2020-01-09,"(642.5, 876.0]",5,13,-8
31267.0,2020-01-09,"(876.0, 1109.5]",13,28,-15
31267.0,2020-01-09,"(1109.5, 1343.0]",11,21,-10
31268.0,2020-01-09,"(30.712, 354.0]",1,2,-1
31268.0,2020-01-09,"(354.0, 676.0]",20,53,-33
31268.0,2020-01-09,"(676.0, 998.0]",9,14,-5
31268.0,2020-01-09,"(998.0, 1320.0]",23,30,-7
31269.0,2020-01-09,"(56.739, 373.25]",1,1,0
31269.0,2020-01-09,"(373.25, 688.5]",6,10,-4
31269.0,2020-01-09,"(688.5, 1003.75]",4,7,-3
31269.0,2020-01-09,"(1003.75, 1319.0]",4,12,-8
31270.0,2020-01-09,"(265.052, 503.0]",7,12,-5
31270.0,2020-01-09,"(503.0, 740.0]",11,13,-2
31270.0,2020-01-09,"(740.0, 977.0]",6,13,-7
31270.0,2020-01-09,"(977.0, 1214.0]",8,17,-9
31271.0,2020-01-09,"(383.075, 615.25]",8,8,0
31271.0,2020-01-09,"(615.25, 846.5]",1,3,-2
31271.0,2020-01-09,"(846.5, 1077.75]",4,14,-10
31271.0,2020-01-09,"(1077.75, 1309.0]",3,11,-8
31272.0,2020-01-09,"(292.023, 537.25]",15,16,-1
31272.0,2020-01-09,"(537.25, 781.5]",8,10,-2
31272.0,2020-01-09,"(781.5, 1025.75]",2,7,-5
31272.0,2020-01-09,"(1025.75, 1270.0]",5,17,-12
31273.0,2020-01-09,"(751.5, 882.75]",1,2,-1
31273.0,2020-01-09,"(882.75, 1014.0]",4,1,3
31274.0,2020-01-09,"(457.114, 679.5]",8,10,-2
31274.0,2020-01-09,"(679.5, 901.0]",2,6,-4
31274.0,2020-01-09,"(901.0, 1122.5]",6,17,-11
31274.0,2020-01-09,"(1122.5, 1344.0]",1,3,-2
31275.0,2020-01-09,"(73.781, 379.75]",1,1,0
31275.0,2020-01-09,"(379.75, 684.5]",7,17,-10
31275.0,2020-01-09,"(684.5, 989.25]",4,12,-8
31275.0,2020-01-09,"(989.25, 1294.0]",11,16,-5
31276.0,2020-01-09,"(406.077, 637.75]",22,24,-2
31276.0,2020-01-09,"(637.75, 868.5]",3,6,-3
31276.0,2020-01-09,"(868.5, 1099.25]",2,10,-8
31276.0,2020-01-09,"(1099.25, 1330.0]",4,12,-8
31277.0,2020-01-09,"(273.99, 527.5]",28,33,-5
31277.0,2020-01-09,"(527.5, 780.0]",12,13,-1
31277.0,2020-01-09,"(780.0, 1032.5]",11,23,-12
31277.0,2020-01-09,"(1032.5, 1285.0]",1,22,-21
31278.0,2020-01-09,"(369.022, 614.5]",7,31,-24
31278.0,2020-01-09,"(614.5, 859.0]",10,16,-6
31278.0,2020-01-09,"(859.0, 1103.5]",6,11,-5
31278.0,2020-01-09,"(1103.5, 1348.0]",14,17,-3
31279.0,2020-01-09,"(377.153, 589.75]",23,26,-3
31279.0,2020-01-09,"(589.75, 801.5]",1,4,-3
31279.0,2020-01-09,"(801.5, 1013.25]",8,17,-9
31279.0,2020-01-09,"(1013.25, 1225.0]",5,26,-21
31280.0,2020-01-09,"(359.06, 595.0]",4,13,-9
31280.0,2020-01-09,"(595.0, 830.0]",2,3,-1
31280.0,2020-01-09,"(830.0, 1065.0]",4,5,-1
31280.0,2020-01-09,"(1065.0, 1300.0]",15,22,-7
31000.0,2020-01-10,"(820.0, 981.0]",1,3,-2
31000.0,2020-01-10,"(981.0, 1142.0]",3,3,0
31001.0,2020-01-10,"(993.0, 1088.0]",1,2,-1
31002.0,2020-01-10,"(374.265, 558.75]",3,10,-7
31002.0,2020-01-10,"(558.75, 742.5]",3,5,-2
31002.0,2020-01-10,"(742.5, 926.25]",1,1,0
31002.0,2020-01-10,"(926.25, 1110.0]",3,8,-5
31003.0,2020-01-10,"(433.153, 645.75]",3,4,-1
31003.0,2020-01-10,"(645.75, 857.5]",1,2,-1
31003.0,2020-01-10,"(857.5, 1069.25]",1,3,-2
31003.0,2020-01-10,"(1069.25, 1281.0]",1,2,-1
31004.0,2020-01-10,"(1003.25, 1174.0]",3,1,2
31005.0,2020-01-10,"(436.205, 635.75]",4,5,-1
31005.0,2020-01-10,"(635.75, 834.5]",2,2,0
31005.0,2020-01-10,"(834.5, 1033.25]",2,4,-2
31005.0,2020-01-10,"(1033.25, 1232.0]",3,11,-8
31006.0,2020-01-10,"(518.437, 659.75]",1,2,-1
31006.0,2020-01-10,"(659.75, 800.5]",1,1,0
31007.0,2020-01-10,"(412.244, 602.0]",5,9,-4
31007.0,2020-01-10,"(602.0, 791.0]",1,3,-2
31007.0,2020-01-10,"(791.0, 980.0]",3,3,0
31007.0,2020-01-10,"(980.0, 1169.0]",9,18,-9
31009.0,2020-01-10,"(489.451, 627.25]",2,2,0
31009.0,2020-01-10,"(901.75, 1039.0]",1,1,0
31010.0,2020-01-10,"(448.013, 695.75]",2,2,0
31010.0,2020-01-10,"(695.75, 942.5]",2,4,-2
31010.0,2020-01-10,"(942.5, 1189.25]",1,1,0
31010.0,2020-01-10,"(1189.25, 1436.0]",1,3,-2
31011.0,2020-01-10,"(377.269, 560.75]",4,4,0
31011.0,2020-01-10,"(743.5, 926.25]",1,1,0
31011.0,2020-01-10,"(926.25, 1109.0]",2,1,1
31012.0,2020-01-10,"(484.456, 621.0]",2,2,0
31012.0,2020-01-10,"(893.0, 1029.0]",1,4,-3
31013.0,2020-01-10,"(597.75, 805.5]",3,1,2
31013.0,2020-01-10,"(805.5, 1013.25]",1,5,-4
31013.0,2020-01-10,"(1013.25, 1221.0]",3,3,0
31014.0,2020-01-10,"(399.99, 653.5]",16,21,-5
31014.0,2020-01-10,"(653.5, 906.0]",4,7,-3
31014.0,2020-01-10,"(906.0, 1158.5]",10,26,-16
31014.0,2020-01-10,"(1158.5, 1411.0]",3,6,-3
31015.0,2020-01-10,"(304.914, 577.5]",14,17,-3
31015.0,2020-01-10,"(577.5, 849.0]",3,6,-3
31015.0,2020-01-10,"(849.0, 1120.5]",5,10,-5
31015.0,2020-01-10,"(1120.5, 1392.0]",4,6,-2
31016.0,2020-01-10,"(774.401, 924.75]",1,2,-1
31016.0,2020-01-10,"(924.75, 1074.5]",3,4,-1
31016.0,2020-01-10,"(1074.5, 1224.25]",1,1,0
31016.0,2020-01-10,"(1224.25, 1374.0]",1,3,-2
31017.0,2020-01-10,"(423.099, 649.25]",2,4,-2
31017.0,2020-01-10,"(649.25, 874.5]",1,2,-1
31017.0,2020-01-10,"(874.5, 1099.75]",1,6,-5
31017.0,2020-01-10,"(1099.75, 1325.0]",1,3,-2
31018.0,2020-01-10,"(987.25, 1173.0]",1,3,-2
31019.0,2020-01-10,"(449.119, 670.25]",1,2,-1
31019.0,2020-01-10,"(890.5, 1110.75]",1,4,-3
31019.0,2020-01-10,"(1110.75, 1331.0]",1,3,-2
31020.0,2020-01-10,"(546.141, 761.75]",1,2,-1
31020.0,2020-01-10,"(761.75, 976.5]",2,2,0
31020.0,2020-01-10,"(976.5, 1191.25]",1,3,-2
31020.0,2020-01-10,"(1191.25, 1406.0]",1,3,-2
31021.0,2020-01-10,"(372.079, 603.25]",2,5,-3
31021.0,2020-01-10,"(603.25, 833.5]",1,2,-1
31021.0,2020-01-10,"(1063.75, 1294.0]",3,2,1
31022.0,2020-01-10,"(510.286, 689.5]",2,6,-4
31022.0,2020-01-10,"(689.5, 868.0]",2,4,-2
31022.0,2020-01-10,"(868.0, 1046.5]",2,6,-4
31022.0,2020-01-10,"(1046.5, 1225.0]",1,6,-5
31023.0,2020-01-10,"(415.023, 660.25]",3,4,-1
31023.0,2020-01-10,"(904.5, 1148.75]",3,3,0
31023.0,2020-01-10,"(1148.75, 1393.0]",1,2,-1
31024.0,2020-01-10,"(394.985, 649.75]",8,14,-6
31024.0,2020-01-10,"(649.75, 903.5]",1,2,-1
31024.0,2020-01-10,"(903.5, 1157.25]",3,14,-11
31024.0,2020-01-10,"(1157.25, 1411.0]",1,4,-3
31025.0,2020-01-10,"(719.307, 893.25]",2,4,-2
31025.0,2020-01-10,"(893.25, 1066.5]",2,5,-3
31025.0,2020-01-10,"(1239.75, 1413.0]",1,1,0
31026.0,2020-01-10,"(737.437, 878.75]",1,2,-1
31026.0,2020-01-10,"(1019.5, 1160.25]",1,1,0
31026.0,2020-01-10,"(1160.25, 1301.0]",1,2,-1
31027.0,2020-01-10,"(957.52, 1078.0]",2,3,-1
31027.0,2020-01-10,"(1318.0, 1438.0]",1,1,0
31028.0,2020-01-10,"(419.166, 628.5]",2,3,-1
31028.0,2020-01-10,"(837.0, 1045.5]",1,2,-1
31028.0,2020-01-10,"(1045.5, 1254.0]",1,4,-3
31029.0,2020-01-10,"(902.5, 1098.25]",3,7,-4
31029.0,2020-01-10,"(1098.25, 1294.0]",3,4,-1
31030.0,2020-01-10,"(828.5, 987.25]",3,4,-1
31030.0,2020-01-10,"(987.25, 1146.0]",3,1,2
31031.0,2020-01-10,"(902.5, 1129.75]",4,3,1
31031.0,2020-01-10,"(1129.75, 1357.0]",2,9,-7
31032.0,2020-01-10,"(844.5, 968.0]",1,1,0
31033.0,2020-01-10,"(521.723, 591.25]",1,1,0
31034.0,2020-01-10,"(481.255, 668.25]",1,3,-2
31034.0,2020-01-10,"(854.5, 1040.75]",1,1,0
31034.0,2020-01-10,"(1040.75, 1227.0]",2,1,1
31035.0,2020-01-10,"(442.059, 678.25]",1,5,-4
31035.0,2020-01-10,"(913.5, 1148.75]",2,1,1
31035.0,2020-01-10,"(1148.75, 1384.0]",2,2,0
31036.0,2020-01-10,"(801.5, 996.75]",1,5,-4
31036.0,2020-01-10,"(996.75, 1192.0]",6,1,5
31037.0,2020-01-10,"(416.203, 616.25]",13,16,-3
31037.0,2020-01-10,"(616.25, 815.5]",1,1,0
31037.0,2020-01-10,"(815.5, 1014.75]",2,4,-2
31037.0,2020-01-10,"(1014.75, 1214.0]",4,23,-19
31038.0,2020-01-10,"(847.797, 898.75]",1,1,0
31038.0,2020-01-10,"(1000.25, 1051.0]",1,2,-1
31039.0,2020-01-10,"(398.112, 621.0]",3,6,-3
31039.0,2020-01-10,"(621.0, 843.0]",1,2,-1
31039.0,2020-01-10,"(843.0, 1065.0]",2,8,-6
31039.0,2020-01-10,"(1065.0, 1287.0]",1,2,-1
31040.0,2020-01-10,"(452.274, 634.5]",1,1,0
31040.0,2020-01-10,"(634.5, 816.0]",2,3,-1
31041.0,2020-01-10,"(847.739, 913.25]",1,1,0
31041.0,2020-01-10,"(1043.75, 1109.0]",1,1,0
31042.0,2020-01-10,"(461.113, 683.75]",7,9,-2
31042.0,2020-01-10,"(683.75, 905.5]",1,2,-1
31042.0,2020-01-10,"(905.5, 1127.25]",2,9,-7
31042.0,2020-01-10,"(1127.25, 1349.0]",1,3,-2
31043.0,2020-01-10,"(509.443, 649.25]",1,1,0
31043.0,2020-01-10,"(649.25, 788.5]",1,2,-1
31044.0,2020-01-10,"(560.316, 732.0]",2,2,0
31044.0,2020-01-10,"(732.0, 903.0]",1,1,0
31044.0,2020-01-10,"(903.0, 1074.0]",1,3,-2
31044.0,2020-01-10,"(1074.0, 1245.0]",3,4,-1
31045.0,2020-01-10,"(597.344, 762.0]",2,3,-1
31045.0,2020-01-10,"(1090.0, 1254.0]",2,2,0
31046.0,2020-01-10,"(399.364, 559.0]",1,3,-2
31046.0,2020-01-10,"(877.0, 1036.0]",1,1,0
31047.0,2020-01-10,"(413.092, 641.0]",5,10,-5
31047.0,2020-01-10,"(641.0, 868.0]",4,9,-5
31047.0,2020-01-10,"(868.0, 1095.0]",7,9,-2
31047.0,2020-01-10,"(1095.0, 1322.0]",3,9,-6
31048.0,2020-01-10,"(718.75, 930.5]",4,1,3
31048.0,2020-01-10,"(930.5, 1142.25]",4,6,-2
31048.0,2020-01-10,"(1142.25, 1354.0]",1,7,-6
31049.0,2020-01-10,"(454.069, 687.75]",2,5,-3
31049.0,2020-01-10,"(687.75, 920.5]",1,2,-1
31049.0,2020-01-10,"(1153.25, 1386.0]",1,2,-1
31050.0,2020-01-10,"(796.5, 1062.0]",2,1,1
31051.0,2020-01-10,"(805.0, 1056.0]",4,5,-1
31051.0,2020-01-10,"(1056.0, 1307.0]",4,1,3
31052.0,2020-01-10,"(467.253, 654.75]",3,4,-1
31052.0,2020-01-10,"(654.75, 841.5]",1,2,-1
31052.0,2020-01-10,"(1028.25, 1215.0]",3,6,-3
,,,,1.0,
,,,,2.0,
,,,,2.0,
31055.0,2020-01-10,"(403.343, 568.25]",1,1,0
31055.0,2020-01-10,"(732.5, 896.75]",1,1,0
31055.0,2020-01-10,"(896.75, 1061.0]",3,6,-3
31056.0,2020-01-10,"(20.973, 278.75]",1,1,0
31056.0,2020-01-10,"(792.25, 1049.0]",4,1,3
31057.0,2020-01-10,"(604.5, 806.0]",1,1,0
31058.0,2020-01-10,"(803.25, 1071.0]",1,1,0
31059.0,2020-01-10,"(792.75, 1057.0]",2,1,1
31060.0,2020-01-10,"(280.5, 551.0]",1,1,0
31060.0,2020-01-10,"(551.0, 821.5]",1,1,0
31061.0,2020-01-10,"(525.75, 701.0]",1,1,0
31062.0,2020-01-10,"(520.431, 663.25]",2,4,-2
31062.0,2020-01-10,"(947.75, 1090.0]",8,1,7
,,,,2.0,
31064.0,2020-01-10,"(850.696, 927.0]",2,4,-2
31064.0,2020-01-10,"(927.0, 1003.0]",2,2,0
31064.0,2020-01-10,"(1003.0, 1079.0]",3,8,-5
31064.0,2020-01-10,"(1079.0, 1155.0]",3,6,-3
31065.0,2020-01-10,"(774.5, 977.25]",1,1,0
31065.0,2020-01-10,"(977.25, 1180.0]",4,1,3
31066.0,2020-01-10,"(531.834, 573.5]",1,1,0
31067.0,2020-01-10,"(417.177, 623.75]",1,5,-4
31067.0,2020-01-10,"(623.75, 829.5]",3,3,0
31067.0,2020-01-10,"(829.5, 1035.25]",2,5,-3
31067.0,2020-01-10,"(1035.25, 1241.0]",2,2,0
31068.0,2020-01-10,"(954.0, 1137.0]",2,1,1
31068.0,2020-01-10,"(1137.0, 1320.0]",1,2,-1
31069.0,2020-01-10,"(853.0, 1043.5]",1,2,-1
31069.0,2020-01-10,"(1043.5, 1234.0]",4,1,3
31070.0,2020-01-10,"(574.248, 763.0]",2,7,-5
31070.0,2020-01-10,"(763.0, 951.0]",2,2,0
31070.0,2020-01-10,"(1139.0, 1327.0]",1,1,0
31071.0,2020-01-10,"(444.189, 647.75]",3,7,-4
31071.0,2020-01-10,"(647.75, 850.5]",2,7,-5
31071.0,2020-01-10,"(850.5, 1053.25]",3,6,-3
31071.0,2020-01-10,"(1053.25, 1256.0]",7,10,-3
,,,,2.0,
31073.0,2020-01-10,"(495.801, 545.75]",1,2,-1
31073.0,2020-01-10,"(645.25, 695.0]",1,1,0
31074.0,2020-01-10,"(820.0, 987.0]",2,1,1
31074.0,2020-01-10,"(987.0, 1154.0]",3,4,-1
31075.0,2020-01-10,"(1065.75, 1271.0]",1,2,-1
31076.0,2020-01-10,"(981.25, 1145.0]",1,1,0
31077.0,2020-01-10,"(523.13, 741.5]",3,7,-4
31077.0,2020-01-10,"(741.5, 959.0]",1,2,-1
31077.0,2020-01-10,"(959.0, 1176.5]",4,5,-1
31077.0,2020-01-10,"(1176.5, 1394.0]",1,1,0
31078.0,2020-01-10,"(481.54, 597.0]",3,3,0
31079.0,2020-01-10,"(447.119, 668.25]",2,6,-4
31079.0,2020-01-10,"(1108.75, 1329.0]",3,1,2
31080.0,2020-01-10,"(903.0, 1140.5]",7,8,-1
31080.0,2020-01-10,"(1140.5, 1378.0]",4,10,-6
31081.0,2020-01-10,"(491.241, 681.75]",1,1,0
31081.0,2020-01-10,"(681.75, 871.5]",1,5,-4
31081.0,2020-01-10,"(871.5, 1061.25]",2,2,0
31081.0,2020-01-10,"(1061.25, 1251.0]",1,3,-2
,,,,2.0,
31083.0,2020-01-10,"(616.5, 823.0]",1,5,-4
31083.0,2020-01-10,"(823.0, 1029.5]",3,1,2
31083.0,2020-01-10,"(1029.5, 1236.0]",3,4,-1
31084.0,2020-01-10,"(508.216, 705.0]",4,4,0
31084.0,2020-01-10,"(705.0, 901.0]",1,2,-1
31084.0,2020-01-10,"(901.0, 1097.0]",1,2,-1
31084.0,2020-01-10,"(1097.0, 1293.0]",3,9,-6
31085.0,2020-01-10,"(405.087, 634.25]",1,4,-3
31085.0,2020-01-10,"(862.5, 1090.75]",1,2,-1
31085.0,2020-01-10,"(1090.75, 1319.0]",3,6,-3
31086.0,2020-01-10,"(988.5, 1180.0]",3,2,1
31087.0,2020-01-10,"(759.0, 903.5]",1,3,-2
31087.0,2020-01-10,"(903.5, 1048.0]",2,2,0
31088.0,2020-01-10,"(732.5, 899.75]",1,1,0
31088.0,2020-01-10,"(899.75, 1067.0]",3,1,2
31089.0,2020-01-10,"(478.123, 698.25]",5,7,-2
31089.0,2020-01-10,"(698.25, 917.5]",4,7,-3
31089.0,2020-01-10,"(917.5, 1136.75]",4,11,-7
31089.0,2020-01-10,"(1136.75, 1356.0]",1,6,-5
31090.0,2020-01-10,"(601.5, 780.0]",1,1,0
31090.0,2020-01-10,"(780.0, 958.5]",1,2,-1
31090.0,2020-01-10,"(958.5, 1137.0]",2,1,1
31091.0,2020-01-10,"(95.041, 335.75]",1,1,0
31091.0,2020-01-10,"(815.25, 1055.0]",3,4,-1
31092.0,2020-01-10,"(899.5, 1144.75]",3,4,-1
31092.0,2020-01-10,"(1144.75, 1390.0]",1,3,-2
,,,,1.0,
,,,,3.0,
31094.0,2020-01-10,"(500.25, 667.0]",1,1,0
,,,,1.0,
,,,,1.0,
31096.0,2020-01-10,"(870.745, 934.75]",2,2,0
31096.0,2020-01-10,"(1062.25, 1126.0]",1,1,0
31097.0,2020-01-10,"(539.236, 731.0]",3,3,0
31097.0,2020-01-10,"(731.0, 922.0]",1,1,0
31097.0,2020-01-10,"(1113.0, 1304.0]",1,3,-2
31098.0,2020-01-10,"(460.273, 642.75]",4,13,-9
31098.0,2020-01-10,"(642.75, 824.5]",1,3,-2
31098.0,2020-01-10,"(824.5, 1006.25]",2,3,-1
31098.0,2020-01-10,"(1006.25, 1188.0]",6,10,-4
,,,,1.0,
,,,,3.0,
,,,,2.0,
31100.0,2020-01-10,"(478.281, 658.75]",15,16,-1
31100.0,2020-01-10,"(838.5, 1018.25]",2,2,0
31101.0,2020-01-10,"(344.909, 618.75]",4,22,-18
31101.0,2020-01-10,"(618.75, 891.5]",4,14,-10
31101.0,2020-01-10,"(891.5, 1164.25]",30,46,-16
31101.0,2020-01-10,"(1164.25, 1437.0]",11,24,-13
31102.0,2020-01-10,"(385.019, 631.25]",2,9,-7
31102.0,2020-01-10,"(631.25, 876.5]",1,2,-1
31102.0,2020-01-10,"(876.5, 1121.75]",11,13,-2
31102.0,2020-01-10,"(1121.75, 1367.0]",5,10,-5
31103.0,2020-01-10,"(14.58, 371.0]",2,5,-3
31103.0,2020-01-10,"(371.0, 726.0]",1,29,-28
31103.0,2020-01-10,"(726.0, 1081.0]",5,8,-3
31103.0,2020-01-10,"(1081.0, 1436.0]",7,17,-10
31104.0,2020-01-10,"(361.0, 720.0]",5,2,3
31104.0,2020-01-10,"(720.0, 1079.0]",12,21,-9
31104.0,2020-01-10,"(1079.0, 1438.0]",27,23,4
31105.0,2020-01-10,"(30.722, 351.5]",1,1,0
31105.0,2020-01-10,"(351.5, 671.0]",2,15,-13
31105.0,2020-01-10,"(671.0, 990.5]",2,10,-8
31105.0,2020-01-10,"(990.5, 1310.0]",2,4,-2
31106.0,2020-01-10,"(398.034, 640.5]",1,7,-6
31106.0,2020-01-10,"(882.0, 1123.5]",4,1,3
31106.0,2020-01-10,"(1123.5, 1365.0]",1,9,-8
31107.0,2020-01-10,"(2.631, 346.25]",1,3,-2
31107.0,2020-01-10,"(346.25, 688.5]",3,22,-19
31107.0,2020-01-10,"(688.5, 1030.75]",8,19,-11
31107.0,2020-01-10,"(1030.75, 1373.0]",22,39,-17
31108.0,2020-01-10,"(372.943, 638.25]",4,21,-17
31108.0,2020-01-10,"(638.25, 902.5]",11,18,-7
31108.0,2020-01-10,"(902.5, 1166.75]",14,23,-9
31108.0,2020-01-10,"(1166.75, 1431.0]",8,12,-4
31109.0,2020-01-10,"(1.567, 361.25]",2,4,-2
31109.0,2020-01-10,"(361.25, 719.5]",8,29,-21
31109.0,2020-01-10,"(719.5, 1077.75]",21,30,-9
31109.0,2020-01-10,"(1077.75, 1436.0]",15,33,-18
31110.0,2020-01-10,"(322.95, 586.5]",16,33,-17
31110.0,2020-01-10,"(586.5, 849.0]",9,16,-7
31110.0,2020-01-10,"(849.0, 1111.5]",17,32,-15
31110.0,2020-01-10,"(1111.5, 1374.0]",11,22,-11
31111.0,2020-01-10,"(32.655, 370.25]",1,1,0
31111.0,2020-01-10,"(370.25, 706.5]",7,24,-17
31111.0,2020-01-10,"(706.5, 1042.75]",15,22,-7
31111.0,2020-01-10,"(1042.75, 1379.0]",12,22,-10
31112.0,2020-01-10,"(316.279, 497.25]",1,2,-1
31112.0,2020-01-10,"(497.25, 677.5]",1,4,-3
31112.0,2020-01-10,"(857.75, 1038.0]",3,4,-1
31113.0,2020-01-10,"(325.955, 588.25]",1,18,-17
31113.0,2020-01-10,"(849.5, 1110.75]",4,6,-2
31113.0,2020-01-10,"(1110.75, 1372.0]",4,9,-5
31114.0,2020-01-10,"(26.601, 377.75]",4,5,-1
31114.0,2020-01-10,"(377.75, 727.5]",3,26,-23
31114.0,2020-01-10,"(727.5, 1077.25]",16,23,-7
31114.0,2020-01-10,"(1077.25, 1427.0]",25,37,-12
31115.0,2020-01-10,"(232.837, 524.75]",3,19,-16
31115.0,2020-01-10,"(815.5, 1106.25]",7,1,6
31115.0,2020-01-10,"(1106.25, 1397.0]",12,16,-4
31116.0,2020-01-10,"(366.99, 620.5]",5,26,-21
31116.0,2020-01-10,"(620.5, 873.0]",5,9,-4
31116.0,2020-01-10,"(873.0, 1125.5]",19,23,-4
31116.0,2020-01-10,"(1125.5, 1378.0]",5,14,-9
31117.0,2020-01-10,"(304.916, 577.0]",4,20,-16
31117.0,2020-01-10,"(577.0, 848.0]",2,6,-4
31117.0,2020-01-10,"(848.0, 1119.0]",5,19,-14
31117.0,2020-01-10,"(1119.0, 1390.0]",4,13,-9
31118.0,2020-01-10,"(318.882, 599.5]",1,16,-15
31118.0,2020-01-10,"(879.0, 1158.5]",13,1,12
31118.0,2020-01-10,"(1158.5, 1438.0]",5,17,-12
31119.0,2020-01-10,"(350.989, 604.75]",13,35,-22
31119.0,2020-01-10,"(604.75, 857.5]",6,9,-3
31119.0,2020-01-10,"(857.5, 1110.25]",18,30,-12
31119.0,2020-01-10,"(1110.25, 1363.0]",11,23,-12
31120.0,2020-01-10,"(462.077, 693.75]",1,15,-14
31120.0,2020-01-10,"(693.75, 924.5]",2,4,-2
31120.0,2020-01-10,"(924.5, 1155.25]",14,16,-2
31120.0,2020-01-10,"(1155.25, 1386.0]",6,11,-5
31121.0,2020-01-10,"(414.163, 624.25]",19,24,-5
31121.0,2020-01-10,"(833.5, 1042.75]",3,4,-1
31121.0,2020-01-10,"(1042.75, 1252.0]",5,7,-2
31122.0,2020-01-10,"(450.038, 691.5]",1,9,-8
31122.0,2020-01-10,"(691.5, 932.0]",1,1,0
31122.0,2020-01-10,"(932.0, 1172.5]",7,14,-7
31122.0,2020-01-10,"(1172.5, 1413.0]",4,8,-4
31123.0,2020-01-10,"(635.25, 900.5]",1,21,-20
31123.0,2020-01-10,"(900.5, 1165.75]",5,1,4
31123.0,2020-01-10,"(1165.75, 1431.0]",5,10,-5
31124.0,2020-01-10,"(9.596, 362.0]",2,2,0
31124.0,2020-01-10,"(362.0, 713.0]",15,52,-37
31124.0,2020-01-10,"(713.0, 1064.0]",15,46,-31
31124.0,2020-01-10,"(1064.0, 1415.0]",16,57,-41
31125.0,2020-01-10,"(352.914, 625.5]",3,25,-22
31125.0,2020-01-10,"(625.5, 897.0]",8,14,-6
31125.0,2020-01-10,"(897.0, 1168.5]",22,27,-5
31125.0,2020-01-10,"(1168.5, 1440.0]",11,17,-6
31126.0,2020-01-10,"(349.026, 593.5]",4,24,-20
31126.0,2020-01-10,"(593.5, 837.0]",6,13,-7
31126.0,2020-01-10,"(837.0, 1080.5]",8,15,-7
31126.0,2020-01-10,"(1080.5, 1324.0]",10,18,-8
,,,,2.0,
31128.0,2020-01-10,"(157.752, 471.0]",6,7,-1
31128.0,2020-01-10,"(471.0, 783.0]",17,31,-14
31128.0,2020-01-10,"(783.0, 1095.0]",10,22,-12
31128.0,2020-01-10,"(1095.0, 1407.0]",8,17,-9
31129.0,2020-01-10,"(477.212, 675.0]",7,9,-2
31129.0,2020-01-10,"(675.0, 872.0]",8,10,-2
31129.0,2020-01-10,"(872.0, 1069.0]",4,9,-5
31129.0,2020-01-10,"(1069.0, 1266.0]",8,11,-3
31130.0,2020-01-10,"(83.778, 390.5]",1,4,-3
31130.0,2020-01-10,"(390.5, 696.0]",8,20,-12
31130.0,2020-01-10,"(696.0, 1001.5]",3,8,-5
31130.0,2020-01-10,"(1001.5, 1307.0]",10,16,-6
31131.0,2020-01-10,"(618.75, 868.5]",1,7,-6
31131.0,2020-01-10,"(868.5, 1118.25]",5,2,3
31131.0,2020-01-10,"(1118.25, 1368.0]",3,8,-5
31200.0,2020-01-10,"(334.953, 597.75]",14,25,-11
31200.0,2020-01-10,"(597.75, 859.5]",4,10,-6
31200.0,2020-01-10,"(859.5, 1121.25]",20,39,-19
31200.0,2020-01-10,"(1121.25, 1383.0]",11,22,-11
31201.0,2020-01-10,"(298.878, 580.5]",20,41,-21
31201.0,2020-01-10,"(580.5, 861.0]",22,38,-16
31201.0,2020-01-10,"(861.0, 1141.5]",29,57,-28
31201.0,2020-01-10,"(1141.5, 1422.0]",18,40,-22
31202.0,2020-01-10,"(338.929, 607.75]",9,24,-15
31202.0,2020-01-10,"(607.75, 875.5]",9,15,-6
31202.0,2020-01-10,"(875.5, 1143.25]",24,38,-14
31202.0,2020-01-10,"(1143.25, 1411.0]",9,19,-10
31203.0,2020-01-10,"(81.662, 417.5]",2,4,-2
31203.0,2020-01-10,"(417.5, 752.0]",14,40,-26
31203.0,2020-01-10,"(752.0, 1086.5]",33,53,-20
31203.0,2020-01-10,"(1086.5, 1421.0]",33,58,-25
31204.0,2020-01-10,"(50.68, 382.0]",1,1,0
31204.0,2020-01-10,"(382.0, 712.0]",12,14,-2
31204.0,2020-01-10,"(712.0, 1042.0]",8,17,-9
31204.0,2020-01-10,"(1042.0, 1372.0]",4,16,-12
31205.0,2020-01-10,"(92.699, 419.25]",1,3,-2
31205.0,2020-01-10,"(419.25, 744.5]",18,22,-4
31205.0,2020-01-10,"(744.5, 1069.75]",11,27,-16
31205.0,2020-01-10,"(1069.75, 1395.0]",7,15,-8
31206.0,2020-01-10,"(401.332, 569.0]",2,2,0
31206.0,2020-01-10,"(569.0, 736.0]",2,2,0
31206.0,2020-01-10,"(903.0, 1070.0]",1,1,0
31207.0,2020-01-10,"(547.373, 704.75]",1,2,-1
31207.0,2020-01-10,"(1018.25, 1175.0]",1,1,0
31208.0,2020-01-10,"(779.43, 922.5]",1,6,-5
31208.0,2020-01-10,"(922.5, 1065.0]",2,7,-5
31208.0,2020-01-10,"(1065.0, 1207.5]",2,3,-1
31208.0,2020-01-10,"(1207.5, 1350.0]",1,2,-1
31209.0,2020-01-10,"(483.43, 626.5]",2,3,-1
31209.0,2020-01-10,"(911.5, 1054.0]",1,2,-1
31211.0,2020-01-10,"(393.035, 635.25]",7,9,-2
31211.0,2020-01-10,"(635.25, 876.5]",2,6,-4
31211.0,2020-01-10,"(876.5, 1117.75]",5,6,-1
31211.0,2020-01-10,"(1117.75, 1359.0]",3,12,-9
31212.0,2020-01-10,"(51.675, 384.25]",2,3,-1
31212.0,2020-01-10,"(384.25, 715.5]",35,50,-15
31212.0,2020-01-10,"(715.5, 1046.75]",19,40,-21
31212.0,2020-01-10,"(1046.75, 1378.0]",14,30,-16
31213.0,2020-01-10,"(333.002, 583.5]",16,25,-9
31213.0,2020-01-10,"(583.5, 833.0]",9,18,-9
31213.0,2020-01-10,"(833.0, 1082.5]",8,22,-14
31213.0,2020-01-10,"(1082.5, 1332.0]",9,13,-4
31214.0,2020-01-10,"(133.713, 456.75]",1,4,-3
31214.0,2020-01-10,"(456.75, 778.5]",16,41,-25
31214.0,2020-01-10,"(778.5, 1100.25]",23,39,-16
31214.0,2020-01-10,"(1100.25, 1422.0]",25,34,-9
31215.0,2020-01-10,"(444.054, 681.5]",13,15,-2
31215.0,2020-01-10,"(681.5, 918.0]",12,14,-2
31215.0,2020-01-10,"(918.0, 1154.5]",10,15,-5
31215.0,2020-01-10,"(1154.5, 1391.0]",2,6,-4
31216.0,2020-01-10,"(418.175, 625.25]",12,14,-2
31216.0,2020-01-10,"(625.25, 831.5]",3,5,-2
31216.0,2020-01-10,"(831.5, 1037.75]",2,5,-3
31216.0,2020-01-10,"(1037.75, 1244.0]",3,14,-11
31217.0,2020-01-10,"(339.181, 544.75]",7,8,-1
31217.0,2020-01-10,"(544.75, 749.5]",4,7,-3
31217.0,2020-01-10,"(749.5, 954.25]",3,6,-3
31218.0,2020-01-10,"(379.143, 594.25]",16,32,-16
31218.0,2020-01-10,"(594.25, 808.5]",4,6,-2
31218.0,2020-01-10,"(808.5, 1022.75]",8,14,-6
31218.0,2020-01-10,"(1022.75, 1237.0]",2,8,-6
31219.0,2020-01-10,"(421.286, 600.5]",6,7,-1
31219.0,2020-01-10,"(600.5, 779.0]",4,5,-1
31219.0,2020-01-10,"(779.0, 957.5]",2,6,-4
31219.0,2020-01-10,"(957.5, 1136.0]",3,9,-6
31220.0,2020-01-10,"(295.252, 483.0]",9,12,-3
31220.0,2020-01-10,"(483.0, 670.0]",10,12,-2
31220.0,2020-01-10,"(670.0, 857.0]",3,7,-4
31221.0,2020-01-10,"(448.106, 672.5]",30,36,-6
31221.0,2020-01-10,"(672.5, 896.0]",9,16,-7
31221.0,2020-01-10,"(896.0, 1119.5]",10,39,-29
31221.0,2020-01-10,"(1119.5, 1343.0]",2,7,-5
31222.0,2020-01-10,"(515.306, 689.5]",16,17,-1
31222.0,2020-01-10,"(689.5, 863.0]",4,8,-4
31222.0,2020-01-10,"(863.0, 1036.5]",4,12,-8
31222.0,2020-01-10,"(1036.5, 1210.0]",4,13,-9
31223.0,2020-01-10,"(42.661, 378.75]",1,2,-1
31223.0,2020-01-10,"(378.75, 713.5]",13,33,-20
31223.0,2020-01-10,"(713.5, 1048.25]",12,23,-11
31223.0,2020-01-10,"(1048.25, 1383.0]",17,36,-19
31224.0,2020-01-10,"(378.999, 630.25]",18,19,-1
31224.0,2020-01-10,"(630.25, 880.5]",3,6,-3
31224.0,2020-01-10,"(880.5, 1130.75]",5,19,-14
31224.0,2020-01-10,"(1130.75, 1381.0]",1,6,-5
31225.0,2020-01-10,"(387.956, 650.0]",9,16,-7
31225.0,2020-01-10,"(650.0, 911.0]",4,8,-4
31225.0,2020-01-10,"(911.0, 1172.0]",13,25,-12
31225.0,2020-01-10,"(1172.0, 1433.0]",2,5,-3
31226.0,2020-01-10,"(464.041, 704.75]",3,9,-6
31226.0,2020-01-10,"(704.75, 944.5]",1,1,0
31226.0,2020-01-10,"(944.5, 1184.25]",5,9,-4
31227.0,2020-01-10,"(441.17, 649.5]",28,31,-3
31227.0,2020-01-10,"(649.5, 857.0]",5,11,-6
31227.0,2020-01-10,"(857.0, 1064.5]",6,22,-16
31227.0,2020-01-10,"(1064.5, 1272.0]",3,11,-8
31228.0,2020-01-10,"(385.75, 733.5]",20,1,19
31228.0,2020-01-10,"(733.5, 1081.25]",10,29,-19
31228.0,2020-01-10,"(1081.25, 1429.0]",19,21,-2
31229.0,2020-01-10,"(351.916, 624.0]",15,48,-33
31229.0,2020-01-10,"(624.0, 895.0]",12,34,-22
31229.0,2020-01-10,"(895.0, 1166.0]",31,50,-19
31229.0,2020-01-10,"(1166.0, 1437.0]",16,30,-14
31230.0,2020-01-10,"(363.061, 598.75]",40,49,-9
31230.0,2020-01-10,"(598.75, 833.5]",10,17,-7
31230.0,2020-01-10,"(833.5, 1068.25]",12,22,-10
31230.0,2020-01-10,"(1068.25, 1303.0]",12,28,-16
31231.0,2020-01-10,"(360.946, 625.5]",14,18,-4
31231.0,2020-01-10,"(625.5, 889.0]",8,19,-11
31231.0,2020-01-10,"(889.0, 1152.5]",9,17,-8
31232.0,2020-01-10,"(105.767, 415.25]",5,6,-1
31232.0,2020-01-10,"(415.25, 723.5]",22,29,-7
31232.0,2020-01-10,"(723.5, 1031.75]",10,24,-14
31232.0,2020-01-10,"(1031.75, 1340.0]",22,48,-26
31233.0,2020-01-10,"(2.572, 361.0]",2,2,0
31233.0,2020-01-10,"(361.0, 718.0]",39,45,-6
31233.0,2020-01-10,"(718.0, 1075.0]",19,39,-20
31233.0,2020-01-10,"(1075.0, 1432.0]",13,24,-11
31234.0,2020-01-10,"(478.14, 694.0]",18,36,-18
31234.0,2020-01-10,"(694.0, 909.0]",7,16,-9
31234.0,2020-01-10,"(909.0, 1124.0]",16,29,-13
31234.0,2020-01-10,"(1124.0, 1339.0]",8,16,-8
31235.0,2020-01-10,"(520.113, 742.75]",6,6,0
31235.0,2020-01-10,"(742.75, 964.5]",1,1,0
31235.0,2020-01-10,"(964.5, 1186.25]",1,3,-2
31235.0,2020-01-10,"(1186.25, 1408.0]",2,5,-3
31236.0,2020-01-10,"(433.076, 665.0]",14,20,-6
31236.0,2020-01-10,"(665.0, 896.0]",7,11,-4
31236.0,2020-01-10,"(896.0, 1127.0]",3,15,-12
31236.0,2020-01-10,"(1127.0, 1358.0]",3,7,-4
31237.0,2020-01-10,"(17.636, 360.0]",3,3,0
31237.0,2020-01-10,"(360.0, 701.0]",8,23,-15
31237.0,2020-01-10,"(701.0, 1042.0]",16,29,-13
31237.0,2020-01-10,"(1042.0, 1383.0]",14,25,-11
31238.0,2020-01-10,"(49.65, 388.5]",1,1,0
31238.0,2020-01-10,"(388.5, 726.0]",17,19,-2
31238.0,2020-01-10,"(726.0, 1063.5]",11,23,-12
31238.0,2020-01-10,"(1063.5, 1401.0]",4,17,-13
31239.0,2020-01-10,"(344.5, 675.0]",26,2,24
31239.0,2020-01-10,"(675.0, 1005.5]",9,31,-22
31239.0,2020-01-10,"(1005.5, 1336.0]",3,20,-17
31240.0,2020-01-10,"(767.649, 855.75]",2,6,-4
31240.0,2020-01-10,"(943.5, 1031.25]",1,2,-1
31240.0,2020-01-10,"(1031.25, 1119.0]",6,11,-5
31241.0,2020-01-10,"(84.663, 420.25]",1,3,-2
31241.0,2020-01-10,"(420.25, 754.5]",31,60,-29
31241.0,2020-01-10,"(754.5, 1088.75]",13,30,-17
31241.0,2020-01-10,"(1088.75, 1423.0]",11,28,-17
31242.0,2020-01-10,"(370.231, 563.25]",23,24,-1
31242.0,2020-01-10,"(563.25, 755.5]",6,11,-5
31242.0,2020-01-10,"(755.5, 947.75]",3,6,-3
31242.0,2020-01-10,"(947.75, 1140.0]",2,27,-25
31243.0,2020-01-10,"(347.04, 588.0]",16,22,-6
31243.0,2020-01-10,"(588.0, 828.0]",1,5,-4
31243.0,2020-01-10,"(828.0, 1068.0]",9,18,-9
31243.0,2020-01-10,"(1068.0, 1308.0]",7,19,-12
31244.0,2020-01-10,"(378.25, 704.5]",7,1,6
31244.0,2020-01-10,"(704.5, 1030.75]",4,13,-9
31244.0,2020-01-10,"(1030.75, 1357.0]",11,9,2
31245.0,2020-01-10,"(379.947, 644.25]",10,21,-11
31245.0,2020-01-10,"(644.25, 907.5]",1,3,-2
31245.0,2020-01-10,"(907.5, 1170.75]",18,33,-15
31245.0,2020-01-10,"(1170.75, 1434.0]",6,12,-6
31246.0,2020-01-10,"(405.122, 625.5]",15,23,-8
31246.0,2020-01-10,"(625.5, 845.0]",5,10,-5
31246.0,2020-01-10,"(845.0, 1064.5]",6,19,-13
31246.0,2020-01-10,"(1064.5, 1284.0]",9,17,-8
31247.0,2020-01-10,"(398.168, 607.0]",11,14,-3
31247.0,2020-01-10,"(607.0, 815.0]",7,25,-18
31247.0,2020-01-10,"(815.0, 1023.0]",10,17,-7
31247.0,2020-01-10,"(1023.0, 1231.0]",2,6,-4
31248.0,2020-01-10,"(349.177, 555.75]",6,12,-6
31248.0,2020-01-10,"(555.75, 761.5]",8,17,-9
31248.0,2020-01-10,"(761.5, 967.25]",10,23,-13
31248.0,2020-01-10,"(967.25, 1173.0]",10,25,-15
31249.0,2020-01-10,"(420.122, 640.5]",4,7,-3
31249.0,2020-01-10,"(640.5, 860.0]",3,6,-3
31249.0,2020-01-10,"(860.0, 1079.5]",5,14,-9
31249.0,2020-01-10,"(1079.5, 1299.0]",2,4,-2
31250.0,2020-01-10,"(416.137, 632.75]",17,17,0
31250.0,2020-01-10,"(632.75, 848.5]",7,14,-7
31250.0,2020-01-10,"(1064.25, 1280.0]",3,9,-6
31251.0,2020-01-10,"(475.038, 716.5]",18,30,-12
31251.0,2020-01-10,"(716.5, 957.0]",8,18,-10
31251.0,2020-01-10,"(957.0, 1197.5]",6,17,-11
31251.0,2020-01-10,"(1197.5, 1438.0]",2,7,-5
31252.0,2020-01-10,"(503.208, 702.0]",18,21,-3
31252.0,2020-01-10,"(702.0, 900.0]",2,5,-3
31252.0,2020-01-10,"(900.0, 1098.0]",5,21,-16
31252.0,2020-01-10,"(1098.0, 1296.0]",3,11,-8
31253.0,2020-01-10,"(353.039, 594.25]",19,19,0
31253.0,2020-01-10,"(594.25, 834.5]",9,23,-14
31253.0,2020-01-10,"(834.5, 1074.75]",9,22,-13
31253.0,2020-01-10,"(1074.75, 1315.0]",3,12,-9
31254.0,2020-01-10,"(409.198, 610.5]",22,27,-5
31254.0,2020-01-10,"(610.5, 811.0]",7,7,0
31254.0,2020-01-10,"(1011.5, 1212.0]",6,11,-5
31255.0,2020-01-10,"(323.169, 531.75]",16,21,-5
31255.0,2020-01-10,"(531.75, 739.5]",2,5,-3
31255.0,2020-01-10,"(739.5, 947.25]",6,11,-5
31255.0,2020-01-10,"(947.25, 1155.0]",8,16,-8
31256.0,2020-01-10,"(273.044, 513.0]",8,8,0
31256.0,2020-01-10,"(513.0, 752.0]",5,8,-3
31256.0,2020-01-10,"(752.0, 991.0]",1,2,-1
31256.0,2020-01-10,"(991.0, 1230.0]",3,8,-5
31257.0,2020-01-10,"(331.066, 565.5]",14,27,-13
31257.0,2020-01-10,"(565.5, 799.0]",9,14,-5
31257.0,2020-01-10,"(799.0, 1032.5]",10,21,-11
31257.0,2020-01-10,"(1032.5, 1266.0]",8,20,-12
31258.0,2020-01-10,"(70.64, 412.0]",1,2,-1
31258.0,2020-01-10,"(412.0, 752.0]",12,25,-13
31258.0,2020-01-10,"(752.0, 1092.0]",21,39,-18
31258.0,2020-01-10,"(1092.0, 1432.0]",7,13,-6
31259.0,2020-01-10,"(447.252, 635.0]",12,13,-1
31259.0,2020-01-10,"(635.0, 822.0]",1,1,0
31259.0,2020-01-10,"(822.0, 1009.0]",1,4,-3
31260.0,2020-01-10,"(355.966, 615.5]",18,19,-1
31260.0,2020-01-10,"(615.5, 874.0]",4,11,-7
31260.0,2020-01-10,"(874.0, 1132.5]",3,21,-18
31260.0,2020-01-10,"(1132.5, 1391.0]",3,3,0
31261.0,2020-01-10,"(392.31, 565.5]",11,11,0
31261.0,2020-01-10,"(910.5, 1083.0]",2,3,-1
31262.0,2020-01-10,"(430.139, 646.25]",7,8,-1
31262.0,2020-01-10,"(646.25, 861.5]",1,4,-3
31262.0,2020-01-10,"(861.5, 1076.75]",6,15,-9
31262.0,2020-01-10,"(1076.75, 1292.0]",4,7,-3
31263.0,2020-01-10,"(112.804, 413.0]",2,3,-1
31263.0,2020-01-10,"(413.0, 712.0]",21,31,-10
31263.0,2020-01-10,"(712.0, 1011.0]",6,17,-11
31263.0,2020-01-10,"(1011.0, 1310.0]",7,25,-18
31264.0,2020-01-10,"(348.25, 665.5]",17,1,16
31264.0,2020-01-10,"(665.5, 982.75]",5,21,-16
31264.0,2020-01-10,"(982.75, 1300.0]",11,10,1
31265.0,2020-01-10,"(358.934, 626.5]",13,31,-18
31265.0,2020-01-10,"(626.5, 893.0]",6,13,-7
31265.0,2020-01-10,"(893.0, 1159.5]",18,33,-15
31265.0,2020-01-10,"(1159.5, 1426.0]",9,16,-7
31266.0,2020-01-10,"(377.75, 730.5]",7,6,1
31266.0,2020-01-10,"(730.5, 1083.25]",16,25,-9
31266.0,2020-01-10,"(1083.25, 1436.0]",24,27,-3
31267.0,2020-01-10,"(392.5, 740.0]",29,2,27
31267.0,2020-01-10,"(740.0, 1087.5]",12,56,-44
31267.0,2020-01-10,"(1087.5, 1435.0]",19,25,-6
31268.0,2020-01-10,"(376.75, 724.5]",10,2,8
31268.0,2020-01-10,"(724.5, 1072.25]",31,35,-4
31268.0,2020-01-10,"(1072.25, 1420.0]",21,50,-29
31269.0,2020-01-10,"(381.996, 634.0]",6,11,-5
31269.0,2020-01-10,"(634.0, 885.0]",4,14,-10
31269.0,2020-01-10,"(885.0, 1136.0]",12,20,-8
31269.0,2020-01-10,"(1136.0, 1387.0]",4,10,-6
31270.0,2020-01-10,"(356.095, 583.25]",10,18,-8
31270.0,2020-01-10,"(583.25, 809.5]",1,2,-1
31270.0,2020-01-10,"(809.5, 1035.75]",4,9,-5
31270.0,2020-01-10,"(1035.75, 1262.0]",4,8,-4
31271.0,2020-01-10,"(397.1, 623.0]",17,19,-2
31271.0,2020-01-10,"(623.0, 848.0]",4,15,-11
31271.0,2020-01-10,"(848.0, 1073.0]",12,28,-16
31271.0,2020-01-10,"(1073.0, 1298.0]",1,7,-6
31272.0,2020-01-10,"(7.678, 339.5]",1,2,-1
31272.0,2020-01-10,"(339.5, 670.0]",21,24,-3
31272.0,2020-01-10,"(670.0, 1000.5]",6,14,-8
31272.0,2020-01-10,"(1000.5, 1331.0]",1,16,-15
31273.0,2020-01-10,"(775.5, 917.25]",2,2,0
31274.0,2020-01-10,"(389.195, 591.25]",12,14,-2
31274.0,2020-01-10,"(591.25, 792.5]",1,4,-3
31274.0,2020-01-10,"(792.5, 993.75]",4,9,-5
31274.0,2020-01-10,"(993.75, 1195.0]",6,14,-8
31275.0,2020-01-10,"(370.937, 637.75]",8,21,-13
31275.0,2020-01-10,"(637.75, 903.5]",7,11,-4
31275.0,2020-01-10,"(903.5, 1169.25]",17,39,-22
31275.0,2020-01-10,"(1169.25, 1435.0]",3,7,-4
31276.0,2020-01-10,"(415.26, 601.0]",12,14,-2
31276.0,2020-01-10,"(601.0, 786.0]",5,11,-6
31276.0,2020-01-10,"(786.0, 971.0]",4,10,-6
31276.0,2020-01-10,"(971.0, 1156.0]",2,23,-21
31277.0,2020-01-10,"(438.066, 672.5]",34,38,-4
31277.0,2020-01-10,"(672.5, 906.0]",10,21,-11
31277.0,2020-01-10,"(906.0, 1139.5]",9,31,-22
31278.0,2020-01-10,"(296.964, 557.0]",10,29,-19
31278.0,2020-01-10,"(557.0, 816.0]",8,18,-10
31278.0,2020-01-10,"(816.0, 1075.0]",11,16,-5
31278.0,2020-01-10,"(1075.0, 1334.0]",15,24,-9
31279.0,2020-01-10,"(429.305, 603.75]",19,21,-2
31279.0,2020-01-10,"(603.75, 777.5]",7,15,-8
31279.0,2020-01-10,"(777.5, 951.25]",8,15,-7
31279.0,2020-01-10,"(951.25, 1125.0]",4,24,-20
31280.0,2020-01-10,"(136.733, 454.75]",3,8,-5
31280.0,2020-01-10,"(454.75, 771.5]",3,15,-12
31280.0,2020-01-10,"(771.5, 1088.25]",10,13,-3
31280.0,2020-01-10,"(1088.25, 1405.0]",11,17,-6
31000.0,2020-01-11,"(767.0, 899.0]",1,1,0
31001.0,2020-01-11,"(560.132, 778.0]",2,4,-2
31001.0,2020-01-11,"(778.0, 995.0]",3,5,-2
31001.0,2020-01-11,"(995.0, 1212.0]",1,1,0
31002.0,2020-01-11,"(721.531, 839.25]",5,11,-6
31002.0,2020-01-11,"(839.25, 956.5]",11,13,-2
31002.0,2020-01-11,"(956.5, 1073.75]",3,8,-5
31002.0,2020-01-11,"(1073.75, 1191.0]",5,7,-2
31003.0,2020-01-11,"(515.21, 713.5]",1,4,-3
31003.0,2020-01-11,"(713.5, 911.0]",3,8,-5
31003.0,2020-01-11,"(911.0, 1108.5]",6,8,-2
31003.0,2020-01-11,"(1108.5, 1306.0]",1,1,0
31004.0,2020-01-11,"(649.498, 775.5]",1,3,-2
31004.0,2020-01-11,"(775.5, 901.0]",2,4,-2
31004.0,2020-01-11,"(1026.5, 1152.0]",2,1,1
31005.0,2020-01-11,"(460.294, 637.5]",3,3,0
31005.0,2020-01-11,"(637.5, 814.0]",5,7,-2
31005.0,2020-01-11,"(814.0, 990.5]",6,12,-6
31005.0,2020-01-11,"(990.5, 1167.0]",4,8,-4
31006.0,2020-01-11,"(553.412, 701.0]",3,5,-2
31006.0,2020-01-11,"(701.0, 848.0]",3,6,-3
31006.0,2020-01-11,"(848.0, 995.0]",4,9,-5
31006.0,2020-01-11,"(995.0, 1142.0]",4,4,0
31007.0,2020-01-11,"(297.0, 576.0]",1,1,0
31007.0,2020-01-11,"(576.0, 855.0]",7,1,6
31007.0,2020-01-11,"(855.0, 1134.0]",7,10,-3
31009.0,2020-01-11,"(678.554, 790.5]",1,3,-2
31009.0,2020-01-11,"(790.5, 902.0]",2,3,-1
31010.0,2020-01-11,"(697.624, 792.0]",1,2,-1
31010.0,2020-01-11,"(792.0, 886.0]",3,3,0
31010.0,2020-01-11,"(886.0, 980.0]",2,4,-2
31010.0,2020-01-11,"(980.0, 1074.0]",4,7,-3
31011.0,2020-01-11,"(418.052, 656.0]",4,7,-3
31011.0,2020-01-11,"(656.0, 893.0]",2,4,-2
31011.0,2020-01-11,"(893.0, 1130.0]",3,11,-8
31011.0,2020-01-11,"(1130.0, 1367.0]",1,2,-1
31012.0,2020-01-11,"(841.8, 892.0]",1,1,0
31012.0,2020-01-11,"(892.0, 942.0]",2,2,0
31012.0,2020-01-11,"(992.0, 1042.0]",1,2,-1
31013.0,2020-01-11,"(560.129, 778.75]",1,6,-5
31013.0,2020-01-11,"(778.75, 996.5]",4,11,-7
31013.0,2020-01-11,"(996.5, 1214.25]",3,4,-1
31014.0,2020-01-11,"(19.617, 366.75]",5,5,0
31014.0,2020-01-11,"(366.75, 712.5]",11,16,-5
31014.0,2020-01-11,"(712.5, 1058.25]",29,47,-18
31014.0,2020-01-11,"(1058.25, 1404.0]",8,18,-10
31015.0,2020-01-11,"(339.969, 598.75]",5,5,0
31015.0,2020-01-11,"(598.75, 856.5]",4,10,-6
31015.0,2020-01-11,"(856.5, 1114.25]",8,15,-7
31015.0,2020-01-11,"(1114.25, 1372.0]",3,7,-4
31016.0,2020-01-11,"(521.442, 661.5]",2,4,-2
31016.0,2020-01-11,"(661.5, 801.0]",1,3,-2
31016.0,2020-01-11,"(801.0, 940.5]",1,5,-4
31016.0,2020-01-11,"(940.5, 1080.0]",2,3,-1
31017.0,2020-01-11,"(931.0, 1158.5]",5,4,1
31017.0,2020-01-11,"(1158.5, 1386.0]",1,3,-2
31018.0,2020-01-11,"(564.406, 713.5]",1,3,-2
31018.0,2020-01-11,"(862.0, 1010.5]",3,1,2
31019.0,2020-01-11,"(727.5, 1030.25]",6,4,2
31020.0,2020-01-11,"(643.211, 841.25]",1,2,-1
31020.0,2020-01-11,"(1038.5, 1235.75]",2,1,1
31021.0,2020-01-11,"(688.0, 932.0]",2,1,1
31021.0,2020-01-11,"(932.0, 1176.0]",4,8,-4
31021.0,2020-01-11,"(1176.0, 1420.0]",1,7,-6
31022.0,2020-01-11,"(388.25, 663.5]",3,1,2
31022.0,2020-01-11,"(663.5, 938.75]",11,4,7
31022.0,2020-01-11,"(938.75, 1214.0]",5,22,-17
31023.0,2020-01-11,"(588.151, 801.25]",5,9,-4
31023.0,2020-01-11,"(801.25, 1013.5]",3,6,-3
31023.0,2020-01-11,"(1013.5, 1225.75]",2,6,-4
31023.0,2020-01-11,"(1225.75, 1438.0]",1,2,-1
31024.0,2020-01-11,"(617.5, 781.0]",3,1,2
31024.0,2020-01-11,"(781.0, 944.5]",3,5,-2
31024.0,2020-01-11,"(944.5, 1108.0]",2,8,-6
31025.0,2020-01-11,"(103.107, 327.25]",1,1,0
31025.0,2020-01-11,"(550.5, 773.75]",3,7,-4
31025.0,2020-01-11,"(773.75, 997.0]",5,7,-2
31026.0,2020-01-11,"(681.259, 867.25]",3,5,-2
31026.0,2020-01-11,"(867.25, 1052.5]",3,6,-3
31026.0,2020-01-11,"(1052.5, 1237.75]",5,7,-2
31026.0,2020-01-11,"(1237.75, 1423.0]",1,1,0
31027.0,2020-01-11,"(897.5, 1048.25]",1,1,0
31027.0,2020-01-11,"(1048.25, 1199.0]",1,1,0
31028.0,2020-01-11,"(699.38, 855.0]",2,3,-1
31028.0,2020-01-11,"(1165.0, 1320.0]",3,6,-3
31029.0,2020-01-11,"(506.404, 656.0]",1,2,-1
31029.0,2020-01-11,"(656.0, 805.0]",4,7,-3
31029.0,2020-01-11,"(954.0, 1103.0]",2,3,-1
31030.0,2020-01-11,"(583.372, 741.0]",3,8,-5
31030.0,2020-01-11,"(741.0, 898.0]",2,5,-3
31030.0,2020-01-11,"(898.0, 1055.0]",1,3,-2
31030.0,2020-01-11,"(1055.0, 1212.0]",1,2,-1
31031.0,2020-01-11,"(818.5, 917.75]",2,3,-1
31031.0,2020-01-11,"(917.75, 1017.0]",2,1,1
31032.0,2020-01-11,"(956.544, 1071.0]",1,1,0
31032.0,2020-01-11,"(1071.0, 1185.0]",1,2,-1
31032.0,2020-01-11,"(1299.0, 1413.0]",1,1,0
31033.0,2020-01-11,"(431.345, 595.75]",1,2,-1
31033.0,2020-01-11,"(595.75, 759.5]",1,3,-2
31033.0,2020-01-11,"(759.5, 923.25]",1,2,-1
31033.0,2020-01-11,"(923.25, 1087.0]",2,4,-2
31034.0,2020-01-11,"(116.847, 406.25]",1,1,0
31034.0,2020-01-11,"(694.5, 982.75]",6,1,5
31035.0,2020-01-11,"(433.322, 603.5]",1,1,0
31035.0,2020-01-11,"(942.5, 1112.0]",1,1,0
31036.0,2020-01-11,"(734.0, 886.5]",1,3,-2
31036.0,2020-01-11,"(886.5, 1039.0]",3,5,-2
31037.0,2020-01-11,"(416.998, 668.5]",5,7,-2
31037.0,2020-01-11,"(668.5, 919.0]",10,16,-6
31037.0,2020-01-11,"(919.0, 1169.5]",8,11,-3
31037.0,2020-01-11,"(1169.5, 1420.0]",1,2,-1
31038.0,2020-01-11,"(898.25, 1061.0]",2,1,1
31039.0,2020-01-11,"(500.128, 719.0]",4,8,-4
31039.0,2020-01-11,"(719.0, 937.0]",1,7,-6
31039.0,2020-01-11,"(937.0, 1155.0]",6,7,-1
31040.0,2020-01-11,"(100.129, 318.75]",1,2,-1
31040.0,2020-01-11,"(318.75, 536.5]",1,1,0
31040.0,2020-01-11,"(536.5, 754.25]",1,3,-2
31040.0,2020-01-11,"(754.25, 972.0]",2,7,-5
31041.0,2020-01-11,"(657.325, 826.75]",7,8,-1
31041.0,2020-01-11,"(826.75, 995.5]",20,29,-9
31041.0,2020-01-11,"(995.5, 1164.25]",1,4,-3
31041.0,2020-01-11,"(1164.25, 1333.0]",3,7,-4
31042.0,2020-01-11,"(323.75, 612.5]",1,1,0
31042.0,2020-01-11,"(612.5, 901.25]",7,1,6
31042.0,2020-01-11,"(901.25, 1190.0]",10,17,-7
31043.0,2020-01-11,"(615.504, 740.0]",4,6,-2
31043.0,2020-01-11,"(740.0, 864.0]",5,9,-4
31043.0,2020-01-11,"(864.0, 988.0]",1,1,0
31043.0,2020-01-11,"(988.0, 1112.0]",1,2,-1
31044.0,2020-01-11,"(717.0, 861.0]",7,1,6
31044.0,2020-01-11,"(1005.0, 1149.0]",2,9,-7
31045.0,2020-01-11,"(670.489, 798.75]",2,6,-4
31045.0,2020-01-11,"(798.75, 926.5]",2,5,-3
31045.0,2020-01-11,"(1054.25, 1182.0]",2,6,-4
,,,,1.0,
,,,,2.0,
,,,,1.0,
,,,,1.0,
31047.0,2020-01-11,"(44.78, 351.0]",1,1,0
31047.0,2020-01-11,"(351.0, 656.0]",1,1,0
31047.0,2020-01-11,"(656.0, 961.0]",5,9,-4
31047.0,2020-01-11,"(961.0, 1266.0]",1,3,-2
31048.0,2020-01-11,"(655.25, 787.5]",2,1,1
31048.0,2020-01-11,"(787.5, 919.75]",1,2,-1
31048.0,2020-01-11,"(919.75, 1052.0]",2,2,0
31049.0,2020-01-11,"(734.5, 891.0]",1,2,-1
31049.0,2020-01-11,"(1047.5, 1204.0]",1,3,-2
31050.0,2020-01-11,"(799.0, 857.0]",2,1,1
31051.0,2020-01-11,"(649.25, 887.5]",3,4,-1
31051.0,2020-01-11,"(1125.75, 1364.0]",2,3,-1
31052.0,2020-01-11,"(772.75, 893.5]",1,1,0
31052.0,2020-01-11,"(893.5, 1014.25]",3,2,1
31052.0,2020-01-11,"(1014.25, 1135.0]",1,4,-3
,,,,2.0,
,,,,2.0,
31055.0,2020-01-11,"(30.852, 319.0]",1,1,0
31055.0,2020-01-11,"(319.0, 606.0]",1,1,0
31055.0,2020-01-11,"(606.0, 893.0]",2,10,-8
31055.0,2020-01-11,"(893.0, 1180.0]",7,13,-6
31056.0,2020-01-11,"(717.0, 873.0]",1,3,-2
31056.0,2020-01-11,"(873.0, 1029.0]",1,1,0
31056.0,2020-01-11,"(1029.0, 1185.0]",1,1,0
31057.0,2020-01-11,"(441.493, 568.75]",1,1,0
31057.0,2020-01-11,"(822.25, 949.0]",4,2,2
31058.0,2020-01-11,"(815.0, 840.0]",1,1,0
31059.0,2020-01-11,"(610.645, 699.75]",1,4,-3
31059.0,2020-01-11,"(788.5, 877.25]",1,1,0
31059.0,2020-01-11,"(877.25, 966.0]",2,3,-1
31060.0,2020-01-11,"(542.537, 658.75]",1,1,0
31060.0,2020-01-11,"(658.75, 774.5]",2,11,-9
31060.0,2020-01-11,"(774.5, 890.25]",6,9,-3
31060.0,2020-01-11,"(890.25, 1006.0]",1,5,-4
31061.0,2020-01-11,"(673.711, 746.25]",1,1,0
31061.0,2020-01-11,"(890.75, 963.0]",1,2,-1
31062.0,2020-01-11,"(498.458, 634.5]",3,8,-5
31062.0,2020-01-11,"(634.5, 770.0]",15,27,-12
31062.0,2020-01-11,"(770.0, 905.5]",10,21,-11
31062.0,2020-01-11,"(905.5, 1041.0]",9,25,-16
31063.0,2020-01-11,"(1087.922, 1107.5]",1,1,0
31064.0,2020-01-11,"(516.419, 662.25]",5,12,-7
31064.0,2020-01-11,"(662.25, 807.5]",19,37,-18
31064.0,2020-01-11,"(807.5, 952.75]",30,60,-30
31064.0,2020-01-11,"(952.75, 1098.0]",21,38,-17
31065.0,2020-01-11,"(487.347, 651.25]",1,3,-2
31065.0,2020-01-11,"(814.5, 977.75]",1,1,0
31065.0,2020-01-11,"(977.75, 1141.0]",1,3,-2
,,,,1.0,
,,,,1.0,
31067.0,2020-01-11,"(817.5, 1021.0]",1,1,0
31067.0,2020-01-11,"(1021.0, 1224.5]",1,2,-1
31067.0,2020-01-11,"(1224.5, 1428.0]",1,1,0
31068.0,2020-01-11,"(675.0, 804.0]",4,2,2
31068.0,2020-01-11,"(804.0, 933.0]",2,4,-2
31068.0,2020-01-11,"(933.0, 1062.0]",4,4,0
31069.0,2020-01-11,"(591.5, 771.0]",2,2,0
31069.0,2020-01-11,"(771.0, 950.5]",1,4,-3
31070.0,2020-01-11,"(558.162, 768.5]",2,5,-3
31070.0,2020-01-11,"(768.5, 978.0]",2,3,-1
31070.0,2020-01-11,"(978.0, 1187.5]",1,2,-1
31070.0,2020-01-11,"(1187.5, 1397.0]",3,4,-1
31071.0,2020-01-11,"(412.053, 649.75]",4,8,-4
31071.0,2020-01-11,"(649.75, 886.5]",7,21,-14
31071.0,2020-01-11,"(886.5, 1123.25]",11,16,-5
31072.0,2020-01-11,"(575.25, 767.0]",1,1,0
31073.0,2020-01-11,"(506.472, 639.0]",1,2,-1
31073.0,2020-01-11,"(639.0, 771.0]",1,1,0
31073.0,2020-01-11,"(903.0, 1035.0]",1,4,-3
31074.0,2020-01-11,"(521.188, 725.0]",2,2,0
31075.0,2020-01-11,"(851.831, 894.25]",3,3,0
31076.0,2020-01-11,"(594.241, 784.75]",2,3,-1
31076.0,2020-01-11,"(784.75, 974.5]",1,1,0
31076.0,2020-01-11,"(1164.25, 1354.0]",1,1,0
31077.0,2020-01-11,"(463.226, 657.5]",7,11,-4
31077.0,2020-01-11,"(657.5, 851.0]",3,16,-13
31077.0,2020-01-11,"(851.0, 1044.5]",11,17,-6
31077.0,2020-01-11,"(1044.5, 1238.0]",5,8,-3
31078.0,2020-01-11,"(562.719, 633.25]",1,1,0
31078.0,2020-01-11,"(773.75, 844.0]",1,2,-1
31079.0,2020-01-11,"(628.209, 826.75]",1,5,-4
31079.0,2020-01-11,"(1024.5, 1222.25]",2,5,-3
31079.0,2020-01-11,"(1222.25, 1420.0]",2,2,0
31080.0,2020-01-11,"(536.183, 741.25]",1,3,-2
31080.0,2020-01-11,"(741.25, 945.5]",2,4,-2
31080.0,2020-01-11,"(945.5, 1149.75]",1,1,0
31080.0,2020-01-11,"(1149.75, 1354.0]",3,3,0
31081.0,2020-01-11,"(650.533, 767.75]",2,3,-1
31081.0,2020-01-11,"(767.75, 884.5]",1,1,0
31081.0,2020-01-11,"(1001.25, 1118.0]",2,3,-1
31082.0,2020-01-11,"(654.602, 754.5]",1,3,-2
31082.0,2020-01-11,"(754.5, 854.0]",3,3,0
31082.0,2020-01-11,"(953.5, 1053.0]",1,4,-3
31083.0,2020-01-11,"(760.75, 893.5]",3,2,1
31083.0,2020-01-11,"(893.5, 1026.25]",3,4,-1
31083.0,2020-01-11,"(1026.25, 1159.0]",2,6,-4
31084.0,2020-01-11,"(834.471, 967.25]",2,3,-1
31084.0,2020-01-11,"(967.25, 1099.5]",1,1,0
31085.0,2020-01-11,"(842.51, 965.5]",1,2,-1
31085.0,2020-01-11,"(1210.5, 1333.0]",2,2,0
31086.0,2020-01-11,"(76.113, 298.75]",1,2,-1
31086.0,2020-01-11,"(742.25, 964.0]",4,4,0
31087.0,2020-01-11,"(700.27, 883.5]",2,6,-4
31087.0,2020-01-11,"(883.5, 1066.0]",1,2,-1
31087.0,2020-01-11,"(1066.0, 1248.5]",1,2,-1
31088.0,2020-01-11,"(635.309, 808.75]",1,5,-4
31088.0,2020-01-11,"(808.75, 981.5]",2,5,-3
31088.0,2020-01-11,"(981.5, 1154.25]",1,1,0
31089.0,2020-01-11,"(470.5, 784.0]",5,1,4
31089.0,2020-01-11,"(784.0, 1097.5]",6,13,-7
31089.0,2020-01-11,"(1097.5, 1411.0]",1,14,-13
31090.0,2020-01-11,"(663.717, 734.75]",3,4,-1
31090.0,2020-01-11,"(876.25, 947.0]",5,2,3
31091.0,2020-01-11,"(189.753, 502.75]",1,2,-1
31091.0,2020-01-11,"(502.75, 814.5]",2,5,-3
31091.0,2020-01-11,"(814.5, 1126.25]",1,3,-2
31091.0,2020-01-11,"(1126.25, 1438.0]",1,1,0
31092.0,2020-01-11,"(602.25, 742.5]",1,1,0
31092.0,2020-01-11,"(882.75, 1023.0]",2,1,1
31093.0,2020-01-11,"(471.389, 624.75]",1,2,-1
31093.0,2020-01-11,"(930.25, 1083.0]",2,2,0
31094.0,2020-01-11,"(650.702, 725.5]",2,2,0
,,,,2.0,
31096.0,2020-01-11,"(651.0, 708.0]",1,1,0
31096.0,2020-01-11,"(708.0, 765.0]",1,1,0
31097.0,2020-01-11,"(609.176, 816.0]",2,5,-3
31097.0,2020-01-11,"(816.0, 1022.0]",1,1,0
31097.0,2020-01-11,"(1228.0, 1434.0]",1,1,0
31098.0,2020-01-11,"(326.25, 628.5]",1,1,0
31098.0,2020-01-11,"(628.5, 930.75]",8,2,6
31098.0,2020-01-11,"(930.75, 1233.0]",2,12,-10
31099.0,2020-01-11,"(634.197, 835.75]",3,5,-2
31099.0,2020-01-11,"(835.75, 1036.5]",1,1,0
31099.0,2020-01-11,"(1237.25, 1438.0]",2,1,1
31100.0,2020-01-11,"(597.433, 739.75]",1,2,-1
31100.0,2020-01-11,"(739.75, 881.5]",2,4,-2
31100.0,2020-01-11,"(881.5, 1023.25]",1,1,0
31100.0,2020-01-11,"(1023.25, 1165.0]",2,2,0
31101.0,2020-01-11,"(8.57, 367.5]",1,4,-3
31101.0,2020-01-11,"(367.5, 725.0]",22,34,-12
31101.0,2020-01-11,"(725.0, 1082.5]",46,85,-39
31101.0,2020-01-11,"(1082.5, 1440.0]",25,40,-15
31102.0,2020-01-11,"(40.665, 375.75]",2,5,-3
31102.0,2020-01-11,"(375.75, 709.5]",2,12,-10
31102.0,2020-01-11,"(709.5, 1043.25]",5,10,-5
31102.0,2020-01-11,"(1043.25, 1377.0]",5,10,-5
31103.0,2020-01-11,"(14.585, 369.75]",3,7,-4
31103.0,2020-01-11,"(369.75, 723.5]",3,16,-13
31103.0,2020-01-11,"(723.5, 1077.25]",5,10,-5
31103.0,2020-01-11,"(1077.25, 1431.0]",4,19,-15
31104.0,2020-01-11,"(3.573, 361.75]",2,13,-11
31104.0,2020-01-11,"(361.75, 718.5]",6,30,-24
31104.0,2020-01-11,"(718.5, 1075.25]",31,65,-34
31104.0,2020-01-11,"(1075.25, 1432.0]",12,37,-25
31105.0,2020-01-11,"(509.106, 733.5]",4,9,-5
31105.0,2020-01-11,"(733.5, 957.0]",2,5,-3
31105.0,2020-01-11,"(957.0, 1180.5]",1,2,-1
31105.0,2020-01-11,"(1180.5, 1404.0]",2,3,-1
31106.0,2020-01-11,"(339.0, 635.0]",1,2,-1
31106.0,2020-01-11,"(635.0, 931.0]",4,3,1
31106.0,2020-01-11,"(931.0, 1227.0]",4,9,-5
31107.0,2020-01-11,"(65.663, 401.25]",1,3,-2
31107.0,2020-01-11,"(401.25, 735.5]",6,24,-18
31107.0,2020-01-11,"(735.5, 1069.75]",11,28,-17
31107.0,2020-01-11,"(1069.75, 1404.0]",9,29,-20
31108.0,2020-01-11,"(121.769, 430.75]",1,1,0
31108.0,2020-01-11,"(430.75, 738.5]",7,29,-22
31108.0,2020-01-11,"(738.5, 1046.25]",41,69,-28
31108.0,2020-01-11,"(1046.25, 1354.0]",17,24,-7
31109.0,2020-01-11,"(21.597, 373.75]",5,10,-5
31109.0,2020-01-11,"(373.75, 724.5]",10,20,-10
31109.0,2020-01-11,"(724.5, 1075.25]",29,54,-25
31109.0,2020-01-11,"(1075.25, 1426.0]",18,33,-15
31110.0,2020-01-11,"(80.704, 406.0]",1,3,-2
31110.0,2020-01-11,"(406.0, 730.0]",16,30,-14
31110.0,2020-01-11,"(730.0, 1054.0]",23,48,-25
31110.0,2020-01-11,"(1054.0, 1378.0]",7,16,-9
31111.0,2020-01-11,"(19.597, 371.75]",3,5,-2
31111.0,2020-01-11,"(371.75, 722.5]",5,15,-10
31111.0,2020-01-11,"(722.5, 1073.25]",21,37,-16
31111.0,2020-01-11,"(1073.25, 1424.0]",7,16,-9
31112.0,2020-01-11,"(619.293, 796.75]",5,8,-3
31112.0,2020-01-11,"(796.75, 973.5]",16,35,-19
31112.0,2020-01-11,"(973.5, 1150.25]",5,7,-2
31112.0,2020-01-11,"(1150.25, 1327.0]",2,3,-1
31113.0,2020-01-11,"(379.944, 645.0]",2,9,-7
31113.0,2020-01-11,"(645.0, 909.0]",6,21,-15
31113.0,2020-01-11,"(909.0, 1173.0]",8,23,-15
31113.0,2020-01-11,"(1173.0, 1437.0]",4,6,-2
31114.0,2020-01-11,"(-0.434, 359.5]",1,7,-6
31114.0,2020-01-11,"(359.5, 718.0]",11,22,-11
31114.0,2020-01-11,"(718.0, 1076.5]",25,46,-21
31114.0,2020-01-11,"(1076.5, 1435.0]",14,34,-20
31115.0,2020-01-11,"(181.751, 495.25]",4,9,-5
31115.0,2020-01-11,"(495.25, 807.5]",8,22,-14
31115.0,2020-01-11,"(807.5, 1119.75]",8,23,-15
31115.0,2020-01-11,"(1119.75, 1432.0]",7,16,-9
31116.0,2020-01-11,"(13.597, 365.75]",4,4,0
31116.0,2020-01-11,"(365.75, 716.5]",14,30,-16
31116.0,2020-01-11,"(716.5, 1067.25]",21,40,-19
31116.0,2020-01-11,"(1067.25, 1418.0]",10,26,-16
31117.0,2020-01-11,"(482.061, 717.75]",2,10,-8
31117.0,2020-01-11,"(717.75, 952.5]",9,21,-12
31117.0,2020-01-11,"(952.5, 1187.25]",8,24,-16
31117.0,2020-01-11,"(1187.25, 1422.0]",9,19,-10
31118.0,2020-01-11,"(44.612, 393.0]",2,2,0
31118.0,2020-01-11,"(393.0, 740.0]",3,11,-8
31118.0,2020-01-11,"(740.0, 1087.0]",14,30,-16
31118.0,2020-01-11,"(1087.0, 1434.0]",4,10,-6
31119.0,2020-01-11,"(11.591, 365.25]",2,4,-2
31119.0,2020-01-11,"(365.25, 717.5]",12,29,-17
31119.0,2020-01-11,"(717.5, 1069.75]",23,40,-17
31119.0,2020-01-11,"(1069.75, 1422.0]",16,28,-12
31120.0,2020-01-11,"(456.5, 780.0]",3,1,2
31120.0,2020-01-11,"(780.0, 1103.5]",9,10,-1
31120.0,2020-01-11,"(1103.5, 1427.0]",16,21,-5
31121.0,2020-01-11,"(28.684, 359.0]",4,5,-1
31121.0,2020-01-11,"(359.0, 688.0]",8,18,-10
31121.0,2020-01-11,"(688.0, 1017.0]",14,36,-22
31121.0,2020-01-11,"(1017.0, 1346.0]",7,11,-4
31122.0,2020-01-11,"(85.669, 419.75]",1,3,-2
31122.0,2020-01-11,"(419.75, 752.5]",4,8,-4
31122.0,2020-01-11,"(752.5, 1085.25]",7,13,-6
31122.0,2020-01-11,"(1085.25, 1418.0]",7,12,-5
31123.0,2020-01-11,"(478.75, 789.5]",2,2,0
31123.0,2020-01-11,"(789.5, 1100.25]",6,10,-4
31123.0,2020-01-11,"(1100.25, 1411.0]",4,12,-8
31124.0,2020-01-11,"(-0.426, 357.5]",4,10,-6
31124.0,2020-01-11,"(357.5, 714.0]",20,46,-26
31124.0,2020-01-11,"(714.0, 1070.5]",21,65,-44
31124.0,2020-01-11,"(1070.5, 1427.0]",9,40,-31
31125.0,2020-01-11,"(135.698, 462.5]",3,7,-4
31125.0,2020-01-11,"(462.5, 788.0]",17,40,-23
31125.0,2020-01-11,"(788.0, 1113.5]",44,77,-33
31125.0,2020-01-11,"(1113.5, 1439.0]",11,16,-5
31126.0,2020-01-11,"(53.619, 400.25]",2,3,-1
31126.0,2020-01-11,"(400.25, 745.5]",6,30,-24
31126.0,2020-01-11,"(745.5, 1090.75]",19,51,-32
31126.0,2020-01-11,"(1090.75, 1436.0]",12,30,-18
,,,,2.0,
31128.0,2020-01-11,"(21.6, 373.0]",3,4,-1
31128.0,2020-01-11,"(373.0, 723.0]",10,16,-6
31128.0,2020-01-11,"(723.0, 1073.0]",18,41,-23
31128.0,2020-01-11,"(1073.0, 1423.0]",7,10,-3
31129.0,2020-01-11,"(629.249, 817.75]",13,33,-20
31129.0,2020-01-11,"(817.75, 1005.5]",16,32,-16
31129.0,2020-01-11,"(1005.5, 1193.25]",15,21,-6
31129.0,2020-01-11,"(1193.25, 1381.0]",3,4,-1
31130.0,2020-01-11,"(396.972, 655.0]",2,6,-4
31130.0,2020-01-11,"(655.0, 912.0]",2,6,-4
31130.0,2020-01-11,"(912.0, 1169.0]",20,30,-10
31130.0,2020-01-11,"(1169.0, 1426.0]",6,8,-2
31131.0,2020-01-11,"(26.62, 373.0]",3,4,-1
31131.0,2020-01-11,"(373.0, 718.0]",3,7,-4
31131.0,2020-01-11,"(718.0, 1063.0]",5,11,-6
31131.0,2020-01-11,"(1063.0, 1408.0]",5,8,-3
31200.0,2020-01-11,"(14.613, 362.75]",1,3,-2
31200.0,2020-01-11,"(362.75, 709.5]",7,14,-7
31200.0,2020-01-11,"(709.5, 1056.25]",30,59,-29
31200.0,2020-01-11,"(1056.25, 1403.0]",10,21,-11
31201.0,2020-01-11,"(28.601, 379.75]",5,12,-7
31201.0,2020-01-11,"(379.75, 729.5]",30,49,-19
31201.0,2020-01-11,"(729.5, 1079.25]",57,117,-60
31201.0,2020-01-11,"(1079.25, 1429.0]",22,41,-19
31202.0,2020-01-11,"(0.57, 359.5]",4,10,-6
31202.0,2020-01-11,"(359.5, 717.0]",22,36,-14
31202.0,2020-01-11,"(717.0, 1074.5]",30,57,-27
31202.0,2020-01-11,"(1074.5, 1432.0]",15,31,-16
31203.0,2020-01-11,"(16.583, 372.25]",3,8,-5
31203.0,2020-01-11,"(372.25, 726.5]",15,22,-7
31203.0,2020-01-11,"(726.5, 1080.75]",32,51,-19
31203.0,2020-01-11,"(1080.75, 1435.0]",27,52,-25
31204.0,2020-01-11,"(125.712, 449.0]",1,1,0
31204.0,2020-01-11,"(449.0, 771.0]",4,11,-7
31204.0,2020-01-11,"(771.0, 1093.0]",8,10,-2
31204.0,2020-01-11,"(1093.0, 1415.0]",8,18,-10
31205.0,2020-01-11,"(285.889, 564.75]",2,3,-1
31205.0,2020-01-11,"(564.75, 842.5]",6,11,-5
31205.0,2020-01-11,"(842.5, 1120.25]",3,10,-7
31205.0,2020-01-11,"(1120.25, 1398.0]",3,4,-1
31206.0,2020-01-11,"(723.0, 964.0]",5,1,4
31207.0,2020-01-11,"(551.128, 770.0]",5,6,-1
31207.0,2020-01-11,"(770.0, 988.0]",3,6,-3
31207.0,2020-01-11,"(988.0, 1206.0]",2,5,-3
31207.0,2020-01-11,"(1206.0, 1424.0]",1,2,-1
31208.0,2020-01-11,"(566.348, 730.0]",8,11,-3
31208.0,2020-01-11,"(730.0, 893.0]",9,12,-3
31208.0,2020-01-11,"(893.0, 1056.0]",5,8,-3
31208.0,2020-01-11,"(1056.0, 1219.0]",5,9,-4
31209.0,2020-01-11,"(567.192, 770.0]",4,8,-4
31209.0,2020-01-11,"(770.0, 972.0]",5,8,-3
31209.0,2020-01-11,"(972.0, 1174.0]",9,14,-5
31209.0,2020-01-11,"(1174.0, 1376.0]",4,4,0
31211.0,2020-01-11,"(585.205, 784.75]",4,7,-3
31211.0,2020-01-11,"(784.75, 983.5]",10,16,-6
31211.0,2020-01-11,"(983.5, 1182.25]",5,11,-6
31212.0,2020-01-11,"(20.584, 376.0]",2,4,-2
31212.0,2020-01-11,"(376.0, 730.0]",12,22,-10
31212.0,2020-01-11,"(730.0, 1084.0]",9,25,-16
31212.0,2020-01-11,"(1084.0, 1438.0]",4,10,-6
31213.0,2020-01-11,"(363.75, 718.5]",6,1,5
31213.0,2020-01-11,"(718.5, 1073.25]",9,11,-2
31213.0,2020-01-11,"(1073.25, 1428.0]",2,18,-16
31214.0,2020-01-11,"(0.622, 346.5]",2,4,-2
31214.0,2020-01-11,"(346.5, 691.0]",11,22,-11
31214.0,2020-01-11,"(691.0, 1035.5]",40,84,-44
31214.0,2020-01-11,"(1035.5, 1380.0]",22,37,-15
31215.0,2020-01-11,"(392.068, 626.0]",5,6,-1
31215.0,2020-01-11,"(626.0, 859.0]",14,20,-6
31215.0,2020-01-11,"(859.0, 1092.0]",24,33,-9
31215.0,2020-01-11,"(1092.0, 1325.0]",5,9,-4
31216.0,2020-01-11,"(517.193, 719.75]",3,4,-1
31216.0,2020-01-11,"(719.75, 921.5]",5,7,-2
31216.0,2020-01-11,"(921.5, 1123.25]",4,6,-2
31217.0,2020-01-11,"(440.178, 646.5]",1,3,-2
31217.0,2020-01-11,"(646.5, 852.0]",4,5,-1
31217.0,2020-01-11,"(852.0, 1057.5]",4,4,0
31217.0,2020-01-11,"(1057.5, 1263.0]",1,2,-1
31218.0,2020-01-11,"(361.0, 703.0]",3,1,2
31218.0,2020-01-11,"(703.0, 1045.0]",18,4,14
31218.0,2020-01-11,"(1045.0, 1387.0]",7,35,-28
31219.0,2020-01-11,"(571.47, 704.5]",8,11,-3
31219.0,2020-01-11,"(704.5, 837.0]",9,12,-3
31219.0,2020-01-11,"(837.0, 969.5]",9,14,-5
31219.0,2020-01-11,"(969.5, 1102.0]",5,18,-13
31220.0,2020-01-11,"(340.013, 587.75]",1,1,0
31220.0,2020-01-11,"(587.75, 834.5]",1,2,-1
31220.0,2020-01-11,"(1081.25, 1328.0]",1,1,0
31221.0,2020-01-11,"(59.622, 405.5]",2,4,-2
31221.0,2020-01-11,"(405.5, 750.0]",6,9,-3
31221.0,2020-01-11,"(750.0, 1094.5]",14,24,-10
31221.0,2020-01-11,"(1094.5, 1439.0]",8,17,-9
31222.0,2020-01-11,"(346.039, 587.25]",1,1,0
31222.0,2020-01-11,"(587.25, 827.5]",8,10,-2
31222.0,2020-01-11,"(827.5, 1067.75]",9,19,-10
31222.0,2020-01-11,"(1067.75, 1308.0]",9,11,-2
31223.0,2020-01-11,"(26.613, 374.75]",1,3,-2
31223.0,2020-01-11,"(374.75, 721.5]",8,16,-8
31223.0,2020-01-11,"(721.5, 1068.25]",20,40,-20
31223.0,2020-01-11,"(1068.25, 1415.0]",11,20,-9
31224.0,2020-01-11,"(478.116, 700.0]",3,6,-3
31224.0,2020-01-11,"(700.0, 921.0]",7,11,-4
31224.0,2020-01-11,"(921.0, 1142.0]",4,6,-2
31224.0,2020-01-11,"(1142.0, 1363.0]",1,3,-2
31225.0,2020-01-11,"(381.5, 734.0]",9,3,6
31225.0,2020-01-11,"(734.0, 1086.5]",18,12,6
31225.0,2020-01-11,"(1086.5, 1439.0]",5,35,-30
31226.0,2020-01-11,"(47.649, 386.75]",1,1,0
31226.0,2020-01-11,"(386.75, 724.5]",2,2,0
31226.0,2020-01-11,"(724.5, 1062.25]",7,14,-7
31226.0,2020-01-11,"(1062.25, 1400.0]",2,7,-5
31227.0,2020-01-11,"(31.656, 369.0]",1,1,0
31227.0,2020-01-11,"(369.0, 705.0]",1,1,0
31227.0,2020-01-11,"(705.0, 1041.0]",12,21,-9
31227.0,2020-01-11,"(1041.0, 1377.0]",1,7,-6
31228.0,2020-01-11,"(440.5, 773.0]",20,2,18
31228.0,2020-01-11,"(773.0, 1105.5]",36,34,2
31228.0,2020-01-11,"(1105.5, 1438.0]",13,64,-51
31229.0,2020-01-11,"(27.595, 380.25]",1,4,-3
31229.0,2020-01-11,"(380.25, 731.5]",30,64,-34
31229.0,2020-01-11,"(731.5, 1082.75]",44,88,-44
31229.0,2020-01-11,"(1082.75, 1434.0]",10,27,-17
31230.0,2020-01-11,"(358.75, 712.5]",8,1,7
31230.0,2020-01-11,"(712.5, 1066.25]",33,12,21
31230.0,2020-01-11,"(1066.25, 1420.0]",7,56,-49
31231.0,2020-01-11,"(507.29, 685.5]",2,3,-1
31231.0,2020-01-11,"(685.5, 863.0]",1,4,-3
31231.0,2020-01-11,"(863.0, 1040.5]",8,14,-6
31232.0,2020-01-11,"(5.581, 361.75]",1,3,-2
31232.0,2020-01-11,"(361.75, 716.5]",4,12,-8
31232.0,2020-01-11,"(716.5, 1071.25]",39,63,-24
31232.0,2020-01-11,"(1071.25, 1426.0]",12,24,-12
31233.0,2020-01-11,"(279.882, 560.5]",1,4,-3
31233.0,2020-01-11,"(560.5, 840.0]",9,13,-4
31233.0,2020-01-11,"(840.0, 1119.5]",10,19,-9
31233.0,2020-01-11,"(1119.5, 1399.0]",1,7,-6
31234.0,2020-01-11,"(410.5, 723.0]",10,1,9
31234.0,2020-01-11,"(723.0, 1035.5]",16,13,3
31234.0,2020-01-11,"(1035.5, 1348.0]",17,37,-20
31235.0,2020-01-11,"(520.338, 686.5]",2,3,-1
31235.0,2020-01-11,"(686.5, 852.0]",6,12,-6
31235.0,2020-01-11,"(852.0, 1017.5]",11,30,-19
31235.0,2020-01-11,"(1017.5, 1183.0]",6,18,-12
31236.0,2020-01-11,"(62.625, 407.75]",1,3,-2
31236.0,2020-01-11,"(407.75, 751.5]",5,5,0
31236.0,2020-01-11,"(751.5, 1095.25]",13,28,-15
31236.0,2020-01-11,"(1095.25, 1439.0]",2,5,-3
31237.0,2020-01-11,"(2.579, 359.25]",3,6,-3
31237.0,2020-01-11,"(359.25, 714.5]",7,15,-8
31237.0,2020-01-11,"(714.5, 1069.75]",17,31,-14
31237.0,2020-01-11,"(1069.75, 1425.0]",7,13,-6
31238.0,2020-01-11,"(35.607, 385.25]",1,2,-1
31238.0,2020-01-11,"(385.25, 733.5]",6,10,-4
31238.0,2020-01-11,"(733.5, 1081.75]",13,18,-5
31238.0,2020-01-11,"(1081.75, 1430.0]",5,11,-6
31239.0,2020-01-11,"(17.698, 344.5]",1,2,-1
31239.0,2020-01-11,"(344.5, 670.0]",7,11,-4
31239.0,2020-01-11,"(670.0, 995.5]",21,36,-15
31239.0,2020-01-11,"(995.5, 1321.0]",7,12,-5
31240.0,2020-01-11,"(609.421, 754.75]",4,4,0
31240.0,2020-01-11,"(754.75, 899.5]",6,18,-12
31240.0,2020-01-11,"(899.5, 1044.25]",20,44,-24
31240.0,2020-01-11,"(1044.25, 1189.0]",4,9,-5
31241.0,2020-01-11,"(30.646, 370.5]",3,6,-3
31241.0,2020-01-11,"(370.5, 709.0]",10,30,-20
31241.0,2020-01-11,"(709.0, 1047.5]",12,29,-17
31241.0,2020-01-11,"(1047.5, 1386.0]",11,22,-11
31242.0,2020-01-11,"(606.172, 814.0]",3,4,-1
31242.0,2020-01-11,"(814.0, 1021.0]",1,4,-3
31242.0,2020-01-11,"(1021.0, 1228.0]",1,2,-1
31242.0,2020-01-11,"(1228.0, 1435.0]",2,4,-2
31243.0,2020-01-11,"(473.075, 705.25]",4,4,0
31243.0,2020-01-11,"(705.25, 936.5]",6,11,-5
31243.0,2020-01-11,"(936.5, 1167.75]",8,11,-3
31243.0,2020-01-11,"(1167.75, 1399.0]",2,5,-3
31244.0,2020-01-11,"(12.622, 358.5]",3,5,-2
31244.0,2020-01-11,"(358.5, 703.0]",2,5,-3
31244.0,2020-01-11,"(703.0, 1047.5]",13,19,-6
31244.0,2020-01-11,"(1047.5, 1392.0]",12,17,-5
31245.0,2020-01-11,"(413.978, 670.5]",6,12,-6
31245.0,2020-01-11,"(670.5, 926.0]",11,23,-12
31245.0,2020-01-11,"(926.0, 1181.5]",15,23,-8
31245.0,2020-01-11,"(1181.5, 1437.0]",10,20,-10
31246.0,2020-01-11,"(59.64, 401.0]",3,6,-3
31246.0,2020-01-11,"(401.0, 741.0]",18,22,-4
31246.0,2020-01-11,"(741.0, 1081.0]",33,56,-23
31246.0,2020-01-11,"(1081.0, 1421.0]",16,29,-13
31247.0,2020-01-11,"(383.75, 735.5]",19,2,17
31247.0,2020-01-11,"(735.5, 1087.25]",68,29,39
31247.0,2020-01-11,"(1087.25, 1439.0]",14,133,-119
31248.0,2020-01-11,"(105.717, 427.75]",2,3,-1
31248.0,2020-01-11,"(427.75, 748.5]",14,23,-9
31248.0,2020-01-11,"(748.5, 1069.25]",73,161,-88
31248.0,2020-01-11,"(1069.25, 1390.0]",16,27,-11
31249.0,2020-01-11,"(492.144, 707.0]",5,9,-4
31249.0,2020-01-11,"(707.0, 921.0]",37,76,-39
31249.0,2020-01-11,"(921.0, 1135.0]",34,63,-29
31249.0,2020-01-11,"(1135.0, 1349.0]",7,9,-2
31250.0,2020-01-11,"(510.375, 667.25]",5,6,-1
31250.0,2020-01-11,"(979.75, 1136.0]",2,2,0
31251.0,2020-01-11,"(14.627, 359.25]",1,1,0
31251.0,2020-01-11,"(359.25, 702.5]",3,11,-8
31251.0,2020-01-11,"(702.5, 1045.75]",10,23,-13
31251.0,2020-01-11,"(1045.75, 1389.0]",8,13,-5
31252.0,2020-01-11,"(48.817, 345.75]",1,1,0
31252.0,2020-01-11,"(345.75, 641.5]",1,2,-1
31252.0,2020-01-11,"(641.5, 937.25]",8,12,-4
31252.0,2020-01-11,"(937.25, 1233.0]",1,3,-2
31253.0,2020-01-11,"(522.397, 673.75]",3,4,-1
31253.0,2020-01-11,"(673.75, 824.5]",3,4,-1
31253.0,2020-01-11,"(975.25, 1126.0]",5,2,3
31254.0,2020-01-11,"(112.682, 443.5]",2,3,-1
31254.0,2020-01-11,"(443.5, 773.0]",6,10,-4
31254.0,2020-01-11,"(773.0, 1102.5]",9,20,-11
31254.0,2020-01-11,"(1102.5, 1432.0]",3,4,-1
31255.0,2020-01-11,"(507.076, 739.0]",4,6,-2
31255.0,2020-01-11,"(739.0, 970.0]",1,3,-2
31255.0,2020-01-11,"(970.0, 1201.0]",4,4,0
31255.0,2020-01-11,"(1201.0, 1432.0]",5,8,-3
31256.0,2020-01-11,"(464.75, 789.5]",6,2,4
31256.0,2020-01-11,"(789.5, 1114.25]",17,10,7
31256.0,2020-01-11,"(1114.25, 1439.0]",5,33,-28
31257.0,2020-01-11,"(27.656, 365.0]",1,2,-1
31257.0,2020-01-11,"(365.0, 701.0]",11,21,-10
31257.0,2020-01-11,"(701.0, 1037.0]",11,32,-21
31257.0,2020-01-11,"(1037.0, 1373.0]",8,17,-9
31258.0,2020-01-11,"(163.733, 481.75]",2,3,-1
31258.0,2020-01-11,"(481.75, 798.5]",29,62,-33
31258.0,2020-01-11,"(798.5, 1115.25]",101,229,-128
31258.0,2020-01-11,"(1115.25, 1432.0]",9,28,-19
31259.0,2020-01-11,"(525.689, 603.75]",1,1,0
31260.0,2020-01-11,"(640.5, 959.75]",3,1,2
31260.0,2020-01-11,"(959.75, 1279.0]",12,1,11
31261.0,2020-01-11,"(720.644, 810.0]",4,7,-3
31261.0,2020-01-11,"(899.0, 988.0]",2,6,-4
31262.0,2020-01-11,"(522.119, 743.25]",3,6,-3
31262.0,2020-01-11,"(743.25, 963.5]",9,15,-6
31262.0,2020-01-11,"(963.5, 1183.75]",5,8,-3
31262.0,2020-01-11,"(1183.75, 1404.0]",1,3,-2
31263.0,2020-01-11,"(432.998, 684.5]",4,6,-2
31263.0,2020-01-11,"(684.5, 935.0]",8,14,-6
31263.0,2020-01-11,"(935.0, 1185.5]",5,9,-4
31263.0,2020-01-11,"(1185.5, 1436.0]",4,4,0
31264.0,2020-01-11,"(469.061, 704.75]",2,4,-2
31264.0,2020-01-11,"(704.75, 939.5]",6,13,-7
31264.0,2020-01-11,"(939.5, 1174.25]",7,13,-6
31264.0,2020-01-11,"(1174.25, 1409.0]",1,7,-6
31265.0,2020-01-11,"(2.564, 363.0]",3,3,0
31265.0,2020-01-11,"(363.0, 722.0]",13,21,-8
31265.0,2020-01-11,"(722.0, 1081.0]",20,42,-22
31265.0,2020-01-11,"(1081.0, 1440.0]",12,20,-8
31266.0,2020-01-11,"(0.594, 353.5]",2,6,-4
31266.0,2020-01-11,"(353.5, 705.0]",5,17,-12
31266.0,2020-01-11,"(705.0, 1056.5]",24,50,-26
31266.0,2020-01-11,"(1056.5, 1408.0]",24,42,-18
31267.0,2020-01-11,"(8.582, 364.5]",3,5,-2
31267.0,2020-01-11,"(364.5, 719.0]",4,11,-7
31267.0,2020-01-11,"(719.0, 1073.5]",7,26,-19
31267.0,2020-01-11,"(1073.5, 1428.0]",12,24,-12
31268.0,2020-01-11,"(8.58, 365.0]",3,8,-5
31268.0,2020-01-11,"(365.0, 720.0]",9,16,-7
31268.0,2020-01-11,"(720.0, 1075.0]",17,32,-15
31268.0,2020-01-11,"(1075.0, 1430.0]",18,32,-14
31269.0,2020-01-11,"(6.69, 335.5]",1,2,-1
31269.0,2020-01-11,"(335.5, 663.0]",6,9,-3
31269.0,2020-01-11,"(663.0, 990.5]",14,33,-19
31269.0,2020-01-11,"(990.5, 1318.0]",2,9,-7
31270.0,2020-01-11,"(378.5, 667.0]",2,1,1
31270.0,2020-01-11,"(667.0, 955.5]",11,6,5
31270.0,2020-01-11,"(955.5, 1244.0]",6,20,-14
31271.0,2020-01-11,"(248.844, 539.0]",1,5,-4
31271.0,2020-01-11,"(539.0, 828.0]",8,13,-5
31271.0,2020-01-11,"(828.0, 1117.0]",27,49,-22
31271.0,2020-01-11,"(1117.0, 1406.0]",6,9,-3
31272.0,2020-01-11,"(466.102, 691.5]",8,8,0
31272.0,2020-01-11,"(691.5, 916.0]",18,28,-10
31272.0,2020-01-11,"(916.0, 1140.5]",10,27,-17
31272.0,2020-01-11,"(1140.5, 1365.0]",1,2,-1
31273.0,2020-01-11,"(446.089, 674.75]",7,15,-8
31273.0,2020-01-11,"(674.75, 902.5]",17,39,-22
31273.0,2020-01-11,"(902.5, 1130.25]",13,23,-10
31273.0,2020-01-11,"(1130.25, 1358.0]",3,5,-2
31274.0,2020-01-11,"(15.073, 247.75]",1,3,-2
31274.0,2020-01-11,"(479.5, 711.25]",7,10,-3
31274.0,2020-01-11,"(711.25, 943.0]",5,8,-3
31275.0,2020-01-11,"(29.602, 380.5]",7,8,-1
31275.0,2020-01-11,"(380.5, 730.0]",4,11,-7
31275.0,2020-01-11,"(730.0, 1079.5]",20,35,-15
31275.0,2020-01-11,"(1079.5, 1429.0]",8,17,-9
31276.0,2020-01-11,"(438.497, 564.75]",2,2,0
31276.0,2020-01-11,"(564.75, 690.5]",2,5,-3
31276.0,2020-01-11,"(690.5, 816.25]",3,5,-2
31276.0,2020-01-11,"(816.25, 942.0]",2,4,-2
31277.0,2020-01-11,"(321.98, 578.0]",2,2,0
31277.0,2020-01-11,"(578.0, 833.0]",13,20,-7
31277.0,2020-01-11,"(833.0, 1088.0]",14,29,-15
31277.0,2020-01-11,"(1088.0, 1343.0]",5,10,-5
31278.0,2020-01-11,"(189.756, 502.0]",1,4,-3
31278.0,2020-01-11,"(502.0, 813.0]",16,33,-17
31278.0,2020-01-11,"(813.0, 1124.0]",17,36,-19
31278.0,2020-01-11,"(1124.0, 1435.0]",11,17,-6
31279.0,2020-01-11,"(602.47, 735.5]",2,4,-2
31279.0,2020-01-11,"(735.5, 868.0]",2,3,-1
31279.0,2020-01-11,"(868.0, 1000.5]",2,4,-2
31279.0,2020-01-11,"(1000.5, 1133.0]",2,4,-2
31280.0,2020-01-11,"(34.613, 382.75]",3,4,-1
31280.0,2020-01-11,"(382.75, 729.5]",13,29,-16
31280.0,2020-01-11,"(729.5, 1076.25]",11,23,-12
31280.0,2020-01-11,"(1076.25, 1423.0]",11,20,-9
31000.0,2020-01-12,"(698.993, 700.75]",1,1,0
31001.0,2020-01-12,"(540.328, 709.0]",2,3,-1
31001.0,2020-01-12,"(709.0, 877.0]",1,2,-1
31002.0,2020-01-12,"(556.418, 702.5]",2,3,-1
31002.0,2020-01-12,"(702.5, 848.0]",3,6,-3
31002.0,2020-01-12,"(848.0, 993.5]",2,6,-4
31002.0,2020-01-12,"(993.5, 1139.0]",1,3,-2
31003.0,2020-01-12,"(6.946, 271.5]",1,2,-1
31003.0,2020-01-12,"(535.0, 798.5]",2,6,-4
31003.0,2020-01-12,"(798.5, 1062.0]",7,13,-6
31004.0,2020-01-12,"(780.0, 934.5]",1,1,0
31004.0,2020-01-12,"(934.5, 1089.0]",2,1,1
31005.0,2020-01-12,"(601.392, 754.0]",1,6,-5
31005.0,2020-01-12,"(754.0, 906.0]",8,12,-4
31005.0,2020-01-12,"(906.0, 1058.0]",6,8,-2
31006.0,2020-01-12,"(532.496, 659.0]",1,3,-2
31006.0,2020-01-12,"(785.0, 911.0]",2,2,0
31006.0,2020-01-12,"(911.0, 1037.0]",4,3,1
31007.0,2020-01-12,"(582.193, 784.75]",4,9,-5
31007.0,2020-01-12,"(784.75, 986.5]",5,13,-8
31007.0,2020-01-12,"(986.5, 1188.25]",3,6,-3
31007.0,2020-01-12,"(1188.25, 1390.0]",1,1,0
31009.0,2020-01-12,"(778.25, 881.5]",3,5,-2
31009.0,2020-01-12,"(881.5, 984.75]",1,3,-2
31009.0,2020-01-12,"(984.75, 1088.0]",1,1,0
31010.0,2020-01-12,"(690.566, 799.5]",2,4,-2
31010.0,2020-01-12,"(799.5, 908.0]",1,3,-2
31010.0,2020-01-12,"(908.0, 1016.5]",3,8,-5
31010.0,2020-01-12,"(1016.5, 1125.0]",3,5,-2
31011.0,2020-01-12,"(619.514, 741.5]",2,5,-3
31011.0,2020-01-12,"(741.5, 863.0]",2,3,-1
31011.0,2020-01-12,"(863.0, 984.5]",1,2,-1
31011.0,2020-01-12,"(984.5, 1106.0]",3,5,-2
31012.0,2020-01-12,"(367.376, 524.0]",1,1,0
31012.0,2020-01-12,"(524.0, 680.0]",1,1,0
31012.0,2020-01-12,"(836.0, 992.0]",1,3,-2
31013.0,2020-01-12,"(696.616, 793.0]",1,2,-1
31013.0,2020-01-12,"(889.0, 985.0]",3,5,-2
31013.0,2020-01-12,"(985.0, 1081.0]",4,8,-4
31014.0,2020-01-12,"(441.04, 682.0]",8,13,-5
31014.0,2020-01-12,"(682.0, 922.0]",6,13,-7
31014.0,2020-01-12,"(922.0, 1162.0]",12,17,-5
31014.0,2020-01-12,"(1162.0, 1402.0]",3,5,-2
31015.0,2020-01-12,"(337.045, 576.75]",2,2,0
31015.0,2020-01-12,"(576.75, 815.5]",12,14,-2
31015.0,2020-01-12,"(815.5, 1054.25]",6,15,-9
31015.0,2020-01-12,"(1054.25, 1293.0]",5,5,0
31016.0,2020-01-12,"(487.333, 654.75]",1,6,-5
31016.0,2020-01-12,"(654.75, 821.5]",7,12,-5
31016.0,2020-01-12,"(821.5, 988.25]",3,6,-3
31016.0,2020-01-12,"(988.25, 1155.0]",6,9,-3
31017.0,2020-01-12,"(851.5, 1106.0]",2,1,1
31018.0,2020-01-12,"(747.75, 911.5]",2,1,1
31018.0,2020-01-12,"(911.5, 1075.25]",3,4,-1
31018.0,2020-01-12,"(1075.25, 1239.0]",1,4,-3
31019.0,2020-01-12,"(552.225, 746.75]",3,7,-4
31019.0,2020-01-12,"(746.75, 940.5]",3,4,-1
31019.0,2020-01-12,"(940.5, 1134.25]",2,4,-2
31019.0,2020-01-12,"(1134.25, 1328.0]",1,2,-1
31020.0,2020-01-12,"(12.128, 231.0]",1,1,0
31020.0,2020-01-12,"(449.0, 667.0]",2,3,-1
31020.0,2020-01-12,"(667.0, 885.0]",4,10,-6
31021.0,2020-01-12,"(527.35, 690.5]",2,2,0
31021.0,2020-01-12,"(690.5, 853.0]",1,5,-4
31021.0,2020-01-12,"(1015.5, 1178.0]",2,1,1
31022.0,2020-01-12,"(339.75, 583.5]",1,2,-1
31022.0,2020-01-12,"(827.25, 1071.0]",7,2,5
31023.0,2020-01-12,"(387.0, 709.0]",2,1,1
31023.0,2020-01-12,"(709.0, 1031.0]",2,6,-4
31023.0,2020-01-12,"(1031.0, 1353.0]",3,4,-1
31024.0,2020-01-12,"(319.0, 634.0]",2,1,1
31024.0,2020-01-12,"(634.0, 949.0]",1,4,-3
31024.0,2020-01-12,"(949.0, 1264.0]",3,6,-3
31025.0,2020-01-12,"(764.502, 889.5]",1,5,-4
31025.0,2020-01-12,"(889.5, 1014.0]",4,6,-2
31025.0,2020-01-12,"(1014.0, 1138.5]",2,4,-2
31025.0,2020-01-12,"(1138.5, 1263.0]",1,2,-1
31026.0,2020-01-12,"(734.25, 890.5]",2,1,1
31026.0,2020-01-12,"(890.5, 1046.75]",1,4,-3
31026.0,2020-01-12,"(1046.75, 1203.0]",1,1,0
31027.0,2020-01-12,"(5.721, 326.75]",1,1,0
31027.0,2020-01-12,"(646.5, 966.25]",2,3,-1
31027.0,2020-01-12,"(966.25, 1286.0]",6,4,2
31028.0,2020-01-12,"(539.329, 707.75]",1,2,-1
31028.0,2020-01-12,"(707.75, 875.5]",2,3,-1
31028.0,2020-01-12,"(1043.25, 1211.0]",2,4,-2
31029.0,2020-01-12,"(642.426, 786.5]",1,8,-7
31029.0,2020-01-12,"(786.5, 930.0]",1,2,-1
31029.0,2020-01-12,"(930.0, 1073.5]",5,7,-2
31029.0,2020-01-12,"(1073.5, 1217.0]",1,3,-2
31030.0,2020-01-12,"(548.305, 722.75]",1,3,-2
31030.0,2020-01-12,"(722.75, 896.5]",1,7,-6
31030.0,2020-01-12,"(896.5, 1070.25]",1,3,-2
31030.0,2020-01-12,"(1070.25, 1244.0]",1,1,0
31031.0,2020-01-12,"(828.0, 993.0]",1,1,0
31031.0,2020-01-12,"(993.0, 1158.0]",3,1,2
31032.0,2020-01-12,"(682.25, 701.0]",1,1,0
31033.0,2020-01-12,"(412.576, 519.0]",1,1,0
31033.0,2020-01-12,"(731.0, 837.0]",4,7,-3
31034.0,2020-01-12,"(101.023, 346.25]",1,1,0
31034.0,2020-01-12,"(346.25, 590.5]",1,1,0
31034.0,2020-01-12,"(590.5, 834.75]",1,3,-2
31034.0,2020-01-12,"(834.75, 1079.0]",6,10,-4
31035.0,2020-01-12,"(873.75, 977.5]",1,3,-2
31036.0,2020-01-12,"(1021.25, 1030.0]",1,1,0
31037.0,2020-01-12,"(616.596, 718.0]",1,7,-6
31037.0,2020-01-12,"(718.0, 819.0]",4,4,0
31037.0,2020-01-12,"(819.0, 920.0]",3,8,-5
31037.0,2020-01-12,"(920.0, 1021.0]",6,11,-5
31038.0,2020-01-12,"(847.973, 854.75]",3,3,0
31039.0,2020-01-12,"(629.433, 771.75]",5,7,-2
31039.0,2020-01-12,"(771.75, 913.5]",2,7,-5
31039.0,2020-01-12,"(913.5, 1055.25]",3,6,-3
31040.0,2020-01-12,"(223.978, 480.5]",1,1,0
31040.0,2020-01-12,"(480.5, 736.0]",1,3,-2
31040.0,2020-01-12,"(736.0, 991.5]",1,7,-6
31040.0,2020-01-12,"(991.5, 1247.0]",1,3,-2
31041.0,2020-01-12,"(557.253, 744.75]",3,7,-4
31041.0,2020-01-12,"(744.75, 931.5]",6,10,-4
31041.0,2020-01-12,"(931.5, 1118.25]",5,7,-2
31042.0,2020-01-12,"(480.22, 676.0]",5,6,-1
31042.0,2020-01-12,"(676.0, 871.0]",5,10,-5
31042.0,2020-01-12,"(1066.0, 1261.0]",1,3,-2
31043.0,2020-01-12,"(623.296, 800.0]",7,13,-6
31043.0,2020-01-12,"(800.0, 976.0]",1,6,-5
31043.0,2020-01-12,"(976.0, 1152.0]",4,8,-4
31043.0,2020-01-12,"(1152.0, 1328.0]",2,2,0
31044.0,2020-01-12,"(562.445, 701.75]",2,2,0
31044.0,2020-01-12,"(701.75, 840.5]",6,9,-3
31044.0,2020-01-12,"(840.5, 979.25]",4,7,-3
31044.0,2020-01-12,"(979.25, 1118.0]",2,5,-3
31045.0,2020-01-12,"(595.444, 735.0]",2,8,-6
31045.0,2020-01-12,"(874.0, 1013.0]",5,5,0
31045.0,2020-01-12,"(1013.0, 1152.0]",2,3,-1
31046.0,2020-01-12,"(523.597, 624.75]",1,3,-2
31046.0,2020-01-12,"(826.25, 927.0]",1,1,0
31047.0,2020-01-12,"(469.239, 660.25]",1,2,-1
31047.0,2020-01-12,"(660.25, 850.5]",4,10,-6
31047.0,2020-01-12,"(850.5, 1040.75]",3,4,-1
31047.0,2020-01-12,"(1040.75, 1231.0]",3,6,-3
31048.0,2020-01-12,"(524.392, 677.0]",2,4,-2
31048.0,2020-01-12,"(829.0, 981.0]",2,1,1
31048.0,2020-01-12,"(981.0, 1133.0]",1,4,-3
31049.0,2020-01-12,"(942.0, 1049.0]",3,1,2
31050.0,2020-01-12,"(618.592, 721.0]",1,1,0
31050.0,2020-01-12,"(823.0, 925.0]",1,2,-1
31050.0,2020-01-12,"(925.0, 1027.0]",4,5,-1
31051.0,2020-01-12,"(648.75, 783.5]",1,1,0
31051.0,2020-01-12,"(918.25, 1053.0]",2,2,0
31052.0,2020-01-12,"(549.515, 671.25]",4,6,-2
31052.0,2020-01-12,"(671.25, 792.5]",3,8,-5
31052.0,2020-01-12,"(792.5, 913.75]",2,2,0
31052.0,2020-01-12,"(913.75, 1035.0]",2,5,-3
31053.0,2020-01-12,"(842.833, 884.75]",1,2,-1
,,,,1.0,
,,,,1.0,
31055.0,2020-01-12,"(5.964, 266.0]",2,2,0
31055.0,2020-01-12,"(525.0, 784.0]",3,6,-3
31055.0,2020-01-12,"(784.0, 1043.0]",3,3,0
31056.0,2020-01-12,"(711.323, 881.25]",2,5,-3
31056.0,2020-01-12,"(881.25, 1050.5]",1,3,-2
31056.0,2020-01-12,"(1050.5, 1219.75]",1,1,0
31056.0,2020-01-12,"(1219.75, 1389.0]",1,1,0
31057.0,2020-01-12,"(853.873, 885.75]",1,2,-1
31057.0,2020-01-12,"(949.25, 981.0]",1,1,0
,,,,1.0,
,,,,1.0,
31059.0,2020-01-12,"(580.413, 727.75]",1,2,-1
31059.0,2020-01-12,"(1021.25, 1168.0]",1,1,0
31060.0,2020-01-12,"(456.08, 687.0]",2,3,-1
31060.0,2020-01-12,"(687.0, 917.0]",7,16,-9
31060.0,2020-01-12,"(917.0, 1147.0]",8,13,-5
31061.0,2020-01-12,"(402.75, 537.0]",1,1,0
31062.0,2020-01-12,"(454.375, 611.25]",3,5,-2
31062.0,2020-01-12,"(611.25, 767.5]",10,19,-9
31062.0,2020-01-12,"(767.5, 923.75]",10,24,-14
31062.0,2020-01-12,"(923.75, 1080.0]",15,26,-11
31063.0,2020-01-12,"(726.0, 810.0]",2,1,1
31063.0,2020-01-12,"(894.0, 978.0]",1,4,-3
31064.0,2020-01-12,"(571.444, 711.0]",6,12,-6
31064.0,2020-01-12,"(711.0, 850.0]",20,41,-21
31064.0,2020-01-12,"(850.0, 989.0]",31,64,-33
31064.0,2020-01-12,"(989.0, 1128.0]",16,34,-18
31065.0,2020-01-12,"(720.623, 815.25]",1,1,0
31065.0,2020-01-12,"(909.5, 1003.75]",1,2,-1
31065.0,2020-01-12,"(1003.75, 1098.0]",1,2,-1
31066.0,2020-01-12,"(716.59, 819.5]",1,2,-1
31066.0,2020-01-12,"(819.5, 922.0]",1,1,0
31066.0,2020-01-12,"(922.0, 1024.5]",1,2,-1
31066.0,2020-01-12,"(1024.5, 1127.0]",1,1,0
31067.0,2020-01-12,"(676.5, 768.0]",1,1,0
31067.0,2020-01-12,"(859.5, 951.0]",2,1,1
31068.0,2020-01-12,"(810.44, 951.0]",2,5,-3
31068.0,2020-01-12,"(1231.0, 1371.0]",1,1,0
31069.0,2020-01-12,"(911.0, 1091.0]",1,2,-1
31069.0,2020-01-12,"(1091.0, 1271.0]",2,2,0
31070.0,2020-01-12,"(1033.5, 1120.0]",2,2,0
31071.0,2020-01-12,"(392.299, 568.25]",1,3,-2
31071.0,2020-01-12,"(568.25, 743.5]",9,19,-10
31071.0,2020-01-12,"(743.5, 918.75]",9,24,-15
31071.0,2020-01-12,"(918.75, 1094.0]",11,15,-4
,,,,2.0,
31073.0,2020-01-12,"(517.399, 668.25]",1,2,-1
31073.0,2020-01-12,"(668.25, 818.5]",2,4,-2
31074.0,2020-01-12,"(564.419, 710.25]",4,7,-3
31074.0,2020-01-12,"(855.5, 1000.75]",1,1,0
31074.0,2020-01-12,"(1000.75, 1146.0]",2,4,-2
31075.0,2020-01-12,"(947.0, 1026.0]",1,2,-1
,,,,1.0,
,,,,1.0,
,,,,3.0,
31077.0,2020-01-12,"(608.536, 725.0]",8,19,-11
31077.0,2020-01-12,"(725.0, 841.0]",5,12,-7
31077.0,2020-01-12,"(841.0, 957.0]",9,18,-9
31077.0,2020-01-12,"(957.0, 1073.0]",3,4,-1
,,,,2.0,
31079.0,2020-01-12,"(559.488, 688.0]",2,6,-4
31079.0,2020-01-12,"(688.0, 816.0]",1,3,-2
31079.0,2020-01-12,"(816.0, 944.0]",1,3,-2
31079.0,2020-01-12,"(944.0, 1072.0]",3,4,-1
31080.0,2020-01-12,"(543.207, 742.25]",2,6,-4
31080.0,2020-01-12,"(742.25, 940.5]",5,17,-12
31080.0,2020-01-12,"(940.5, 1138.75]",3,5,-2
31080.0,2020-01-12,"(1138.75, 1337.0]",1,1,0
31081.0,2020-01-12,"(813.616, 910.0]",6,12,-6
31081.0,2020-01-12,"(1102.0, 1198.0]",4,5,-1
31082.0,2020-01-12,"(39.071, 272.25]",2,2,0
31082.0,2020-01-12,"(736.75, 969.0]",1,1,0
31083.0,2020-01-12,"(478.318, 649.5]",1,2,-1
31083.0,2020-01-12,"(649.5, 820.0]",1,2,-1
31083.0,2020-01-12,"(990.5, 1161.0]",2,3,-1
31084.0,2020-01-12,"(14.88, 296.0]",1,1,0
31084.0,2020-01-12,"(296.0, 576.0]",1,1,0
31084.0,2020-01-12,"(576.0, 856.0]",2,3,-1
31084.0,2020-01-12,"(856.0, 1136.0]",2,6,-4
31085.0,2020-01-12,"(959.5, 1052.0]",2,1,1
31086.0,2020-01-12,"(782.466, 916.5]",3,7,-4
31086.0,2020-01-12,"(1050.0, 1183.5]",2,1,1
31087.0,2020-01-12,"(593.473, 725.75]",2,2,0
31087.0,2020-01-12,"(725.75, 857.5]",2,9,-7
31087.0,2020-01-12,"(857.5, 989.25]",3,4,-1
31087.0,2020-01-12,"(989.25, 1121.0]",3,4,-1
31088.0,2020-01-12,"(798.679, 879.25]",2,3,-1
31088.0,2020-01-12,"(879.25, 959.5]",1,1,0
31089.0,2020-01-12,"(582.365, 741.75]",5,14,-9
31089.0,2020-01-12,"(741.75, 900.5]",8,18,-10
31089.0,2020-01-12,"(900.5, 1059.25]",3,10,-7
31089.0,2020-01-12,"(1059.25, 1218.0]",2,3,-1
31090.0,2020-01-12,"(761.791, 814.25]",1,2,-1
31090.0,2020-01-12,"(866.5, 918.75]",1,1,0
31090.0,2020-01-12,"(918.75, 971.0]",1,2,-1
31091.0,2020-01-12,"(465.252, 653.0]",1,4,-3
31091.0,2020-01-12,"(653.0, 840.0]",3,4,-1
31091.0,2020-01-12,"(840.0, 1027.0]",2,6,-4
31091.0,2020-01-12,"(1027.0, 1214.0]",2,2,0
31092.0,2020-01-12,"(20.974, 278.5]",2,2,0
31092.0,2020-01-12,"(791.5, 1048.0]",2,2,0
31093.0,2020-01-12,"(994.5, 1170.75]",1,2,-1
31093.0,2020-01-12,"(1170.75, 1347.0]",1,2,-1
,,,,1.0,
,,,,1.0,
31095.0,2020-01-12,"(672.544, 787.0]",2,2,0
31096.0,2020-01-12,"(534.0, 712.0]",2,1,1
31097.0,2020-01-12,"(555.193, 757.75]",2,10,-8
31097.0,2020-01-12,"(757.75, 959.5]",3,8,-5
31097.0,2020-01-12,"(959.5, 1161.25]",1,2,-1
31097.0,2020-01-12,"(1161.25, 1363.0]",5,6,-1
31098.0,2020-01-12,"(681.425, 825.75]",4,5,-1
31098.0,2020-01-12,"(825.75, 969.5]",6,6,0
31098.0,2020-01-12,"(1113.25, 1257.0]",3,1,2
31099.0,2020-01-12,"(-0.904, 226.0]",2,3,-1
31099.0,2020-01-12,"(678.0, 904.0]",4,4,0
31100.0,2020-01-12,"(752.635, 844.25]",4,7,-3
31100.0,2020-01-12,"(844.25, 935.5]",4,5,-1
31101.0,2020-01-12,"(14.65, 353.5]",3,7,-4
31101.0,2020-01-12,"(353.5, 691.0]",17,28,-11
31101.0,2020-01-12,"(691.0, 1028.5]",56,106,-50
31101.0,2020-01-12,"(1028.5, 1366.0]",27,51,-24
31102.0,2020-01-12,"(5.697, 332.75]",1,2,-1
31102.0,2020-01-12,"(658.5, 984.25]",10,10,0
31102.0,2020-01-12,"(984.25, 1310.0]",7,19,-12
31103.0,2020-01-12,"(117.791, 421.25]",1,1,0
31103.0,2020-01-12,"(421.25, 723.5]",10,33,-23
31103.0,2020-01-12,"(723.5, 1025.75]",8,36,-28
31103.0,2020-01-12,"(1025.75, 1328.0]",8,28,-20
31104.0,2020-01-12,"(19.682, 350.5]",3,5,-2
31104.0,2020-01-12,"(350.5, 680.0]",5,13,-8
31104.0,2020-01-12,"(680.0, 1009.5]",36,65,-29
31104.0,2020-01-12,"(1009.5, 1339.0]",14,36,-22
31105.0,2020-01-12,"(213.006, 462.5]",1,1,0
31105.0,2020-01-12,"(462.5, 711.0]",2,4,-2
31105.0,2020-01-12,"(711.0, 959.5]",4,10,-6
31105.0,2020-01-12,"(959.5, 1208.0]",3,6,-3
31106.0,2020-01-12,"(351.25, 686.5]",2,2,0
31106.0,2020-01-12,"(686.5, 1021.75]",4,4,0
31106.0,2020-01-12,"(1021.75, 1357.0]",2,4,-2
31107.0,2020-01-12,"(-0.375, 344.75]",3,4,-1
31107.0,2020-01-12,"(344.75, 688.5]",9,27,-18
31107.0,2020-01-12,"(688.5, 1032.25]",10,34,-24
31107.0,2020-01-12,"(1032.25, 1376.0]",14,26,-12
31108.0,2020-01-12,"(10.679, 342.25]",1,4,-3
31108.0,2020-01-12,"(342.25, 672.5]",6,23,-17
31108.0,2020-01-12,"(672.5, 1002.75]",41,79,-38
31108.0,2020-01-12,"(1002.75, 1333.0]",18,27,-9
31109.0,2020-01-12,"(4.619, 351.25]",3,10,-7
31109.0,2020-01-12,"(351.25, 696.5]",13,21,-8
31109.0,2020-01-12,"(696.5, 1041.75]",20,43,-23
31109.0,2020-01-12,"(1041.75, 1387.0]",13,29,-16
31110.0,2020-01-12,"(40.618, 387.5]",2,2,0
31110.0,2020-01-12,"(387.5, 733.0]",15,30,-15
31110.0,2020-01-12,"(733.0, 1078.5]",16,35,-19
31110.0,2020-01-12,"(1078.5, 1424.0]",11,19,-8
31111.0,2020-01-12,"(0.566, 360.5]",3,6,-3
31111.0,2020-01-12,"(360.5, 719.0]",10,22,-12
31111.0,2020-01-12,"(719.0, 1077.5]",22,40,-18
31111.0,2020-01-12,"(1077.5, 1436.0]",14,25,-11
31112.0,2020-01-12,"(553.515, 675.25]",2,4,-2
31112.0,2020-01-12,"(675.25, 796.5]",5,11,-6
31112.0,2020-01-12,"(796.5, 917.75]",5,8,-3
31112.0,2020-01-12,"(917.75, 1039.0]",1,1,0
31113.0,2020-01-12,"(0.655, 338.25]",3,5,-2
31113.0,2020-01-12,"(338.25, 674.5]",2,12,-10
31113.0,2020-01-12,"(674.5, 1010.75]",11,36,-25
31113.0,2020-01-12,"(1010.75, 1347.0]",9,15,-6
31114.0,2020-01-12,"(8.588, 363.0]",3,8,-5
31114.0,2020-01-12,"(363.0, 716.0]",3,14,-11
31114.0,2020-01-12,"(716.0, 1069.0]",20,43,-23
31114.0,2020-01-12,"(1069.0, 1422.0]",7,17,-10
31115.0,2020-01-12,"(306.983, 562.25]",1,6,-5
31115.0,2020-01-12,"(562.25, 816.5]",12,30,-18
31115.0,2020-01-12,"(816.5, 1070.75]",5,12,-7
31115.0,2020-01-12,"(1070.75, 1325.0]",4,12,-8
31116.0,2020-01-12,"(13.615, 361.25]",3,5,-2
31116.0,2020-01-12,"(361.25, 707.5]",11,20,-9
31116.0,2020-01-12,"(707.5, 1053.75]",19,44,-25
31116.0,2020-01-12,"(1053.75, 1400.0]",6,10,-4
31117.0,2020-01-12,"(460.08, 691.0]",3,23,-20
31117.0,2020-01-12,"(691.0, 921.0]",13,31,-18
31117.0,2020-01-12,"(921.0, 1151.0]",8,19,-11
31117.0,2020-01-12,"(1151.0, 1381.0]",3,6,-3
31118.0,2020-01-12,"(24.819, 321.25]",3,4,-1
31118.0,2020-01-12,"(321.25, 616.5]",1,7,-6
31118.0,2020-01-12,"(616.5, 911.75]",7,20,-13
31118.0,2020-01-12,"(911.75, 1207.0]",10,18,-8
31119.0,2020-01-12,"(75.729, 394.75]",3,6,-3
31119.0,2020-01-12,"(394.75, 712.5]",10,26,-16
31119.0,2020-01-12,"(712.5, 1030.25]",14,31,-17
31119.0,2020-01-12,"(1030.25, 1348.0]",7,14,-7
31120.0,2020-01-12,"(4.589, 358.75]",4,6,-2
31120.0,2020-01-12,"(358.75, 711.5]",5,10,-5
31120.0,2020-01-12,"(711.5, 1064.25]",14,34,-20
31120.0,2020-01-12,"(1064.25, 1417.0]",7,9,-2
31121.0,2020-01-12,"(34.689, 363.75]",1,1,0
31121.0,2020-01-12,"(363.75, 691.5]",6,9,-3
31121.0,2020-01-12,"(691.5, 1019.25]",10,24,-14
31121.0,2020-01-12,"(1019.25, 1347.0]",10,19,-9
31122.0,2020-01-12,"(10.636, 353.0]",2,3,-1
31122.0,2020-01-12,"(353.0, 694.0]",7,18,-11
31122.0,2020-01-12,"(694.0, 1035.0]",7,14,-7
31122.0,2020-01-12,"(1035.0, 1376.0]",2,8,-6
31123.0,2020-01-12,"(11.664, 347.0]",1,3,-2
31123.0,2020-01-12,"(681.0, 1015.0]",7,9,-2
31123.0,2020-01-12,"(1015.0, 1349.0]",4,14,-10
31124.0,2020-01-12,"(2.695, 330.25]",3,4,-1
31124.0,2020-01-12,"(330.25, 656.5]",6,20,-14
31124.0,2020-01-12,"(656.5, 982.75]",19,74,-55
31124.0,2020-01-12,"(982.75, 1309.0]",19,39,-20
31125.0,2020-01-12,"(36.625, 381.75]",1,2,-1
31125.0,2020-01-12,"(381.75, 725.5]",12,35,-23
31125.0,2020-01-12,"(725.5, 1069.25]",42,84,-42
31125.0,2020-01-12,"(1069.25, 1413.0]",14,22,-8
31126.0,2020-01-12,"(1.682, 332.5]",3,5,-2
31126.0,2020-01-12,"(332.5, 662.0]",1,9,-8
31126.0,2020-01-12,"(662.0, 991.5]",7,28,-21
31126.0,2020-01-12,"(991.5, 1321.0]",9,14,-5
,,,,2.0,
31128.0,2020-01-12,"(40.678, 372.5]",2,3,-1
31128.0,2020-01-12,"(372.5, 703.0]",7,15,-8
31128.0,2020-01-12,"(703.0, 1033.5]",32,63,-31
31128.0,2020-01-12,"(1033.5, 1364.0]",19,27,-8
31129.0,2020-01-12,"(481.214, 678.5]",4,9,-5
31129.0,2020-01-12,"(678.5, 875.0]",7,9,-2
31129.0,2020-01-12,"(875.0, 1071.5]",22,32,-10
31129.0,2020-01-12,"(1071.5, 1268.0]",2,6,-4
31130.0,2020-01-12,"(662.0, 988.0]",11,1,10
31130.0,2020-01-12,"(988.0, 1314.0]",5,4,1
31131.0,2020-01-12,"(-0.347, 337.75]",4,4,0
31131.0,2020-01-12,"(337.75, 674.5]",1,4,-3
31131.0,2020-01-12,"(674.5, 1011.25]",6,16,-10
31131.0,2020-01-12,"(1011.25, 1348.0]",2,3,-1
31200.0,2020-01-12,"(20.614, 368.5]",1,2,-1
31200.0,2020-01-12,"(368.5, 715.0]",24,48,-24
31200.0,2020-01-12,"(715.0, 1061.5]",47,101,-54
31200.0,2020-01-12,"(1061.5, 1408.0]",13,23,-10
31201.0,2020-01-12,"(384.25, 731.5]",33,1,32
31201.0,2020-01-12,"(731.5, 1078.75]",55,58,-3
31201.0,2020-01-12,"(1078.75, 1426.0]",17,108,-91
31202.0,2020-01-12,"(32.674, 365.5]",1,4,-3
31202.0,2020-01-12,"(365.5, 697.0]",14,21,-7
31202.0,2020-01-12,"(697.0, 1028.5]",47,92,-45
31202.0,2020-01-12,"(1028.5, 1360.0]",17,37,-20
31203.0,2020-01-12,"(-0.353, 339.25]",3,10,-7
31203.0,2020-01-12,"(339.25, 677.5]",23,30,-7
31203.0,2020-01-12,"(677.5, 1015.75]",49,83,-34
31203.0,2020-01-12,"(1015.75, 1354.0]",22,38,-16
31204.0,2020-01-12,"(57.839, 349.25]",1,1,0
31204.0,2020-01-12,"(349.25, 639.5]",6,13,-7
31204.0,2020-01-12,"(639.5, 929.75]",6,18,-12
31204.0,2020-01-12,"(929.75, 1220.0]",9,16,-7
31205.0,2020-01-12,"(189.873, 472.75]",2,3,-1
31205.0,2020-01-12,"(472.75, 754.5]",4,7,-3
31205.0,2020-01-12,"(754.5, 1036.25]",6,15,-9
31205.0,2020-01-12,"(1036.25, 1318.0]",4,13,-9
31206.0,2020-01-12,"(902.638, 993.5]",5,12,-7
31206.0,2020-01-12,"(993.5, 1084.0]",2,4,-2
31206.0,2020-01-12,"(1084.0, 1174.5]",3,3,0
31207.0,2020-01-12,"(642.288, 821.0]",2,7,-5
31207.0,2020-01-12,"(821.0, 999.0]",4,8,-4
31207.0,2020-01-12,"(999.0, 1177.0]",2,3,-1
31207.0,2020-01-12,"(1177.0, 1355.0]",1,2,-1
31208.0,2020-01-12,"(505.343, 670.25]",6,8,-2
31208.0,2020-01-12,"(670.25, 834.5]",14,19,-5
31208.0,2020-01-12,"(834.5, 998.75]",2,3,-1
31208.0,2020-01-12,"(998.75, 1163.0]",2,4,-2
31209.0,2020-01-12,"(475.119, 696.25]",4,10,-6
31209.0,2020-01-12,"(696.25, 916.5]",13,22,-9
31209.0,2020-01-12,"(916.5, 1136.75]",14,23,-9
31211.0,2020-01-12,"(41.978, 298.5]",1,1,0
31211.0,2020-01-12,"(554.0, 809.5]",8,2,6
31211.0,2020-01-12,"(809.5, 1065.0]",4,11,-7
31212.0,2020-01-12,"(47.708, 372.0]",2,2,0
31212.0,2020-01-12,"(372.0, 695.0]",14,18,-4
31212.0,2020-01-12,"(695.0, 1018.0]",23,46,-23
31212.0,2020-01-12,"(1018.0, 1341.0]",10,22,-12
31213.0,2020-01-12,"(531.48, 662.0]",3,4,-1
31213.0,2020-01-12,"(662.0, 792.0]",5,11,-6
31213.0,2020-01-12,"(792.0, 922.0]",3,5,-2
31213.0,2020-01-12,"(922.0, 1052.0]",4,8,-4
31214.0,2020-01-12,"(6.66, 343.0]",4,6,-2
31214.0,2020-01-12,"(343.0, 678.0]",15,28,-13
31214.0,2020-01-12,"(678.0, 1013.0]",29,66,-37
31214.0,2020-01-12,"(1013.0, 1348.0]",25,42,-17
31215.0,2020-01-12,"(405.272, 588.0]",2,5,-3
31215.0,2020-01-12,"(588.0, 770.0]",21,37,-16
31215.0,2020-01-12,"(770.0, 952.0]",18,30,-12
31215.0,2020-01-12,"(952.0, 1134.0]",15,24,-9
31216.0,2020-01-12,"(720.335, 887.25]",3,3,0
31216.0,2020-01-12,"(887.25, 1053.5]",4,7,-3
31216.0,2020-01-12,"(1053.5, 1219.75]",3,3,0
31216.0,2020-01-12,"(1219.75, 1386.0]",3,4,-1
31217.0,2020-01-12,"(848.75, 949.5]",3,1,2
31217.0,2020-01-12,"(949.5, 1050.25]",6,10,-4
31217.0,2020-01-12,"(1050.25, 1151.0]",1,8,-7
31218.0,2020-01-12,"(496.137, 712.75]",3,4,-1
31218.0,2020-01-12,"(712.75, 928.5]",2,4,-2
31218.0,2020-01-12,"(928.5, 1144.25]",7,17,-10
31219.0,2020-01-12,"(487.331, 655.25]",1,5,-4
31219.0,2020-01-12,"(655.25, 822.5]",10,17,-7
31219.0,2020-01-12,"(822.5, 989.75]",15,33,-18
31219.0,2020-01-12,"(989.75, 1157.0]",4,18,-14
31220.0,2020-01-12,"(337.215, 534.25]",1,1,0
31220.0,2020-01-12,"(534.25, 730.5]",2,3,-1
31220.0,2020-01-12,"(730.5, 926.75]",3,6,-3
31220.0,2020-01-12,"(926.75, 1123.0]",3,6,-3
31221.0,2020-01-12,"(34.947, 299.25]",2,3,-1
31221.0,2020-01-12,"(299.25, 562.5]",2,2,0
31221.0,2020-01-12,"(562.5, 825.75]",11,12,-1
31221.0,2020-01-12,"(825.75, 1089.0]",15,29,-14
31222.0,2020-01-12,"(593.477, 724.75]",2,3,-1
31222.0,2020-01-12,"(724.75, 855.5]",3,5,-2
31222.0,2020-01-12,"(855.5, 986.25]",12,12,0
31222.0,2020-01-12,"(986.25, 1117.0]",5,9,-4
31223.0,2020-01-12,"(11.659, 348.25]",1,7,-6
31223.0,2020-01-12,"(348.25, 683.5]",23,33,-10
31223.0,2020-01-12,"(683.5, 1018.75]",31,70,-39
31223.0,2020-01-12,"(1018.75, 1354.0]",21,38,-17
31224.0,2020-01-12,"(170.885, 450.75]",1,1,0
31224.0,2020-01-12,"(729.5, 1008.25]",7,4,3
31224.0,2020-01-12,"(1008.25, 1287.0]",1,8,-7
31225.0,2020-01-12,"(307.0, 599.0]",2,4,-2
31225.0,2020-01-12,"(599.0, 891.0]",11,3,8
31225.0,2020-01-12,"(891.0, 1183.0]",20,16,4
31226.0,2020-01-12,"(661.332, 829.0]",4,7,-3
31226.0,2020-01-12,"(829.0, 996.0]",5,9,-4
31226.0,2020-01-12,"(996.0, 1163.0]",2,5,-3
31226.0,2020-01-12,"(1163.0, 1330.0]",3,3,0
31227.0,2020-01-12,"(516.172, 724.0]",1,3,-2
31227.0,2020-01-12,"(724.0, 931.0]",7,13,-6
31227.0,2020-01-12,"(931.0, 1138.0]",11,14,-3
31227.0,2020-01-12,"(1138.0, 1345.0]",1,6,-5
31228.0,2020-01-12,"(376.5, 728.0]",6,4,2
31228.0,2020-01-12,"(728.0, 1079.5]",30,15,15
31228.0,2020-01-12,"(1079.5, 1431.0]",11,50,-39
31229.0,2020-01-12,"(14.586, 369.5]",4,8,-4
31229.0,2020-01-12,"(369.5, 723.0]",32,66,-34
31229.0,2020-01-12,"(723.0, 1076.5]",42,96,-54
31229.0,2020-01-12,"(1076.5, 1430.0]",20,34,-14
31230.0,2020-01-12,"(313.75, 609.5]",4,2,2
31230.0,2020-01-12,"(609.5, 905.25]",26,7,19
31230.0,2020-01-12,"(905.25, 1201.0]",21,39,-18
31231.0,2020-01-12,"(674.325, 843.75]",16,23,-7
31231.0,2020-01-12,"(843.75, 1012.5]",10,19,-9
31231.0,2020-01-12,"(1012.5, 1181.25]",1,3,-2
31232.0,2020-01-12,"(13.628, 358.0]",3,4,-1
31232.0,2020-01-12,"(358.0, 701.0]",6,13,-7
31232.0,2020-01-12,"(701.0, 1044.0]",36,56,-20
31232.0,2020-01-12,"(1044.0, 1387.0]",16,37,-21
31233.0,2020-01-12,"(51.664, 387.0]",4,4,0
31233.0,2020-01-12,"(387.0, 721.0]",2,4,-2
31233.0,2020-01-12,"(721.0, 1055.0]",6,14,-8
31233.0,2020-01-12,"(1055.0, 1389.0]",6,9,-3
31234.0,2020-01-12,"(4.65, 343.5]",2,2,0
31234.0,2020-01-12,"(343.5, 681.0]",10,20,-10
31234.0,2020-01-12,"(681.0, 1018.5]",17,40,-23
31234.0,2020-01-12,"(1018.5, 1356.0]",10,20,-10
31235.0,2020-01-12,"(600.477, 731.75]",4,10,-6
31235.0,2020-01-12,"(731.75, 862.5]",10,18,-8
31235.0,2020-01-12,"(862.5, 993.25]",17,21,-4
31235.0,2020-01-12,"(993.25, 1124.0]",7,18,-11
31236.0,2020-01-12,"(623.218, 819.5]",11,19,-8
31236.0,2020-01-12,"(819.5, 1015.0]",18,24,-6
31236.0,2020-01-12,"(1015.0, 1210.5]",6,21,-15
31236.0,2020-01-12,"(1210.5, 1406.0]",2,3,-1
31237.0,2020-01-12,"(494.189, 697.75]",8,19,-11
31237.0,2020-01-12,"(697.75, 900.5]",18,33,-15
31237.0,2020-01-12,"(900.5, 1103.25]",13,26,-13
31237.0,2020-01-12,"(1103.25, 1306.0]",3,6,-3
31238.0,2020-01-12,"(52.969, 311.75]",1,1,0
31238.0,2020-01-12,"(311.75, 569.5]",1,2,-1
31238.0,2020-01-12,"(569.5, 827.25]",4,7,-3
31238.0,2020-01-12,"(827.25, 1085.0]",2,4,-2
31239.0,2020-01-12,"(467.029, 710.75]",8,14,-6
31239.0,2020-01-12,"(710.75, 953.5]",14,24,-10
31239.0,2020-01-12,"(953.5, 1196.25]",8,19,-11
31239.0,2020-01-12,"(1196.25, 1439.0]",2,4,-2
31240.0,2020-01-12,"(532.41, 680.5]",6,16,-10
31240.0,2020-01-12,"(680.5, 828.0]",9,18,-9
31240.0,2020-01-12,"(828.0, 975.5]",25,45,-20
31240.0,2020-01-12,"(975.5, 1123.0]",10,26,-16
31241.0,2020-01-12,"(46.67, 380.5]",4,5,-1
31241.0,2020-01-12,"(380.5, 713.0]",11,23,-12
31241.0,2020-01-12,"(713.0, 1045.5]",19,51,-32
31241.0,2020-01-12,"(1045.5, 1378.0]",16,23,-7
31242.0,2020-01-12,"(556.297, 732.75]",5,7,-2
31242.0,2020-01-12,"(732.75, 908.5]",3,3,0
31242.0,2020-01-12,"(908.5, 1084.25]",2,4,-2
31242.0,2020-01-12,"(1084.25, 1260.0]",2,2,0
31243.0,2020-01-12,"(457.204, 657.0]",1,1,0
31243.0,2020-01-12,"(657.0, 856.0]",2,8,-6
31243.0,2020-01-12,"(856.0, 1055.0]",6,8,-2
31243.0,2020-01-12,"(1055.0, 1254.0]",2,7,-5
31244.0,2020-01-12,"(7.849, 296.75]",3,4,-1
31244.0,2020-01-12,"(296.75, 584.5]",2,2,0
31244.0,2020-01-12,"(584.5, 872.25]",12,17,-5
31244.0,2020-01-12,"(872.25, 1160.0]",7,13,-6
31245.0,2020-01-12,"(371.75, 716.5]",8,1,7
31245.0,2020-01-12,"(716.5, 1061.25]",27,14,13
31245.0,2020-01-12,"(1061.25, 1406.0]",7,55,-48
31246.0,2020-01-12,"(31.66, 368.0]",2,3,-1
31246.0,2020-01-12,"(368.0, 703.0]",25,35,-10
31246.0,2020-01-12,"(703.0, 1038.0]",34,57,-23
31246.0,2020-01-12,"(1038.0, 1373.0]",8,18,-10
31247.0,2020-01-12,"(-1.102, 275.5]",2,2,0
31247.0,2020-01-12,"(275.5, 551.0]",4,8,-4
31247.0,2020-01-12,"(551.0, 826.5]",17,29,-12
31247.0,2020-01-12,"(826.5, 1102.0]",67,123,-56
31248.0,2020-01-12,"(458.092, 686.0]",19,27,-8
31248.0,2020-01-12,"(686.0, 913.0]",28,66,-38
31248.0,2020-01-12,"(913.0, 1140.0]",34,73,-39
31248.0,2020-01-12,"(1140.0, 1367.0]",12,15,-3
31249.0,2020-01-12,"(516.144, 731.0]",15,28,-13
31249.0,2020-01-12,"(731.0, 945.0]",41,83,-42
31249.0,2020-01-12,"(945.0, 1159.0]",34,66,-32
31249.0,2020-01-12,"(1159.0, 1373.0]",2,3,-1
31250.0,2020-01-12,"(-1.148, 287.0]",2,4,-2
31250.0,2020-01-12,"(287.0, 574.0]",1,1,0
31250.0,2020-01-12,"(574.0, 861.0]",7,11,-4
31250.0,2020-01-12,"(861.0, 1148.0]",3,6,-3
31251.0,2020-01-12,"(21.851, 310.25]",2,2,0
31251.0,2020-01-12,"(310.25, 597.5]",1,2,-1
31251.0,2020-01-12,"(597.5, 884.75]",12,30,-18
31251.0,2020-01-12,"(884.75, 1172.0]",12,20,-8
31252.0,2020-01-12,"(663.57, 771.5]",4,4,0
31252.0,2020-01-12,"(771.5, 879.0]",3,5,-2
31253.0,2020-01-12,"(643.5, 942.25]",2,1,1
31253.0,2020-01-12,"(942.25, 1241.0]",4,4,0
31254.0,2020-01-12,"(651.0, 907.0]",4,3,1
31254.0,2020-01-12,"(907.0, 1163.0]",5,6,-1
31254.0,2020-01-12,"(1163.0, 1419.0]",1,5,-4
31255.0,2020-01-12,"(380.102, 605.5]",3,4,-1
31255.0,2020-01-12,"(605.5, 830.0]",9,12,-3
31255.0,2020-01-12,"(830.0, 1054.5]",6,11,-5
31255.0,2020-01-12,"(1054.5, 1279.0]",3,5,-2
31256.0,2020-01-12,"(359.75, 698.5]",1,2,-1
31256.0,2020-01-12,"(698.5, 1037.25]",12,4,8
31256.0,2020-01-12,"(1037.25, 1376.0]",6,22,-16
31257.0,2020-01-12,"(500.213, 697.75]",4,6,-2
31257.0,2020-01-12,"(697.75, 894.5]",8,12,-4
31257.0,2020-01-12,"(894.5, 1091.25]",20,33,-13
31257.0,2020-01-12,"(1091.25, 1288.0]",3,6,-3
31258.0,2020-01-12,"(439.009, 687.75]",9,18,-9
31258.0,2020-01-12,"(687.75, 935.5]",67,140,-73
31258.0,2020-01-12,"(935.5, 1183.25]",43,79,-36
31258.0,2020-01-12,"(1183.25, 1431.0]",8,19,-11
,,,,1.0,
,,,,1.0,
31260.0,2020-01-12,"(592.282, 772.5]",4,8,-4
31260.0,2020-01-12,"(772.5, 952.0]",2,7,-5
31260.0,2020-01-12,"(952.0, 1131.5]",5,7,-2
31260.0,2020-01-12,"(1131.5, 1311.0]",5,6,-1
31261.0,2020-01-12,"(714.512, 837.0]",2,7,-5
31261.0,2020-01-12,"(837.0, 959.0]",4,5,-1
31261.0,2020-01-12,"(959.0, 1081.0]",1,6,-5
31261.0,2020-01-12,"(1081.0, 1203.0]",4,7,-3
31262.0,2020-01-12,"(539.171, 747.25]",2,3,-1
31262.0,2020-01-12,"(747.25, 954.5]",3,10,-7
31262.0,2020-01-12,"(954.5, 1161.75]",4,5,-1
31262.0,2020-01-12,"(1161.75, 1369.0]",3,6,-3
31263.0,2020-01-12,"(355.0, 700.0]",9,3,6
31263.0,2020-01-12,"(700.0, 1045.0]",25,15,10
31263.0,2020-01-12,"(1045.0, 1390.0]",9,43,-34
31264.0,2020-01-12,"(337.5, 662.0]",3,1,2
31264.0,2020-01-12,"(662.0, 986.5]",13,7,6
31264.0,2020-01-12,"(986.5, 1311.0]",4,20,-16
31265.0,2020-01-12,"(19.708, 344.0]",2,3,-1
31265.0,2020-01-12,"(344.0, 667.0]",6,14,-8
31265.0,2020-01-12,"(667.0, 990.0]",25,48,-23
31265.0,2020-01-12,"(990.0, 1313.0]",17,33,-16
31266.0,2020-01-12,"(37.606, 387.5]",5,7,-2
31266.0,2020-01-12,"(387.5, 736.0]",6,28,-22
31266.0,2020-01-12,"(736.0, 1084.5]",36,74,-38
31266.0,2020-01-12,"(1084.5, 1433.0]",11,18,-7
31267.0,2020-01-12,"(89.753, 402.75]",1,2,-1
31267.0,2020-01-12,"(402.75, 714.5]",3,7,-4
31267.0,2020-01-12,"(714.5, 1026.25]",20,32,-12
31267.0,2020-01-12,"(1026.25, 1338.0]",12,19,-7
31268.0,2020-01-12,"(-0.331, 333.75]",2,9,-7
31268.0,2020-01-12,"(333.75, 666.5]",13,19,-6
31268.0,2020-01-12,"(666.5, 999.25]",14,33,-19
31268.0,2020-01-12,"(999.25, 1332.0]",13,21,-8
31269.0,2020-01-12,"(17.748, 332.0]",3,3,0
31269.0,2020-01-12,"(332.0, 645.0]",5,11,-6
31269.0,2020-01-12,"(645.0, 958.0]",24,51,-27
31269.0,2020-01-12,"(958.0, 1271.0]",8,17,-9
31270.0,2020-01-12,"(505.413, 652.75]",2,4,-2
31270.0,2020-01-12,"(652.75, 799.5]",1,5,-4
31270.0,2020-01-12,"(799.5, 946.25]",8,15,-7
31270.0,2020-01-12,"(946.25, 1093.0]",9,15,-6
31271.0,2020-01-12,"(525.125, 744.75]",5,8,-3
31271.0,2020-01-12,"(744.75, 963.5]",30,50,-20
31271.0,2020-01-12,"(963.5, 1182.25]",9,18,-9
31271.0,2020-01-12,"(1182.25, 1401.0]",6,18,-12
31272.0,2020-01-12,"(511.224, 706.0]",7,10,-3
31272.0,2020-01-12,"(706.0, 900.0]",17,24,-7
31272.0,2020-01-12,"(900.0, 1094.0]",5,13,-8
31272.0,2020-01-12,"(1094.0, 1288.0]",1,1,0
31273.0,2020-01-12,"(524.258, 710.5]",3,7,-4
31273.0,2020-01-12,"(710.5, 896.0]",10,17,-7
31273.0,2020-01-12,"(896.0, 1081.5]",12,27,-15
31273.0,2020-01-12,"(1081.5, 1267.0]",3,4,-1
31274.0,2020-01-12,"(458.261, 643.75]",1,3,-2
31274.0,2020-01-12,"(643.75, 828.5]",4,7,-3
31274.0,2020-01-12,"(828.5, 1013.25]",1,2,-1
31274.0,2020-01-12,"(1013.25, 1198.0]",3,6,-3
31275.0,2020-01-12,"(175.818, 472.5]",3,5,-2
31275.0,2020-01-12,"(472.5, 768.0]",5,12,-7
31275.0,2020-01-12,"(768.0, 1063.5]",18,29,-11
31275.0,2020-01-12,"(1063.5, 1359.0]",6,14,-8
31276.0,2020-01-12,"(7.752, 321.0]",2,3,-1
31276.0,2020-01-12,"(633.0, 945.0]",3,1,2
31277.0,2020-01-12,"(328.966, 588.5]",2,6,-4
31277.0,2020-01-12,"(588.5, 847.0]",9,20,-11
31277.0,2020-01-12,"(847.0, 1105.5]",15,20,-5
31277.0,2020-01-12,"(1105.5, 1364.0]",2,4,-2
31278.0,2020-01-12,"(3.566, 363.5]",1,2,-1
31278.0,2020-01-12,"(363.5, 722.0]",13,29,-16
31278.0,2020-01-12,"(722.0, 1080.5]",24,47,-23
31278.0,2020-01-12,"(1080.5, 1439.0]",10,23,-13
31279.0,2020-01-12,"(661.631, 754.25]",3,4,-1
31279.0,2020-01-12,"(754.25, 846.5]",1,2,-1
31279.0,2020-01-12,"(846.5, 938.75]",2,5,-3
31279.0,2020-01-12,"(938.75, 1031.0]",2,2,0
31280.0,2020-01-12,"(32.698, 359.5]",1,2,-1
31280.0,2020-01-12,"(359.5, 685.0]",6,14,-8
31280.0,2020-01-12,"(685.0, 1010.5]",21,34,-13
31280.0,2020-01-12,"(1010.5, 1336.0]",10,15,-5
31000.0,2020-01-13,"(897.0, 994.0]",1,1,0
31001.0,2020-01-13,"(894.75, 956.5]",1,1,0
31001.0,2020-01-13,"(1018.25, 1080.0]",1,1,0
31002.0,2020-01-13,"(437.347, 601.25]",5,7,-2
31002.0,2020-01-13,"(764.5, 927.75]",1,1,0
31002.0,2020-01-13,"(927.75, 1091.0]",3,5,-2
31003.0,2020-01-13,"(401.013, 648.75]",3,5,-2
31003.0,2020-01-13,"(648.75, 895.5]",2,4,-2
31003.0,2020-01-13,"(895.5, 1142.25]",2,7,-5
31003.0,2020-01-13,"(1142.25, 1389.0]",2,4,-2
31004.0,2020-01-13,"(661.25, 825.5]",2,3,-1
31004.0,2020-01-13,"(825.5, 989.75]",2,4,-2
31004.0,2020-01-13,"(989.75, 1154.0]",2,2,0
31005.0,2020-01-13,"(420.029, 663.75]",2,4,-2
31005.0,2020-01-13,"(663.75, 906.5]",2,4,-2
31005.0,2020-01-13,"(906.5, 1149.25]",3,11,-8
31005.0,2020-01-13,"(1149.25, 1392.0]",1,4,-3
31006.0,2020-01-13,"(411.122, 631.5]",1,5,-4
31006.0,2020-01-13,"(631.5, 851.0]",1,3,-2
31006.0,2020-01-13,"(851.0, 1070.5]",2,2,0
31006.0,2020-01-13,"(1070.5, 1290.0]",4,8,-4
31007.0,2020-01-13,"(420.067, 654.25]",11,24,-13
31007.0,2020-01-13,"(654.25, 887.5]",2,4,-2
31007.0,2020-01-13,"(887.5, 1120.75]",7,17,-10
31007.0,2020-01-13,"(1120.75, 1354.0]",3,8,-5
31009.0,2020-01-13,"(447.064, 682.0]",3,3,0
31009.0,2020-01-13,"(682.0, 916.0]",1,1,0
31010.0,2020-01-13,"(647.648, 736.0]",1,1,0
31010.0,2020-01-13,"(912.0, 1000.0]",1,3,-2
31011.0,2020-01-13,"(383.117, 604.75]",8,8,0
31011.0,2020-01-13,"(604.75, 825.5]",1,4,-3
31011.0,2020-01-13,"(825.5, 1046.25]",1,2,-1
31011.0,2020-01-13,"(1046.25, 1267.0]",2,5,-3
31012.0,2020-01-13,"(405.108, 629.0]",3,4,-1
31012.0,2020-01-13,"(629.0, 852.0]",1,2,-1
31012.0,2020-01-13,"(852.0, 1075.0]",1,4,-3
31012.0,2020-01-13,"(1075.0, 1298.0]",2,3,-1
31013.0,2020-01-13,"(666.0, 824.0]",2,2,0
31013.0,2020-01-13,"(982.0, 1140.0]",3,3,0
31014.0,2020-01-13,"(304.908, 579.0]",15,25,-10
31014.0,2020-01-13,"(579.0, 852.0]",8,10,-2
31014.0,2020-01-13,"(852.0, 1125.0]",17,34,-17
31014.0,2020-01-13,"(1125.0, 1398.0]",8,11,-3
31015.0,2020-01-13,"(28.826, 323.5]",2,2,0
31015.0,2020-01-13,"(323.5, 617.0]",12,12,0
31015.0,2020-01-13,"(617.0, 910.5]",5,10,-5
31015.0,2020-01-13,"(910.5, 1204.0]",8,18,-10
31016.0,2020-01-13,"(342.121, 562.75]",4,8,-4
31016.0,2020-01-13,"(782.5, 1002.25]",2,4,-2
31016.0,2020-01-13,"(1002.25, 1222.0]",9,17,-8
31017.0,2020-01-13,"(467.142, 682.5]",4,6,-2
31017.0,2020-01-13,"(682.5, 897.0]",1,3,-2
31017.0,2020-01-13,"(897.0, 1111.5]",2,9,-7
31017.0,2020-01-13,"(1111.5, 1326.0]",2,7,-5
31018.0,2020-01-13,"(695.0, 784.0]",1,4,-3
31019.0,2020-01-13,"(456.144, 671.0]",1,3,-2
31019.0,2020-01-13,"(671.0, 885.0]",1,2,-1
31019.0,2020-01-13,"(885.0, 1099.0]",2,4,-2
31019.0,2020-01-13,"(1099.0, 1313.0]",2,3,-1
31020.0,2020-01-13,"(410.018, 656.5]",3,6,-3
31020.0,2020-01-13,"(656.5, 902.0]",3,6,-3
31020.0,2020-01-13,"(902.0, 1147.5]",1,1,0
31020.0,2020-01-13,"(1147.5, 1393.0]",1,4,-3
31021.0,2020-01-13,"(468.139, 684.25]",2,6,-4
31021.0,2020-01-13,"(684.25, 899.5]",2,5,-3
31021.0,2020-01-13,"(899.5, 1114.75]",2,6,-4
31021.0,2020-01-13,"(1114.75, 1330.0]",2,7,-5
31022.0,2020-01-13,"(408.091, 636.25]",2,7,-5
31022.0,2020-01-13,"(636.25, 863.5]",1,1,0
31022.0,2020-01-13,"(1090.75, 1318.0]",3,3,0
31023.0,2020-01-13,"(513.188, 717.0]",2,2,0
31023.0,2020-01-13,"(920.0, 1123.0]",2,2,0
31024.0,2020-01-13,"(414.181, 619.75]",3,6,-3
31024.0,2020-01-13,"(619.75, 824.5]",5,7,-2
31024.0,2020-01-13,"(824.5, 1029.25]",3,6,-3
31024.0,2020-01-13,"(1029.25, 1234.0]",5,10,-5
31025.0,2020-01-13,"(490.253, 677.75]",1,3,-2
31025.0,2020-01-13,"(677.75, 864.5]",1,1,0
31025.0,2020-01-13,"(1051.25, 1238.0]",2,4,-2
31026.0,2020-01-13,"(789.5, 1111.25]",2,2,0
31026.0,2020-01-13,"(1111.25, 1433.0]",1,3,-2
31027.0,2020-01-13,"(26.871, 310.25]",1,1,0
31027.0,2020-01-13,"(874.75, 1157.0]",4,2,2
31028.0,2020-01-13,"(481.101, 706.75]",2,5,-3
31028.0,2020-01-13,"(706.75, 931.5]",1,3,-2
31028.0,2020-01-13,"(931.5, 1156.25]",2,6,-4
31028.0,2020-01-13,"(1156.25, 1381.0]",2,5,-3
31029.0,2020-01-13,"(461.164, 671.0]",1,8,-7
31029.0,2020-01-13,"(671.0, 880.0]",2,3,-1
31029.0,2020-01-13,"(880.0, 1089.0]",1,2,-1
31029.0,2020-01-13,"(1089.0, 1298.0]",4,5,-1
31030.0,2020-01-13,"(334.94, 601.0]",2,10,-8
31030.0,2020-01-13,"(866.0, 1131.0]",5,3,2
31030.0,2020-01-13,"(1131.0, 1396.0]",1,8,-7
31031.0,2020-01-13,"(873.5, 1092.25]",3,5,-2
31031.0,2020-01-13,"(1092.25, 1311.0]",3,8,-5
31032.0,2020-01-13,"(1003.75, 1182.0]",1,1,0
31033.0,2020-01-13,"(527.1, 753.0]",1,2,-1
31033.0,2020-01-13,"(753.0, 978.0]",1,1,0
31033.0,2020-01-13,"(978.0, 1203.0]",1,1,0
31034.0,2020-01-13,"(520.115, 742.25]",2,5,-3
31034.0,2020-01-13,"(742.25, 963.5]",1,2,-1
31035.0,2020-01-13,"(586.322, 756.5]",1,2,-1
31035.0,2020-01-13,"(756.5, 926.0]",1,1,0
31035.0,2020-01-13,"(926.0, 1095.5]",1,1,0
31035.0,2020-01-13,"(1095.5, 1265.0]",3,7,-4
31036.0,2020-01-13,"(646.5, 853.0]",1,5,-4
31036.0,2020-01-13,"(853.0, 1059.5]",3,2,1
31036.0,2020-01-13,"(1059.5, 1266.0]",4,4,0
31037.0,2020-01-13,"(415.093, 642.75]",14,19,-5
31037.0,2020-01-13,"(642.75, 869.5]",7,13,-6
31037.0,2020-01-13,"(869.5, 1096.25]",5,15,-10
31037.0,2020-01-13,"(1096.25, 1323.0]",1,10,-9
31038.0,2020-01-13,"(480.175, 687.25]",4,4,0
31039.0,2020-01-13,"(392.253, 579.75]",1,4,-3
31039.0,2020-01-13,"(766.5, 953.25]",3,2,1
31039.0,2020-01-13,"(953.25, 1140.0]",3,6,-3
31040.0,2020-01-13,"(389.223, 584.25]",3,6,-3
31040.0,2020-01-13,"(778.5, 972.75]",1,1,0
31040.0,2020-01-13,"(972.75, 1167.0]",1,3,-2
31041.0,2020-01-13,"(468.088, 697.0]",4,4,0
31041.0,2020-01-13,"(1153.0, 1381.0]",1,5,-4
31042.0,2020-01-13,"(450.148, 664.0]",3,5,-2
31042.0,2020-01-13,"(877.0, 1090.0]",1,9,-8
31042.0,2020-01-13,"(1090.0, 1303.0]",1,1,0
31043.0,2020-01-13,"(418.343, 583.25]",2,3,-1
31043.0,2020-01-13,"(911.75, 1076.0]",3,1,2
31044.0,2020-01-13,"(463.319, 634.25]",2,3,-1
31044.0,2020-01-13,"(974.75, 1145.0]",1,3,-2
31045.0,2020-01-13,"(544.408, 693.0]",5,9,-4
31045.0,2020-01-13,"(989.0, 1137.0]",4,4,0
31046.0,2020-01-13,"(778.75, 866.0]",2,1,1
31047.0,2020-01-13,"(40.878, 322.5]",1,1,0
31047.0,2020-01-13,"(322.5, 603.0]",14,23,-9
31047.0,2020-01-13,"(603.0, 883.5]",3,6,-3
31047.0,2020-01-13,"(883.5, 1164.0]",9,28,-19
31048.0,2020-01-13,"(388.16, 599.0]",5,7,-2
31048.0,2020-01-13,"(1019.0, 1229.0]",3,3,0
31049.0,2020-01-13,"(541.466, 675.5]",2,2,0
31050.0,2020-01-13,"(807.75, 943.0]",3,2,1
31051.0,2020-01-13,"(862.0, 1142.5]",7,2,5
31051.0,2020-01-13,"(1142.5, 1423.0]",3,8,-5
31052.0,2020-01-13,"(496.371, 654.25]",3,5,-2
31052.0,2020-01-13,"(654.25, 811.5]",2,3,-1
31052.0,2020-01-13,"(968.75, 1126.0]",1,2,-1
31053.0,2020-01-13,"(987.75, 1317.0]",2,1,1
31054.0,2020-01-13,"(747.75, 997.0]",1,1,0
31055.0,2020-01-13,"(447.187, 651.25]",1,3,-2
31055.0,2020-01-13,"(1057.75, 1261.0]",2,1,1
31056.0,2020-01-13,"(392.986, 647.5]",1,2,-1
31056.0,2020-01-13,"(647.5, 901.0]",1,1,0
31056.0,2020-01-13,"(901.0, 1154.5]",1,4,-3
31056.0,2020-01-13,"(1154.5, 1408.0]",4,4,0
,,,,2.0,
31058.0,2020-01-13,"(760.322, 930.5]",1,1,0
31058.0,2020-01-13,"(930.5, 1100.0]",1,1,0
31058.0,2020-01-13,"(1269.5, 1439.0]",2,3,-1
31059.0,2020-01-13,"(565.0, 644.0]",1,2,-1
31059.0,2020-01-13,"(644.0, 723.0]",1,1,0
31060.0,2020-01-13,"(628.235, 820.25]",1,1,0
31060.0,2020-01-13,"(1011.5, 1202.75]",1,1,0
31061.0,2020-01-13,"(626.5, 659.0]",1,1,0
31062.0,2020-01-13,"(491.311, 664.25]",2,4,-2
31062.0,2020-01-13,"(836.5, 1008.75]",3,2,1
31062.0,2020-01-13,"(1008.75, 1181.0]",3,6,-3
,,,,2.0,
31064.0,2020-01-13,"(489.283, 669.25]",2,4,-2
31064.0,2020-01-13,"(669.25, 848.5]",2,6,-4
31064.0,2020-01-13,"(848.5, 1027.75]",3,6,-3
31064.0,2020-01-13,"(1027.75, 1207.0]",5,10,-5
31065.0,2020-01-13,"(149.115, 371.25]",1,1,0
31065.0,2020-01-13,"(813.75, 1035.0]",1,1,0
,,,,1.0,
,,,,1.0,
,,,,1.0,
31067.0,2020-01-13,"(420.309, 593.75]",2,4,-2
31067.0,2020-01-13,"(939.25, 1112.0]",2,1,1
31068.0,2020-01-13,"(501.146, 715.5]",1,4,-3
31068.0,2020-01-13,"(715.5, 929.0]",1,3,-2
31068.0,2020-01-13,"(1142.5, 1356.0]",3,3,0
31069.0,2020-01-13,"(644.75, 873.5]",1,4,-3
31069.0,2020-01-13,"(873.5, 1102.25]",2,2,0
31069.0,2020-01-13,"(1102.25, 1331.0]",3,2,1
31070.0,2020-01-13,"(899.5, 1063.25]",1,2,-1
31070.0,2020-01-13,"(1063.25, 1227.0]",1,1,0
31071.0,2020-01-13,"(433.303, 608.25]",1,4,-3
31071.0,2020-01-13,"(608.25, 782.5]",2,3,-1
31071.0,2020-01-13,"(782.5, 956.75]",1,3,-2
31071.0,2020-01-13,"(956.75, 1131.0]",7,7,0
,,,,1.0,
,,,,2.0,
,,,,1.0,
31073.0,2020-01-13,"(498.963, 508.25]",1,1,0
31073.0,2020-01-13,"(508.25, 517.5]",1,1,0
31073.0,2020-01-13,"(526.75, 536.0]",1,2,-1
31074.0,2020-01-13,"(933.25, 1117.0]",3,2,1
31075.0,2020-01-13,"(968.5, 1112.0]",1,1,0
31076.0,2020-01-13,"(342.75, 672.5]",1,1,0
31076.0,2020-01-13,"(672.5, 1002.25]",2,2,0
31076.0,2020-01-13,"(1002.25, 1332.0]",2,3,-1
31077.0,2020-01-13,"(453.213, 650.75]",1,5,-4
31077.0,2020-01-13,"(650.75, 847.5]",2,2,0
31077.0,2020-01-13,"(847.5, 1044.25]",4,8,-4
31077.0,2020-01-13,"(1044.25, 1241.0]",3,4,-1
31078.0,2020-01-13,"(461.386, 615.5]",8,9,-1
31078.0,2020-01-13,"(615.5, 769.0]",1,2,-1
31078.0,2020-01-13,"(922.5, 1076.0]",1,8,-7
31079.0,2020-01-13,"(460.078, 691.5]",1,9,-8
31079.0,2020-01-13,"(691.5, 922.0]",1,3,-2
31079.0,2020-01-13,"(922.0, 1152.5]",2,3,-1
31079.0,2020-01-13,"(1152.5, 1383.0]",5,8,-3
31080.0,2020-01-13,"(300.904, 576.0]",1,6,-5
31080.0,2020-01-13,"(576.0, 850.0]",1,2,-1
31080.0,2020-01-13,"(850.0, 1124.0]",3,6,-3
31080.0,2020-01-13,"(1124.0, 1398.0]",5,5,0
31081.0,2020-01-13,"(444.314, 616.5]",1,1,0
31081.0,2020-01-13,"(616.5, 788.0]",1,2,-1
31081.0,2020-01-13,"(788.0, 959.5]",1,2,-1
31082.0,2020-01-13,"(539.463, 674.25]",2,2,0
31082.0,2020-01-13,"(942.75, 1077.0]",1,2,-1
31083.0,2020-01-13,"(561.25, 719.5]",2,3,-1
31083.0,2020-01-13,"(719.5, 877.75]",2,4,-2
31083.0,2020-01-13,"(877.75, 1036.0]",2,2,0
31084.0,2020-01-13,"(568.437, 709.75]",6,7,-1
31084.0,2020-01-13,"(709.75, 850.5]",2,4,-2
31085.0,2020-01-13,"(973.75, 1126.0]",3,2,1
31086.0,2020-01-13,"(713.5, 861.25]",1,2,-1
31086.0,2020-01-13,"(861.25, 1009.0]",2,1,1
31087.0,2020-01-13,"(525.406, 674.5]",3,5,-2
31087.0,2020-01-13,"(971.5, 1120.0]",1,2,-1
31088.0,2020-01-13,"(617.25, 798.5]",1,3,-2
31088.0,2020-01-13,"(798.5, 979.75]",1,2,-1
31088.0,2020-01-13,"(979.75, 1161.0]",4,1,3
31089.0,2020-01-13,"(361.25, 698.5]",8,1,7
31089.0,2020-01-13,"(698.5, 1035.75]",4,15,-11
31089.0,2020-01-13,"(1035.75, 1373.0]",4,12,-8
31090.0,2020-01-13,"(883.5, 1038.0]",1,1,0
31091.0,2020-01-13,"(847.0, 1070.0]",3,3,0
31091.0,2020-01-13,"(1070.0, 1293.0]",6,4,2
31092.0,2020-01-13,"(1066.75, 1266.0]",3,2,1
,,,,1.0,
,,,,2.0,
,,,,2.0,
,,,,2.0,
31094.0,2020-01-13,"(505.213, 702.75]",1,1,0
31094.0,2020-01-13,"(899.5, 1096.25]",2,2,0
31094.0,2020-01-13,"(1096.25, 1293.0]",1,2,-1
,,,,1.0,
,,,,1.0,
31096.0,2020-01-13,"(504.43, 647.5]",1,1,0
31096.0,2020-01-13,"(932.5, 1075.0]",1,2,-1
31097.0,2020-01-13,"(467.3, 643.0]",1,3,-2
31097.0,2020-01-13,"(818.0, 993.0]",1,1,0
31097.0,2020-01-13,"(993.0, 1168.0]",2,1,1
31098.0,2020-01-13,"(442.151, 655.25]",6,12,-6
31098.0,2020-01-13,"(655.25, 867.5]",1,4,-3
31098.0,2020-01-13,"(867.5, 1079.75]",7,12,-5
31098.0,2020-01-13,"(1079.75, 1292.0]",1,4,-3
31099.0,2020-01-13,"(912.5, 1060.0]",2,1,1
31100.0,2020-01-13,"(304.75, 606.5]",11,1,10
31100.0,2020-01-13,"(606.5, 908.25]",4,13,-9
31100.0,2020-01-13,"(908.25, 1210.0]",1,9,-8
31101.0,2020-01-13,"(18.58, 375.0]",2,3,-1
31101.0,2020-01-13,"(375.0, 730.0]",8,40,-32
31101.0,2020-01-13,"(730.0, 1085.0]",32,47,-15
31101.0,2020-01-13,"(1085.0, 1440.0]",27,42,-15
31102.0,2020-01-13,"(404.5, 735.0]",1,3,-2
31102.0,2020-01-13,"(735.0, 1065.5]",5,14,-9
31102.0,2020-01-13,"(1065.5, 1396.0]",14,6,8
31103.0,2020-01-13,"(338.922, 609.5]",2,27,-25
31103.0,2020-01-13,"(609.5, 879.0]",2,15,-13
31103.0,2020-01-13,"(879.0, 1148.5]",9,25,-16
31103.0,2020-01-13,"(1148.5, 1418.0]",5,13,-8
31104.0,2020-01-13,"(451.023, 696.25]",5,21,-16
31104.0,2020-01-13,"(696.25, 940.5]",5,6,-1
31104.0,2020-01-13,"(940.5, 1184.75]",14,27,-13
31104.0,2020-01-13,"(1184.75, 1429.0]",11,21,-10
31105.0,2020-01-13,"(767.25, 948.5]",1,11,-10
31105.0,2020-01-13,"(948.5, 1129.75]",5,2,3
31105.0,2020-01-13,"(1129.75, 1311.0]",1,8,-7
31106.0,2020-01-13,"(664.5, 893.0]",2,3,-1
31106.0,2020-01-13,"(893.0, 1121.5]",3,3,0
31106.0,2020-01-13,"(1121.5, 1350.0]",4,4,0
31107.0,2020-01-13,"(342.98, 599.0]",4,20,-16
31107.0,2020-01-13,"(599.0, 854.0]",2,4,-2
31107.0,2020-01-13,"(854.0, 1109.0]",10,13,-3
31107.0,2020-01-13,"(1109.0, 1364.0]",6,14,-8
31108.0,2020-01-13,"(344.983, 600.25]",14,29,-15
31108.0,2020-01-13,"(600.25, 854.5]",15,31,-16
31108.0,2020-01-13,"(854.5, 1108.75]",22,30,-8
31108.0,2020-01-13,"(1108.75, 1363.0]",7,14,-7
31109.0,2020-01-13,"(14.579, 371.25]",1,1,0
31109.0,2020-01-13,"(371.25, 726.5]",7,18,-11
31109.0,2020-01-13,"(726.5, 1081.75]",11,16,-5
31109.0,2020-01-13,"(1081.75, 1437.0]",15,24,-9
31110.0,2020-01-13,"(313.878, 595.5]",17,37,-20
31110.0,2020-01-13,"(595.5, 876.0]",6,11,-5
31110.0,2020-01-13,"(876.0, 1156.5]",27,45,-18
31110.0,2020-01-13,"(1156.5, 1437.0]",5,14,-9
31111.0,2020-01-13,"(333.962, 594.5]",3,18,-15
31111.0,2020-01-13,"(594.5, 854.0]",6,11,-5
31111.0,2020-01-13,"(854.0, 1113.5]",14,21,-7
31111.0,2020-01-13,"(1113.5, 1373.0]",6,9,-3
31112.0,2020-01-13,"(767.5, 890.25]",2,4,-2
31112.0,2020-01-13,"(890.25, 1013.0]",3,1,2
31113.0,2020-01-13,"(610.5, 880.0]",2,22,-20
31113.0,2020-01-13,"(880.0, 1149.5]",7,8,-1
31113.0,2020-01-13,"(1149.5, 1419.0]",8,13,-5
31114.0,2020-01-13,"(22.686, 352.5]",1,2,-1
31114.0,2020-01-13,"(352.5, 681.0]",4,28,-24
31114.0,2020-01-13,"(681.0, 1009.5]",8,15,-7
31114.0,2020-01-13,"(1009.5, 1338.0]",31,41,-10
31115.0,2020-01-13,"(862.5, 1120.25]",15,15,0
31115.0,2020-01-13,"(1120.25, 1378.0]",9,6,3
31116.0,2020-01-13,"(306.943, 572.25]",7,23,-16
31116.0,2020-01-13,"(572.25, 836.5]",7,10,-3
31116.0,2020-01-13,"(836.5, 1100.75]",16,26,-10
31116.0,2020-01-13,"(1100.75, 1365.0]",11,15,-4
31117.0,2020-01-13,"(305.983, 561.25]",3,13,-10
31117.0,2020-01-13,"(561.25, 815.5]",1,12,-11
31117.0,2020-01-13,"(815.5, 1069.75]",2,4,-2
31117.0,2020-01-13,"(1069.75, 1324.0]",8,13,-5
31118.0,2020-01-13,"(411.171, 619.25]",3,15,-12
31118.0,2020-01-13,"(619.25, 826.5]",2,6,-4
31118.0,2020-01-13,"(826.5, 1033.75]",3,10,-7
31118.0,2020-01-13,"(1033.75, 1241.0]",15,20,-5
31119.0,2020-01-13,"(309.961, 570.75]",5,22,-17
31119.0,2020-01-13,"(570.75, 830.5]",3,5,-2
31119.0,2020-01-13,"(830.5, 1090.25]",9,16,-7
31119.0,2020-01-13,"(1090.25, 1350.0]",20,30,-10
31120.0,2020-01-13,"(459.027, 703.25]",1,18,-17
31120.0,2020-01-13,"(703.25, 946.5]",3,10,-7
31120.0,2020-01-13,"(946.5, 1189.75]",15,27,-12
31120.0,2020-01-13,"(1189.75, 1433.0]",11,15,-4
31121.0,2020-01-13,"(362.969, 621.75]",16,24,-8
31121.0,2020-01-13,"(621.75, 879.5]",6,15,-9
31121.0,2020-01-13,"(879.5, 1137.25]",5,13,-8
31121.0,2020-01-13,"(1137.25, 1395.0]",5,12,-7
31122.0,2020-01-13,"(76.686, 406.5]",1,2,-1
31122.0,2020-01-13,"(406.5, 735.0]",2,11,-9
31122.0,2020-01-13,"(735.0, 1063.5]",6,12,-6
31122.0,2020-01-13,"(1063.5, 1392.0]",10,13,-3
31123.0,2020-01-13,"(355.045, 594.75]",1,7,-6
31123.0,2020-01-13,"(594.75, 833.5]",1,1,0
31123.0,2020-01-13,"(833.5, 1072.25]",1,5,-4
31123.0,2020-01-13,"(1072.25, 1311.0]",7,14,-7
31124.0,2020-01-13,"(349.915, 622.25]",18,54,-36
31124.0,2020-01-13,"(622.25, 893.5]",12,28,-16
31124.0,2020-01-13,"(893.5, 1164.75]",15,51,-36
31124.0,2020-01-13,"(1164.75, 1436.0]",10,30,-20
31125.0,2020-01-13,"(346.956, 609.0]",9,29,-20
31125.0,2020-01-13,"(609.0, 870.0]",4,14,-10
31125.0,2020-01-13,"(870.0, 1131.0]",23,32,-9
31125.0,2020-01-13,"(1131.0, 1392.0]",16,25,-9
31126.0,2020-01-13,"(372.072, 605.0]",3,20,-17
31126.0,2020-01-13,"(605.0, 837.0]",4,8,-4
31126.0,2020-01-13,"(837.0, 1069.0]",6,15,-9
31126.0,2020-01-13,"(1069.0, 1301.0]",19,29,-10
,,,,2.0,
31128.0,2020-01-13,"(46.669, 380.75]",5,6,-1
31128.0,2020-01-13,"(380.75, 713.5]",33,53,-20
31128.0,2020-01-13,"(713.5, 1046.25]",27,43,-16
31128.0,2020-01-13,"(1046.25, 1379.0]",12,26,-14
31129.0,2020-01-13,"(374.041, 614.75]",17,19,-2
31129.0,2020-01-13,"(614.75, 854.5]",6,17,-11
31129.0,2020-01-13,"(854.5, 1094.25]",6,10,-4
31129.0,2020-01-13,"(1094.25, 1334.0]",4,6,-2
31130.0,2020-01-13,"(20.631, 364.25]",1,3,-2
31130.0,2020-01-13,"(364.25, 706.5]",2,7,-5
31130.0,2020-01-13,"(706.5, 1048.75]",8,17,-9
31130.0,2020-01-13,"(1048.75, 1391.0]",10,17,-7
31131.0,2020-01-13,"(863.0, 1111.0]",1,17,-16
31131.0,2020-01-13,"(1111.0, 1359.0]",4,4,0
31200.0,2020-01-13,"(349.25, 698.5]",23,2,21
31200.0,2020-01-13,"(698.5, 1047.75]",21,43,-22
31200.0,2020-01-13,"(1047.75, 1397.0]",17,39,-22
31201.0,2020-01-13,"(289.864, 575.0]",18,46,-28
31201.0,2020-01-13,"(575.0, 859.0]",17,28,-11
31201.0,2020-01-13,"(859.0, 1143.0]",35,63,-28
31201.0,2020-01-13,"(1143.0, 1427.0]",16,33,-17
31202.0,2020-01-13,"(349.93, 618.5]",9,25,-16
31202.0,2020-01-13,"(618.5, 886.0]",5,13,-8
31202.0,2020-01-13,"(886.0, 1153.5]",28,43,-15
31202.0,2020-01-13,"(1153.5, 1421.0]",10,22,-12
31203.0,2020-01-13,"(444.5, 773.0]",11,4,7
31203.0,2020-01-13,"(773.0, 1101.5]",20,28,-8
31203.0,2020-01-13,"(1101.5, 1430.0]",11,34,-23
31204.0,2020-01-13,"(-0.434, 359.5]",1,1,0
31204.0,2020-01-13,"(359.5, 718.0]",16,21,-5
31204.0,2020-01-13,"(718.0, 1076.5]",7,23,-16
31204.0,2020-01-13,"(1076.5, 1435.0]",9,17,-8
31205.0,2020-01-13,"(34.613, 382.75]",1,2,-1
31205.0,2020-01-13,"(382.75, 729.5]",40,45,-5
31205.0,2020-01-13,"(729.5, 1076.25]",11,22,-11
31205.0,2020-01-13,"(1076.25, 1423.0]",3,27,-24
31206.0,2020-01-13,"(522.469, 655.75]",5,7,-2
31206.0,2020-01-13,"(921.25, 1054.0]",4,1,3
31207.0,2020-01-13,"(732.25, 943.5]",1,2,-1
31207.0,2020-01-13,"(1154.75, 1366.0]",4,1,3
31208.0,2020-01-13,"(562.277, 743.75]",6,9,-3
31208.0,2020-01-13,"(743.75, 924.5]",2,4,-2
31208.0,2020-01-13,"(924.5, 1105.25]",10,18,-8
31208.0,2020-01-13,"(1105.25, 1286.0]",7,10,-3
31209.0,2020-01-13,"(423.132, 641.0]",3,5,-2
31209.0,2020-01-13,"(641.0, 858.0]",1,2,-1
31209.0,2020-01-13,"(858.0, 1075.0]",1,2,-1
31211.0,2020-01-13,"(310.082, 540.5]",4,6,-2
31211.0,2020-01-13,"(540.5, 770.0]",2,3,-1
31211.0,2020-01-13,"(770.0, 999.5]",5,8,-3
31211.0,2020-01-13,"(999.5, 1229.0]",5,10,-5
31212.0,2020-01-13,"(411.994, 664.5]",27,40,-13
31212.0,2020-01-13,"(664.5, 916.0]",7,17,-10
31212.0,2020-01-13,"(916.0, 1167.5]",18,42,-24
31212.0,2020-01-13,"(1167.5, 1419.0]",8,12,-4
31213.0,2020-01-13,"(344.979, 601.25]",25,43,-18
31213.0,2020-01-13,"(601.25, 856.5]",9,18,-9
31213.0,2020-01-13,"(856.5, 1111.75]",14,29,-15
31213.0,2020-01-13,"(1111.75, 1367.0]",6,22,-16
31214.0,2020-01-13,"(418.996, 671.0]",9,35,-26
31214.0,2020-01-13,"(671.0, 922.0]",5,10,-5
31214.0,2020-01-13,"(922.0, 1173.0]",26,39,-13
31214.0,2020-01-13,"(1173.0, 1424.0]",6,7,-1
31215.0,2020-01-13,"(60.862, 346.5]",1,1,0
31215.0,2020-01-13,"(346.5, 631.0]",13,14,-1
31215.0,2020-01-13,"(631.0, 915.5]",8,16,-8
31215.0,2020-01-13,"(915.5, 1200.0]",10,24,-14
31216.0,2020-01-13,"(392.15, 605.5]",8,11,-3
31216.0,2020-01-13,"(605.5, 818.0]",3,8,-5
31216.0,2020-01-13,"(818.0, 1030.5]",3,12,-9
31216.0,2020-01-13,"(1030.5, 1243.0]",2,19,-17
31217.0,2020-01-13,"(226.076, 458.0]",3,6,-3
31217.0,2020-01-13,"(458.0, 689.0]",19,22,-3
31217.0,2020-01-13,"(689.0, 920.0]",7,12,-5
31217.0,2020-01-13,"(920.0, 1151.0]",2,16,-14
31218.0,2020-01-13,"(338.953, 601.75]",24,41,-17
31218.0,2020-01-13,"(601.75, 863.5]",2,4,-2
31218.0,2020-01-13,"(863.5, 1125.25]",14,26,-12
31218.0,2020-01-13,"(1125.25, 1387.0]",3,6,-3
31219.0,2020-01-13,"(444.094, 671.5]",20,21,-1
31219.0,2020-01-13,"(671.5, 898.0]",6,7,-1
31219.0,2020-01-13,"(898.0, 1124.5]",3,11,-8
31219.0,2020-01-13,"(1124.5, 1351.0]",1,4,-3
31220.0,2020-01-13,"(282.24, 473.0]",8,10,-2
31220.0,2020-01-13,"(473.0, 663.0]",6,6,0
31220.0,2020-01-13,"(663.0, 853.0]",8,16,-8
31220.0,2020-01-13,"(853.0, 1043.0]",3,20,-17
31221.0,2020-01-13,"(348.0, 664.0]",19,1,18
31221.0,2020-01-13,"(664.0, 980.0]",14,24,-10
31221.0,2020-01-13,"(980.0, 1296.0]",13,22,-9
31222.0,2020-01-13,"(47.765, 357.75]",3,3,0
31222.0,2020-01-13,"(357.75, 666.5]",18,19,-1
31222.0,2020-01-13,"(666.5, 975.25]",3,7,-4
31222.0,2020-01-13,"(975.25, 1284.0]",3,22,-19
31223.0,2020-01-13,"(38.625, 383.75]",1,2,-1
31223.0,2020-01-13,"(383.75, 727.5]",35,70,-35
31223.0,2020-01-13,"(727.5, 1071.25]",13,32,-19
31223.0,2020-01-13,"(1071.25, 1415.0]",29,46,-17
31224.0,2020-01-13,"(452.098, 678.5]",12,14,-2
31224.0,2020-01-13,"(678.5, 904.0]",1,11,-10
31224.0,2020-01-13,"(904.0, 1129.5]",8,25,-17
31224.0,2020-01-13,"(1129.5, 1355.0]",2,7,-5
31225.0,2020-01-13,"(419.104, 644.0]",8,15,-7
31225.0,2020-01-13,"(644.0, 868.0]",8,13,-5
31225.0,2020-01-13,"(868.0, 1092.0]",11,21,-10
31225.0,2020-01-13,"(1092.0, 1316.0]",8,12,-4
31226.0,2020-01-13,"(358.019, 604.25]",4,13,-9
31226.0,2020-01-13,"(604.25, 849.5]",5,6,-1
31226.0,2020-01-13,"(849.5, 1094.75]",4,9,-5
31226.0,2020-01-13,"(1094.75, 1340.0]",7,11,-4
31227.0,2020-01-13,"(436.282, 616.5]",16,20,-4
31227.0,2020-01-13,"(616.5, 796.0]",5,12,-7
31227.0,2020-01-13,"(796.0, 975.5]",8,11,-3
31227.0,2020-01-13,"(975.5, 1155.0]",4,13,-9
31228.0,2020-01-13,"(348.942, 614.5]",28,35,-7
31228.0,2020-01-13,"(614.5, 879.0]",17,27,-10
31228.0,2020-01-13,"(879.0, 1143.5]",17,33,-16
31228.0,2020-01-13,"(1143.5, 1408.0]",12,35,-23
31229.0,2020-01-13,"(349.935, 617.25]",12,55,-43
31229.0,2020-01-13,"(617.25, 883.5]",7,16,-9
31229.0,2020-01-13,"(883.5, 1149.75]",31,48,-17
31229.0,2020-01-13,"(1149.75, 1416.0]",17,36,-19
31230.0,2020-01-13,"(381.057, 617.75]",47,54,-7
31230.0,2020-01-13,"(617.75, 853.5]",13,18,-5
31230.0,2020-01-13,"(853.5, 1089.25]",17,44,-27
31230.0,2020-01-13,"(1089.25, 1325.0]",6,25,-19
31231.0,2020-01-13,"(324.908, 599.0]",15,19,-4
31231.0,2020-01-13,"(599.0, 872.0]",22,26,-4
31231.0,2020-01-13,"(872.0, 1145.0]",11,33,-22
31232.0,2020-01-13,"(93.687, 423.25]",2,4,-2
31232.0,2020-01-13,"(423.25, 751.5]",27,36,-9
31232.0,2020-01-13,"(751.5, 1079.75]",19,38,-19
31232.0,2020-01-13,"(1079.75, 1408.0]",16,38,-22
31233.0,2020-01-13,"(355.75, 685.5]",55,1,54
31233.0,2020-01-13,"(685.5, 1015.25]",17,62,-45
31233.0,2020-01-13,"(1015.25, 1345.0]",8,28,-20
31234.0,2020-01-13,"(343.75, 681.5]",22,2,20
31234.0,2020-01-13,"(681.5, 1019.25]",19,35,-16
31234.0,2020-01-13,"(1019.25, 1357.0]",23,27,-4
31235.0,2020-01-13,"(440.156, 652.0]",10,10,0
31235.0,2020-01-13,"(652.0, 863.0]",3,4,-1
31235.0,2020-01-13,"(863.0, 1074.0]",8,8,0
31235.0,2020-01-13,"(1074.0, 1285.0]",2,6,-4
31236.0,2020-01-13,"(466.16, 677.0]",17,22,-5
31236.0,2020-01-13,"(677.0, 887.0]",8,18,-10
31236.0,2020-01-13,"(887.0, 1097.0]",12,30,-18
31236.0,2020-01-13,"(1097.0, 1307.0]",4,16,-12
31237.0,2020-01-13,"(446.068, 680.0]",7,14,-7
31237.0,2020-01-13,"(680.0, 913.0]",4,9,-5
31237.0,2020-01-13,"(913.0, 1146.0]",10,21,-11
31237.0,2020-01-13,"(1146.0, 1379.0]",8,17,-9
31238.0,2020-01-13,"(378.072, 611.0]",6,12,-6
31238.0,2020-01-13,"(611.0, 843.0]",6,15,-9
31238.0,2020-01-13,"(843.0, 1075.0]",9,22,-13
31238.0,2020-01-13,"(1075.0, 1307.0]",3,18,-15
31239.0,2020-01-13,"(16.723, 337.25]",2,2,0
31239.0,2020-01-13,"(337.25, 656.5]",27,34,-7
31239.0,2020-01-13,"(656.5, 975.75]",4,11,-7
31239.0,2020-01-13,"(975.75, 1295.0]",14,46,-32
31240.0,2020-01-13,"(625.894, 652.5]",2,2,0
31241.0,2020-01-13,"(271.839, 563.25]",18,37,-19
31241.0,2020-01-13,"(563.25, 853.5]",20,37,-17
31241.0,2020-01-13,"(853.5, 1143.75]",17,42,-25
31241.0,2020-01-13,"(1143.75, 1434.0]",23,34,-11
31242.0,2020-01-13,"(353.918, 625.5]",19,20,-1
31242.0,2020-01-13,"(625.5, 896.0]",2,8,-6
31242.0,2020-01-13,"(896.0, 1166.5]",3,27,-24
31243.0,2020-01-13,"(23.662, 359.5]",1,1,0
31243.0,2020-01-13,"(359.5, 694.0]",10,12,-2
31243.0,2020-01-13,"(694.0, 1028.5]",7,23,-16
31243.0,2020-01-13,"(1028.5, 1363.0]",3,17,-14
31244.0,2020-01-13,"(348.972, 607.0]",20,31,-11
31244.0,2020-01-13,"(607.0, 864.0]",4,8,-4
31244.0,2020-01-13,"(864.0, 1121.0]",9,23,-14
31244.0,2020-01-13,"(1121.0, 1378.0]",8,11,-3
31245.0,2020-01-13,"(337.93, 606.5]",6,18,-12
31245.0,2020-01-13,"(606.5, 874.0]",3,15,-12
31245.0,2020-01-13,"(874.0, 1141.5]",13,26,-13
31245.0,2020-01-13,"(1141.5, 1409.0]",5,8,-3
31246.0,2020-01-13,"(18.666, 353.5]",1,3,-2
31246.0,2020-01-13,"(353.5, 687.0]",15,27,-12
31246.0,2020-01-13,"(687.0, 1020.5]",7,12,-5
31246.0,2020-01-13,"(1020.5, 1354.0]",13,32,-19
31247.0,2020-01-13,"(354.971, 613.25]",18,24,-6
31247.0,2020-01-13,"(613.25, 870.5]",10,22,-12
31247.0,2020-01-13,"(870.5, 1127.75]",20,39,-19
31247.0,2020-01-13,"(1127.75, 1385.0]",2,4,-2
31248.0,2020-01-13,"(338.03, 581.5]",8,12,-4
31248.0,2020-01-13,"(581.5, 824.0]",2,4,-2
31248.0,2020-01-13,"(824.0, 1066.5]",4,10,-6
31248.0,2020-01-13,"(1066.5, 1309.0]",3,6,-3
31249.0,2020-01-13,"(367.989, 621.75]",7,14,-7
31249.0,2020-01-13,"(621.75, 874.5]",11,18,-7
31249.0,2020-01-13,"(874.5, 1127.25]",6,13,-7
31249.0,2020-01-13,"(1127.25, 1380.0]",2,4,-2
31250.0,2020-01-13,"(402.974, 660.5]",14,20,-6
31250.0,2020-01-13,"(660.5, 917.0]",6,15,-9
31250.0,2020-01-13,"(917.0, 1173.5]",2,18,-16
31250.0,2020-01-13,"(1173.5, 1430.0]",4,6,-2
31251.0,2020-01-13,"(241.852, 530.0]",12,22,-10
31251.0,2020-01-13,"(530.0, 817.0]",26,39,-13
31251.0,2020-01-13,"(817.0, 1104.0]",9,24,-15
31251.0,2020-01-13,"(1104.0, 1391.0]",15,33,-18
31252.0,2020-01-13,"(416.122, 636.5]",11,12,-1
31252.0,2020-01-13,"(636.5, 856.0]",1,3,-2
31252.0,2020-01-13,"(856.0, 1075.5]",5,15,-10
31252.0,2020-01-13,"(1075.5, 1295.0]",2,15,-13
31253.0,2020-01-13,"(405.227, 599.25]",23,25,-2
31253.0,2020-01-13,"(599.25, 792.5]",17,20,-3
31253.0,2020-01-13,"(792.5, 985.75]",8,15,-7
31253.0,2020-01-13,"(985.75, 1179.0]",5,26,-21
31254.0,2020-01-13,"(408.031, 651.25]",19,23,-4
31254.0,2020-01-13,"(651.25, 893.5]",2,4,-2
31254.0,2020-01-13,"(893.5, 1135.75]",3,8,-5
31254.0,2020-01-13,"(1135.75, 1378.0]",2,7,-5
31255.0,2020-01-13,"(370.058, 606.5]",9,17,-8
31255.0,2020-01-13,"(606.5, 842.0]",2,4,-2
31255.0,2020-01-13,"(842.0, 1077.5]",6,23,-17
31255.0,2020-01-13,"(1077.5, 1313.0]",11,21,-10
31256.0,2020-01-13,"(264.977, 521.75]",10,12,-2
31256.0,2020-01-13,"(521.75, 777.5]",8,8,0
31256.0,2020-01-13,"(777.5, 1033.25]",5,17,-12
31256.0,2020-01-13,"(1033.25, 1289.0]",5,17,-12
31257.0,2020-01-13,"(296.864, 582.0]",15,28,-13
31257.0,2020-01-13,"(582.0, 866.0]",9,18,-9
31257.0,2020-01-13,"(866.0, 1150.0]",16,42,-26
31257.0,2020-01-13,"(1150.0, 1434.0]",3,11,-8
31258.0,2020-01-13,"(439.021, 684.75]",7,19,-12
31258.0,2020-01-13,"(684.75, 929.5]",6,21,-15
31258.0,2020-01-13,"(929.5, 1174.25]",9,11,-2
31258.0,2020-01-13,"(1174.25, 1419.0]",3,6,-3
31259.0,2020-01-13,"(421.268, 605.0]",15,15,0
31259.0,2020-01-13,"(605.0, 788.0]",1,2,-1
31259.0,2020-01-13,"(788.0, 971.0]",1,3,-2
31260.0,2020-01-13,"(381.049, 619.75]",20,24,-4
31260.0,2020-01-13,"(619.75, 857.5]",2,5,-3
31260.0,2020-01-13,"(857.5, 1095.25]",3,17,-14
31260.0,2020-01-13,"(1095.25, 1333.0]",3,7,-4
31261.0,2020-01-13,"(387.273, 569.75]",7,7,0
31261.0,2020-01-13,"(751.5, 933.25]",1,3,-2
31261.0,2020-01-13,"(933.25, 1115.0]",2,5,-3
31262.0,2020-01-13,"(428.158, 639.5]",3,5,-2
31262.0,2020-01-13,"(639.5, 850.0]",1,3,-2
31262.0,2020-01-13,"(850.0, 1060.5]",4,11,-7
31262.0,2020-01-13,"(1060.5, 1271.0]",2,12,-10
31263.0,2020-01-13,"(15.646, 355.5]",2,2,0
31263.0,2020-01-13,"(355.5, 694.0]",15,29,-14
31263.0,2020-01-13,"(694.0, 1032.5]",17,39,-22
31263.0,2020-01-13,"(1032.5, 1371.0]",15,36,-21
31264.0,2020-01-13,"(420.063, 655.25]",6,9,-3
31264.0,2020-01-13,"(655.25, 889.5]",6,13,-7
31264.0,2020-01-13,"(889.5, 1123.75]",7,19,-12
31264.0,2020-01-13,"(1123.75, 1358.0]",4,10,-6
31265.0,2020-01-13,"(93.667, 428.25]",4,10,-6
31265.0,2020-01-13,"(428.25, 761.5]",18,33,-15
31265.0,2020-01-13,"(761.5, 1094.75]",19,37,-18
31265.0,2020-01-13,"(1094.75, 1428.0]",15,28,-13
31266.0,2020-01-13,"(88.657, 425.75]",2,11,-9
31266.0,2020-01-13,"(425.75, 761.5]",14,32,-18
31266.0,2020-01-13,"(761.5, 1097.25]",22,43,-21
31266.0,2020-01-13,"(1097.25, 1433.0]",18,27,-9
31267.0,2020-01-13,"(426.005, 675.75]",21,41,-20
31267.0,2020-01-13,"(675.75, 924.5]",8,15,-7
31267.0,2020-01-13,"(924.5, 1173.25]",17,32,-15
31267.0,2020-01-13,"(1173.25, 1422.0]",12,19,-7
31268.0,2020-01-13,"(334.904, 610.0]",14,43,-29
31268.0,2020-01-13,"(610.0, 884.0]",7,13,-6
31268.0,2020-01-13,"(884.0, 1158.0]",31,45,-14
31268.0,2020-01-13,"(1158.0, 1432.0]",9,16,-7
31269.0,2020-01-13,"(381.164, 591.0]",9,14,-5
31269.0,2020-01-13,"(591.0, 800.0]",10,21,-11
31269.0,2020-01-13,"(800.0, 1009.0]",6,13,-7
31269.0,2020-01-13,"(1009.0, 1218.0]",6,17,-11
31270.0,2020-01-13,"(350.012, 598.0]",21,31,-10
31270.0,2020-01-13,"(598.0, 845.0]",4,13,-9
31270.0,2020-01-13,"(845.0, 1092.0]",13,29,-16
31270.0,2020-01-13,"(1092.0, 1339.0]",5,13,-8
31271.0,2020-01-13,"(382.166, 591.5]",17,20,-3
31271.0,2020-01-13,"(591.5, 800.0]",6,15,-9
31271.0,2020-01-13,"(800.0, 1008.5]",8,14,-6
31271.0,2020-01-13,"(1008.5, 1217.0]",9,23,-14
31272.0,2020-01-13,"(292.866, 577.5]",29,34,-5
31272.0,2020-01-13,"(577.5, 861.0]",5,8,-3
31272.0,2020-01-13,"(861.0, 1144.5]",13,45,-32
31272.0,2020-01-13,"(1144.5, 1428.0]",2,6,-4
31273.0,2020-01-13,"(418.271, 601.25]",1,2,-1
31273.0,2020-01-13,"(601.25, 783.5]",4,10,-6
31273.0,2020-01-13,"(783.5, 965.75]",2,2,0
31273.0,2020-01-13,"(965.75, 1148.0]",1,1,0
31274.0,2020-01-13,"(393.027, 637.25]",15,19,-4
31274.0,2020-01-13,"(637.25, 880.5]",2,6,-4
31274.0,2020-01-13,"(880.5, 1123.75]",4,13,-9
31274.0,2020-01-13,"(1123.75, 1367.0]",1,7,-6
31275.0,2020-01-13,"(71.701, 397.75]",2,2,0
31275.0,2020-01-13,"(397.75, 722.5]",16,32,-16
31275.0,2020-01-13,"(722.5, 1047.25]",14,32,-18
31275.0,2020-01-13,"(1047.25, 1372.0]",14,27,-13
31276.0,2020-01-13,"(408.326, 577.5]",24,26,-2
31276.0,2020-01-13,"(577.5, 746.0]",6,13,-7
31276.0,2020-01-13,"(746.0, 914.5]",10,14,-4
31276.0,2020-01-13,"(914.5, 1083.0]",5,16,-11
31277.0,2020-01-13,"(394.053, 631.75]",31,34,-3
31277.0,2020-01-13,"(631.75, 868.5]",12,18,-6
31277.0,2020-01-13,"(868.5, 1105.25]",11,36,-25
31277.0,2020-01-13,"(1105.25, 1342.0]",1,8,-7
31278.0,2020-01-13,"(315.89, 594.5]",8,26,-18
31278.0,2020-01-13,"(594.5, 872.0]",6,12,-6
31278.0,2020-01-13,"(872.0, 1149.5]",12,23,-11
31278.0,2020-01-13,"(1149.5, 1427.0]",11,20,-9
31279.0,2020-01-13,"(425.261, 610.75]",18,19,-1
31279.0,2020-01-13,"(610.75, 795.5]",6,13,-7
31279.0,2020-01-13,"(795.5, 980.25]",4,7,-3
31279.0,2020-01-13,"(980.25, 1165.0]",1,24,-23
31280.0,2020-01-13,"(338.956, 601.0]",3,22,-19
31280.0,2020-01-13,"(601.0, 862.0]",3,9,-6
31280.0,2020-01-13,"(862.0, 1123.0]",14,17,-3
31280.0,2020-01-13,"(1123.0, 1384.0]",7,11,-4
31000.0,2020-01-14,"(1168.895, 1195.25]",1,1,0
31000.0,2020-01-14,"(1195.25, 1221.5]",1,1,0
31001.0,2020-01-14,"(1126.5, 1152.0]",3,2,1
31002.0,2020-01-14,"(448.141, 663.75]",2,3,-1
31002.0,2020-01-14,"(663.75, 878.5]",2,3,-1
31003.0,2020-01-14,"(377.085, 606.75]",3,5,-2
31003.0,2020-01-14,"(835.5, 1064.25]",3,2,1
31003.0,2020-01-14,"(1064.25, 1293.0]",1,5,-4
31004.0,2020-01-14,"(832.0, 1022.5]",1,1,0
31004.0,2020-01-14,"(1022.5, 1213.0]",2,1,1
31005.0,2020-01-14,"(436.159, 647.25]",2,2,0
31005.0,2020-01-14,"(857.5, 1067.75]",1,1,0
31005.0,2020-01-14,"(1067.75, 1278.0]",2,1,1
31006.0,2020-01-14,"(904.578, 1010.5]",1,3,-2
31006.0,2020-01-14,"(1010.5, 1116.0]",1,1,0
31006.0,2020-01-14,"(1221.5, 1327.0]",2,1,1
31007.0,2020-01-14,"(432.152, 645.0]",5,14,-9
31007.0,2020-01-14,"(645.0, 857.0]",2,3,-1
31007.0,2020-01-14,"(857.0, 1069.0]",1,11,-10
31007.0,2020-01-14,"(1069.0, 1281.0]",5,15,-10
31009.0,2020-01-14,"(409.5, 546.0]",3,1,2
31010.0,2020-01-14,"(450.083, 680.25]",2,3,-1
31010.0,2020-01-14,"(909.5, 1138.75]",3,6,-3
31011.0,2020-01-14,"(330.045, 569.75]",4,4,0
31011.0,2020-01-14,"(569.75, 808.5]",3,3,0
31011.0,2020-01-14,"(808.5, 1047.25]",1,3,-2
31011.0,2020-01-14,"(1047.25, 1286.0]",8,11,-3
31012.0,2020-01-14,"(383.049, 621.75]",1,4,-3
31012.0,2020-01-14,"(859.5, 1097.25]",1,3,-2
31012.0,2020-01-14,"(1097.25, 1335.0]",1,2,-1
31013.0,2020-01-14,"(390.114, 612.5]",1,3,-2
31013.0,2020-01-14,"(834.0, 1055.5]",2,1,1
31013.0,2020-01-14,"(1055.5, 1277.0]",1,2,-1
31014.0,2020-01-14,"(320.954, 583.5]",13,20,-7
31014.0,2020-01-14,"(583.5, 845.0]",4,5,-1
31014.0,2020-01-14,"(845.0, 1106.5]",15,27,-12
31014.0,2020-01-14,"(1106.5, 1368.0]",9,14,-5
31015.0,2020-01-14,"(405.207, 604.25]",9,11,-2
31015.0,2020-01-14,"(604.25, 802.5]",4,4,0
31015.0,2020-01-14,"(802.5, 1000.75]",2,2,0
31015.0,2020-01-14,"(1000.75, 1199.0]",2,4,-2
31016.0,2020-01-14,"(20.919, 292.25]",1,1,0
31016.0,2020-01-14,"(292.25, 562.5]",1,3,-2
31016.0,2020-01-14,"(562.5, 832.75]",1,2,-1
31016.0,2020-01-14,"(832.75, 1103.0]",2,5,-3
31017.0,2020-01-14,"(367.75, 714.5]",5,1,4
31017.0,2020-01-14,"(1061.25, 1408.0]",1,6,-5
31018.0,2020-01-14,"(402.222, 597.5]",1,3,-2
31018.0,2020-01-14,"(986.5, 1181.0]",2,1,1
31019.0,2020-01-14,"(1135.75, 1333.0]",1,1,0
31020.0,2020-01-14,"(603.443, 743.25]",1,2,-1
31020.0,2020-01-14,"(1021.75, 1161.0]",1,1,0
31021.0,2020-01-14,"(543.379, 699.25]",1,3,-2
31021.0,2020-01-14,"(699.25, 854.5]",1,1,0
31021.0,2020-01-14,"(1009.75, 1165.0]",1,1,0
31022.0,2020-01-14,"(323.0, 574.0]",5,7,-2
31022.0,2020-01-14,"(574.0, 824.0]",2,3,-1
31022.0,2020-01-14,"(824.0, 1074.0]",1,5,-4
31022.0,2020-01-14,"(1074.0, 1324.0]",1,7,-6
31023.0,2020-01-14,"(410.064, 645.0]",2,2,0
31023.0,2020-01-14,"(879.0, 1113.0]",3,2,1
31024.0,2020-01-14,"(363.09, 591.5]",6,10,-4
31024.0,2020-01-14,"(819.0, 1046.5]",3,2,1
31024.0,2020-01-14,"(1046.5, 1274.0]",1,6,-5
31025.0,2020-01-14,"(1054.5, 1119.0]",1,1,0
31026.0,2020-01-14,"(12.917, 284.75]",1,3,-2
31026.0,2020-01-14,"(826.25, 1097.0]",1,3,-2
31027.0,2020-01-14,"(313.942, 579.5]",1,2,-1
31027.0,2020-01-14,"(844.0, 1108.5]",1,2,-1
31027.0,2020-01-14,"(1108.5, 1373.0]",2,1,1
31028.0,2020-01-14,"(746.25, 915.5]",1,1,0
31028.0,2020-01-14,"(915.5, 1084.75]",2,2,0
31028.0,2020-01-14,"(1084.75, 1254.0]",2,3,-1
31029.0,2020-01-14,"(948.5, 1163.75]",2,7,-5
31029.0,2020-01-14,"(1163.75, 1379.0]",2,2,0
31030.0,2020-01-14,"(943.75, 1132.0]",4,4,0
31031.0,2020-01-14,"(17.586, 372.5]",1,1,0
31031.0,2020-01-14,"(726.0, 1079.5]",1,1,0
31031.0,2020-01-14,"(1079.5, 1433.0]",5,3,2
31032.0,2020-01-14,"(1054.5, 1249.0]",1,1,0
,,,,2.0,
31034.0,2020-01-14,"(366.017, 612.75]",3,4,-1
31034.0,2020-01-14,"(858.5, 1104.25]",1,3,-2
31035.0,2020-01-14,"(31.792, 335.0]",1,1,0
31035.0,2020-01-14,"(335.0, 637.0]",1,2,-1
31035.0,2020-01-14,"(637.0, 939.0]",1,2,-1
31035.0,2020-01-14,"(939.0, 1241.0]",4,7,-3
31036.0,2020-01-14,"(635.75, 824.5]",1,2,-1
31036.0,2020-01-14,"(824.5, 1013.25]",2,2,0
31036.0,2020-01-14,"(1013.25, 1202.0]",4,3,1
31037.0,2020-01-14,"(412.161, 622.75]",5,7,-2
31037.0,2020-01-14,"(622.75, 832.5]",2,2,0
31037.0,2020-01-14,"(832.5, 1042.25]",4,9,-5
31037.0,2020-01-14,"(1042.25, 1252.0]",3,11,-8
,,,,2.0,
31039.0,2020-01-14,"(361.116, 583.0]",1,4,-3
31039.0,2020-01-14,"(583.0, 804.0]",1,4,-3
31039.0,2020-01-14,"(804.0, 1025.0]",1,2,-1
31039.0,2020-01-14,"(1025.0, 1246.0]",1,4,-3
31040.0,2020-01-14,"(470.221, 665.75]",3,3,0
31041.0,2020-01-14,"(1064.5, 1101.0]",1,1,0
31042.0,2020-01-14,"(520.189, 723.75]",7,8,-1
31042.0,2020-01-14,"(723.75, 926.5]",1,2,-1
31043.0,2020-01-14,"(401.218, 597.5]",1,2,-1
31043.0,2020-01-14,"(988.5, 1184.0]",3,1,2
31044.0,2020-01-14,"(536.389, 689.75]",2,2,0
31044.0,2020-01-14,"(842.5, 995.25]",1,2,-1
31044.0,2020-01-14,"(995.25, 1148.0]",1,3,-2
31045.0,2020-01-14,"(12.883, 293.25]",1,1,0
31045.0,2020-01-14,"(572.5, 851.75]",1,1,0
31045.0,2020-01-14,"(851.75, 1131.0]",2,1,1
31046.0,2020-01-14,"(398.359, 559.25]",1,2,-1
31046.0,2020-01-14,"(719.5, 879.75]",1,1,0
31047.0,2020-01-14,"(396.114, 618.5]",9,18,-9
31047.0,2020-01-14,"(618.5, 840.0]",2,3,-1
31047.0,2020-01-14,"(840.0, 1061.5]",5,14,-9
31047.0,2020-01-14,"(1061.5, 1283.0]",5,14,-9
31048.0,2020-01-14,"(327.991, 581.25]",3,6,-3
31048.0,2020-01-14,"(833.5, 1085.75]",5,1,4
31048.0,2020-01-14,"(1085.75, 1338.0]",2,6,-4
31049.0,2020-01-14,"(1294.0, 1384.0]",1,1,0
,,,,1.0,
,,,,2.0,
31051.0,2020-01-14,"(825.0, 979.5]",2,2,0
31051.0,2020-01-14,"(979.5, 1134.0]",4,3,1
31052.0,2020-01-14,"(522.282, 702.5]",1,2,-1
31052.0,2020-01-14,"(1061.5, 1241.0]",3,3,0
31053.0,2020-01-14,"(687.763, 747.25]",1,1,0
31054.0,2020-01-14,"(840.75, 1121.0]",1,1,0
31055.0,2020-01-14,"(400.233, 592.75]",1,1,0
31055.0,2020-01-14,"(976.25, 1168.0]",3,4,-1
31056.0,2020-01-14,"(944.5, 1136.75]",1,1,0
31056.0,2020-01-14,"(1136.75, 1329.0]",2,1,1
,,,,2.0,
31058.0,2020-01-14,"(753.0, 1004.0]",1,1,0
,,,,2.0,
31060.0,2020-01-14,"(671.354, 833.5]",1,1,0
31061.0,2020-01-14,"(390.75, 521.0]",1,1,0
31062.0,2020-01-14,"(944.0, 1020.0]",1,1,0
31063.0,2020-01-14,"(921.5, 1078.0]",1,1,0
31064.0,2020-01-14,"(990.778, 1046.5]",1,2,-1
31064.0,2020-01-14,"(1046.5, 1102.0]",3,6,-3
31064.0,2020-01-14,"(1102.0, 1157.5]",1,2,-1
31064.0,2020-01-14,"(1157.5, 1213.0]",2,4,-2
31065.0,2020-01-14,"(735.75, 981.0]",1,1,0
,,,,2.0,
31067.0,2020-01-14,"(1000.5, 1193.25]",2,2,0
31067.0,2020-01-14,"(1193.25, 1386.0]",1,2,-1
31068.0,2020-01-14,"(571.208, 770.0]",1,2,-1
31068.0,2020-01-14,"(968.0, 1166.0]",1,1,0
31068.0,2020-01-14,"(1166.0, 1364.0]",1,1,0
31069.0,2020-01-14,"(899.0, 1081.0]",2,2,0
31069.0,2020-01-14,"(1081.0, 1263.0]",3,1,2
31070.0,2020-01-14,"(749.25, 905.5]",1,1,0
31070.0,2020-01-14,"(905.5, 1061.75]",1,2,-1
31070.0,2020-01-14,"(1061.75, 1218.0]",1,1,0
31071.0,2020-01-14,"(558.5, 792.0]",1,2,-1
31071.0,2020-01-14,"(792.0, 1025.5]",3,1,2
31071.0,2020-01-14,"(1025.5, 1259.0]",5,5,0
31072.0,2020-01-14,"(787.25, 792.0]",1,1,0
31073.0,2020-01-14,"(860.25, 1147.0]",2,1,1
31074.0,2020-01-14,"(665.25, 822.5]",1,2,-1
31074.0,2020-01-14,"(822.5, 979.75]",2,1,1
31074.0,2020-01-14,"(979.75, 1137.0]",3,3,0
31075.0,2020-01-14,"(676.5, 821.0]",1,1,0
31075.0,2020-01-14,"(965.5, 1110.0]",1,2,-1
31076.0,2020-01-14,"(841.5, 1122.0]",1,1,0
31077.0,2020-01-14,"(945.0, 1138.0]",2,3,-1
31077.0,2020-01-14,"(1138.0, 1331.0]",2,1,1
31078.0,2020-01-14,"(479.437, 620.75]",3,3,0
31078.0,2020-01-14,"(902.25, 1043.0]",1,1,0
31079.0,2020-01-14,"(494.083, 724.25]",1,5,-4
31079.0,2020-01-14,"(1182.75, 1412.0]",3,3,0
31080.0,2020-01-14,"(646.0, 902.0]",1,6,-5
31080.0,2020-01-14,"(902.0, 1158.0]",6,2,4
31080.0,2020-01-14,"(1158.0, 1414.0]",4,8,-4
31081.0,2020-01-14,"(484.354, 646.5]",1,1,0
31081.0,2020-01-14,"(808.0, 969.5]",1,1,0
31082.0,2020-01-14,"(870.25, 976.0]",1,1,0
31083.0,2020-01-14,"(793.0, 993.0]",1,4,-3
31083.0,2020-01-14,"(993.0, 1193.0]",3,1,2
31084.0,2020-01-14,"(306.5, 603.0]",1,1,0
31084.0,2020-01-14,"(603.0, 899.5]",2,2,0
31085.0,2020-01-14,"(403.181, 608.75]",1,4,-3
31085.0,2020-01-14,"(1018.25, 1223.0]",1,1,0
31086.0,2020-01-14,"(455.11, 678.5]",1,2,-1
31086.0,2020-01-14,"(901.0, 1123.5]",1,1,0
31086.0,2020-01-14,"(1123.5, 1346.0]",1,1,0
31087.0,2020-01-14,"(439.148, 653.0]",1,2,-1
31087.0,2020-01-14,"(653.0, 866.0]",1,2,-1
31087.0,2020-01-14,"(1079.0, 1292.0]",1,1,0
31088.0,2020-01-14,"(753.5, 927.0]",1,1,0
31088.0,2020-01-14,"(927.0, 1100.5]",3,2,1
31088.0,2020-01-14,"(1100.5, 1274.0]",3,3,0
31089.0,2020-01-14,"(154.931, 423.25]",1,1,0
31089.0,2020-01-14,"(423.25, 690.5]",4,9,-5
31089.0,2020-01-14,"(690.5, 957.75]",1,5,-4
31089.0,2020-01-14,"(957.75, 1225.0]",2,11,-9
31090.0,2020-01-14,"(435.418, 581.5]",1,2,-1
31090.0,2020-01-14,"(872.5, 1018.0]",1,1,0
31091.0,2020-01-14,"(936.0, 1187.0]",4,3,1
31091.0,2020-01-14,"(1187.0, 1438.0]",1,5,-4
31092.0,2020-01-14,"(680.0, 882.0]",1,1,0
31092.0,2020-01-14,"(882.0, 1084.0]",1,1,0
31092.0,2020-01-14,"(1084.0, 1286.0]",1,2,-1
,,,,1.0,
,,,,1.0,
,,,,2.0,
,,,,2.0,
31096.0,2020-01-14,"(423.39, 576.5]",1,2,-1
31097.0,2020-01-14,"(465.227, 659.25]",3,3,0
31097.0,2020-01-14,"(1045.75, 1239.0]",3,3,0
31098.0,2020-01-14,"(515.197, 716.75]",3,7,-4
31098.0,2020-01-14,"(716.75, 917.5]",1,1,0
31098.0,2020-01-14,"(917.5, 1118.25]",4,7,-3
31099.0,2020-01-14,"(540.5, 810.75]",1,1,0
31099.0,2020-01-14,"(810.75, 1081.0]",1,1,0
31100.0,2020-01-14,"(374.214, 571.5]",10,10,0
31100.0,2020-01-14,"(571.5, 768.0]",3,3,0
31100.0,2020-01-14,"(768.0, 964.5]",2,3,-1
31100.0,2020-01-14,"(964.5, 1161.0]",5,23,-18
31101.0,2020-01-14,"(0.567, 360.25]",2,4,-2
31101.0,2020-01-14,"(360.25, 718.5]",12,31,-19
31101.0,2020-01-14,"(718.5, 1076.75]",19,33,-14
31101.0,2020-01-14,"(1076.75, 1435.0]",33,51,-18
31102.0,2020-01-14,"(316.908, 591.0]",1,11,-10
31102.0,2020-01-14,"(591.0, 864.0]",3,4,-1
31102.0,2020-01-14,"(864.0, 1137.0]",9,12,-3
31102.0,2020-01-14,"(1137.0, 1410.0]",9,14,-5
31103.0,2020-01-14,"(372.956, 635.0]",2,22,-20
31103.0,2020-01-14,"(635.0, 896.0]",2,8,-6
31103.0,2020-01-14,"(896.0, 1157.0]",6,18,-12
31103.0,2020-01-14,"(1157.0, 1418.0]",5,9,-4
31104.0,2020-01-14,"(57.65, 396.5]",1,4,-3
31104.0,2020-01-14,"(396.5, 734.0]",1,13,-12
31104.0,2020-01-14,"(734.0, 1071.5]",7,13,-6
31104.0,2020-01-14,"(1071.5, 1409.0]",10,25,-15
31105.0,2020-01-14,"(1071.0, 1158.0]",1,4,-3
31105.0,2020-01-14,"(1245.0, 1332.0]",1,1,0
31106.0,2020-01-14,"(697.0, 883.0]",1,1,0
31106.0,2020-01-14,"(1069.0, 1255.0]",5,3,2
31107.0,2020-01-14,"(123.71, 447.5]",2,6,-4
31107.0,2020-01-14,"(447.5, 770.0]",2,17,-15
31107.0,2020-01-14,"(770.0, 1092.5]",13,21,-8
31107.0,2020-01-14,"(1092.5, 1415.0]",5,11,-6
31108.0,2020-01-14,"(352.75, 692.5]",2,2,0
31108.0,2020-01-14,"(692.5, 1032.25]",9,21,-12
31108.0,2020-01-14,"(1032.25, 1372.0]",28,17,11
31109.0,2020-01-14,"(423.13, 641.5]",5,15,-10
31109.0,2020-01-14,"(641.5, 859.0]",5,11,-6
31109.0,2020-01-14,"(859.0, 1076.5]",10,17,-7
31109.0,2020-01-14,"(1076.5, 1294.0]",14,25,-11
31110.0,2020-01-14,"(36.601, 387.75]",1,3,-2
31110.0,2020-01-14,"(387.75, 737.5]",18,35,-17
31110.0,2020-01-14,"(737.5, 1087.25]",8,22,-14
31110.0,2020-01-14,"(1087.25, 1437.0]",17,28,-11
31111.0,2020-01-14,"(6.586, 361.5]",2,4,-2
31111.0,2020-01-14,"(361.5, 715.0]",4,13,-9
31111.0,2020-01-14,"(715.0, 1068.5]",8,11,-3
31111.0,2020-01-14,"(1068.5, 1422.0]",10,13,-3
31112.0,2020-01-14,"(959.25, 1097.0]",1,1,0
31113.0,2020-01-14,"(10.674, 343.5]",1,2,-1
31113.0,2020-01-14,"(343.5, 675.0]",3,22,-19
31113.0,2020-01-14,"(675.0, 1006.5]",2,7,-5
31113.0,2020-01-14,"(1006.5, 1338.0]",10,19,-9
31114.0,2020-01-14,"(350.954, 613.5]",2,21,-19
31114.0,2020-01-14,"(613.5, 875.0]",1,2,-1
31114.0,2020-01-14,"(875.0, 1136.5]",14,20,-6
31114.0,2020-01-14,"(1136.5, 1398.0]",17,20,-3
31115.0,2020-01-14,"(402.088, 631.0]",1,17,-16
31115.0,2020-01-14,"(631.0, 859.0]",1,5,-4
31115.0,2020-01-14,"(859.0, 1087.0]",4,9,-5
31115.0,2020-01-14,"(1087.0, 1315.0]",13,20,-7
31116.0,2020-01-14,"(16.62, 363.0]",1,2,-1
31116.0,2020-01-14,"(363.0, 708.0]",5,15,-10
31116.0,2020-01-14,"(708.0, 1053.0]",7,16,-9
31116.0,2020-01-14,"(1053.0, 1398.0]",13,19,-6
31117.0,2020-01-14,"(261.852, 550.0]",4,22,-18
31117.0,2020-01-14,"(550.0, 837.0]",1,11,-10
31117.0,2020-01-14,"(837.0, 1124.0]",7,11,-4
31117.0,2020-01-14,"(1124.0, 1411.0]",6,13,-7
31118.0,2020-01-14,"(590.25, 813.5]",2,14,-12
31118.0,2020-01-14,"(813.5, 1036.75]",4,3,1
31118.0,2020-01-14,"(1036.75, 1260.0]",12,5,7
31119.0,2020-01-14,"(340.93, 609.5]",8,28,-20
31119.0,2020-01-14,"(609.5, 877.0]",4,6,-2
31119.0,2020-01-14,"(877.0, 1144.5]",16,22,-6
31119.0,2020-01-14,"(1144.5, 1412.0]",9,17,-8
31120.0,2020-01-14,"(8.681, 339.75]",1,1,0
31120.0,2020-01-14,"(669.5, 999.25]",6,13,-7
31120.0,2020-01-14,"(999.25, 1329.0]",10,8,2
31121.0,2020-01-14,"(356.936, 624.0]",14,19,-5
31121.0,2020-01-14,"(890.0, 1156.0]",2,1,1
31121.0,2020-01-14,"(1156.0, 1422.0]",7,11,-4
31122.0,2020-01-14,"(163.779, 470.25]",1,5,-4
31122.0,2020-01-14,"(470.25, 775.5]",3,11,-8
31122.0,2020-01-14,"(775.5, 1080.75]",5,9,-4
31122.0,2020-01-14,"(1080.75, 1386.0]",16,24,-8
31123.0,2020-01-14,"(313.942, 579.5]",1,12,-11
31123.0,2020-01-14,"(844.0, 1108.5]",5,1,4
31123.0,2020-01-14,"(1108.5, 1373.0]",6,6,0
31124.0,2020-01-14,"(16.602, 367.5]",1,3,-2
31124.0,2020-01-14,"(367.5, 717.0]",15,39,-24
31124.0,2020-01-14,"(717.0, 1066.5]",16,31,-15
31124.0,2020-01-14,"(1066.5, 1416.0]",17,51,-34
31125.0,2020-01-14,"(352.959, 614.25]",9,36,-27
31125.0,2020-01-14,"(614.25, 874.5]",3,5,-2
31125.0,2020-01-14,"(874.5, 1134.75]",20,32,-12
31125.0,2020-01-14,"(1134.75, 1395.0]",13,17,-4
31126.0,2020-01-14,"(298.921, 569.75]",4,26,-22
31126.0,2020-01-14,"(569.75, 839.5]",1,5,-4
31126.0,2020-01-14,"(839.5, 1109.25]",3,8,-5
31126.0,2020-01-14,"(1109.25, 1379.0]",6,9,-3
,,,,2.0,
31128.0,2020-01-14,"(46.653, 384.75]",6,7,-1
31128.0,2020-01-14,"(384.75, 721.5]",17,22,-5
31128.0,2020-01-14,"(721.5, 1058.25]",23,34,-11
31128.0,2020-01-14,"(1058.25, 1395.0]",10,23,-13
31129.0,2020-01-14,"(389.054, 626.5]",5,8,-3
31129.0,2020-01-14,"(626.5, 863.0]",6,8,-2
31129.0,2020-01-14,"(863.0, 1099.5]",8,12,-4
31129.0,2020-01-14,"(1099.5, 1336.0]",3,6,-3
31130.0,2020-01-14,"(345.97, 604.5]",4,16,-12
31130.0,2020-01-14,"(604.5, 862.0]",2,3,-1
31130.0,2020-01-14,"(862.0, 1119.5]",4,8,-4
31130.0,2020-01-14,"(1119.5, 1377.0]",8,11,-3
31131.0,2020-01-14,"(880.0, 1121.0]",5,8,-3
31131.0,2020-01-14,"(1121.0, 1362.0]",1,7,-6
31200.0,2020-01-14,"(134.711, 458.25]",3,8,-5
31200.0,2020-01-14,"(458.25, 780.5]",16,28,-12
31200.0,2020-01-14,"(780.5, 1102.75]",19,40,-21
31200.0,2020-01-14,"(1102.75, 1425.0]",16,39,-23
31201.0,2020-01-14,"(299.902, 575.5]",18,38,-20
31201.0,2020-01-14,"(575.5, 850.0]",7,17,-10
31201.0,2020-01-14,"(850.0, 1124.5]",28,54,-26
31201.0,2020-01-14,"(1124.5, 1399.0]",24,45,-21
31202.0,2020-01-14,"(346.932, 615.0]",6,18,-12
31202.0,2020-01-14,"(615.0, 882.0]",9,16,-7
31202.0,2020-01-14,"(882.0, 1149.0]",16,27,-11
31202.0,2020-01-14,"(1149.0, 1416.0]",6,14,-8
31203.0,2020-01-14,"(345.929, 614.75]",5,22,-17
31203.0,2020-01-14,"(614.75, 882.5]",6,10,-4
31203.0,2020-01-14,"(882.5, 1150.25]",16,24,-8
31203.0,2020-01-14,"(1150.25, 1418.0]",12,26,-14
31204.0,2020-01-14,"(70.636, 413.0]",2,3,-1
31204.0,2020-01-14,"(413.0, 754.0]",8,12,-4
31204.0,2020-01-14,"(754.0, 1095.0]",10,29,-19
31204.0,2020-01-14,"(1095.0, 1436.0]",9,17,-8
31205.0,2020-01-14,"(42.607, 392.25]",2,3,-1
31205.0,2020-01-14,"(392.25, 740.5]",18,20,-2
31205.0,2020-01-14,"(740.5, 1088.75]",15,31,-16
31205.0,2020-01-14,"(1088.75, 1437.0]",3,22,-19
31206.0,2020-01-14,"(393.144, 608.0]",1,1,0
31206.0,2020-01-14,"(822.0, 1036.0]",1,1,0
31206.0,2020-01-14,"(1036.0, 1250.0]",4,6,-2
31207.0,2020-01-14,"(16.718, 338.5]",1,1,0
31207.0,2020-01-14,"(659.0, 979.5]",2,4,-2
31207.0,2020-01-14,"(979.5, 1300.0]",4,3,1
31208.0,2020-01-14,"(474.346, 638.5]",2,4,-2
31208.0,2020-01-14,"(802.0, 965.5]",1,4,-3
31208.0,2020-01-14,"(965.5, 1129.0]",1,10,-9
31209.0,2020-01-14,"(503.233, 695.75]",3,4,-1
31209.0,2020-01-14,"(887.5, 1079.25]",2,3,-1
31209.0,2020-01-14,"(1079.25, 1271.0]",2,4,-2
31211.0,2020-01-14,"(449.168, 658.0]",9,11,-2
31211.0,2020-01-14,"(866.0, 1074.0]",3,6,-3
31212.0,2020-01-14,"(2.568, 362.0]",3,3,0
31212.0,2020-01-14,"(362.0, 720.0]",30,54,-24
31212.0,2020-01-14,"(720.0, 1078.0]",20,38,-18
31212.0,2020-01-14,"(1078.0, 1436.0]",17,34,-17
31213.0,2020-01-14,"(414.012, 662.0]",22,31,-9
31213.0,2020-01-14,"(662.0, 909.0]",7,15,-8
31213.0,2020-01-14,"(909.0, 1156.0]",15,30,-15
31213.0,2020-01-14,"(1156.0, 1403.0]",5,16,-11
31214.0,2020-01-14,"(393.25, 686.5]",5,2,3
31214.0,2020-01-14,"(686.5, 979.75]",13,26,-13
31214.0,2020-01-14,"(979.75, 1273.0]",29,20,9
31215.0,2020-01-14,"(439.306, 613.5]",18,20,-2
31215.0,2020-01-14,"(613.5, 787.0]",5,7,-2
31215.0,2020-01-14,"(787.0, 960.5]",1,4,-3
31215.0,2020-01-14,"(960.5, 1134.0]",8,20,-12
31216.0,2020-01-14,"(322.942, 588.5]",14,16,-2
31216.0,2020-01-14,"(588.5, 853.0]",13,16,-3
31216.0,2020-01-14,"(853.0, 1117.5]",2,12,-10
31216.0,2020-01-14,"(1117.5, 1382.0]",1,13,-12
31217.0,2020-01-14,"(377.267, 561.25]",9,10,-1
31217.0,2020-01-14,"(561.25, 744.5]",4,6,-2
31217.0,2020-01-14,"(744.5, 927.75]",2,5,-3
31217.0,2020-01-14,"(927.75, 1111.0]",1,11,-10
31218.0,2020-01-14,"(301.884, 582.0]",11,26,-15
31218.0,2020-01-14,"(582.0, 861.0]",5,7,-2
31218.0,2020-01-14,"(861.0, 1140.0]",10,16,-6
31218.0,2020-01-14,"(1140.0, 1419.0]",1,7,-6
31219.0,2020-01-14,"(353.048, 592.0]",10,11,-1
31219.0,2020-01-14,"(592.0, 830.0]",5,11,-6
31219.0,2020-01-14,"(830.0, 1068.0]",3,10,-7
31219.0,2020-01-14,"(1068.0, 1306.0]",1,3,-2
31220.0,2020-01-14,"(326.319, 497.25]",7,8,-1
31220.0,2020-01-14,"(497.25, 667.5]",7,7,0
31220.0,2020-01-14,"(837.75, 1008.0]",1,1,0
31221.0,2020-01-14,"(380.974, 638.5]",26,27,-1
31221.0,2020-01-14,"(638.5, 895.0]",4,8,-4
31221.0,2020-01-14,"(895.0, 1151.5]",6,29,-23
31221.0,2020-01-14,"(1151.5, 1408.0]",4,11,-7
31222.0,2020-01-14,"(317.231, 510.25]",3,4,-1
31222.0,2020-01-14,"(510.25, 702.5]",5,7,-2
31222.0,2020-01-14,"(702.5, 894.75]",1,2,-1
31222.0,2020-01-14,"(894.75, 1087.0]",4,15,-11
31223.0,2020-01-14,"(358.5, 710.0]",23,2,21
31223.0,2020-01-14,"(710.0, 1061.5]",14,38,-24
31223.0,2020-01-14,"(1061.5, 1413.0]",15,34,-19
31224.0,2020-01-14,"(418.073, 650.75]",12,12,0
31224.0,2020-01-14,"(650.75, 882.5]",4,8,-4
31224.0,2020-01-14,"(882.5, 1114.25]",3,17,-14
31224.0,2020-01-14,"(1114.25, 1346.0]",1,7,-6
31225.0,2020-01-14,"(362.25, 714.5]",10,1,9
31225.0,2020-01-14,"(714.5, 1066.75]",3,21,-18
31225.0,2020-01-14,"(1066.75, 1419.0]",6,10,-4
31226.0,2020-01-14,"(350.0, 687.0]",4,2,2
31226.0,2020-01-14,"(687.0, 1024.0]",2,8,-6
31226.0,2020-01-14,"(1024.0, 1361.0]",7,5,2
31227.0,2020-01-14,"(392.004, 642.0]",26,29,-3
31227.0,2020-01-14,"(642.0, 891.0]",5,10,-5
31227.0,2020-01-14,"(891.0, 1140.0]",1,17,-16
31227.0,2020-01-14,"(1140.0, 1389.0]",1,9,-8
31228.0,2020-01-14,"(7.607, 357.25]",1,2,-1
31228.0,2020-01-14,"(357.25, 705.5]",15,23,-8
31228.0,2020-01-14,"(705.5, 1053.75]",21,37,-16
31228.0,2020-01-14,"(1053.75, 1402.0]",19,44,-25
31229.0,2020-01-14,"(19.629, 363.75]",2,5,-3
31229.0,2020-01-14,"(363.75, 706.5]",8,35,-27
31229.0,2020-01-14,"(706.5, 1049.25]",22,32,-10
31229.0,2020-01-14,"(1049.25, 1392.0]",32,55,-23
31230.0,2020-01-14,"(327.957, 589.75]",39,46,-7
31230.0,2020-01-14,"(589.75, 850.5]",7,16,-9
31230.0,2020-01-14,"(850.5, 1111.25]",10,33,-23
31230.0,2020-01-14,"(1111.25, 1372.0]",4,24,-20
31231.0,2020-01-14,"(330.115, 552.25]",17,19,-2
31231.0,2020-01-14,"(552.25, 773.5]",7,12,-5
31231.0,2020-01-14,"(773.5, 994.75]",9,16,-7
31231.0,2020-01-14,"(994.75, 1216.0]",3,13,-10
31232.0,2020-01-14,"(1.571, 360.25]",3,5,-2
31232.0,2020-01-14,"(360.25, 717.5]",14,18,-4
31232.0,2020-01-14,"(717.5, 1074.75]",8,16,-8
31232.0,2020-01-14,"(1074.75, 1432.0]",11,27,-16
31233.0,2020-01-14,"(278.934, 546.5]",20,23,-3
31233.0,2020-01-14,"(546.5, 813.0]",12,14,-2
31233.0,2020-01-14,"(813.0, 1079.5]",9,20,-11
31233.0,2020-01-14,"(1079.5, 1346.0]",5,14,-9
31234.0,2020-01-14,"(368.009, 616.75]",15,26,-11
31234.0,2020-01-14,"(616.75, 864.5]",9,17,-8
31234.0,2020-01-14,"(864.5, 1112.25]",9,18,-9
31234.0,2020-01-14,"(1112.25, 1360.0]",6,13,-7
31235.0,2020-01-14,"(502.432, 645.0]",7,7,0
31235.0,2020-01-14,"(645.0, 787.0]",1,1,0
31235.0,2020-01-14,"(787.0, 929.0]",2,2,0
31235.0,2020-01-14,"(929.0, 1071.0]",1,4,-3
31236.0,2020-01-14,"(455.109, 678.75]",17,19,-2
31236.0,2020-01-14,"(678.75, 901.5]",8,18,-10
31236.0,2020-01-14,"(901.5, 1124.25]",11,30,-19
31236.0,2020-01-14,"(1124.25, 1347.0]",3,11,-8
31237.0,2020-01-14,"(95.679, 427.25]",2,3,-1
31237.0,2020-01-14,"(427.25, 757.5]",7,19,-12
31237.0,2020-01-14,"(757.5, 1087.75]",11,19,-8
31237.0,2020-01-14,"(1087.75, 1418.0]",13,23,-10
31238.0,2020-01-14,"(52.639, 394.25]",3,3,0
31238.0,2020-01-14,"(394.25, 734.5]",13,16,-3
31238.0,2020-01-14,"(734.5, 1074.75]",13,32,-19
31238.0,2020-01-14,"(1074.75, 1415.0]",5,18,-13
31239.0,2020-01-14,"(50.625, 395.75]",4,5,-1
31239.0,2020-01-14,"(395.75, 739.5]",21,25,-4
31239.0,2020-01-14,"(739.5, 1083.25]",6,23,-17
31239.0,2020-01-14,"(1083.25, 1427.0]",10,28,-18
31240.0,2020-01-14,"(1145.999, 1146.25]",1,1,0
31241.0,2020-01-14,"(91.658, 428.5]",1,7,-6
31241.0,2020-01-14,"(428.5, 764.0]",25,50,-25
31241.0,2020-01-14,"(764.0, 1099.5]",11,32,-21
31241.0,2020-01-14,"(1099.5, 1435.0]",20,40,-20
31242.0,2020-01-14,"(299.904, 575.0]",17,19,-2
31242.0,2020-01-14,"(575.0, 849.0]",10,17,-7
31242.0,2020-01-14,"(849.0, 1123.0]",11,27,-16
31242.0,2020-01-14,"(1123.0, 1397.0]",1,19,-18
31243.0,2020-01-14,"(381.201, 581.75]",19,21,-2
31243.0,2020-01-14,"(581.75, 781.5]",3,3,0
31243.0,2020-01-14,"(781.5, 981.25]",3,16,-13
31243.0,2020-01-14,"(981.25, 1181.0]",4,22,-18
31244.0,2020-01-14,"(419.03, 662.5]",10,15,-5
31244.0,2020-01-14,"(662.5, 905.0]",3,8,-5
31244.0,2020-01-14,"(905.0, 1147.5]",7,16,-9
31244.0,2020-01-14,"(1147.5, 1390.0]",2,4,-2
31245.0,2020-01-14,"(388.958, 650.5]",12,20,-8
31245.0,2020-01-14,"(650.5, 911.0]",2,3,-1
31245.0,2020-01-14,"(911.0, 1171.5]",10,24,-14
31245.0,2020-01-14,"(1171.5, 1432.0]",7,12,-5
31246.0,2020-01-14,"(405.046, 644.5]",9,14,-5
31246.0,2020-01-14,"(644.5, 883.0]",2,8,-6
31246.0,2020-01-14,"(883.0, 1121.5]",15,27,-12
31246.0,2020-01-14,"(1121.5, 1360.0]",8,20,-12
31247.0,2020-01-14,"(425.154, 637.5]",8,9,-1
31247.0,2020-01-14,"(637.5, 849.0]",5,7,-2
31247.0,2020-01-14,"(849.0, 1060.5]",5,12,-7
31248.0,2020-01-14,"(355.197, 556.75]",5,9,-4
31248.0,2020-01-14,"(556.75, 757.5]",2,2,0
31248.0,2020-01-14,"(757.5, 958.25]",2,4,-2
31248.0,2020-01-14,"(958.25, 1159.0]",10,28,-18
31249.0,2020-01-14,"(425.182, 630.5]",2,5,-3
31249.0,2020-01-14,"(630.5, 835.0]",1,2,-1
31249.0,2020-01-14,"(835.0, 1039.5]",2,4,-2
31249.0,2020-01-14,"(1039.5, 1244.0]",4,10,-6
31250.0,2020-01-14,"(405.994, 658.5]",19,22,-3
31250.0,2020-01-14,"(658.5, 910.0]",3,7,-4
31250.0,2020-01-14,"(910.0, 1161.5]",1,20,-19
31250.0,2020-01-14,"(1161.5, 1413.0]",2,3,-1
31251.0,2020-01-14,"(243.914, 516.5]",2,7,-5
31251.0,2020-01-14,"(516.5, 788.0]",16,30,-14
31251.0,2020-01-14,"(788.0, 1059.5]",5,18,-13
31251.0,2020-01-14,"(1059.5, 1331.0]",14,26,-12
31252.0,2020-01-14,"(310.028, 554.0]",13,14,-1
31252.0,2020-01-14,"(554.0, 797.0]",7,10,-3
31252.0,2020-01-14,"(797.0, 1040.0]",4,10,-6
31252.0,2020-01-14,"(1040.0, 1283.0]",2,15,-13
31253.0,2020-01-14,"(396.003, 646.25]",15,17,-2
31253.0,2020-01-14,"(646.25, 895.5]",9,15,-6
31253.0,2020-01-14,"(895.5, 1144.75]",5,22,-17
31253.0,2020-01-14,"(1144.75, 1394.0]",2,8,-6
31254.0,2020-01-14,"(410.087, 639.25]",16,18,-2
31254.0,2020-01-14,"(639.25, 867.5]",2,3,-1
31254.0,2020-01-14,"(867.5, 1095.75]",4,23,-19
31254.0,2020-01-14,"(1095.75, 1324.0]",4,11,-7
31255.0,2020-01-14,"(374.947, 639.25]",20,31,-11
31255.0,2020-01-14,"(639.25, 902.5]",5,12,-7
31255.0,2020-01-14,"(902.5, 1165.75]",7,25,-18
31255.0,2020-01-14,"(1165.75, 1429.0]",2,4,-2
31256.0,2020-01-14,"(38.672, 372.0]",2,3,-1
31256.0,2020-01-14,"(372.0, 704.0]",11,14,-3
31256.0,2020-01-14,"(704.0, 1036.0]",3,8,-5
31256.0,2020-01-14,"(1036.0, 1368.0]",6,15,-9
31257.0,2020-01-14,"(321.941, 587.75]",20,25,-5
31257.0,2020-01-14,"(587.75, 852.5]",11,26,-15
31257.0,2020-01-14,"(852.5, 1117.25]",10,26,-16
31257.0,2020-01-14,"(1117.25, 1382.0]",5,14,-9
31258.0,2020-01-14,"(670.256, 857.0]",2,2,0
31258.0,2020-01-14,"(857.0, 1043.0]",5,8,-3
31258.0,2020-01-14,"(1043.0, 1229.0]",2,4,-2
31258.0,2020-01-14,"(1229.0, 1415.0]",2,4,-2
31259.0,2020-01-14,"(403.331, 571.25]",10,12,-2
31259.0,2020-01-14,"(571.25, 738.5]",3,4,-1
31259.0,2020-01-14,"(905.75, 1073.0]",2,1,1
31260.0,2020-01-14,"(386.97, 645.5]",15,16,-1
31260.0,2020-01-14,"(645.5, 903.0]",6,13,-7
31260.0,2020-01-14,"(903.0, 1160.5]",4,21,-17
31260.0,2020-01-14,"(1160.5, 1418.0]",1,5,-4
31261.0,2020-01-14,"(387.247, 576.25]",2,2,0
31261.0,2020-01-14,"(952.75, 1141.0]",1,3,-2
31262.0,2020-01-14,"(436.127, 655.25]",8,9,-1
31262.0,2020-01-14,"(655.25, 873.5]",4,6,-2
31262.0,2020-01-14,"(873.5, 1091.75]",5,14,-9
31262.0,2020-01-14,"(1091.75, 1310.0]",4,15,-11
31263.0,2020-01-14,"(-0.386, 347.5]",2,2,0
31263.0,2020-01-14,"(347.5, 694.0]",17,22,-5
31263.0,2020-01-14,"(694.0, 1040.5]",11,32,-21
31263.0,2020-01-14,"(1040.5, 1387.0]",6,24,-18
31264.0,2020-01-14,"(465.08, 696.0]",7,9,-2
31264.0,2020-01-14,"(696.0, 926.0]",1,1,0
31264.0,2020-01-14,"(926.0, 1156.0]",3,13,-10
31264.0,2020-01-14,"(1156.0, 1386.0]",3,4,-1
31265.0,2020-01-14,"(319.924, 590.0]",12,28,-16
31265.0,2020-01-14,"(590.0, 859.0]",7,9,-2
31265.0,2020-01-14,"(859.0, 1128.0]",21,43,-22
31265.0,2020-01-14,"(1128.0, 1397.0]",12,22,-10
31266.0,2020-01-14,"(3.61, 352.5]",1,6,-5
31266.0,2020-01-14,"(352.5, 700.0]",11,28,-17
31266.0,2020-01-14,"(700.0, 1047.5]",11,23,-12
31266.0,2020-01-14,"(1047.5, 1395.0]",26,47,-21
31267.0,2020-01-14,"(23.625, 368.75]",1,2,-1
31267.0,2020-01-14,"(368.75, 712.5]",15,35,-20
31267.0,2020-01-14,"(712.5, 1056.25]",11,21,-10
31267.0,2020-01-14,"(1056.25, 1400.0]",23,39,-16
31268.0,2020-01-14,"(323.997, 575.75]",9,25,-16
31268.0,2020-01-14,"(575.75, 826.5]",3,6,-3
31268.0,2020-01-14,"(826.5, 1077.25]",15,24,-9
31268.0,2020-01-14,"(1077.25, 1328.0]",18,27,-9
31269.0,2020-01-14,"(350.009, 598.75]",5,9,-4
31269.0,2020-01-14,"(598.75, 846.5]",8,11,-3
31269.0,2020-01-14,"(846.5, 1094.25]",7,16,-9
31269.0,2020-01-14,"(1094.25, 1342.0]",3,8,-5
31270.0,2020-01-14,"(322.972, 581.0]",10,16,-6
31270.0,2020-01-14,"(581.0, 838.0]",6,10,-4
31270.0,2020-01-14,"(838.0, 1095.0]",12,21,-9
31270.0,2020-01-14,"(1095.0, 1352.0]",2,7,-5
31271.0,2020-01-14,"(90.841, 381.75]",2,4,-2
31271.0,2020-01-14,"(381.75, 671.5]",11,13,-2
31271.0,2020-01-14,"(671.5, 961.25]",6,14,-8
31271.0,2020-01-14,"(961.25, 1251.0]",3,20,-17
31272.0,2020-01-14,"(295.023, 540.25]",9,10,-1
31272.0,2020-01-14,"(540.25, 784.5]",15,16,-1
31272.0,2020-01-14,"(784.5, 1028.75]",7,22,-15
31272.0,2020-01-14,"(1028.75, 1273.0]",4,18,-14
31273.0,2020-01-14,"(463.405, 612.75]",2,3,-1
31273.0,2020-01-14,"(612.75, 761.5]",1,4,-3
31273.0,2020-01-14,"(910.25, 1059.0]",4,4,0
31274.0,2020-01-14,"(447.204, 647.0]",9,9,0
31274.0,2020-01-14,"(647.0, 846.0]",5,8,-3
31274.0,2020-01-14,"(846.0, 1045.0]",2,5,-3
31274.0,2020-01-14,"(1045.0, 1244.0]",1,9,-8
31275.0,2020-01-14,"(271.939, 538.25]",3,9,-6
31275.0,2020-01-14,"(538.25, 803.5]",10,16,-6
31275.0,2020-01-14,"(803.5, 1068.75]",8,17,-9
31275.0,2020-01-14,"(1068.75, 1334.0]",7,21,-14
31276.0,2020-01-14,"(413.061, 648.75]",17,18,-1
31276.0,2020-01-14,"(648.75, 883.5]",6,13,-7
31276.0,2020-01-14,"(883.5, 1118.25]",7,24,-17
31276.0,2020-01-14,"(1118.25, 1353.0]",1,7,-6
31277.0,2020-01-14,"(371.279, 552.25]",18,18,0
31277.0,2020-01-14,"(552.25, 732.5]",8,9,-1
31277.0,2020-01-14,"(732.5, 912.75]",8,14,-6
31277.0,2020-01-14,"(912.75, 1093.0]",8,35,-27
31278.0,2020-01-14,"(20.589, 374.75]",1,4,-3
31278.0,2020-01-14,"(374.75, 727.5]",9,31,-22
31278.0,2020-01-14,"(727.5, 1080.25]",11,18,-7
31278.0,2020-01-14,"(1080.25, 1433.0]",22,32,-10
31279.0,2020-01-14,"(385.199, 586.25]",17,19,-2
31279.0,2020-01-14,"(586.25, 786.5]",7,8,-1
31279.0,2020-01-14,"(786.5, 986.75]",3,10,-7
31279.0,2020-01-14,"(986.75, 1187.0]",5,21,-16
31280.0,2020-01-14,"(42.65, 381.5]",2,4,-2
31280.0,2020-01-14,"(381.5, 719.0]",3,13,-10
31280.0,2020-01-14,"(719.0, 1056.5]",5,8,-3
31280.0,2020-01-14,"(1056.5, 1394.0]",11,16,-5
31000.0,2020-01-15,"(984.75, 1147.0]",3,1,2
31001.0,2020-01-15,"(890.625, 984.75]",1,1,0
31001.0,2020-01-15,"(1172.25, 1266.0]",2,1,1
31002.0,2020-01-15,"(517.235, 709.25]",4,6,-2
31002.0,2020-01-15,"(900.5, 1091.75]",4,2,2
31002.0,2020-01-15,"(1091.75, 1283.0]",2,7,-5
31003.0,2020-01-15,"(407.022, 652.5]",5,7,-2
31003.0,2020-01-15,"(652.5, 897.0]",1,3,-2
31003.0,2020-01-15,"(897.0, 1141.5]",3,8,-5
31003.0,2020-01-15,"(1141.5, 1386.0]",2,4,-2
31004.0,2020-01-15,"(964.75, 1120.0]",3,1,2
31005.0,2020-01-15,"(438.134, 655.5]",4,5,-1
31005.0,2020-01-15,"(655.5, 872.0]",1,4,-3
31005.0,2020-01-15,"(1088.5, 1305.0]",6,5,1
31006.0,2020-01-15,"(633.25, 867.5]",5,1,4
31006.0,2020-01-15,"(867.5, 1101.75]",1,5,-4
31006.0,2020-01-15,"(1101.75, 1336.0]",1,1,0
31007.0,2020-01-15,"(413.115, 635.25]",8,22,-14
31007.0,2020-01-15,"(635.25, 856.5]",2,9,-7
31007.0,2020-01-15,"(856.5, 1077.75]",7,18,-11
31007.0,2020-01-15,"(1077.75, 1299.0]",3,10,-7
31009.0,2020-01-15,"(370.342, 535.5]",4,6,-2
31009.0,2020-01-15,"(535.5, 700.0]",3,3,0
31009.0,2020-01-15,"(700.0, 864.5]",1,1,0
31010.0,2020-01-15,"(682.0, 884.0]",1,1,0
31010.0,2020-01-15,"(884.0, 1086.0]",1,1,0
31010.0,2020-01-15,"(1086.0, 1288.0]",3,4,-1
31011.0,2020-01-15,"(495.333, 662.75]",4,6,-2
31011.0,2020-01-15,"(829.5, 996.25]",2,3,-1
31011.0,2020-01-15,"(996.25, 1163.0]",2,7,-5
31012.0,2020-01-15,"(412.231, 605.25]",5,5,0
31012.0,2020-01-15,"(605.25, 797.5]",2,2,0
31012.0,2020-01-15,"(797.5, 989.75]",1,4,-3
31013.0,2020-01-15,"(390.005, 639.75]",1,3,-2
31013.0,2020-01-15,"(639.75, 888.5]",3,6,-3
31013.0,2020-01-15,"(888.5, 1137.25]",3,3,0
31013.0,2020-01-15,"(1137.25, 1386.0]",2,4,-2
31014.0,2020-01-15,"(409.009, 657.75]",27,35,-8
31014.0,2020-01-15,"(657.75, 905.5]",8,12,-4
31014.0,2020-01-15,"(905.5, 1153.25]",20,38,-18
31014.0,2020-01-15,"(1153.25, 1401.0]",3,7,-4
31015.0,2020-01-15,"(305.119, 526.25]",5,8,-3
31015.0,2020-01-15,"(526.25, 746.5]",8,11,-3
31015.0,2020-01-15,"(746.5, 966.75]",2,6,-4
31015.0,2020-01-15,"(966.75, 1187.0]",6,9,-3
31016.0,2020-01-15,"(348.253, 535.75]",6,11,-5
31016.0,2020-01-15,"(722.5, 909.25]",1,2,-1
31016.0,2020-01-15,"(909.25, 1096.0]",3,3,0
31017.0,2020-01-15,"(541.117, 762.75]",2,4,-2
31017.0,2020-01-15,"(762.75, 983.5]",1,1,0
31017.0,2020-01-15,"(983.5, 1204.25]",1,5,-4
31017.0,2020-01-15,"(1204.25, 1425.0]",2,3,-1
31018.0,2020-01-15,"(794.5, 979.75]",1,2,-1
31018.0,2020-01-15,"(979.75, 1165.0]",1,1,0
31019.0,2020-01-15,"(672.5, 893.0]",1,1,0
31019.0,2020-01-15,"(893.0, 1113.5]",2,3,-1
31020.0,2020-01-15,"(439.197, 640.75]",2,2,0
31020.0,2020-01-15,"(640.75, 841.5]",1,2,-1
31020.0,2020-01-15,"(841.5, 1042.25]",1,3,-2
31021.0,2020-01-15,"(377.029, 620.75]",1,8,-7
31021.0,2020-01-15,"(620.75, 863.5]",2,3,-1
31021.0,2020-01-15,"(863.5, 1106.25]",1,4,-3
31021.0,2020-01-15,"(1106.25, 1349.0]",3,8,-5
31022.0,2020-01-15,"(448.019, 694.25]",3,6,-3
31022.0,2020-01-15,"(694.25, 939.5]",4,8,-4
31022.0,2020-01-15,"(1184.75, 1430.0]",2,3,-1
31023.0,2020-01-15,"(465.136, 682.0]",1,4,-3
31023.0,2020-01-15,"(682.0, 898.0]",1,2,-1
31023.0,2020-01-15,"(898.0, 1114.0]",4,5,-1
31023.0,2020-01-15,"(1114.0, 1330.0]",3,10,-7
31024.0,2020-01-15,"(412.13, 630.5]",7,12,-5
31024.0,2020-01-15,"(630.5, 848.0]",5,8,-3
31024.0,2020-01-15,"(848.0, 1065.5]",1,7,-6
31024.0,2020-01-15,"(1065.5, 1283.0]",3,7,-4
31025.0,2020-01-15,"(853.75, 870.5]",1,1,0
31025.0,2020-01-15,"(870.5, 887.25]",2,1,1
31026.0,2020-01-15,"(350.75, 682.5]",1,1,0
31026.0,2020-01-15,"(1014.25, 1346.0]",3,4,-1
31027.0,2020-01-15,"(1082.25, 1129.0]",1,1,0
31028.0,2020-01-15,"(481.171, 689.25]",2,3,-1
31028.0,2020-01-15,"(689.25, 896.5]",1,1,0
31028.0,2020-01-15,"(1103.75, 1311.0]",1,3,-2
31029.0,2020-01-15,"(850.5, 1054.25]",1,7,-6
31029.0,2020-01-15,"(1054.25, 1258.0]",3,3,0
31030.0,2020-01-15,"(338.911, 612.25]",1,9,-8
31030.0,2020-01-15,"(612.25, 884.5]",1,3,-2
31030.0,2020-01-15,"(884.5, 1156.75]",3,4,-1
31030.0,2020-01-15,"(1156.75, 1429.0]",1,3,-2
31031.0,2020-01-15,"(965.75, 1184.0]",3,3,0
31032.0,2020-01-15,"(185.792, 489.0]",2,4,-2
31032.0,2020-01-15,"(1093.0, 1395.0]",1,1,0
31033.0,2020-01-15,"(318.961, 579.75]",1,2,-1
31033.0,2020-01-15,"(839.5, 1099.25]",1,1,0
31033.0,2020-01-15,"(1099.25, 1359.0]",1,2,-1
31034.0,2020-01-15,"(473.066, 707.5]",6,9,-3
31034.0,2020-01-15,"(707.5, 941.0]",2,6,-4
31034.0,2020-01-15,"(941.0, 1174.5]",1,6,-5
31034.0,2020-01-15,"(1174.5, 1408.0]",1,2,-1
31035.0,2020-01-15,"(5.587, 360.25]",1,1,0
31035.0,2020-01-15,"(360.25, 713.5]",1,2,-1
31035.0,2020-01-15,"(713.5, 1066.75]",2,6,-4
31035.0,2020-01-15,"(1066.75, 1420.0]",4,7,-3
31036.0,2020-01-15,"(638.0, 849.0]",1,3,-2
31036.0,2020-01-15,"(849.0, 1060.0]",2,2,0
31036.0,2020-01-15,"(1060.0, 1271.0]",2,2,0
31037.0,2020-01-15,"(435.029, 678.75]",9,13,-4
31037.0,2020-01-15,"(678.75, 921.5]",3,7,-4
31037.0,2020-01-15,"(921.5, 1164.25]",4,17,-13
31037.0,2020-01-15,"(1164.25, 1407.0]",1,4,-3
31038.0,2020-01-15,"(401.134, 618.5]",1,2,-1
31038.0,2020-01-15,"(618.5, 835.0]",4,7,-3
31038.0,2020-01-15,"(1051.5, 1268.0]",1,1,0
31039.0,2020-01-15,"(418.108, 642.0]",5,8,-3
31039.0,2020-01-15,"(642.0, 865.0]",1,5,-4
31039.0,2020-01-15,"(865.0, 1088.0]",3,6,-3
31040.0,2020-01-15,"(459.327, 628.25]",2,2,0
31040.0,2020-01-15,"(628.25, 796.5]",3,3,0
31040.0,2020-01-15,"(796.5, 964.75]",1,3,-2
31040.0,2020-01-15,"(964.75, 1133.0]",1,3,-2
31041.0,2020-01-15,"(464.404, 614.0]",3,4,-1
31041.0,2020-01-15,"(763.0, 912.0]",1,2,-1
31041.0,2020-01-15,"(912.0, 1061.0]",1,1,0
31042.0,2020-01-15,"(450.166, 659.5]",10,10,0
31042.0,2020-01-15,"(659.5, 868.0]",2,4,-2
31042.0,2020-01-15,"(1076.5, 1285.0]",1,5,-4
31043.0,2020-01-15,"(415.241, 605.75]",1,2,-1
31043.0,2020-01-15,"(605.75, 795.5]",2,3,-1
31043.0,2020-01-15,"(795.5, 985.25]",2,4,-2
31043.0,2020-01-15,"(985.25, 1175.0]",3,5,-2
31044.0,2020-01-15,"(473.219, 669.25]",6,8,-2
31044.0,2020-01-15,"(669.25, 864.5]",1,2,-1
31044.0,2020-01-15,"(864.5, 1059.75]",2,3,-1
31044.0,2020-01-15,"(1059.75, 1255.0]",3,5,-2
31045.0,2020-01-15,"(704.25, 872.5]",1,1,0
31045.0,2020-01-15,"(1040.75, 1209.0]",1,2,-1
31046.0,2020-01-15,"(399.328, 568.0]",1,5,-4
31046.0,2020-01-15,"(736.0, 904.0]",1,1,0
31046.0,2020-01-15,"(904.0, 1072.0]",1,2,-1
31047.0,2020-01-15,"(351.144, 566.0]",10,22,-12
31047.0,2020-01-15,"(566.0, 780.0]",5,7,-2
31047.0,2020-01-15,"(780.0, 994.0]",2,4,-2
31047.0,2020-01-15,"(994.0, 1208.0]",16,34,-18
31048.0,2020-01-15,"(339.09, 567.5]",5,6,-1
31048.0,2020-01-15,"(795.0, 1022.5]",1,4,-3
31048.0,2020-01-15,"(1022.5, 1250.0]",3,4,-1
31049.0,2020-01-15,"(436.375, 593.25]",2,2,0
31049.0,2020-01-15,"(905.75, 1062.0]",1,1,0
31050.0,2020-01-15,"(895.75, 1045.0]",1,3,-2
31051.0,2020-01-15,"(731.0, 945.5]",3,3,0
31051.0,2020-01-15,"(945.5, 1160.0]",6,4,2
31052.0,2020-01-15,"(524.703, 599.25]",2,4,-2
31052.0,2020-01-15,"(747.75, 822.0]",1,1,0
31053.0,2020-01-15,"(539.449, 677.75]",1,2,-1
31053.0,2020-01-15,"(953.25, 1091.0]",1,1,0
31054.0,2020-01-15,"(579.0, 722.0]",1,1,0
31054.0,2020-01-15,"(865.0, 1008.0]",1,1,0
31055.0,2020-01-15,"(400.442, 540.5]",2,3,-1
31055.0,2020-01-15,"(819.5, 959.0]",2,3,-1
31056.0,2020-01-15,"(731.75, 928.5]",1,1,0
31056.0,2020-01-15,"(928.5, 1125.25]",3,2,1
31056.0,2020-01-15,"(1125.25, 1322.0]",2,3,-1
31057.0,2020-01-15,"(28.5, 38.0]",1,1,0
31058.0,2020-01-15,"(90.049, 328.75]",1,2,-1
31058.0,2020-01-15,"(328.75, 566.5]",1,2,-1
31058.0,2020-01-15,"(804.25, 1042.0]",1,1,0
31059.0,2020-01-15,"(315.265, 499.75]",1,4,-3
31059.0,2020-01-15,"(867.25, 1051.0]",3,4,-1
31060.0,2020-01-15,"(548.185, 752.75]",1,1,0
31060.0,2020-01-15,"(956.5, 1160.25]",2,5,-3
31060.0,2020-01-15,"(1160.25, 1364.0]",3,5,-2
31061.0,2020-01-15,"(408.0, 544.0]",1,1,0
31062.0,2020-01-15,"(508.449, 646.75]",2,4,-2
31062.0,2020-01-15,"(646.75, 784.5]",3,5,-2
31062.0,2020-01-15,"(784.5, 922.25]",3,6,-3
31062.0,2020-01-15,"(922.25, 1060.0]",2,3,-1
31063.0,2020-01-15,"(792.75, 1057.0]",2,1,1
31064.0,2020-01-15,"(497.332, 665.0]",5,12,-7
31064.0,2020-01-15,"(665.0, 832.0]",1,2,-1
31064.0,2020-01-15,"(832.0, 999.0]",7,13,-6
31064.0,2020-01-15,"(999.0, 1166.0]",8,15,-7
31065.0,2020-01-15,"(700.0, 863.0]",2,2,0
31065.0,2020-01-15,"(863.0, 1026.0]",1,3,-2
,,,,1.0,
,,,,1.0,
31067.0,2020-01-15,"(93.827, 388.25]",1,2,-1
31067.0,2020-01-15,"(974.75, 1268.0]",4,2,2
31068.0,2020-01-15,"(716.5, 927.0]",1,2,-1
31068.0,2020-01-15,"(1137.5, 1348.0]",2,1,1
31069.0,2020-01-15,"(434.302, 609.5]",1,7,-6
31069.0,2020-01-15,"(784.0, 958.5]",2,2,0
31069.0,2020-01-15,"(958.5, 1133.0]",3,4,-1
31070.0,2020-01-15,"(532.183, 737.25]",1,4,-3
31070.0,2020-01-15,"(941.5, 1145.75]",3,1,2
31070.0,2020-01-15,"(1145.75, 1350.0]",1,6,-5
31071.0,2020-01-15,"(471.249, 659.75]",2,4,-2
31071.0,2020-01-15,"(659.75, 847.5]",2,9,-7
31071.0,2020-01-15,"(847.5, 1035.25]",7,10,-3
31071.0,2020-01-15,"(1035.25, 1223.0]",5,8,-3
,,,,1.0,
,,,,1.0,
,,,,1.0,
31073.0,2020-01-15,"(497.369, 655.75]",2,4,-2
31073.0,2020-01-15,"(971.25, 1129.0]",1,1,0
31074.0,2020-01-15,"(747.75, 965.5]",1,2,-1
31074.0,2020-01-15,"(965.5, 1183.25]",2,1,1
31074.0,2020-01-15,"(1183.25, 1401.0]",3,5,-2
31075.0,2020-01-15,"(991.25, 1145.0]",3,1,2
31076.0,2020-01-15,"(432.293, 609.75]",1,2,-1
31076.0,2020-01-15,"(786.5, 963.25]",1,1,0
31076.0,2020-01-15,"(963.25, 1140.0]",1,2,-1
31077.0,2020-01-15,"(530.142, 745.5]",7,11,-4
31077.0,2020-01-15,"(745.5, 960.0]",1,5,-4
31077.0,2020-01-15,"(960.0, 1174.5]",2,3,-1
31077.0,2020-01-15,"(1174.5, 1389.0]",1,1,0
31078.0,2020-01-15,"(470.375, 627.25]",4,6,-2
31078.0,2020-01-15,"(939.75, 1096.0]",1,3,-2
31079.0,2020-01-15,"(698.75, 943.5]",1,5,-4
31079.0,2020-01-15,"(943.5, 1188.25]",2,3,-1
31079.0,2020-01-15,"(1188.25, 1433.0]",6,3,3
31080.0,2020-01-15,"(383.042, 623.5]",1,9,-8
31080.0,2020-01-15,"(623.5, 863.0]",1,3,-2
31080.0,2020-01-15,"(863.0, 1102.5]",4,6,-2
31080.0,2020-01-15,"(1102.5, 1342.0]",3,3,0
31081.0,2020-01-15,"(448.309, 621.75]",3,5,-2
31081.0,2020-01-15,"(794.5, 967.25]",1,2,-1
31081.0,2020-01-15,"(967.25, 1140.0]",1,5,-4
,,,,2.0,
31083.0,2020-01-15,"(463.167, 672.25]",1,6,-5
31083.0,2020-01-15,"(672.25, 880.5]",2,2,0
31083.0,2020-01-15,"(880.5, 1088.75]",1,3,-2
31083.0,2020-01-15,"(1088.75, 1297.0]",4,4,0
31084.0,2020-01-15,"(335.088, 564.0]",3,5,-2
31084.0,2020-01-15,"(564.0, 792.0]",5,6,-1
31084.0,2020-01-15,"(1020.0, 1248.0]",1,1,0
31085.0,2020-01-15,"(404.379, 560.25]",1,4,-3
31085.0,2020-01-15,"(870.75, 1026.0]",1,2,-1
31086.0,2020-01-15,"(596.25, 778.5]",1,2,-1
31086.0,2020-01-15,"(960.75, 1143.0]",4,2,2
31087.0,2020-01-15,"(606.5, 771.0]",1,4,-3
31087.0,2020-01-15,"(935.5, 1100.0]",5,3,2
31088.0,2020-01-15,"(669.25, 884.5]",1,3,-2
31088.0,2020-01-15,"(884.5, 1099.75]",5,4,1
31088.0,2020-01-15,"(1099.75, 1315.0]",3,5,-2
31089.0,2020-01-15,"(478.119, 699.25]",6,10,-4
31089.0,2020-01-15,"(699.25, 919.5]",3,6,-3
31089.0,2020-01-15,"(919.5, 1139.75]",4,16,-12
31089.0,2020-01-15,"(1139.75, 1360.0]",3,7,-4
31090.0,2020-01-15,"(574.25, 724.5]",1,1,0
31090.0,2020-01-15,"(724.5, 874.75]",1,3,-2
31090.0,2020-01-15,"(874.75, 1025.0]",2,2,0
31091.0,2020-01-15,"(436.045, 675.75]",1,4,-3
31091.0,2020-01-15,"(914.5, 1153.25]",5,1,4
31091.0,2020-01-15,"(1153.25, 1392.0]",2,5,-3
31092.0,2020-01-15,"(643.75, 816.5]",1,3,-2
31092.0,2020-01-15,"(989.25, 1162.0]",4,1,3
,,,,1.0,
,,,,3.0,
,,,,3.0,
31094.0,2020-01-15,"(666.581, 771.75]",1,3,-2
31094.0,2020-01-15,"(981.25, 1086.0]",1,2,-1
,,,,2.0,
31096.0,2020-01-15,"(944.25, 1088.0]",1,1,0
31097.0,2020-01-15,"(467.252, 655.0]",4,5,-1
31097.0,2020-01-15,"(655.0, 842.0]",1,1,0
31097.0,2020-01-15,"(842.0, 1029.0]",1,1,0
31097.0,2020-01-15,"(1029.0, 1216.0]",2,4,-2
31098.0,2020-01-15,"(366.18, 572.0]",5,12,-7
31098.0,2020-01-15,"(572.0, 777.0]",2,5,-3
31098.0,2020-01-15,"(982.0, 1187.0]",9,18,-9
31099.0,2020-01-15,"(911.25, 1004.0]",1,1,0
31100.0,2020-01-15,"(422.301, 597.75]",14,14,0
31100.0,2020-01-15,"(597.75, 772.5]",1,2,-1
31100.0,2020-01-15,"(772.5, 947.25]",2,5,-3
31101.0,2020-01-15,"(332.903, 608.25]",14,51,-37
31101.0,2020-01-15,"(608.25, 882.5]",17,30,-13
31101.0,2020-01-15,"(882.5, 1156.75]",45,66,-21
31101.0,2020-01-15,"(1156.75, 1431.0]",7,21,-14
31102.0,2020-01-15,"(21.645, 361.75]",1,1,0
31102.0,2020-01-15,"(361.75, 700.5]",3,29,-26
31102.0,2020-01-15,"(700.5, 1039.25]",3,5,-2
31102.0,2020-01-15,"(1039.25, 1378.0]",12,21,-9
31103.0,2020-01-15,"(352.25, 692.5]",2,1,1
31103.0,2020-01-15,"(692.5, 1032.75]",4,25,-21
31103.0,2020-01-15,"(1032.75, 1373.0]",9,16,-7
31104.0,2020-01-15,"(83.722, 404.5]",1,3,-2
31104.0,2020-01-15,"(404.5, 724.0]",4,14,-10
31104.0,2020-01-15,"(724.0, 1043.5]",9,21,-12
31104.0,2020-01-15,"(1043.5, 1363.0]",11,22,-11
31105.0,2020-01-15,"(858.5, 1118.25]",3,9,-6
31105.0,2020-01-15,"(1118.25, 1378.0]",4,11,-7
31106.0,2020-01-15,"(892.5, 1108.25]",1,11,-10
31106.0,2020-01-15,"(1108.25, 1324.0]",4,3,1
31107.0,2020-01-15,"(358.75, 713.5]",6,1,5
31107.0,2020-01-15,"(713.5, 1068.25]",15,30,-15
31107.0,2020-01-15,"(1068.25, 1423.0]",19,30,-11
31108.0,2020-01-15,"(344.98, 601.0]",6,32,-26
31108.0,2020-01-15,"(601.0, 856.0]",9,13,-4
31108.0,2020-01-15,"(856.0, 1111.0]",18,29,-11
31108.0,2020-01-15,"(1111.0, 1366.0]",11,18,-7
31109.0,2020-01-15,"(14.6, 366.0]",1,2,-1
31109.0,2020-01-15,"(366.0, 716.0]",6,19,-13
31109.0,2020-01-15,"(716.0, 1066.0]",14,25,-11
31109.0,2020-01-15,"(1066.0, 1416.0]",16,28,-12
31110.0,2020-01-15,"(332.947, 597.25]",15,36,-21
31110.0,2020-01-15,"(597.25, 860.5]",4,9,-5
31110.0,2020-01-15,"(860.5, 1123.75]",18,34,-16
31110.0,2020-01-15,"(1123.75, 1387.0]",10,17,-7
31111.0,2020-01-15,"(406.976, 664.0]",6,21,-15
31111.0,2020-01-15,"(664.0, 920.0]",4,11,-7
31111.0,2020-01-15,"(920.0, 1176.0]",15,20,-5
31111.0,2020-01-15,"(1176.0, 1432.0]",7,13,-6
31112.0,2020-01-15,"(304.226, 498.5]",2,3,-1
31112.0,2020-01-15,"(692.0, 885.5]",1,1,0
31112.0,2020-01-15,"(885.5, 1079.0]",3,2,1
31113.0,2020-01-15,"(599.0, 877.0]",1,22,-21
31113.0,2020-01-15,"(877.0, 1155.0]",10,8,2
31113.0,2020-01-15,"(1155.0, 1433.0]",7,14,-7
31114.0,2020-01-15,"(10.642, 351.5]",1,2,-1
31114.0,2020-01-15,"(351.5, 691.0]",4,30,-26
31114.0,2020-01-15,"(691.0, 1030.5]",9,18,-9
31114.0,2020-01-15,"(1030.5, 1370.0]",25,43,-18
31115.0,2020-01-15,"(332.941, 598.75]",1,24,-23
31115.0,2020-01-15,"(598.75, 863.5]",1,8,-7
31115.0,2020-01-15,"(863.5, 1128.25]",6,15,-9
31115.0,2020-01-15,"(1128.25, 1393.0]",12,15,-3
31116.0,2020-01-15,"(34.63, 378.5]",2,3,-1
31116.0,2020-01-15,"(378.5, 721.0]",1,21,-20
31116.0,2020-01-15,"(721.0, 1063.5]",13,22,-9
31116.0,2020-01-15,"(1063.5, 1406.0]",25,35,-10
31117.0,2020-01-15,"(302.938, 569.5]",2,18,-16
31117.0,2020-01-15,"(569.5, 835.0]",1,14,-13
31117.0,2020-01-15,"(835.0, 1100.5]",7,13,-6
31117.0,2020-01-15,"(1100.5, 1366.0]",14,29,-15
31118.0,2020-01-15,"(315.986, 570.5]",2,17,-15
31118.0,2020-01-15,"(570.5, 824.0]",3,6,-3
31118.0,2020-01-15,"(824.0, 1077.5]",7,13,-6
31118.0,2020-01-15,"(1077.5, 1331.0]",16,20,-4
31119.0,2020-01-15,"(3.574, 361.5]",2,3,-1
31119.0,2020-01-15,"(361.5, 718.0]",8,24,-16
31119.0,2020-01-15,"(718.0, 1074.5]",14,24,-10
31119.0,2020-01-15,"(1074.5, 1431.0]",16,29,-13
31120.0,2020-01-15,"(404.077, 635.75]",4,19,-15
31120.0,2020-01-15,"(635.75, 866.5]",1,5,-4
31120.0,2020-01-15,"(866.5, 1097.25]",5,7,-2
31120.0,2020-01-15,"(1097.25, 1328.0]",12,16,-4
31121.0,2020-01-15,"(354.061, 589.75]",12,18,-6
31121.0,2020-01-15,"(589.75, 824.5]",1,5,-4
31121.0,2020-01-15,"(824.5, 1059.25]",4,12,-8
31121.0,2020-01-15,"(1059.25, 1294.0]",7,14,-7
31122.0,2020-01-15,"(14.59, 368.5]",1,4,-3
31122.0,2020-01-15,"(368.5, 721.0]",4,20,-16
31122.0,2020-01-15,"(721.0, 1073.5]",9,13,-4
31122.0,2020-01-15,"(1073.5, 1426.0]",16,25,-9
31123.0,2020-01-15,"(13.579, 370.25]",3,3,0
31123.0,2020-01-15,"(370.25, 725.5]",2,22,-20
31123.0,2020-01-15,"(725.5, 1080.75]",4,11,-7
31123.0,2020-01-15,"(1080.75, 1436.0]",5,10,-5
31124.0,2020-01-15,"(419.997, 671.75]",18,50,-32
31124.0,2020-01-15,"(671.75, 922.5]",8,21,-13
31124.0,2020-01-15,"(922.5, 1173.25]",19,58,-39
31124.0,2020-01-15,"(1173.25, 1424.0]",11,31,-20
31125.0,2020-01-15,"(327.891, 606.25]",3,24,-21
31125.0,2020-01-15,"(606.25, 883.5]",6,8,-2
31125.0,2020-01-15,"(883.5, 1160.75]",31,48,-17
31125.0,2020-01-15,"(1160.75, 1438.0]",17,27,-10
31126.0,2020-01-15,"(346.01, 594.5]",4,25,-21
31126.0,2020-01-15,"(594.5, 842.0]",3,10,-7
31126.0,2020-01-15,"(842.0, 1089.5]",17,30,-13
31126.0,2020-01-15,"(1089.5, 1337.0]",11,16,-5
,,,,2.0,
31128.0,2020-01-15,"(24.59, 378.5]",3,6,-3
31128.0,2020-01-15,"(378.5, 731.0]",40,61,-21
31128.0,2020-01-15,"(731.0, 1083.5]",28,50,-22
31128.0,2020-01-15,"(1083.5, 1436.0]",16,36,-20
31129.0,2020-01-15,"(426.009, 674.75]",11,16,-5
31129.0,2020-01-15,"(674.75, 922.5]",10,21,-11
31129.0,2020-01-15,"(922.5, 1170.25]",14,25,-11
31129.0,2020-01-15,"(1170.25, 1418.0]",2,6,-4
31130.0,2020-01-15,"(290.045, 529.75]",2,9,-7
31130.0,2020-01-15,"(529.75, 768.5]",4,8,-4
31130.0,2020-01-15,"(768.5, 1007.25]",5,12,-7
31130.0,2020-01-15,"(1007.25, 1246.0]",16,23,-7
31131.0,2020-01-15,"(78.7, 405.0]",1,3,-2
31131.0,2020-01-15,"(405.0, 730.0]",1,16,-15
31131.0,2020-01-15,"(730.0, 1055.0]",2,7,-5
31131.0,2020-01-15,"(1055.0, 1380.0]",10,13,-3
31200.0,2020-01-15,"(402.973, 660.75]",29,48,-19
31200.0,2020-01-15,"(660.75, 917.5]",10,20,-10
31200.0,2020-01-15,"(917.5, 1174.25]",27,56,-29
31200.0,2020-01-15,"(1174.25, 1431.0]",13,21,-8
31201.0,2020-01-15,"(293.914, 566.5]",18,49,-31
31201.0,2020-01-15,"(566.5, 838.0]",22,38,-16
31201.0,2020-01-15,"(838.0, 1109.5]",41,71,-30
31201.0,2020-01-15,"(1109.5, 1381.0]",19,48,-29
31202.0,2020-01-15,"(382.25, 734.5]",9,4,5
31202.0,2020-01-15,"(734.5, 1086.75]",24,24,0
31202.0,2020-01-15,"(1086.75, 1439.0]",25,34,-9
31203.0,2020-01-15,"(358.25, 713.5]",11,1,10
31203.0,2020-01-15,"(713.5, 1068.75]",31,35,-4
31203.0,2020-01-15,"(1068.75, 1424.0]",26,44,-18
31204.0,2020-01-15,"(32.71, 356.5]",2,2,0
31204.0,2020-01-15,"(356.5, 679.0]",14,19,-5
31204.0,2020-01-15,"(679.0, 1001.5]",10,25,-15
31204.0,2020-01-15,"(1001.5, 1324.0]",10,20,-10
31205.0,2020-01-15,"(17.691, 346.25]",2,6,-4
31205.0,2020-01-15,"(346.25, 673.5]",29,33,-4
31205.0,2020-01-15,"(673.5, 1000.75]",25,35,-10
31205.0,2020-01-15,"(1000.75, 1328.0]",17,44,-27
31206.0,2020-01-15,"(470.401, 620.75]",6,6,0
31206.0,2020-01-15,"(920.25, 1070.0]",1,11,-10
31207.0,2020-01-15,"(11.805, 311.75]",1,1,0
31207.0,2020-01-15,"(610.5, 909.25]",5,6,-1
31207.0,2020-01-15,"(909.25, 1208.0]",1,6,-5
31208.0,2020-01-15,"(326.958, 588.5]",10,11,-1
31208.0,2020-01-15,"(588.5, 849.0]",1,2,-1
31208.0,2020-01-15,"(849.0, 1109.5]",3,14,-11
31209.0,2020-01-15,"(502.159, 713.25]",2,3,-1
31209.0,2020-01-15,"(923.5, 1133.75]",5,2,3
31209.0,2020-01-15,"(1133.75, 1344.0]",4,9,-5
31211.0,2020-01-15,"(443.061, 678.75]",12,16,-4
31211.0,2020-01-15,"(678.75, 913.5]",4,7,-3
31211.0,2020-01-15,"(913.5, 1148.25]",11,21,-10
31212.0,2020-01-15,"(69.709, 393.75]",2,4,-2
31212.0,2020-01-15,"(393.75, 716.5]",33,53,-20
31212.0,2020-01-15,"(716.5, 1039.25]",18,39,-21
31212.0,2020-01-15,"(1039.25, 1362.0]",23,43,-20
31213.0,2020-01-15,"(87.766, 397.5]",4,4,0
31213.0,2020-01-15,"(397.5, 706.0]",44,56,-12
31213.0,2020-01-15,"(706.0, 1014.5]",13,27,-14
31213.0,2020-01-15,"(1014.5, 1323.0]",19,43,-24
31214.0,2020-01-15,"(209.775, 517.25]",3,21,-18
31214.0,2020-01-15,"(517.25, 823.5]",11,27,-16
31214.0,2020-01-15,"(823.5, 1129.75]",27,47,-20
31214.0,2020-01-15,"(1129.75, 1436.0]",5,11,-6
31215.0,2020-01-15,"(436.231, 629.25]",20,21,-1
31215.0,2020-01-15,"(629.25, 821.5]",1,2,-1
31215.0,2020-01-15,"(821.5, 1013.75]",6,9,-3
31215.0,2020-01-15,"(1013.75, 1206.0]",15,26,-11
31216.0,2020-01-15,"(409.064, 644.0]",21,22,-1
31216.0,2020-01-15,"(644.0, 878.0]",4,9,-5
31216.0,2020-01-15,"(878.0, 1112.0]",7,21,-14
31216.0,2020-01-15,"(1112.0, 1346.0]",1,10,-9
31217.0,2020-01-15,"(335.211, 533.25]",10,12,-2
31217.0,2020-01-15,"(533.25, 730.5]",8,13,-5
31217.0,2020-01-15,"(730.5, 927.75]",4,8,-4
31217.0,2020-01-15,"(927.75, 1125.0]",3,16,-13
31218.0,2020-01-15,"(378.06, 614.0]",18,37,-19
31218.0,2020-01-15,"(614.0, 849.0]",6,8,-2
31218.0,2020-01-15,"(849.0, 1084.0]",8,14,-6
31218.0,2020-01-15,"(1084.0, 1319.0]",3,6,-3
31219.0,2020-01-15,"(443.329, 611.75]",11,13,-2
31219.0,2020-01-15,"(611.75, 779.5]",3,5,-2
31219.0,2020-01-15,"(779.5, 947.25]",4,8,-4
31219.0,2020-01-15,"(947.25, 1115.0]",4,19,-15
31220.0,2020-01-15,"(283.193, 485.75]",9,15,-6
31220.0,2020-01-15,"(485.75, 687.5]",11,12,-1
31220.0,2020-01-15,"(687.5, 889.25]",1,2,-1
31220.0,2020-01-15,"(889.25, 1091.0]",1,17,-16
31221.0,2020-01-15,"(14.606, 364.5]",1,2,-1
31221.0,2020-01-15,"(364.5, 713.0]",42,50,-8
31221.0,2020-01-15,"(713.0, 1061.5]",17,42,-25
31221.0,2020-01-15,"(1061.5, 1410.0]",11,33,-22
31222.0,2020-01-15,"(390.064, 625.0]",22,25,-3
31222.0,2020-01-15,"(625.0, 859.0]",10,17,-7
31222.0,2020-01-15,"(859.0, 1093.0]",18,33,-15
31222.0,2020-01-15,"(1093.0, 1327.0]",2,14,-12
31223.0,2020-01-15,"(32.611, 381.25]",4,8,-4
31223.0,2020-01-15,"(381.25, 728.5]",29,61,-32
31223.0,2020-01-15,"(728.5, 1075.75]",17,41,-24
31223.0,2020-01-15,"(1075.75, 1423.0]",18,33,-15
31224.0,2020-01-15,"(380.956, 643.0]",20,21,-1
31224.0,2020-01-15,"(643.0, 904.0]",6,11,-5
31224.0,2020-01-15,"(904.0, 1165.0]",6,16,-10
31224.0,2020-01-15,"(1165.0, 1426.0]",3,5,-2
31225.0,2020-01-15,"(425.058, 661.5]",14,24,-10
31225.0,2020-01-15,"(661.5, 897.0]",8,13,-5
31225.0,2020-01-15,"(897.0, 1132.5]",11,29,-18
31225.0,2020-01-15,"(1132.5, 1368.0]",4,9,-5
31226.0,2020-01-15,"(319.75, 626.5]",6,2,4
31226.0,2020-01-15,"(626.5, 933.25]",5,12,-7
31226.0,2020-01-15,"(933.25, 1240.0]",10,10,0
31227.0,2020-01-15,"(448.229, 641.75]",23,24,-1
31227.0,2020-01-15,"(641.75, 834.5]",5,9,-4
31227.0,2020-01-15,"(834.5, 1027.25]",3,9,-6
31227.0,2020-01-15,"(1027.25, 1220.0]",4,21,-17
31228.0,2020-01-15,"(20.596, 373.0]",3,4,-1
31228.0,2020-01-15,"(373.0, 724.0]",24,34,-10
31228.0,2020-01-15,"(724.0, 1075.0]",24,51,-27
31228.0,2020-01-15,"(1075.0, 1426.0]",20,32,-12
31229.0,2020-01-15,"(21.596, 374.0]",2,7,-5
31229.0,2020-01-15,"(374.0, 725.0]",16,72,-56
31229.0,2020-01-15,"(725.0, 1076.0]",39,63,-24
31229.0,2020-01-15,"(1076.0, 1427.0]",19,33,-14
31230.0,2020-01-15,"(72.668, 407.0]",2,4,-2
31230.0,2020-01-15,"(407.0, 740.0]",69,87,-18
31230.0,2020-01-15,"(740.0, 1073.0]",29,55,-26
31230.0,2020-01-15,"(1073.0, 1406.0]",9,34,-25
31231.0,2020-01-15,"(311.243, 501.25]",13,13,0
31231.0,2020-01-15,"(501.25, 690.5]",14,20,-6
31231.0,2020-01-15,"(690.5, 879.75]",10,18,-8
31231.0,2020-01-15,"(879.75, 1069.0]",11,30,-19
31232.0,2020-01-15,"(139.717, 461.75]",7,10,-3
31232.0,2020-01-15,"(461.75, 782.5]",23,29,-6
31232.0,2020-01-15,"(782.5, 1103.25]",22,40,-18
31232.0,2020-01-15,"(1103.25, 1424.0]",9,25,-16
31233.0,2020-01-15,"(-0.417, 355.25]",1,1,0
31233.0,2020-01-15,"(355.25, 709.5]",49,54,-5
31233.0,2020-01-15,"(709.5, 1063.75]",21,47,-26
31233.0,2020-01-15,"(1063.75, 1418.0]",5,27,-22
31234.0,2020-01-15,"(29.619, 376.25]",2,3,-1
31234.0,2020-01-15,"(376.25, 721.5]",21,38,-17
31234.0,2020-01-15,"(721.5, 1066.75]",15,28,-13
31234.0,2020-01-15,"(1066.75, 1412.0]",28,48,-20
31235.0,2020-01-15,"(328.15, 541.5]",4,5,-1
31235.0,2020-01-15,"(541.5, 754.0]",6,7,-1
31235.0,2020-01-15,"(754.0, 966.5]",12,19,-7
31235.0,2020-01-15,"(966.5, 1179.0]",2,6,-4
31236.0,2020-01-15,"(372.982, 628.5]",14,19,-5
31236.0,2020-01-15,"(628.5, 883.0]",13,23,-10
31236.0,2020-01-15,"(883.0, 1137.5]",13,36,-23
31236.0,2020-01-15,"(1137.5, 1392.0]",4,11,-7
31237.0,2020-01-15,"(320.939, 587.25]",3,16,-13
31237.0,2020-01-15,"(587.25, 852.5]",4,9,-5
31237.0,2020-01-15,"(852.5, 1117.75]",15,24,-9
31237.0,2020-01-15,"(1117.75, 1383.0]",15,24,-9
31238.0,2020-01-15,"(40.713, 363.75]",1,2,-1
31238.0,2020-01-15,"(363.75, 685.5]",25,30,-5
31238.0,2020-01-15,"(685.5, 1007.25]",8,17,-9
31238.0,2020-01-15,"(1007.25, 1329.0]",5,24,-19
31239.0,2020-01-15,"(374.009, 622.75]",26,34,-8
31239.0,2020-01-15,"(622.75, 870.5]",9,19,-10
31239.0,2020-01-15,"(870.5, 1118.25]",14,39,-25
31239.0,2020-01-15,"(1118.25, 1366.0]",7,20,-13
31240.0,2020-01-15,"(496.468, 630.0]",1,2,-1
31240.0,2020-01-15,"(896.0, 1029.0]",1,3,-2
31241.0,2020-01-15,"(29.613, 377.75]",1,4,-3
31241.0,2020-01-15,"(377.75, 724.5]",38,74,-36
31241.0,2020-01-15,"(724.5, 1071.25]",18,43,-25
31241.0,2020-01-15,"(1071.25, 1418.0]",24,43,-19
31242.0,2020-01-15,"(392.117, 613.75]",29,33,-4
31242.0,2020-01-15,"(613.75, 834.5]",3,6,-3
31242.0,2020-01-15,"(834.5, 1055.25]",2,19,-17
31242.0,2020-01-15,"(1055.25, 1276.0]",4,27,-23
31243.0,2020-01-15,"(379.014, 626.5]",27,30,-3
31243.0,2020-01-15,"(626.5, 873.0]",4,8,-4
31243.0,2020-01-15,"(873.0, 1119.5]",6,30,-24
31243.0,2020-01-15,"(1119.5, 1366.0]",4,11,-7
31244.0,2020-01-15,"(416.981, 672.75]",21,31,-10
31244.0,2020-01-15,"(672.75, 927.5]",10,14,-4
31244.0,2020-01-15,"(927.5, 1182.25]",12,30,-18
31244.0,2020-01-15,"(1182.25, 1437.0]",7,9,-2
31245.0,2020-01-15,"(7.613, 355.75]",1,2,-1
31245.0,2020-01-15,"(355.75, 702.5]",15,29,-14
31245.0,2020-01-15,"(702.5, 1049.25]",12,28,-16
31245.0,2020-01-15,"(1049.25, 1396.0]",16,33,-17
31246.0,2020-01-15,"(77.778, 384.5]",3,4,-1
31246.0,2020-01-15,"(384.5, 690.0]",17,28,-11
31246.0,2020-01-15,"(690.0, 995.5]",10,21,-11
31246.0,2020-01-15,"(995.5, 1301.0]",17,31,-14
31247.0,2020-01-15,"(427.061, 662.75]",17,28,-11
31247.0,2020-01-15,"(662.75, 897.5]",19,37,-18
31247.0,2020-01-15,"(897.5, 1132.25]",19,45,-26
31247.0,2020-01-15,"(1132.25, 1367.0]",2,3,-1
31248.0,2020-01-15,"(338.968, 598.0]",13,18,-5
31248.0,2020-01-15,"(598.0, 856.0]",10,22,-12
31248.0,2020-01-15,"(856.0, 1114.0]",16,40,-24
31248.0,2020-01-15,"(1114.0, 1372.0]",1,4,-3
31249.0,2020-01-15,"(382.968, 642.0]",11,21,-10
31249.0,2020-01-15,"(642.0, 900.0]",5,10,-5
31249.0,2020-01-15,"(900.0, 1158.0]",21,41,-20
31249.0,2020-01-15,"(1158.0, 1416.0]",8,14,-6
31250.0,2020-01-15,"(24.664, 360.0]",1,2,-1
31250.0,2020-01-15,"(360.0, 694.0]",21,25,-4
31250.0,2020-01-15,"(694.0, 1028.0]",10,24,-14
31250.0,2020-01-15,"(1028.0, 1362.0]",3,20,-17
31251.0,2020-01-15,"(328.976, 586.0]",22,36,-14
31251.0,2020-01-15,"(586.0, 842.0]",12,18,-6
31251.0,2020-01-15,"(842.0, 1098.0]",10,22,-12
31251.0,2020-01-15,"(1098.0, 1354.0]",7,21,-14
31252.0,2020-01-15,"(-0.281, 321.25]",1,2,-1
31252.0,2020-01-15,"(321.25, 641.5]",14,14,0
31252.0,2020-01-15,"(641.5, 961.75]",3,11,-8
31252.0,2020-01-15,"(961.75, 1282.0]",4,21,-17
31253.0,2020-01-15,"(401.047, 640.25]",26,29,-3
31253.0,2020-01-15,"(640.25, 878.5]",5,17,-12
31253.0,2020-01-15,"(878.5, 1116.75]",13,35,-22
31253.0,2020-01-15,"(1116.75, 1355.0]",3,11,-8
31254.0,2020-01-15,"(297.25, 587.5]",24,1,23
31254.0,2020-01-15,"(587.5, 877.75]",5,26,-21
31254.0,2020-01-15,"(877.75, 1168.0]",9,12,-3
31255.0,2020-01-15,"(381.055, 618.25]",21,28,-7
31255.0,2020-01-15,"(618.25, 854.5]",2,8,-6
31255.0,2020-01-15,"(854.5, 1090.75]",3,15,-12
31255.0,2020-01-15,"(1090.75, 1327.0]",8,13,-5
31256.0,2020-01-15,"(253.884, 534.0]",12,14,-2
31256.0,2020-01-15,"(534.0, 813.0]",2,5,-3
31256.0,2020-01-15,"(813.0, 1092.0]",7,16,-9
31256.0,2020-01-15,"(1092.0, 1371.0]",3,7,-4
31257.0,2020-01-15,"(7.605, 357.75]",3,5,-2
31257.0,2020-01-15,"(357.75, 706.5]",24,36,-12
31257.0,2020-01-15,"(706.5, 1055.25]",16,35,-19
31257.0,2020-01-15,"(1055.25, 1404.0]",14,33,-19
31258.0,2020-01-15,"(318.071, 551.25]",9,32,-23
31258.0,2020-01-15,"(551.25, 783.5]",20,44,-24
31258.0,2020-01-15,"(783.5, 1015.75]",33,69,-36
31258.0,2020-01-15,"(1015.75, 1248.0]",10,28,-18
31259.0,2020-01-15,"(360.931, 629.25]",14,14,0
31259.0,2020-01-15,"(629.25, 896.5]",2,3,-1
31259.0,2020-01-15,"(896.5, 1163.75]",2,14,-12
31260.0,2020-01-15,"(387.069, 620.75]",22,28,-6
31260.0,2020-01-15,"(620.75, 853.5]",3,7,-4
31260.0,2020-01-15,"(853.5, 1086.25]",8,25,-17
31260.0,2020-01-15,"(1086.25, 1319.0]",3,11,-8
31261.0,2020-01-15,"(391.074, 623.5]",11,11,0
31261.0,2020-01-15,"(855.0, 1086.5]",2,10,-8
31261.0,2020-01-15,"(1086.5, 1318.0]",1,6,-5
31262.0,2020-01-15,"(419.0, 670.0]",16,17,-1
31262.0,2020-01-15,"(670.0, 920.0]",3,7,-4
31262.0,2020-01-15,"(920.0, 1170.0]",7,19,-12
31263.0,2020-01-15,"(365.006, 614.5]",29,45,-16
31263.0,2020-01-15,"(614.5, 863.0]",11,24,-13
31263.0,2020-01-15,"(863.0, 1111.5]",14,38,-24
31263.0,2020-01-15,"(1111.5, 1360.0]",8,16,-8
31264.0,2020-01-15,"(357.964, 618.0]",10,14,-4
31264.0,2020-01-15,"(618.0, 877.0]",2,5,-3
31264.0,2020-01-15,"(877.0, 1136.0]",5,14,-9
31264.0,2020-01-15,"(1136.0, 1395.0]",3,6,-3
31265.0,2020-01-15,"(159.725, 479.75]",4,16,-12
31265.0,2020-01-15,"(479.75, 798.5]",27,49,-22
31265.0,2020-01-15,"(798.5, 1117.25]",25,45,-20
31265.0,2020-01-15,"(1117.25, 1436.0]",14,25,-11
31266.0,2020-01-15,"(121.697, 448.75]",2,12,-10
31266.0,2020-01-15,"(448.75, 774.5]",8,28,-20
31266.0,2020-01-15,"(774.5, 1100.25]",24,42,-18
31266.0,2020-01-15,"(1100.25, 1426.0]",17,37,-20
31267.0,2020-01-15,"(11.592, 365.0]",2,2,0
31267.0,2020-01-15,"(365.0, 717.0]",25,50,-25
31267.0,2020-01-15,"(717.0, 1069.0]",16,34,-18
31267.0,2020-01-15,"(1069.0, 1421.0]",17,28,-11
31268.0,2020-01-15,"(22.614, 370.5]",1,5,-4
31268.0,2020-01-15,"(370.5, 717.0]",9,43,-34
31268.0,2020-01-15,"(717.0, 1063.5]",17,28,-11
31268.0,2020-01-15,"(1063.5, 1410.0]",27,41,-14
31269.0,2020-01-15,"(351.08, 582.0]",7,12,-5
31269.0,2020-01-15,"(582.0, 812.0]",5,12,-7
31269.0,2020-01-15,"(812.0, 1042.0]",10,20,-10
31269.0,2020-01-15,"(1042.0, 1272.0]",7,16,-9
31270.0,2020-01-15,"(322.999, 574.25]",20,27,-7
31270.0,2020-01-15,"(574.25, 824.5]",7,14,-7
31270.0,2020-01-15,"(824.5, 1074.75]",9,23,-14
31270.0,2020-01-15,"(1074.75, 1325.0]",7,7,0
31271.0,2020-01-15,"(384.009, 632.75]",16,18,-2
31271.0,2020-01-15,"(632.75, 880.5]",11,15,-4
31271.0,2020-01-15,"(880.5, 1128.25]",7,27,-20
31271.0,2020-01-15,"(1128.25, 1376.0]",1,4,-3
31272.0,2020-01-15,"(302.907, 577.25]",31,36,-5
31272.0,2020-01-15,"(577.25, 850.5]",10,22,-12
31272.0,2020-01-15,"(850.5, 1123.75]",12,30,-18
31272.0,2020-01-15,"(1123.75, 1397.0]",4,8,-4
31273.0,2020-01-15,"(416.292, 594.0]",3,8,-5
31273.0,2020-01-15,"(594.0, 771.0]",2,4,-2
31273.0,2020-01-15,"(771.0, 948.0]",2,3,-1
31273.0,2020-01-15,"(948.0, 1125.0]",2,2,0
31274.0,2020-01-15,"(404.056, 641.0]",9,11,-2
31274.0,2020-01-15,"(641.0, 877.0]",5,16,-11
31274.0,2020-01-15,"(877.0, 1113.0]",7,22,-15
31274.0,2020-01-15,"(1113.0, 1349.0]",5,13,-8
31275.0,2020-01-15,"(25.596, 378.0]",3,4,-1
31275.0,2020-01-15,"(378.0, 729.0]",18,34,-16
31275.0,2020-01-15,"(729.0, 1080.0]",13,32,-19
31275.0,2020-01-15,"(1080.0, 1431.0]",17,31,-14
31276.0,2020-01-15,"(415.133, 632.75]",27,33,-6
31276.0,2020-01-15,"(632.75, 849.5]",2,4,-2
31276.0,2020-01-15,"(849.5, 1066.25]",3,17,-14
31276.0,2020-01-15,"(1066.25, 1283.0]",6,23,-17
31277.0,2020-01-15,"(366.112, 589.0]",47,54,-7
31277.0,2020-01-15,"(589.0, 811.0]",4,8,-4
31277.0,2020-01-15,"(811.0, 1033.0]",15,35,-20
31277.0,2020-01-15,"(1033.0, 1255.0]",5,14,-9
31278.0,2020-01-15,"(105.898, 382.5]",1,7,-6
31278.0,2020-01-15,"(382.5, 658.0]",12,33,-21
31278.0,2020-01-15,"(658.0, 933.5]",9,16,-7
31278.0,2020-01-15,"(933.5, 1209.0]",28,43,-15
31279.0,2020-01-15,"(423.305, 597.75]",25,28,-3
31279.0,2020-01-15,"(597.75, 771.5]",3,7,-4
31279.0,2020-01-15,"(771.5, 945.25]",2,4,-2
31279.0,2020-01-15,"(945.25, 1119.0]",12,45,-33
31280.0,2020-01-15,"(345.012, 593.0]",3,22,-19
31280.0,2020-01-15,"(593.0, 840.0]",5,11,-6
31280.0,2020-01-15,"(840.0, 1087.0]",17,21,-4
31280.0,2020-01-15,"(1087.0, 1334.0]",10,17,-7
31000.0,2020-01-16,"(632.25, 843.0]",1,1,0
31001.0,2020-01-16,"(829.5, 965.25]",2,2,0
31001.0,2020-01-16,"(965.25, 1101.0]",1,3,-2
31002.0,2020-01-16,"(435.329, 603.75]",3,6,-3
31002.0,2020-01-16,"(603.75, 771.5]",2,3,-1
31003.0,2020-01-16,"(466.268, 650.0]",4,6,-2
31003.0,2020-01-16,"(833.0, 1016.0]",1,2,-1
31003.0,2020-01-16,"(1016.0, 1199.0]",1,3,-2
31004.0,2020-01-16,"(663.532, 781.0]",1,2,-1
31005.0,2020-01-16,"(439.517, 560.75]",1,2,-1
31005.0,2020-01-16,"(681.5, 802.25]",1,3,-2
31006.0,2020-01-16,"(405.064, 640.0]",3,6,-3
31006.0,2020-01-16,"(640.0, 874.0]",1,1,0
31006.0,2020-01-16,"(874.0, 1108.0]",1,1,0
31006.0,2020-01-16,"(1108.0, 1342.0]",1,2,-1
31007.0,2020-01-16,"(449.054, 686.5]",14,33,-19
31007.0,2020-01-16,"(686.5, 923.0]",3,6,-3
31007.0,2020-01-16,"(923.0, 1159.5]",5,15,-10
31007.0,2020-01-16,"(1159.5, 1396.0]",3,5,-2
31009.0,2020-01-16,"(472.166, 681.5]",7,8,-1
31009.0,2020-01-16,"(681.5, 890.0]",2,3,-1
31009.0,2020-01-16,"(890.0, 1098.5]",1,1,0
31009.0,2020-01-16,"(1098.5, 1307.0]",1,2,-1
31010.0,2020-01-16,"(460.148, 674.0]",2,2,0
31010.0,2020-01-16,"(674.0, 887.0]",1,1,0
31010.0,2020-01-16,"(887.0, 1100.0]",3,4,-1
31010.0,2020-01-16,"(1100.0, 1313.0]",1,2,-1
31011.0,2020-01-16,"(333.942, 599.5]",4,5,-1
31011.0,2020-01-16,"(599.5, 864.0]",6,8,-2
31011.0,2020-01-16,"(864.0, 1128.5]",4,9,-5
31012.0,2020-01-16,"(454.236, 646.0]",4,6,-2
31012.0,2020-01-16,"(1028.0, 1219.0]",1,1,0
31013.0,2020-01-16,"(892.25, 1059.0]",2,5,-3
31014.0,2020-01-16,"(351.186, 555.5]",16,22,-6
31014.0,2020-01-16,"(555.5, 759.0]",8,10,-2
31014.0,2020-01-16,"(759.0, 962.5]",7,12,-5
31014.0,2020-01-16,"(962.5, 1166.0]",10,20,-10
31015.0,2020-01-16,"(129.84, 421.0]",3,4,-1
31015.0,2020-01-16,"(421.0, 711.0]",15,15,0
31015.0,2020-01-16,"(711.0, 1001.0]",4,9,-5
31015.0,2020-01-16,"(1001.0, 1291.0]",7,11,-4
31016.0,2020-01-16,"(433.15, 646.5]",4,10,-6
31016.0,2020-01-16,"(646.5, 859.0]",2,3,-1
31016.0,2020-01-16,"(859.0, 1071.5]",5,6,-1
31017.0,2020-01-16,"(395.203, 595.25]",5,6,-1
31017.0,2020-01-16,"(993.75, 1193.0]",1,1,0
31018.0,2020-01-16,"(628.25, 813.5]",1,2,-1
31018.0,2020-01-16,"(813.5, 998.75]",2,1,1
31018.0,2020-01-16,"(998.75, 1184.0]",2,2,0
31019.0,2020-01-16,"(396.163, 606.25]",2,3,-1
31019.0,2020-01-16,"(1024.75, 1234.0]",1,2,-1
31020.0,2020-01-16,"(394.01, 642.5]",1,3,-2
31020.0,2020-01-16,"(642.5, 890.0]",1,4,-3
31020.0,2020-01-16,"(890.0, 1137.5]",3,4,-1
31020.0,2020-01-16,"(1137.5, 1385.0]",1,2,-1
31021.0,2020-01-16,"(364.75, 701.5]",3,1,2
31021.0,2020-01-16,"(701.5, 1038.25]",1,9,-8
31021.0,2020-01-16,"(1038.25, 1375.0]",2,2,0
31022.0,2020-01-16,"(426.161, 636.75]",3,9,-6
31022.0,2020-01-16,"(636.75, 846.5]",2,3,-1
31022.0,2020-01-16,"(846.5, 1056.25]",2,6,-4
31022.0,2020-01-16,"(1056.25, 1266.0]",2,5,-3
31023.0,2020-01-16,"(486.664, 571.0]",1,1,0
31023.0,2020-01-16,"(739.0, 823.0]",3,4,-1
31024.0,2020-01-16,"(451.191, 654.25]",7,9,-2
31024.0,2020-01-16,"(654.25, 856.5]",2,4,-2
31024.0,2020-01-16,"(856.5, 1058.75]",3,6,-3
31024.0,2020-01-16,"(1058.75, 1261.0]",2,6,-4
31025.0,2020-01-16,"(1063.0, 1265.0]",2,1,1
31026.0,2020-01-16,"(478.061, 713.75]",1,2,-1
31026.0,2020-01-16,"(948.5, 1183.25]",1,1,0
31026.0,2020-01-16,"(1183.25, 1418.0]",1,5,-4
,,,,1.0,
,,,,2.0,
31028.0,2020-01-16,"(612.75, 837.5]",2,3,-1
31028.0,2020-01-16,"(837.5, 1062.25]",1,3,-2
31028.0,2020-01-16,"(1062.25, 1287.0]",2,4,-2
31029.0,2020-01-16,"(441.126, 660.5]",1,9,-8
31029.0,2020-01-16,"(879.0, 1097.5]",2,1,1
31029.0,2020-01-16,"(1097.5, 1316.0]",2,2,0
31030.0,2020-01-16,"(987.25, 1165.0]",5,12,-7
31031.0,2020-01-16,"(634.5, 852.0]",2,4,-2
31031.0,2020-01-16,"(852.0, 1069.5]",1,2,-1
31031.0,2020-01-16,"(1069.5, 1287.0]",1,6,-5
31032.0,2020-01-16,"(1033.25, 1197.0]",2,1,1
31033.0,2020-01-16,"(908.5, 994.75]",1,1,0
31033.0,2020-01-16,"(994.75, 1081.0]",1,1,0
31034.0,2020-01-16,"(446.343, 611.25]",4,8,-4
31034.0,2020-01-16,"(939.75, 1104.0]",2,1,1
31035.0,2020-01-16,"(420.21, 618.5]",3,5,-2
31035.0,2020-01-16,"(618.5, 816.0]",1,5,-4
31035.0,2020-01-16,"(816.0, 1013.5]",1,2,-1
31035.0,2020-01-16,"(1013.5, 1211.0]",1,3,-2
31036.0,2020-01-16,"(898.0, 1058.0]",3,3,0
31037.0,2020-01-16,"(416.162, 626.5]",13,20,-7
31037.0,2020-01-16,"(626.5, 836.0]",6,8,-2
31037.0,2020-01-16,"(836.0, 1045.5]",2,7,-5
31037.0,2020-01-16,"(1045.5, 1255.0]",2,10,-8
31038.0,2020-01-16,"(393.33, 561.5]",1,1,0
31038.0,2020-01-16,"(729.0, 896.5]",1,2,-1
31039.0,2020-01-16,"(449.038, 690.5]",4,5,-1
31039.0,2020-01-16,"(690.5, 931.0]",1,3,-2
31040.0,2020-01-16,"(457.566, 566.5]",1,2,-1
31040.0,2020-01-16,"(783.5, 892.0]",3,4,-1
31041.0,2020-01-16,"(532.321, 702.75]",3,3,0
31041.0,2020-01-16,"(872.5, 1042.25]",1,1,0
31041.0,2020-01-16,"(1042.25, 1212.0]",1,3,-2
31042.0,2020-01-16,"(348.283, 528.25]",6,7,-1
31042.0,2020-01-16,"(528.25, 707.5]",2,4,-2
31042.0,2020-01-16,"(707.5, 886.75]",2,5,-3
31043.0,2020-01-16,"(414.219, 610.25]",2,3,-1
31043.0,2020-01-16,"(610.25, 805.5]",1,1,0
31043.0,2020-01-16,"(1000.75, 1196.0]",1,5,-4
31044.0,2020-01-16,"(442.349, 605.75]",4,5,-1
31044.0,2020-01-16,"(605.75, 768.5]",1,2,-1
31044.0,2020-01-16,"(931.25, 1094.0]",4,6,-2
31045.0,2020-01-16,"(485.355, 647.25]",1,2,-1
31045.0,2020-01-16,"(969.75, 1131.0]",2,1,1
31046.0,2020-01-16,"(663.0, 917.0]",1,2,-1
31046.0,2020-01-16,"(1171.0, 1425.0]",1,1,0
31047.0,2020-01-16,"(350.068, 584.0]",12,25,-13
31047.0,2020-01-16,"(584.0, 817.0]",1,2,-1
31047.0,2020-01-16,"(817.0, 1050.0]",6,10,-4
31047.0,2020-01-16,"(1050.0, 1283.0]",2,12,-10
31048.0,2020-01-16,"(514.169, 722.75]",3,8,-5
31048.0,2020-01-16,"(930.5, 1138.25]",5,12,-7
31048.0,2020-01-16,"(1138.25, 1346.0]",1,4,-3
31049.0,2020-01-16,"(438.326, 607.5]",2,5,-3
31049.0,2020-01-16,"(944.5, 1113.0]",1,4,-3
,,,,1.0,
,,,,1.0,
31051.0,2020-01-16,"(972.75, 1196.0]",4,3,1
31052.0,2020-01-16,"(518.397, 669.75]",3,4,-1
31052.0,2020-01-16,"(971.25, 1122.0]",2,3,-1
31053.0,2020-01-16,"(528.437, 669.75]",1,3,-2
31053.0,2020-01-16,"(951.25, 1092.0]",2,1,1
31054.0,2020-01-16,"(750.0, 1000.0]",1,1,0
31055.0,2020-01-16,"(402.416, 549.0]",1,2,-1
31055.0,2020-01-16,"(841.0, 987.0]",1,1,0
31056.0,2020-01-16,"(1045.5, 1190.0]",1,1,0
,,,,2.0,
31058.0,2020-01-16,"(593.603, 693.25]",1,1,0
31058.0,2020-01-16,"(891.75, 991.0]",1,2,-1
,,,,1.0,
,,,,1.0,
31060.0,2020-01-16,"(376.244, 566.0]",2,2,0
31060.0,2020-01-16,"(566.0, 755.0]",1,1,0
31061.0,2020-01-16,"(799.5, 1066.0]",1,1,0
31062.0,2020-01-16,"(541.241, 731.75]",1,2,-1
31062.0,2020-01-16,"(731.75, 921.5]",2,3,-1
31062.0,2020-01-16,"(921.5, 1111.25]",6,11,-5
31062.0,2020-01-16,"(1111.25, 1301.0]",2,4,-2
31063.0,2020-01-16,"(774.0, 1032.0]",3,1,2
31064.0,2020-01-16,"(507.3, 683.0]",1,2,-1
31064.0,2020-01-16,"(683.0, 858.0]",1,2,-1
31064.0,2020-01-16,"(858.0, 1033.0]",3,6,-3
31064.0,2020-01-16,"(1033.0, 1208.0]",1,2,-1
31065.0,2020-01-16,"(710.0, 879.5]",1,2,-1
31065.0,2020-01-16,"(879.5, 1049.0]",1,1,0
31066.0,2020-01-16,"(738.25, 767.0]",1,1,0
31067.0,2020-01-16,"(498.176, 705.0]",2,5,-3
31067.0,2020-01-16,"(911.0, 1117.0]",3,1,2
31067.0,2020-01-16,"(1117.0, 1323.0]",1,4,-3
31068.0,2020-01-16,"(1047.75, 1202.0]",1,1,0
31069.0,2020-01-16,"(359.166, 568.5]",1,6,-5
31069.0,2020-01-16,"(777.0, 985.5]",1,2,-1
31069.0,2020-01-16,"(985.5, 1194.0]",5,6,-1
31070.0,2020-01-16,"(1055.75, 1203.0]",1,1,0
31071.0,2020-01-16,"(328.134, 545.5]",3,8,-5
31071.0,2020-01-16,"(545.5, 762.0]",2,3,-1
31071.0,2020-01-16,"(762.0, 978.5]",3,6,-3
31071.0,2020-01-16,"(978.5, 1195.0]",2,5,-3
,,,,2.0,
31073.0,2020-01-16,"(458.831, 501.25]",2,3,-1
31073.0,2020-01-16,"(585.75, 628.0]",1,2,-1
31074.0,2020-01-16,"(492.06, 728.0]",1,4,-3
31074.0,2020-01-16,"(728.0, 963.0]",2,3,-1
31074.0,2020-01-16,"(963.0, 1198.0]",3,4,-1
,,,,1.0,
,,,,2.0,
31076.0,2020-01-16,"(929.25, 1239.0]",1,1,0
31077.0,2020-01-16,"(465.367, 624.25]",2,7,-5
31077.0,2020-01-16,"(624.25, 782.5]",3,4,-1
31077.0,2020-01-16,"(782.5, 940.75]",1,3,-2
31077.0,2020-01-16,"(940.75, 1099.0]",2,2,0
31078.0,2020-01-16,"(472.49, 600.5]",6,6,0
31078.0,2020-01-16,"(855.5, 983.0]",1,2,-1
31079.0,2020-01-16,"(489.101, 714.75]",2,9,-7
31079.0,2020-01-16,"(714.75, 939.5]",2,4,-2
31079.0,2020-01-16,"(939.5, 1164.25]",4,7,-3
31079.0,2020-01-16,"(1164.25, 1389.0]",4,4,0
31080.0,2020-01-16,"(348.067, 582.25]",1,6,-5
31080.0,2020-01-16,"(815.5, 1048.75]",3,3,0
31080.0,2020-01-16,"(1048.75, 1282.0]",7,5,2
31081.0,2020-01-16,"(478.313, 650.75]",4,4,0
31081.0,2020-01-16,"(650.75, 822.5]",1,2,-1
31081.0,2020-01-16,"(994.25, 1166.0]",1,4,-3
31082.0,2020-01-16,"(624.583, 729.25]",1,3,-2
31083.0,2020-01-16,"(624.0, 788.0]",1,1,0
31083.0,2020-01-16,"(952.0, 1116.0]",4,3,1
31084.0,2020-01-16,"(489.249, 677.75]",5,5,0
31084.0,2020-01-16,"(677.75, 865.5]",2,2,0
31084.0,2020-01-16,"(865.5, 1053.25]",3,7,-4
31085.0,2020-01-16,"(941.0, 1105.0]",2,4,-2
31086.0,2020-01-16,"(558.357, 719.75]",2,2,0
31086.0,2020-01-16,"(880.5, 1041.25]",1,1,0
31086.0,2020-01-16,"(1041.25, 1202.0]",3,1,2
31087.0,2020-01-16,"(640.75, 805.5]",1,3,-2
31087.0,2020-01-16,"(970.25, 1135.0]",2,2,0
31088.0,2020-01-16,"(944.5, 1107.0]",3,2,1
31089.0,2020-01-16,"(480.173, 687.75]",10,16,-6
31089.0,2020-01-16,"(687.75, 894.5]",2,6,-4
31089.0,2020-01-16,"(894.5, 1101.25]",1,11,-10
31089.0,2020-01-16,"(1101.25, 1308.0]",1,7,-6
31090.0,2020-01-16,"(401.356, 563.0]",3,7,-4
31090.0,2020-01-16,"(885.0, 1046.0]",3,1,2
31091.0,2020-01-16,"(783.5, 956.25]",1,3,-2
31091.0,2020-01-16,"(956.25, 1129.0]",2,1,1
31092.0,2020-01-16,"(926.5, 1082.0]",1,3,-2
,,,,1.0,
,,,,3.0,
,,,,3.0,
31094.0,2020-01-16,"(788.25, 1051.0]",1,1,0
31095.0,2020-01-16,"(524.949, 537.75]",1,1,0
31096.0,2020-01-16,"(1057.75, 1132.5]",1,1,0
31096.0,2020-01-16,"(1207.25, 1282.0]",1,1,0
31097.0,2020-01-16,"(528.241, 718.75]",4,5,-1
31097.0,2020-01-16,"(908.5, 1098.25]",3,5,-2
31097.0,2020-01-16,"(1098.25, 1288.0]",1,1,0
31098.0,2020-01-16,"(353.957, 615.75]",9,16,-7
31098.0,2020-01-16,"(876.5, 1137.25]",6,2,4
31099.0,2020-01-16,"(862.0, 1060.0]",1,1,0
31099.0,2020-01-16,"(1060.0, 1258.0]",3,1,2
31100.0,2020-01-16,"(414.094, 641.5]",17,21,-4
31100.0,2020-01-16,"(641.5, 868.0]",5,10,-5
31100.0,2020-01-16,"(868.0, 1094.5]",4,21,-17
31100.0,2020-01-16,"(1094.5, 1321.0]",2,4,-2
31101.0,2020-01-16,"(341.924, 612.0]",11,43,-32
31101.0,2020-01-16,"(612.0, 881.0]",15,27,-12
31101.0,2020-01-16,"(881.0, 1150.0]",21,34,-13
31101.0,2020-01-16,"(1150.0, 1419.0]",17,29,-12
31102.0,2020-01-16,"(13.641, 354.75]",1,1,0
31102.0,2020-01-16,"(354.75, 694.5]",3,25,-22
31102.0,2020-01-16,"(694.5, 1034.25]",1,4,-3
31102.0,2020-01-16,"(1034.25, 1374.0]",11,15,-4
31103.0,2020-01-16,"(305.87, 589.5]",2,23,-21
31103.0,2020-01-16,"(589.5, 872.0]",2,18,-16
31103.0,2020-01-16,"(872.0, 1154.5]",7,18,-11
31103.0,2020-01-16,"(1154.5, 1437.0]",2,6,-4
31104.0,2020-01-16,"(84.649, 423.75]",1,7,-6
31104.0,2020-01-16,"(423.75, 761.5]",2,10,-8
31104.0,2020-01-16,"(761.5, 1099.25]",10,20,-10
31104.0,2020-01-16,"(1099.25, 1437.0]",4,18,-14
31105.0,2020-01-16,"(886.5, 1088.75]",1,8,-7
31106.0,2020-01-16,"(454.131, 672.25]",2,8,-6
31106.0,2020-01-16,"(672.25, 889.5]",1,1,0
31106.0,2020-01-16,"(889.5, 1106.75]",1,2,-1
31106.0,2020-01-16,"(1106.75, 1324.0]",2,3,-1
31107.0,2020-01-16,"(0.576, 358.0]",2,6,-4
31107.0,2020-01-16,"(358.0, 714.0]",5,28,-23
31107.0,2020-01-16,"(714.0, 1070.0]",19,32,-13
31107.0,2020-01-16,"(1070.0, 1426.0]",5,14,-9
31108.0,2020-01-16,"(343.911, 617.25]",3,23,-20
31108.0,2020-01-16,"(617.25, 889.5]",11,16,-5
31108.0,2020-01-16,"(889.5, 1161.75]",16,25,-9
31108.0,2020-01-16,"(1161.75, 1434.0]",8,9,-1
31109.0,2020-01-16,"(356.929, 625.75]",7,24,-17
31109.0,2020-01-16,"(625.75, 893.5]",2,3,-1
31109.0,2020-01-16,"(893.5, 1161.25]",20,28,-8
31109.0,2020-01-16,"(1161.25, 1429.0]",5,11,-6
31110.0,2020-01-16,"(326.955, 589.25]",17,46,-29
31110.0,2020-01-16,"(589.25, 850.5]",14,25,-11
31110.0,2020-01-16,"(850.5, 1111.75]",20,39,-19
31110.0,2020-01-16,"(1111.75, 1373.0]",6,18,-12
31111.0,2020-01-16,"(50.62, 397.0]",2,2,0
31111.0,2020-01-16,"(397.0, 742.0]",5,22,-17
31111.0,2020-01-16,"(742.0, 1087.0]",11,14,-3
31111.0,2020-01-16,"(1087.0, 1432.0]",17,25,-8
31112.0,2020-01-16,"(946.25, 1075.0]",2,2,0
31113.0,2020-01-16,"(717.0, 1069.0]",3,3,0
31113.0,2020-01-16,"(1069.0, 1421.0]",8,24,-16
31114.0,2020-01-16,"(-0.434, 359.5]",2,2,0
31114.0,2020-01-16,"(359.5, 718.0]",5,19,-14
31114.0,2020-01-16,"(718.0, 1076.5]",17,29,-12
31114.0,2020-01-16,"(1076.5, 1435.0]",22,36,-14
31115.0,2020-01-16,"(167.741, 483.75]",1,10,-9
31115.0,2020-01-16,"(483.75, 798.5]",2,14,-12
31115.0,2020-01-16,"(798.5, 1113.25]",6,18,-12
31115.0,2020-01-16,"(1113.25, 1428.0]",12,17,-5
31116.0,2020-01-16,"(8.609, 357.75]",1,2,-1
31116.0,2020-01-16,"(357.75, 705.5]",4,27,-23
31116.0,2020-01-16,"(705.5, 1053.25]",10,13,-3
31116.0,2020-01-16,"(1053.25, 1401.0]",17,23,-6
31117.0,2020-01-16,"(4.625, 349.75]",1,3,-2
31117.0,2020-01-16,"(349.75, 693.5]",4,16,-12
31117.0,2020-01-16,"(693.5, 1037.25]",8,17,-9
31117.0,2020-01-16,"(1037.25, 1381.0]",6,17,-11
31118.0,2020-01-16,"(322.092, 550.0]",1,16,-15
31118.0,2020-01-16,"(550.0, 777.0]",2,4,-2
31118.0,2020-01-16,"(777.0, 1004.0]",3,5,-2
31118.0,2020-01-16,"(1004.0, 1231.0]",17,21,-4
31119.0,2020-01-16,"(19.678, 351.5]",2,4,-2
31119.0,2020-01-16,"(351.5, 682.0]",8,25,-17
31119.0,2020-01-16,"(682.0, 1012.5]",10,14,-4
31119.0,2020-01-16,"(1012.5, 1343.0]",13,23,-10
31120.0,2020-01-16,"(403.093, 630.75]",3,18,-15
31120.0,2020-01-16,"(857.5, 1084.25]",6,7,-1
31120.0,2020-01-16,"(1084.25, 1311.0]",5,9,-4
31121.0,2020-01-16,"(426.09, 654.5]",16,25,-9
31121.0,2020-01-16,"(654.5, 882.0]",1,3,-2
31121.0,2020-01-16,"(882.0, 1109.5]",3,8,-5
31121.0,2020-01-16,"(1109.5, 1337.0]",7,15,-8
31122.0,2020-01-16,"(15.582, 371.5]",1,3,-2
31122.0,2020-01-16,"(371.5, 726.0]",1,14,-13
31122.0,2020-01-16,"(726.0, 1080.5]",7,12,-5
31122.0,2020-01-16,"(1080.5, 1435.0]",9,17,-8
31123.0,2020-01-16,"(395.053, 632.75]",1,23,-22
31123.0,2020-01-16,"(632.75, 869.5]",2,2,0
31123.0,2020-01-16,"(869.5, 1106.25]",4,9,-5
31123.0,2020-01-16,"(1106.25, 1343.0]",4,10,-6
31124.0,2020-01-16,"(158.723, 479.25]",7,13,-6
31124.0,2020-01-16,"(479.25, 798.5]",15,49,-34
31124.0,2020-01-16,"(798.5, 1117.75]",16,38,-22
31124.0,2020-01-16,"(1117.75, 1437.0]",9,26,-17
31125.0,2020-01-16,"(23.696, 351.0]",2,3,-1
31125.0,2020-01-16,"(351.0, 677.0]",4,27,-23
31125.0,2020-01-16,"(677.0, 1003.0]",7,11,-4
31125.0,2020-01-16,"(1003.0, 1329.0]",25,34,-9
31126.0,2020-01-16,"(308.087, 537.25]",2,20,-18
31126.0,2020-01-16,"(537.25, 765.5]",1,6,-5
31126.0,2020-01-16,"(765.5, 993.75]",3,6,-3
31126.0,2020-01-16,"(993.75, 1222.0]",13,20,-7
,,,,2.0,
31128.0,2020-01-16,"(56.625, 401.75]",4,6,-2
31128.0,2020-01-16,"(401.75, 745.5]",35,57,-22
31128.0,2020-01-16,"(745.5, 1089.25]",33,50,-17
31128.0,2020-01-16,"(1089.25, 1433.0]",16,30,-14
31129.0,2020-01-16,"(426.3, 602.0]",13,16,-3
31129.0,2020-01-16,"(602.0, 777.0]",3,6,-3
31129.0,2020-01-16,"(777.0, 952.0]",10,15,-5
31129.0,2020-01-16,"(952.0, 1127.0]",4,6,-2
31130.0,2020-01-16,"(411.986, 666.5]",3,15,-12
31130.0,2020-01-16,"(666.5, 920.0]",6,10,-4
31130.0,2020-01-16,"(920.0, 1173.5]",9,14,-5
31130.0,2020-01-16,"(1173.5, 1427.0]",4,5,-1
31131.0,2020-01-16,"(333.111, 556.25]",1,16,-15
31131.0,2020-01-16,"(556.25, 778.5]",1,1,0
31131.0,2020-01-16,"(778.5, 1000.75]",2,5,-3
31131.0,2020-01-16,"(1000.75, 1223.0]",3,4,-1
31200.0,2020-01-16,"(6.575, 364.25]",2,4,-2
31200.0,2020-01-16,"(364.25, 720.5]",27,43,-16
31200.0,2020-01-16,"(720.5, 1076.75]",20,44,-24
31200.0,2020-01-16,"(1076.75, 1433.0]",19,40,-21
31201.0,2020-01-16,"(300.915, 573.25]",22,46,-24
31201.0,2020-01-16,"(573.25, 844.5]",13,25,-12
31201.0,2020-01-16,"(844.5, 1115.75]",38,66,-28
31201.0,2020-01-16,"(1115.75, 1387.0]",23,45,-22
31202.0,2020-01-16,"(350.992, 604.0]",13,30,-17
31202.0,2020-01-16,"(604.0, 856.0]",5,9,-4
31202.0,2020-01-16,"(856.0, 1108.0]",20,34,-14
31202.0,2020-01-16,"(1108.0, 1360.0]",17,28,-11
31203.0,2020-01-16,"(8.596, 361.0]",4,8,-4
31203.0,2020-01-16,"(361.0, 712.0]",9,27,-18
31203.0,2020-01-16,"(712.0, 1063.0]",19,31,-12
31203.0,2020-01-16,"(1063.0, 1414.0]",18,28,-10
31204.0,2020-01-16,"(15.695, 343.25]",1,1,0
31204.0,2020-01-16,"(343.25, 669.5]",23,30,-7
31204.0,2020-01-16,"(669.5, 995.75]",12,27,-15
31204.0,2020-01-16,"(995.75, 1322.0]",15,30,-15
31205.0,2020-01-16,"(419.104, 644.0]",22,25,-3
31205.0,2020-01-16,"(644.0, 868.0]",7,14,-7
31205.0,2020-01-16,"(868.0, 1092.0]",14,34,-20
31205.0,2020-01-16,"(1092.0, 1316.0]",3,18,-15
31206.0,2020-01-16,"(388.175, 595.25]",10,11,-1
31206.0,2020-01-16,"(595.25, 801.5]",1,2,-1
31206.0,2020-01-16,"(801.5, 1007.75]",3,8,-5
31207.0,2020-01-16,"(559.287, 738.25]",1,2,-1
31207.0,2020-01-16,"(916.5, 1094.75]",3,5,-2
31207.0,2020-01-16,"(1094.75, 1273.0]",1,3,-2
31208.0,2020-01-16,"(385.095, 612.25]",13,14,-1
31208.0,2020-01-16,"(1064.75, 1291.0]",2,9,-7
31209.0,2020-01-16,"(386.005, 635.75]",6,9,-3
31209.0,2020-01-16,"(635.75, 884.5]",2,3,-1
31209.0,2020-01-16,"(884.5, 1133.25]",1,3,-2
31209.0,2020-01-16,"(1133.25, 1382.0]",2,3,-1
31211.0,2020-01-16,"(433.105, 657.75]",13,14,-1
31211.0,2020-01-16,"(657.75, 881.5]",2,5,-3
31211.0,2020-01-16,"(881.5, 1105.25]",11,18,-7
31211.0,2020-01-16,"(1105.25, 1329.0]",3,10,-7
31212.0,2020-01-16,"(9.577, 366.75]",1,2,-1
31212.0,2020-01-16,"(366.75, 722.5]",46,73,-27
31212.0,2020-01-16,"(722.5, 1078.25]",20,40,-20
31212.0,2020-01-16,"(1078.25, 1434.0]",10,25,-15
31213.0,2020-01-16,"(65.709, 389.75]",3,3,0
31213.0,2020-01-16,"(389.75, 712.5]",33,49,-16
31213.0,2020-01-16,"(712.5, 1035.25]",15,27,-12
31213.0,2020-01-16,"(1035.25, 1358.0]",12,28,-16
31214.0,2020-01-16,"(21.588, 376.0]",2,5,-3
31214.0,2020-01-16,"(376.0, 729.0]",12,39,-27
31214.0,2020-01-16,"(729.0, 1082.0]",16,27,-11
31214.0,2020-01-16,"(1082.0, 1435.0]",20,30,-10
31215.0,2020-01-16,"(431.213, 628.75]",16,18,-2
31215.0,2020-01-16,"(628.75, 825.5]",6,8,-2
31215.0,2020-01-16,"(825.5, 1022.25]",5,9,-4
31215.0,2020-01-16,"(1022.25, 1219.0]",4,11,-7
31216.0,2020-01-16,"(339.066, 573.5]",18,19,-1
31216.0,2020-01-16,"(573.5, 807.0]",5,12,-7
31216.0,2020-01-16,"(807.0, 1040.5]",4,8,-4
31216.0,2020-01-16,"(1040.5, 1274.0]",2,14,-12
31217.0,2020-01-16,"(323.158, 534.5]",13,16,-3
31217.0,2020-01-16,"(534.5, 745.0]",4,8,-4
31217.0,2020-01-16,"(745.0, 955.5]",1,3,-2
31217.0,2020-01-16,"(955.5, 1166.0]",4,9,-5
31218.0,2020-01-16,"(373.248, 562.0]",14,35,-21
31218.0,2020-01-16,"(562.0, 750.0]",5,5,0
31218.0,2020-01-16,"(750.0, 938.0]",3,7,-4
31218.0,2020-01-16,"(938.0, 1126.0]",11,19,-8
31219.0,2020-01-16,"(358.96, 620.0]",13,13,0
31219.0,2020-01-16,"(620.0, 880.0]",5,8,-3
31219.0,2020-01-16,"(880.0, 1140.0]",5,11,-6
31220.0,2020-01-16,"(362.323, 532.25]",13,15,-2
31220.0,2020-01-16,"(532.25, 701.5]",4,4,0
31220.0,2020-01-16,"(701.5, 870.75]",2,6,-4
31221.0,2020-01-16,"(408.154, 620.5]",34,41,-7
31221.0,2020-01-16,"(620.5, 832.0]",7,15,-8
31221.0,2020-01-16,"(832.0, 1043.5]",9,19,-10
31221.0,2020-01-16,"(1043.5, 1255.0]",17,37,-20
31222.0,2020-01-16,"(377.0, 628.0]",22,25,-3
31222.0,2020-01-16,"(628.0, 878.0]",5,7,-2
31222.0,2020-01-16,"(1128.0, 1378.0]",3,11,-8
31223.0,2020-01-16,"(42.665, 377.75]",2,3,-1
31223.0,2020-01-16,"(377.75, 711.5]",17,49,-32
31223.0,2020-01-16,"(711.5, 1045.25]",6,15,-9
31223.0,2020-01-16,"(1045.25, 1379.0]",14,29,-15
31224.0,2020-01-16,"(452.105, 676.75]",18,22,-4
31224.0,2020-01-16,"(676.75, 900.5]",7,11,-4
31224.0,2020-01-16,"(900.5, 1124.25]",3,15,-12
31224.0,2020-01-16,"(1124.25, 1348.0]",3,12,-9
31225.0,2020-01-16,"(419.21, 617.5]",4,10,-6
31225.0,2020-01-16,"(617.5, 815.0]",5,9,-4
31225.0,2020-01-16,"(815.0, 1012.5]",3,5,-2
31225.0,2020-01-16,"(1012.5, 1210.0]",4,9,-5
31226.0,2020-01-16,"(296.998, 548.5]",5,9,-4
31226.0,2020-01-16,"(548.5, 799.0]",4,8,-4
31226.0,2020-01-16,"(799.0, 1049.5]",4,12,-8
31226.0,2020-01-16,"(1049.5, 1300.0]",4,4,0
31227.0,2020-01-16,"(359.134, 576.5]",20,25,-5
31227.0,2020-01-16,"(576.5, 793.0]",7,13,-6
31227.0,2020-01-16,"(793.0, 1009.5]",9,19,-10
31227.0,2020-01-16,"(1009.5, 1226.0]",8,26,-18
31228.0,2020-01-16,"(380.033, 622.75]",18,27,-9
31228.0,2020-01-16,"(622.75, 864.5]",14,24,-10
31228.0,2020-01-16,"(864.5, 1106.25]",20,36,-16
31228.0,2020-01-16,"(1106.25, 1348.0]",3,10,-7
31229.0,2020-01-16,"(4.582, 360.5]",5,9,-4
31229.0,2020-01-16,"(360.5, 715.0]",15,61,-46
31229.0,2020-01-16,"(715.0, 1069.5]",28,45,-17
31229.0,2020-01-16,"(1069.5, 1424.0]",32,58,-26
31230.0,2020-01-16,"(358.072, 591.0]",44,53,-9
31230.0,2020-01-16,"(591.0, 823.0]",12,18,-6
31230.0,2020-01-16,"(823.0, 1055.0]",10,20,-10
31230.0,2020-01-16,"(1055.0, 1287.0]",8,31,-23
31231.0,2020-01-16,"(329.029, 572.75]",23,26,-3
31231.0,2020-01-16,"(572.75, 815.5]",9,17,-8
31231.0,2020-01-16,"(815.5, 1058.25]",9,20,-11
31231.0,2020-01-16,"(1058.25, 1301.0]",4,6,-2
31232.0,2020-01-16,"(155.734, 473.5]",6,10,-4
31232.0,2020-01-16,"(473.5, 790.0]",15,25,-10
31232.0,2020-01-16,"(790.0, 1106.5]",13,26,-13
31232.0,2020-01-16,"(1106.5, 1423.0]",5,11,-6
31233.0,2020-01-16,"(3.584, 359.0]",2,3,-1
31233.0,2020-01-16,"(359.0, 713.0]",51,63,-12
31233.0,2020-01-16,"(713.0, 1067.0]",27,43,-16
31233.0,2020-01-16,"(1067.0, 1421.0]",11,30,-19
31234.0,2020-01-16,"(380.109, 603.75]",20,32,-12
31234.0,2020-01-16,"(603.75, 826.5]",9,13,-4
31234.0,2020-01-16,"(826.5, 1049.25]",7,12,-5
31234.0,2020-01-16,"(1049.25, 1272.0]",11,23,-12
31235.0,2020-01-16,"(406.21, 604.5]",7,8,-1
31235.0,2020-01-16,"(604.5, 802.0]",2,2,0
31235.0,2020-01-16,"(802.0, 999.5]",1,1,0
31235.0,2020-01-16,"(999.5, 1197.0]",2,4,-2
31236.0,2020-01-16,"(461.041, 701.75]",24,31,-7
31236.0,2020-01-16,"(701.75, 941.5]",8,16,-8
31236.0,2020-01-16,"(941.5, 1181.25]",8,17,-9
31236.0,2020-01-16,"(1181.25, 1421.0]",4,13,-9
31237.0,2020-01-16,"(427.118, 648.5]",3,18,-15
31237.0,2020-01-16,"(648.5, 869.0]",5,7,-2
31237.0,2020-01-16,"(869.0, 1089.5]",16,22,-6
31237.0,2020-01-16,"(1089.5, 1310.0]",5,10,-5
31238.0,2020-01-16,"(48.706, 373.5]",1,2,-1
31238.0,2020-01-16,"(373.5, 697.0]",19,22,-3
31238.0,2020-01-16,"(697.0, 1020.5]",3,9,-6
31238.0,2020-01-16,"(1020.5, 1344.0]",4,26,-22
31239.0,2020-01-16,"(350.973, 608.75]",28,31,-3
31239.0,2020-01-16,"(608.75, 865.5]",10,14,-4
31239.0,2020-01-16,"(865.5, 1122.25]",11,36,-25
31239.0,2020-01-16,"(1122.25, 1379.0]",2,10,-8
31240.0,2020-01-16,"(792.723, 862.25]",11,22,-11
31240.0,2020-01-16,"(931.5, 1000.75]",1,2,-1
31240.0,2020-01-16,"(1000.75, 1070.0]",1,1,0
31241.0,2020-01-16,"(15.597, 367.75]",3,3,0
31241.0,2020-01-16,"(367.75, 718.5]",35,70,-35
31241.0,2020-01-16,"(718.5, 1069.25]",16,38,-22
31241.0,2020-01-16,"(1069.25, 1420.0]",16,36,-20
31242.0,2020-01-16,"(407.968, 416.0]",1,2,-1
31242.0,2020-01-16,"(432.0, 440.0]",3,3,0
31243.0,2020-01-16,"(208.9, 485.0]",15,19,-4
31243.0,2020-01-16,"(485.0, 760.0]",17,20,-3
31243.0,2020-01-16,"(760.0, 1035.0]",5,19,-14
31243.0,2020-01-16,"(1035.0, 1310.0]",4,12,-8
31244.0,2020-01-16,"(6.719, 328.25]",1,2,-1
31244.0,2020-01-16,"(328.25, 648.5]",24,37,-13
31244.0,2020-01-16,"(648.5, 968.75]",4,11,-7
31244.0,2020-01-16,"(968.75, 1289.0]",9,22,-13
31245.0,2020-01-16,"(352.75, 687.5]",12,2,10
31245.0,2020-01-16,"(687.5, 1022.25]",7,27,-20
31245.0,2020-01-16,"(1022.25, 1357.0]",13,12,1
31246.0,2020-01-16,"(13.618, 360.5]",1,2,-1
31246.0,2020-01-16,"(360.5, 706.0]",19,28,-9
31246.0,2020-01-16,"(706.0, 1051.5]",12,24,-12
31246.0,2020-01-16,"(1051.5, 1397.0]",14,25,-11
31247.0,2020-01-16,"(50.955, 313.25]",6,6,0
31247.0,2020-01-16,"(313.25, 574.5]",12,18,-6
31247.0,2020-01-16,"(574.5, 835.75]",3,5,-2
31247.0,2020-01-16,"(835.75, 1097.0]",8,21,-13
31248.0,2020-01-16,"(387.216, 584.0]",10,18,-8
31248.0,2020-01-16,"(584.0, 780.0]",8,20,-12
31248.0,2020-01-16,"(780.0, 976.0]",8,14,-6
31248.0,2020-01-16,"(976.0, 1172.0]",9,20,-11
31249.0,2020-01-16,"(449.349, 612.75]",7,15,-8
31249.0,2020-01-16,"(612.75, 775.5]",4,7,-3
31249.0,2020-01-16,"(775.5, 938.25]",4,8,-4
31249.0,2020-01-16,"(938.25, 1101.0]",6,11,-5
31250.0,2020-01-16,"(411.984, 667.0]",24,30,-6
31250.0,2020-01-16,"(667.0, 921.0]",4,10,-6
31250.0,2020-01-16,"(921.0, 1175.0]",6,28,-22
31250.0,2020-01-16,"(1175.0, 1429.0]",2,4,-2
31251.0,2020-01-16,"(191.77, 500.5]",4,7,-3
31251.0,2020-01-16,"(500.5, 808.0]",20,34,-14
31251.0,2020-01-16,"(808.0, 1115.5]",14,28,-14
31251.0,2020-01-16,"(1115.5, 1423.0]",7,14,-7
31252.0,2020-01-16,"(347.5, 683.0]",21,1,20
31252.0,2020-01-16,"(683.0, 1018.5]",2,24,-22
31252.0,2020-01-16,"(1018.5, 1354.0]",6,10,-4
31253.0,2020-01-16,"(384.173, 591.75]",22,23,-1
31253.0,2020-01-16,"(591.75, 798.5]",4,7,-3
31253.0,2020-01-16,"(798.5, 1005.25]",9,15,-6
31253.0,2020-01-16,"(1005.25, 1212.0]",2,21,-19
31254.0,2020-01-16,"(409.001, 659.75]",31,36,-5
31254.0,2020-01-16,"(659.75, 909.5]",4,8,-4
31254.0,2020-01-16,"(909.5, 1159.25]",5,24,-19
31254.0,2020-01-16,"(1159.25, 1409.0]",2,4,-2
31255.0,2020-01-16,"(362.966, 622.5]",19,28,-9
31255.0,2020-01-16,"(622.5, 881.0]",5,10,-5
31255.0,2020-01-16,"(881.0, 1139.5]",5,19,-14
31255.0,2020-01-16,"(1139.5, 1398.0]",5,8,-3
31256.0,2020-01-16,"(264.937, 531.75]",14,15,-1
31256.0,2020-01-16,"(531.75, 797.5]",6,8,-2
31256.0,2020-01-16,"(797.5, 1063.25]",7,17,-10
31256.0,2020-01-16,"(1063.25, 1329.0]",5,13,-8
31257.0,2020-01-16,"(127.766, 437.5]",3,3,0
31257.0,2020-01-16,"(437.5, 746.0]",18,31,-13
31257.0,2020-01-16,"(746.0, 1054.5]",9,21,-12
31257.0,2020-01-16,"(1054.5, 1363.0]",21,41,-20
31258.0,2020-01-16,"(329.273, 511.75]",2,4,-2
31258.0,2020-01-16,"(511.75, 693.5]",4,9,-5
31258.0,2020-01-16,"(693.5, 875.25]",12,20,-8
31258.0,2020-01-16,"(875.25, 1057.0]",9,20,-11
31259.0,2020-01-16,"(428.232, 621.0]",13,13,0
31260.0,2020-01-16,"(14.683, 345.25]",1,1,0
31260.0,2020-01-16,"(345.25, 674.5]",18,21,-3
31260.0,2020-01-16,"(674.5, 1003.75]",4,10,-6
31260.0,2020-01-16,"(1003.75, 1333.0]",5,22,-17
31261.0,2020-01-16,"(388.214, 585.5]",10,10,0
31261.0,2020-01-16,"(782.0, 978.5]",1,1,0
31261.0,2020-01-16,"(978.5, 1175.0]",1,5,-4
31262.0,2020-01-16,"(38.638, 380.5]",2,3,-1
31262.0,2020-01-16,"(380.5, 721.0]",12,13,-1
31262.0,2020-01-16,"(721.0, 1061.5]",3,8,-5
31262.0,2020-01-16,"(1061.5, 1402.0]",1,10,-9
31263.0,2020-01-16,"(36.774, 344.5]",2,2,0
31263.0,2020-01-16,"(344.5, 651.0]",27,38,-11
31263.0,2020-01-16,"(651.0, 957.5]",9,21,-12
31263.0,2020-01-16,"(957.5, 1264.0]",10,30,-20
31264.0,2020-01-16,"(368.0, 710.0]",15,1,14
31264.0,2020-01-16,"(710.0, 1052.0]",8,18,-10
31264.0,2020-01-16,"(1052.0, 1394.0]",3,20,-17
31265.0,2020-01-16,"(347.25, 693.5]",17,1,16
31265.0,2020-01-16,"(693.5, 1039.75]",15,41,-26
31265.0,2020-01-16,"(1039.75, 1386.0]",29,35,-6
31266.0,2020-01-16,"(-0.42, 356.0]",1,5,-4
31266.0,2020-01-16,"(356.0, 711.0]",10,36,-26
31266.0,2020-01-16,"(711.0, 1066.0]",18,32,-14
31266.0,2020-01-16,"(1066.0, 1421.0]",19,35,-16
31267.0,2020-01-16,"(374.5, 725.0]",19,1,18
31267.0,2020-01-16,"(725.0, 1075.5]",13,42,-29
31267.0,2020-01-16,"(1075.5, 1426.0]",9,32,-23
31268.0,2020-01-16,"(81.755, 394.25]",9,14,-5
31268.0,2020-01-16,"(394.25, 705.5]",8,35,-27
31268.0,2020-01-16,"(705.5, 1016.75]",10,14,-4
31268.0,2020-01-16,"(1016.75, 1328.0]",18,26,-8
31269.0,2020-01-16,"(349.003, 599.25]",10,19,-9
31269.0,2020-01-16,"(599.25, 848.5]",3,7,-4
31269.0,2020-01-16,"(848.5, 1097.75]",6,17,-11
31269.0,2020-01-16,"(1097.75, 1347.0]",7,11,-4
31270.0,2020-01-16,"(421.003, 671.25]",13,18,-5
31270.0,2020-01-16,"(671.25, 920.5]",2,5,-3
31270.0,2020-01-16,"(920.5, 1169.75]",7,14,-7
31270.0,2020-01-16,"(1169.75, 1419.0]",1,3,-2
31271.0,2020-01-16,"(407.101, 632.75]",20,26,-6
31271.0,2020-01-16,"(632.75, 857.5]",7,13,-6
31271.0,2020-01-16,"(1082.25, 1307.0]",3,9,-6
31272.0,2020-01-16,"(295.957, 557.75]",29,32,-3
31272.0,2020-01-16,"(557.75, 818.5]",12,22,-10
31272.0,2020-01-16,"(818.5, 1079.25]",7,22,-15
31272.0,2020-01-16,"(1079.25, 1340.0]",2,8,-6
31273.0,2020-01-16,"(641.75, 766.5]",1,2,-1
31273.0,2020-01-16,"(766.5, 891.25]",2,1,1
31273.0,2020-01-16,"(891.25, 1016.0]",3,3,0
31274.0,2020-01-16,"(315.75, 603.5]",20,4,16
31274.0,2020-01-16,"(603.5, 891.25]",8,23,-15
31274.0,2020-01-16,"(891.25, 1179.0]",12,12,0
31275.0,2020-01-16,"(60.673, 393.75]",3,4,-1
31275.0,2020-01-16,"(393.75, 725.5]",21,37,-16
31275.0,2020-01-16,"(725.5, 1057.25]",14,28,-14
31275.0,2020-01-16,"(1057.25, 1389.0]",11,24,-13
31276.0,2020-01-16,"(397.063, 632.25]",25,27,-2
31276.0,2020-01-16,"(632.25, 866.5]",2,7,-5
31276.0,2020-01-16,"(866.5, 1100.75]",5,23,-18
31276.0,2020-01-16,"(1100.75, 1335.0]",2,5,-3
31277.0,2020-01-16,"(414.316, 586.0]",43,47,-4
31277.0,2020-01-16,"(586.0, 757.0]",4,9,-5
31277.0,2020-01-16,"(757.0, 928.0]",4,7,-3
31277.0,2020-01-16,"(928.0, 1099.0]",8,39,-31
31278.0,2020-01-16,"(301.865, 586.75]",13,37,-24
31278.0,2020-01-16,"(586.75, 870.5]",6,16,-10
31278.0,2020-01-16,"(870.5, 1154.25]",17,27,-10
31278.0,2020-01-16,"(1154.25, 1438.0]",6,9,-3
31279.0,2020-01-16,"(416.227, 610.25]",25,28,-3
31279.0,2020-01-16,"(610.25, 803.5]",7,14,-7
31279.0,2020-01-16,"(803.5, 996.75]",5,11,-6
31279.0,2020-01-16,"(996.75, 1190.0]",5,31,-26
31280.0,2020-01-16,"(109.703, 435.25]",1,6,-5
31280.0,2020-01-16,"(435.25, 759.5]",6,24,-18
31280.0,2020-01-16,"(759.5, 1083.75]",8,10,-2
31280.0,2020-01-16,"(1083.75, 1408.0]",10,11,-1
,,,,1.0,
,,,,1.0,
,,,,1.0,
31001.0,2020-01-17,"(542.426, 686.5]",1,1,0
31001.0,2020-01-17,"(973.5, 1117.0]",2,4,-2
31002.0,2020-01-17,"(508.316, 680.0]",2,5,-3
31002.0,2020-01-17,"(680.0, 851.0]",2,2,0
31002.0,2020-01-17,"(1022.0, 1193.0]",3,3,0
31003.0,2020-01-17,"(539.403, 689.25]",2,3,-1
31003.0,2020-01-17,"(838.5, 987.75]",1,3,-2
31003.0,2020-01-17,"(987.75, 1137.0]",2,4,-2
31004.0,2020-01-17,"(493.268, 677.0]",2,4,-2
31004.0,2020-01-17,"(1043.0, 1226.0]",1,2,-1
31005.0,2020-01-17,"(440.221, 635.75]",3,5,-2
31005.0,2020-01-17,"(1025.25, 1220.0]",2,1,1
31006.0,2020-01-17,"(896.876, 928.0]",1,1,0
31006.0,2020-01-17,"(990.0, 1021.0]",2,2,0
31007.0,2020-01-17,"(427.17, 635.5]",6,11,-5
31007.0,2020-01-17,"(635.5, 843.0]",2,2,0
31007.0,2020-01-17,"(843.0, 1050.5]",7,13,-6
31007.0,2020-01-17,"(1050.5, 1258.0]",2,7,-5
31009.0,2020-01-17,"(543.492, 671.0]",3,3,0
31010.0,2020-01-17,"(400.976, 658.0]",1,2,-1
31010.0,2020-01-17,"(914.0, 1170.0]",4,3,1
31010.0,2020-01-17,"(1170.0, 1426.0]",2,5,-3
31011.0,2020-01-17,"(418.32, 589.0]",1,1,0
31011.0,2020-01-17,"(929.0, 1099.0]",1,6,-5
31012.0,2020-01-17,"(544.562, 654.5]",1,1,0
31012.0,2020-01-17,"(873.5, 983.0]",1,2,-1
31013.0,2020-01-17,"(857.5, 1014.0]",2,2,0
31014.0,2020-01-17,"(405.086, 634.5]",12,16,-4
31014.0,2020-01-17,"(634.5, 863.0]",6,8,-2
31014.0,2020-01-17,"(863.0, 1091.5]",10,19,-9
31014.0,2020-01-17,"(1091.5, 1320.0]",5,8,-3
31015.0,2020-01-17,"(431.151, 644.25]",13,15,-2
31015.0,2020-01-17,"(644.25, 856.5]",3,3,0
31015.0,2020-01-17,"(856.5, 1068.75]",8,14,-6
31015.0,2020-01-17,"(1068.75, 1281.0]",3,4,-1
31016.0,2020-01-17,"(347.07, 580.5]",4,8,-4
31016.0,2020-01-17,"(580.5, 813.0]",1,1,0
31016.0,2020-01-17,"(813.0, 1045.5]",6,10,-4
31017.0,2020-01-17,"(483.315, 655.25]",3,6,-3
31017.0,2020-01-17,"(655.25, 826.5]",2,5,-3
31017.0,2020-01-17,"(826.5, 997.75]",1,4,-3
31017.0,2020-01-17,"(997.75, 1169.0]",1,4,-3
31018.0,2020-01-17,"(439.37, 597.5]",1,4,-3
31018.0,2020-01-17,"(755.0, 912.5]",1,1,0
31018.0,2020-01-17,"(912.5, 1070.0]",1,1,0
31019.0,2020-01-17,"(396.5, 709.0]",1,1,0
31019.0,2020-01-17,"(709.0, 1021.5]",1,1,0
31019.0,2020-01-17,"(1021.5, 1334.0]",1,2,-1
31020.0,2020-01-17,"(301.0, 600.0]",1,1,0
31020.0,2020-01-17,"(600.0, 899.0]",2,1,1
31020.0,2020-01-17,"(899.0, 1198.0]",2,3,-1
31021.0,2020-01-17,"(814.5, 1011.25]",2,4,-2
31021.0,2020-01-17,"(1011.25, 1208.0]",1,2,-1
31022.0,2020-01-17,"(477.233, 669.75]",4,8,-4
31022.0,2020-01-17,"(1053.25, 1245.0]",1,1,0
31023.0,2020-01-17,"(652.344, 817.0]",1,2,-1
31023.0,2020-01-17,"(981.0, 1145.0]",3,4,-1
31024.0,2020-01-17,"(412.204, 612.0]",6,9,-3
31024.0,2020-01-17,"(811.0, 1010.0]",4,6,-2
31025.0,2020-01-17,"(656.641, 746.75]",1,3,-2
31025.0,2020-01-17,"(926.25, 1016.0]",1,1,0
31026.0,2020-01-17,"(780.0, 966.0]",1,2,-1
31026.0,2020-01-17,"(966.0, 1152.0]",3,3,0
31027.0,2020-01-17,"(975.536, 1092.0]",2,2,0
31027.0,2020-01-17,"(1092.0, 1208.0]",1,2,-1
31027.0,2020-01-17,"(1324.0, 1440.0]",1,1,0
31028.0,2020-01-17,"(487.301, 662.75]",2,4,-2
31028.0,2020-01-17,"(662.75, 837.5]",1,1,0
31028.0,2020-01-17,"(837.5, 1012.25]",1,2,-1
31028.0,2020-01-17,"(1012.25, 1187.0]",2,6,-4
31029.0,2020-01-17,"(638.25, 830.5]",1,4,-3
31029.0,2020-01-17,"(830.5, 1022.75]",4,1,3
31029.0,2020-01-17,"(1022.75, 1215.0]",5,6,-1
31030.0,2020-01-17,"(3.851, 292.25]",2,2,0
31030.0,2020-01-17,"(579.5, 866.75]",1,8,-7
31030.0,2020-01-17,"(866.75, 1154.0]",5,2,3
31031.0,2020-01-17,"(421.19, 624.5]",1,5,-4
31031.0,2020-01-17,"(1029.5, 1232.0]",2,4,-2
31032.0,2020-01-17,"(860.5, 1055.25]",1,2,-1
31032.0,2020-01-17,"(1055.25, 1250.0]",3,1,2
31033.0,2020-01-17,"(553.744, 618.0]",1,1,0
31033.0,2020-01-17,"(746.0, 810.0]",1,1,0
31034.0,2020-01-17,"(417.313, 589.75]",1,4,-3
31034.0,2020-01-17,"(761.5, 933.25]",1,1,0
31034.0,2020-01-17,"(933.25, 1105.0]",1,1,0
31035.0,2020-01-17,"(584.5, 742.0]",1,4,-3
31035.0,2020-01-17,"(899.5, 1057.0]",3,2,1
31036.0,2020-01-17,"(611.0, 812.0]",1,4,-3
31036.0,2020-01-17,"(812.0, 1013.0]",1,1,0
31036.0,2020-01-17,"(1013.0, 1214.0]",4,1,3
31037.0,2020-01-17,"(349.938, 616.5]",7,10,-3
31037.0,2020-01-17,"(616.5, 882.0]",1,3,-2
31037.0,2020-01-17,"(882.0, 1147.5]",5,16,-11
31038.0,2020-01-17,"(522.0, 696.0]",1,1,0
31039.0,2020-01-17,"(485.264, 670.0]",1,4,-3
31039.0,2020-01-17,"(670.0, 854.0]",1,1,0
31039.0,2020-01-17,"(854.0, 1038.0]",3,8,-5
31039.0,2020-01-17,"(1038.0, 1222.0]",1,3,-2
31040.0,2020-01-17,"(447.405, 596.75]",2,2,0
31040.0,2020-01-17,"(745.5, 894.25]",1,3,-2
31041.0,2020-01-17,"(686.395, 838.25]",1,1,0
31041.0,2020-01-17,"(838.25, 989.5]",1,2,-1
31041.0,2020-01-17,"(989.5, 1140.75]",2,2,0
31042.0,2020-01-17,"(456.275, 638.25]",8,9,-1
31042.0,2020-01-17,"(638.25, 819.5]",2,4,-2
31042.0,2020-01-17,"(1000.75, 1182.0]",1,1,0
31043.0,2020-01-17,"(399.231, 592.25]",3,4,-1
31043.0,2020-01-17,"(592.25, 784.5]",2,2,0
31044.0,2020-01-17,"(477.363, 637.25]",2,3,-1
31044.0,2020-01-17,"(796.5, 955.75]",1,1,0
31044.0,2020-01-17,"(955.75, 1115.0]",1,1,0
31045.0,2020-01-17,"(907.25, 1041.0]",2,2,0
31046.0,2020-01-17,"(398.363, 558.25]",1,3,-2
31046.0,2020-01-17,"(558.25, 717.5]",1,2,-1
31046.0,2020-01-17,"(876.75, 1036.0]",1,1,0
31047.0,2020-01-17,"(407.007, 656.25]",8,15,-7
31047.0,2020-01-17,"(656.25, 904.5]",3,8,-5
31047.0,2020-01-17,"(904.5, 1152.75]",6,14,-8
31047.0,2020-01-17,"(1152.75, 1401.0]",1,2,-1
31048.0,2020-01-17,"(515.21, 713.5]",2,3,-1
31048.0,2020-01-17,"(911.0, 1108.5]",2,1,1
31048.0,2020-01-17,"(1108.5, 1306.0]",2,5,-3
31049.0,2020-01-17,"(422.018, 668.5]",1,1,0
31049.0,2020-01-17,"(1159.5, 1405.0]",1,2,-1
31050.0,2020-01-17,"(915.75, 1221.0]",2,1,1
31051.0,2020-01-17,"(824.0, 989.0]",1,2,-1
31051.0,2020-01-17,"(989.0, 1154.0]",4,1,3
31052.0,2020-01-17,"(504.396, 656.0]",4,6,-2
31052.0,2020-01-17,"(958.0, 1109.0]",4,9,-5
31053.0,2020-01-17,"(944.5, 1045.0]",1,1,0
,,,,2.0,
31055.0,2020-01-17,"(243.0, 486.0]",2,1,1
31055.0,2020-01-17,"(729.0, 972.0]",2,2,0
31056.0,2020-01-17,"(904.25, 1054.0]",1,2,-1
,,,,2.0,
31058.0,2020-01-17,"(491.25, 655.0]",1,1,0
31059.0,2020-01-17,"(1006.0, 1171.0]",1,1,0
31060.0,2020-01-17,"(542.455, 679.25]",2,2,0
31060.0,2020-01-17,"(679.25, 815.5]",1,1,0
31061.0,2020-01-17,"(715.967, 724.25]",1,1,0
31062.0,2020-01-17,"(433.375, 590.25]",2,5,-3
31062.0,2020-01-17,"(902.75, 1059.0]",2,7,-5
,,,,2.0,
31064.0,2020-01-17,"(389.278, 570.5]",1,2,-1
31064.0,2020-01-17,"(570.5, 751.0]",1,3,-2
31064.0,2020-01-17,"(751.0, 931.5]",3,6,-3
31064.0,2020-01-17,"(931.5, 1112.0]",3,6,-3
31065.0,2020-01-17,"(440.026, 684.5]",1,3,-2
31065.0,2020-01-17,"(1171.5, 1415.0]",1,1,0
31066.0,2020-01-17,"(948.5, 1041.0]",1,1,0
31067.0,2020-01-17,"(12.989, 266.75]",1,2,-1
31067.0,2020-01-17,"(519.5, 772.25]",1,2,-1
31067.0,2020-01-17,"(772.25, 1025.0]",2,3,-1
,,,,1.0,
,,,,1.0,
,,,,1.0,
31069.0,2020-01-17,"(948.0, 1102.0]",2,3,-1
31070.0,2020-01-17,"(626.308, 800.0]",1,1,0
31070.0,2020-01-17,"(800.0, 973.0]",2,4,-2
31070.0,2020-01-17,"(1146.0, 1319.0]",1,1,0
31071.0,2020-01-17,"(455.364, 615.0]",1,4,-3
31071.0,2020-01-17,"(615.0, 774.0]",1,2,-1
31071.0,2020-01-17,"(774.0, 933.0]",3,3,0
31071.0,2020-01-17,"(933.0, 1092.0]",5,6,-1
,,,,2.0,
31073.0,2020-01-17,"(484.462, 619.5]",1,1,0
31074.0,2020-01-17,"(28.916, 301.0]",1,1,0
31074.0,2020-01-17,"(843.0, 1114.0]",3,2,1
31075.0,2020-01-17,"(510.401, 660.75]",1,3,-2
31075.0,2020-01-17,"(960.25, 1110.0]",1,1,0
31076.0,2020-01-17,"(858.0, 1144.0]",1,1,0
31077.0,2020-01-17,"(486.235, 678.25]",1,4,-3
31077.0,2020-01-17,"(869.5, 1060.75]",1,2,-1
31077.0,2020-01-17,"(1060.75, 1252.0]",2,3,-1
31078.0,2020-01-17,"(492.54, 608.0]",4,4,0
31079.0,2020-01-17,"(673.0, 891.0]",3,6,-3
31079.0,2020-01-17,"(891.0, 1109.0]",4,4,0
31079.0,2020-01-17,"(1109.0, 1327.0]",2,7,-5
31080.0,2020-01-17,"(439.043, 679.25]",1,8,-7
31080.0,2020-01-17,"(679.25, 918.5]",1,3,-2
31080.0,2020-01-17,"(918.5, 1157.75]",4,8,-4
31080.0,2020-01-17,"(1157.75, 1397.0]",3,4,-1
31081.0,2020-01-17,"(226.054, 463.5]",1,1,0
31081.0,2020-01-17,"(463.5, 700.0]",1,1,0
31081.0,2020-01-17,"(700.0, 936.5]",1,3,-2
31081.0,2020-01-17,"(936.5, 1173.0]",1,3,-2
31082.0,2020-01-17,"(873.82, 919.0]",1,2,-1
31082.0,2020-01-17,"(919.0, 964.0]",1,1,0
31083.0,2020-01-17,"(693.5, 847.0]",1,2,-1
31083.0,2020-01-17,"(1000.5, 1154.0]",2,1,1
31084.0,2020-01-17,"(657.38, 813.0]",2,2,0
31084.0,2020-01-17,"(813.0, 968.0]",1,1,0
31084.0,2020-01-17,"(968.0, 1123.0]",1,2,-1
31084.0,2020-01-17,"(1123.0, 1278.0]",1,3,-2
31085.0,2020-01-17,"(403.274, 585.5]",1,4,-3
31085.0,2020-01-17,"(948.5, 1130.0]",2,2,0
31086.0,2020-01-17,"(590.25, 708.5]",1,2,-1
31086.0,2020-01-17,"(826.75, 945.0]",1,1,0
,,,,1.0,
,,,,1.0,
31088.0,2020-01-17,"(761.0, 936.5]",1,2,-1
31088.0,2020-01-17,"(936.5, 1112.0]",4,1,3
31089.0,2020-01-17,"(249.817, 546.75]",5,10,-5
31089.0,2020-01-17,"(546.75, 842.5]",4,7,-3
31089.0,2020-01-17,"(842.5, 1138.25]",5,20,-15
31089.0,2020-01-17,"(1138.25, 1434.0]",1,5,-4
31090.0,2020-01-17,"(839.5, 980.0]",1,1,0
31091.0,2020-01-17,"(55.82, 352.0]",1,1,0
31091.0,2020-01-17,"(942.0, 1237.0]",2,6,-4
31092.0,2020-01-17,"(948.0, 1177.0]",1,1,0
31092.0,2020-01-17,"(1177.0, 1406.0]",1,1,0
31093.0,2020-01-17,"(927.0, 1049.0]",1,1,0
31094.0,2020-01-17,"(747.647, 836.25]",2,2,0
,,,,2.0,
31096.0,2020-01-17,"(1081.0, 1147.0]",1,1,0
31096.0,2020-01-17,"(1213.0, 1279.0]",1,1,0
31097.0,2020-01-17,"(447.5, 681.0]",2,1,1
31097.0,2020-01-17,"(914.5, 1148.0]",1,3,-2
31098.0,2020-01-17,"(449.34, 615.0]",3,10,-7
31098.0,2020-01-17,"(780.0, 945.0]",1,1,0
31098.0,2020-01-17,"(945.0, 1110.0]",6,10,-4
31099.0,2020-01-17,"(775.0, 853.5]",1,1,0
31100.0,2020-01-17,"(398.07, 631.5]",13,13,0
31100.0,2020-01-17,"(631.5, 864.0]",2,5,-3
31100.0,2020-01-17,"(864.0, 1096.5]",3,9,-6
31100.0,2020-01-17,"(1096.5, 1329.0]",4,12,-8
31101.0,2020-01-17,"(0.585, 355.75]",4,4,0
31101.0,2020-01-17,"(355.75, 709.5]",19,36,-17
31101.0,2020-01-17,"(709.5, 1063.25]",35,50,-15
31101.0,2020-01-17,"(1063.25, 1417.0]",21,40,-19
31102.0,2020-01-17,"(405.005, 654.75]",1,13,-12
31102.0,2020-01-17,"(654.75, 903.5]",3,6,-3
31102.0,2020-01-17,"(903.5, 1152.25]",8,14,-6
31102.0,2020-01-17,"(1152.25, 1401.0]",5,9,-4
31103.0,2020-01-17,"(443.059, 679.25]",2,27,-25
31103.0,2020-01-17,"(679.25, 914.5]",4,10,-6
31103.0,2020-01-17,"(914.5, 1149.75]",8,16,-8
31103.0,2020-01-17,"(1149.75, 1385.0]",6,12,-6
31104.0,2020-01-17,"(361.5, 714.0]",7,4,3
31104.0,2020-01-17,"(714.0, 1066.5]",15,32,-17
31104.0,2020-01-17,"(1066.5, 1419.0]",8,32,-24
31105.0,2020-01-17,"(432.248, 621.0]",1,6,-5
31105.0,2020-01-17,"(621.0, 809.0]",1,5,-4
31106.0,2020-01-17,"(407.106, 631.5]",2,6,-4
31106.0,2020-01-17,"(855.0, 1078.5]",1,1,0
31106.0,2020-01-17,"(1078.5, 1302.0]",3,3,0
31107.0,2020-01-17,"(368.939, 635.25]",2,15,-13
31107.0,2020-01-17,"(635.25, 900.5]",1,12,-11
31107.0,2020-01-17,"(900.5, 1165.75]",13,21,-8
31107.0,2020-01-17,"(1165.75, 1431.0]",5,10,-5
31108.0,2020-01-17,"(4.598, 356.5]",1,1,0
31108.0,2020-01-17,"(356.5, 707.0]",6,23,-17
31108.0,2020-01-17,"(707.0, 1057.5]",20,33,-13
31108.0,2020-01-17,"(1057.5, 1408.0]",18,24,-6
31109.0,2020-01-17,"(388.5, 733.0]",8,2,6
31109.0,2020-01-17,"(733.0, 1077.5]",12,21,-9
31109.0,2020-01-17,"(1077.5, 1422.0]",12,16,-4
31110.0,2020-01-17,"(109.736, 427.0]",8,14,-6
31110.0,2020-01-17,"(427.0, 743.0]",10,20,-10
31110.0,2020-01-17,"(743.0, 1059.0]",12,24,-12
31110.0,2020-01-17,"(1059.0, 1375.0]",8,14,-6
31111.0,2020-01-17,"(72.636, 415.0]",1,2,-1
31111.0,2020-01-17,"(415.0, 756.0]",7,15,-8
31111.0,2020-01-17,"(756.0, 1097.0]",13,24,-11
31111.0,2020-01-17,"(1097.0, 1438.0]",9,12,-3
31112.0,2020-01-17,"(505.451, 643.25]",2,4,-2
31112.0,2020-01-17,"(643.25, 780.5]",1,3,-2
31112.0,2020-01-17,"(917.75, 1055.0]",3,2,1
31113.0,2020-01-17,"(596.25, 874.5]",1,10,-9
31113.0,2020-01-17,"(874.5, 1152.75]",3,11,-8
31113.0,2020-01-17,"(1152.75, 1431.0]",5,6,-1
31114.0,2020-01-17,"(348.96, 610.0]",4,28,-24
31114.0,2020-01-17,"(610.0, 870.0]",2,8,-6
31114.0,2020-01-17,"(870.0, 1130.0]",12,18,-6
31114.0,2020-01-17,"(1130.0, 1390.0]",12,22,-10
31115.0,2020-01-17,"(397.75, 716.5]",2,3,-1
31115.0,2020-01-17,"(716.5, 1035.25]",3,16,-13
31115.0,2020-01-17,"(1035.25, 1354.0]",9,11,-2
31116.0,2020-01-17,"(331.918, 603.5]",3,23,-20
31116.0,2020-01-17,"(603.5, 874.0]",3,5,-2
31116.0,2020-01-17,"(874.0, 1144.5]",18,22,-4
31116.0,2020-01-17,"(1144.5, 1415.0]",6,12,-6
31117.0,2020-01-17,"(8.617, 355.75]",2,4,-2
31117.0,2020-01-17,"(355.75, 701.5]",1,26,-25
31117.0,2020-01-17,"(701.5, 1047.25]",5,20,-15
31117.0,2020-01-17,"(1047.25, 1393.0]",6,10,-4
31118.0,2020-01-17,"(326.97, 585.5]",2,18,-16
31118.0,2020-01-17,"(585.5, 843.0]",1,1,0
31118.0,2020-01-17,"(843.0, 1100.5]",8,10,-2
31118.0,2020-01-17,"(1100.5, 1358.0]",5,5,0
31119.0,2020-01-17,"(-0.354, 339.5]",1,1,0
31119.0,2020-01-17,"(339.5, 678.0]",10,31,-21
31119.0,2020-01-17,"(678.0, 1016.5]",9,14,-5
31119.0,2020-01-17,"(1016.5, 1355.0]",12,26,-14
31120.0,2020-01-17,"(89.723, 410.25]",2,3,-1
31120.0,2020-01-17,"(410.25, 729.5]",3,13,-10
31120.0,2020-01-17,"(729.5, 1048.75]",8,14,-6
31120.0,2020-01-17,"(1048.75, 1368.0]",5,9,-4
31121.0,2020-01-17,"(384.964, 645.0]",14,18,-4
31121.0,2020-01-17,"(645.0, 904.0]",3,8,-5
31121.0,2020-01-17,"(904.0, 1163.0]",4,16,-12
31121.0,2020-01-17,"(1163.0, 1422.0]",2,4,-2
31122.0,2020-01-17,"(426.996, 679.0]",3,17,-14
31122.0,2020-01-17,"(679.0, 930.0]",3,5,-2
31122.0,2020-01-17,"(930.0, 1181.0]",6,12,-6
31123.0,2020-01-17,"(852.0, 1088.5]",4,9,-5
31123.0,2020-01-17,"(1088.5, 1325.0]",3,7,-4
31124.0,2020-01-17,"(64.639, 406.25]",1,3,-2
31124.0,2020-01-17,"(406.25, 746.5]",20,44,-24
31124.0,2020-01-17,"(746.5, 1086.75]",16,50,-34
31124.0,2020-01-17,"(1086.75, 1427.0]",13,33,-20
31125.0,2020-01-17,"(404.997, 656.75]",1,21,-20
31125.0,2020-01-17,"(656.75, 907.5]",3,5,-2
31125.0,2020-01-17,"(907.5, 1158.25]",15,22,-7
31125.0,2020-01-17,"(1158.25, 1409.0]",8,11,-3
31126.0,2020-01-17,"(331.903, 607.25]",3,24,-21
31126.0,2020-01-17,"(607.25, 881.5]",3,9,-6
31126.0,2020-01-17,"(881.5, 1155.75]",9,18,-9
31126.0,2020-01-17,"(1155.75, 1430.0]",13,19,-6
,,,,2.0,
31128.0,2020-01-17,"(337.117, 558.75]",18,25,-7
31128.0,2020-01-17,"(558.75, 779.5]",8,19,-11
31128.0,2020-01-17,"(779.5, 1000.25]",10,15,-5
31128.0,2020-01-17,"(1000.25, 1221.0]",12,17,-5
31129.0,2020-01-17,"(492.152, 705.0]",9,11,-2
31129.0,2020-01-17,"(705.0, 917.0]",11,18,-7
31129.0,2020-01-17,"(917.0, 1129.0]",4,6,-2
31129.0,2020-01-17,"(1129.0, 1341.0]",2,4,-2
31130.0,2020-01-17,"(360.998, 612.5]",1,8,-7
31130.0,2020-01-17,"(863.0, 1113.5]",8,13,-5
31130.0,2020-01-17,"(1113.5, 1364.0]",7,8,-1
31131.0,2020-01-17,"(632.0, 901.0]",1,13,-12
31131.0,2020-01-17,"(901.0, 1170.0]",3,3,0
31131.0,2020-01-17,"(1170.0, 1439.0]",2,6,-4
31200.0,2020-01-17,"(405.027, 649.25]",18,27,-9
31200.0,2020-01-17,"(649.25, 892.5]",13,22,-9
31200.0,2020-01-17,"(892.5, 1135.75]",12,32,-20
31200.0,2020-01-17,"(1135.75, 1379.0]",6,11,-5
31201.0,2020-01-17,"(28.591, 382.25]",1,1,0
31201.0,2020-01-17,"(382.25, 734.5]",16,39,-23
31201.0,2020-01-17,"(734.5, 1086.75]",25,43,-18
31201.0,2020-01-17,"(1086.75, 1439.0]",23,47,-24
31202.0,2020-01-17,"(103.687, 433.25]",3,8,-5
31202.0,2020-01-17,"(433.25, 761.5]",16,33,-17
31202.0,2020-01-17,"(761.5, 1089.75]",24,37,-13
31202.0,2020-01-17,"(1089.75, 1418.0]",11,19,-8
31203.0,2020-01-17,"(27.641, 368.75]",1,2,-1
31203.0,2020-01-17,"(368.75, 708.5]",15,36,-21
31203.0,2020-01-17,"(708.5, 1048.25]",22,35,-13
31203.0,2020-01-17,"(1048.25, 1388.0]",21,40,-19
31204.0,2020-01-17,"(36.684, 367.0]",1,3,-2
31204.0,2020-01-17,"(367.0, 696.0]",14,18,-4
31204.0,2020-01-17,"(696.0, 1025.0]",7,18,-11
31204.0,2020-01-17,"(1025.0, 1354.0]",10,22,-12
31205.0,2020-01-17,"(462.25, 650.5]",21,26,-5
31205.0,2020-01-17,"(650.5, 838.0]",13,15,-2
31205.0,2020-01-17,"(838.0, 1025.5]",5,10,-5
31205.0,2020-01-17,"(1025.5, 1213.0]",7,16,-9
31206.0,2020-01-17,"(485.186, 689.5]",4,4,0
31206.0,2020-01-17,"(689.5, 893.0]",1,3,-2
31206.0,2020-01-17,"(893.0, 1096.5]",1,2,-1
31207.0,2020-01-17,"(366.058, 602.5]",1,8,-7
31207.0,2020-01-17,"(602.5, 838.0]",2,3,-1
31207.0,2020-01-17,"(838.0, 1073.5]",2,3,-1
31207.0,2020-01-17,"(1073.5, 1309.0]",2,5,-3
31208.0,2020-01-17,"(350.092, 578.0]",7,8,-1
31208.0,2020-01-17,"(578.0, 805.0]",2,3,-1
31208.0,2020-01-17,"(805.0, 1032.0]",3,10,-7
31208.0,2020-01-17,"(1032.0, 1259.0]",3,6,-3
31209.0,2020-01-17,"(854.5, 1045.25]",4,4,0
31209.0,2020-01-17,"(1045.25, 1236.0]",1,4,-3
31211.0,2020-01-17,"(482.329, 650.75]",4,5,-1
31211.0,2020-01-17,"(650.75, 818.5]",1,2,-1
31211.0,2020-01-17,"(818.5, 986.25]",1,3,-2
31211.0,2020-01-17,"(986.25, 1154.0]",2,7,-5
31212.0,2020-01-17,"(350.951, 614.25]",28,43,-15
31212.0,2020-01-17,"(614.25, 876.5]",8,14,-6
31212.0,2020-01-17,"(876.5, 1138.75]",13,29,-16
31212.0,2020-01-17,"(1138.75, 1401.0]",6,14,-8
31213.0,2020-01-17,"(339.933, 607.75]",26,33,-7
31213.0,2020-01-17,"(607.75, 874.5]",6,13,-7
31213.0,2020-01-17,"(874.5, 1141.25]",15,28,-13
31213.0,2020-01-17,"(1141.25, 1408.0]",1,3,-2
31214.0,2020-01-17,"(351.25, 700.5]",8,3,5
31214.0,2020-01-17,"(700.5, 1049.75]",13,28,-15
31214.0,2020-01-17,"(1049.75, 1399.0]",20,25,-5
31215.0,2020-01-17,"(424.043, 664.25]",19,21,-2
31215.0,2020-01-17,"(664.25, 903.5]",6,11,-5
31215.0,2020-01-17,"(903.5, 1142.75]",8,17,-9
31216.0,2020-01-17,"(299.75, 597.5]",17,1,16
31216.0,2020-01-17,"(597.5, 895.25]",7,22,-15
31216.0,2020-01-17,"(895.25, 1193.0]",8,13,-5
31217.0,2020-01-17,"(341.287, 520.25]",4,7,-3
31217.0,2020-01-17,"(520.25, 698.5]",5,6,-1
31217.0,2020-01-17,"(698.5, 876.75]",3,5,-2
31217.0,2020-01-17,"(876.75, 1055.0]",1,10,-9
31218.0,2020-01-17,"(375.95, 639.5]",9,18,-9
31218.0,2020-01-17,"(639.5, 902.0]",2,5,-3
31218.0,2020-01-17,"(902.0, 1164.5]",5,13,-8
31218.0,2020-01-17,"(1164.5, 1427.0]",1,2,-1
31219.0,2020-01-17,"(387.34, 553.0]",5,6,-1
31219.0,2020-01-17,"(553.0, 718.0]",2,2,0
31219.0,2020-01-17,"(718.0, 883.0]",3,6,-3
31219.0,2020-01-17,"(883.0, 1048.0]",5,7,-2
31220.0,2020-01-17,"(442.388, 596.0]",13,14,-1
31220.0,2020-01-17,"(596.0, 749.0]",4,5,-1
31220.0,2020-01-17,"(749.0, 902.0]",1,3,-2
31220.0,2020-01-17,"(902.0, 1055.0]",1,15,-14
31221.0,2020-01-17,"(378.75, 661.5]",31,1,30
31221.0,2020-01-17,"(661.5, 944.25]",6,36,-30
31221.0,2020-01-17,"(944.25, 1227.0]",11,17,-6
31222.0,2020-01-17,"(491.067, 725.25]",14,15,-1
31222.0,2020-01-17,"(725.25, 958.5]",8,17,-9
31222.0,2020-01-17,"(958.5, 1191.75]",9,20,-11
31222.0,2020-01-17,"(1191.75, 1425.0]",1,4,-3
31223.0,2020-01-17,"(345.0, 670.0]",14,3,11
31223.0,2020-01-17,"(670.0, 995.0]",7,33,-26
31223.0,2020-01-17,"(995.0, 1320.0]",18,11,7
31224.0,2020-01-17,"(481.339, 647.25]",10,12,-2
31224.0,2020-01-17,"(647.25, 812.5]",8,8,0
31224.0,2020-01-17,"(812.5, 977.75]",2,4,-2
31224.0,2020-01-17,"(977.75, 1143.0]",3,9,-6
31225.0,2020-01-17,"(428.24, 619.0]",7,13,-6
31225.0,2020-01-17,"(619.0, 809.0]",3,5,-2
31225.0,2020-01-17,"(809.0, 999.0]",7,11,-4
31225.0,2020-01-17,"(999.0, 1189.0]",7,12,-5
31226.0,2020-01-17,"(363.157, 574.75]",6,11,-5
31226.0,2020-01-17,"(785.5, 996.25]",1,2,-1
31226.0,2020-01-17,"(996.25, 1207.0]",4,4,0
31227.0,2020-01-17,"(448.224, 643.0]",26,30,-4
31227.0,2020-01-17,"(643.0, 837.0]",4,8,-4
31227.0,2020-01-17,"(837.0, 1031.0]",2,6,-4
31227.0,2020-01-17,"(1031.0, 1225.0]",6,16,-10
31228.0,2020-01-17,"(351.955, 614.25]",12,18,-6
31228.0,2020-01-17,"(614.25, 875.5]",8,16,-8
31228.0,2020-01-17,"(875.5, 1136.75]",15,29,-14
31228.0,2020-01-17,"(1136.75, 1398.0]",7,16,-9
31229.0,2020-01-17,"(155.729, 474.75]",6,19,-13
31229.0,2020-01-17,"(474.75, 792.5]",7,43,-36
31229.0,2020-01-17,"(792.5, 1110.25]",39,56,-17
31229.0,2020-01-17,"(1110.25, 1428.0]",12,27,-15
31230.0,2020-01-17,"(331.131, 549.25]",34,37,-3
31230.0,2020-01-17,"(549.25, 766.5]",13,16,-3
31230.0,2020-01-17,"(766.5, 983.75]",6,9,-3
31230.0,2020-01-17,"(983.75, 1201.0]",8,28,-20
31231.0,2020-01-17,"(414.351, 577.25]",11,13,-2
31231.0,2020-01-17,"(577.25, 739.5]",2,6,-4
31231.0,2020-01-17,"(739.5, 901.75]",5,7,-2
31231.0,2020-01-17,"(901.75, 1064.0]",5,11,-6
31232.0,2020-01-17,"(286.858, 573.5]",13,17,-4
31232.0,2020-01-17,"(573.5, 859.0]",11,24,-13
31232.0,2020-01-17,"(859.0, 1144.5]",14,26,-12
31232.0,2020-01-17,"(1144.5, 1430.0]",2,6,-4
31233.0,2020-01-17,"(-1.401, 350.25]",2,2,0
31233.0,2020-01-17,"(350.25, 700.5]",42,50,-8
31233.0,2020-01-17,"(700.5, 1050.75]",20,26,-6
31233.0,2020-01-17,"(1050.75, 1401.0]",6,20,-14
31234.0,2020-01-17,"(384.0, 635.0]",12,18,-6
31234.0,2020-01-17,"(635.0, 885.0]",10,15,-5
31234.0,2020-01-17,"(885.0, 1135.0]",16,22,-6
31234.0,2020-01-17,"(1135.0, 1385.0]",2,6,-4
31235.0,2020-01-17,"(564.354, 726.5]",1,1,0
31235.0,2020-01-17,"(726.5, 888.0]",2,2,0
31236.0,2020-01-17,"(479.113, 701.75]",13,15,-2
31236.0,2020-01-17,"(701.75, 923.5]",6,11,-5
31236.0,2020-01-17,"(923.5, 1145.25]",5,21,-16
31236.0,2020-01-17,"(1145.25, 1367.0]",2,9,-7
31237.0,2020-01-17,"(381.944, 647.0]",1,10,-9
31237.0,2020-01-17,"(647.0, 911.0]",9,18,-9
31237.0,2020-01-17,"(911.0, 1175.0]",14,23,-9
31237.0,2020-01-17,"(1175.0, 1439.0]",6,13,-7
31238.0,2020-01-17,"(47.872, 331.0]",1,1,0
31238.0,2020-01-17,"(331.0, 613.0]",9,12,-3
31238.0,2020-01-17,"(613.0, 895.0]",6,10,-4
31238.0,2020-01-17,"(895.0, 1177.0]",4,18,-14
31239.0,2020-01-17,"(151.73, 470.5]",4,6,-2
31239.0,2020-01-17,"(470.5, 788.0]",22,27,-5
31239.0,2020-01-17,"(788.0, 1105.5]",11,25,-14
31239.0,2020-01-17,"(1105.5, 1423.0]",4,13,-9
31240.0,2020-01-17,"(1016.5, 1091.0]",3,1,2
31241.0,2020-01-17,"(110.707, 435.25]",5,8,-3
31241.0,2020-01-17,"(435.25, 758.5]",21,54,-33
31241.0,2020-01-17,"(758.5, 1081.75]",10,23,-13
31241.0,2020-01-17,"(1081.75, 1405.0]",10,24,-14
31242.0,2020-01-17,"(607.374, 764.5]",4,9,-5
31242.0,2020-01-17,"(764.5, 921.0]",2,8,-6
31242.0,2020-01-17,"(1077.5, 1234.0]",2,11,-9
31243.0,2020-01-17,"(384.983, 640.25]",21,27,-6
31243.0,2020-01-17,"(640.25, 894.5]",1,3,-2
31243.0,2020-01-17,"(894.5, 1148.75]",8,23,-15
31243.0,2020-01-17,"(1148.75, 1403.0]",1,2,-1
31244.0,2020-01-17,"(355.5, 705.0]",14,2,12
31244.0,2020-01-17,"(705.0, 1054.5]",7,21,-14
31244.0,2020-01-17,"(1054.5, 1404.0]",5,15,-10
31245.0,2020-01-17,"(403.995, 656.25]",11,18,-7
31245.0,2020-01-17,"(656.25, 907.5]",4,7,-3
31245.0,2020-01-17,"(907.5, 1158.75]",4,13,-9
31245.0,2020-01-17,"(1158.75, 1410.0]",7,10,-3
31246.0,2020-01-17,"(415.102, 640.5]",7,13,-6
31246.0,2020-01-17,"(640.5, 865.0]",14,21,-7
31246.0,2020-01-17,"(865.0, 1089.5]",11,23,-12
31246.0,2020-01-17,"(1089.5, 1314.0]",7,12,-5
31247.0,2020-01-17,"(434.326, 603.5]",12,22,-10
31247.0,2020-01-17,"(603.5, 772.0]",10,19,-9
31247.0,2020-01-17,"(772.0, 940.5]",10,18,-8
31247.0,2020-01-17,"(940.5, 1109.0]",10,19,-9
31248.0,2020-01-17,"(393.148, 607.0]",3,5,-2
31248.0,2020-01-17,"(607.0, 820.0]",8,16,-8
31248.0,2020-01-17,"(820.0, 1033.0]",18,26,-8
31248.0,2020-01-17,"(1033.0, 1246.0]",4,11,-7
31249.0,2020-01-17,"(440.38, 596.0]",1,1,0
31249.0,2020-01-17,"(751.0, 906.0]",1,2,-1
31249.0,2020-01-17,"(906.0, 1061.0]",4,9,-5
31250.0,2020-01-17,"(116.678, 448.5]",2,3,-1
31250.0,2020-01-17,"(448.5, 779.0]",17,24,-7
31250.0,2020-01-17,"(779.0, 1109.5]",8,24,-16
31250.0,2020-01-17,"(1109.5, 1440.0]",4,7,-3
31251.0,2020-01-17,"(463.05, 701.5]",11,29,-18
31251.0,2020-01-17,"(701.5, 939.0]",4,11,-7
31251.0,2020-01-17,"(939.0, 1176.5]",3,12,-9
31251.0,2020-01-17,"(1176.5, 1414.0]",3,4,-1
31252.0,2020-01-17,"(390.198, 591.5]",17,18,-1
31252.0,2020-01-17,"(591.5, 792.0]",2,4,-2
31252.0,2020-01-17,"(792.0, 992.5]",1,3,-2
31252.0,2020-01-17,"(992.5, 1193.0]",4,23,-19
31253.0,2020-01-17,"(318.005, 567.75]",12,14,-2
31253.0,2020-01-17,"(567.75, 816.5]",11,14,-3
31253.0,2020-01-17,"(816.5, 1065.25]",1,9,-8
31253.0,2020-01-17,"(1065.25, 1314.0]",2,9,-7
31254.0,2020-01-17,"(432.208, 631.0]",17,22,-5
31254.0,2020-01-17,"(631.0, 829.0]",1,7,-6
31254.0,2020-01-17,"(829.0, 1027.0]",3,7,-4
31254.0,2020-01-17,"(1027.0, 1225.0]",4,14,-10
31255.0,2020-01-17,"(182.82, 479.0]",3,8,-5
31255.0,2020-01-17,"(479.0, 774.0]",9,17,-8
31255.0,2020-01-17,"(774.0, 1069.0]",7,15,-8
31255.0,2020-01-17,"(1069.0, 1364.0]",3,9,-6
31256.0,2020-01-17,"(271.99, 525.5]",10,10,0
31256.0,2020-01-17,"(525.5, 778.0]",3,7,-4
31256.0,2020-01-17,"(778.0, 1030.5]",7,18,-11
31256.0,2020-01-17,"(1030.5, 1283.0]",5,9,-4
31257.0,2020-01-17,"(72.713, 395.75]",1,2,-1
31257.0,2020-01-17,"(395.75, 717.5]",16,32,-16
31257.0,2020-01-17,"(717.5, 1039.25]",15,31,-16
31257.0,2020-01-17,"(1039.25, 1361.0]",12,35,-23
31258.0,2020-01-17,"(28.602, 379.5]",1,2,-1
31258.0,2020-01-17,"(379.5, 729.0]",7,18,-11
31258.0,2020-01-17,"(729.0, 1078.5]",24,54,-30
31258.0,2020-01-17,"(1078.5, 1428.0]",1,2,-1
31259.0,2020-01-17,"(389.262, 574.5]",10,10,0
31259.0,2020-01-17,"(574.5, 759.0]",1,2,-1
31259.0,2020-01-17,"(759.0, 943.5]",1,2,-1
31260.0,2020-01-17,"(370.187, 574.25]",16,19,-3
31260.0,2020-01-17,"(777.5, 980.75]",3,7,-4
31260.0,2020-01-17,"(980.75, 1184.0]",2,15,-13
31261.0,2020-01-17,"(390.329, 558.75]",7,7,0
31261.0,2020-01-17,"(558.75, 726.5]",1,1,0
31261.0,2020-01-17,"(726.5, 894.25]",4,9,-5
31262.0,2020-01-17,"(420.282, 600.5]",6,6,0
31262.0,2020-01-17,"(600.5, 780.0]",2,5,-3
31262.0,2020-01-17,"(780.0, 959.5]",2,6,-4
31262.0,2020-01-17,"(959.5, 1139.0]",2,6,-4
31263.0,2020-01-17,"(405.036, 647.0]",15,23,-8
31263.0,2020-01-17,"(647.0, 888.0]",6,9,-3
31263.0,2020-01-17,"(888.0, 1129.0]",8,18,-10
31263.0,2020-01-17,"(1129.0, 1370.0]",4,5,-1
31264.0,2020-01-17,"(354.059, 590.25]",8,11,-3
31264.0,2020-01-17,"(590.25, 825.5]",2,4,-2
31264.0,2020-01-17,"(825.5, 1060.75]",5,12,-7
31264.0,2020-01-17,"(1060.75, 1296.0]",4,11,-7
31265.0,2020-01-17,"(4.597, 356.75]",2,2,0
31265.0,2020-01-17,"(356.75, 707.5]",15,40,-25
31265.0,2020-01-17,"(707.5, 1058.25]",19,37,-18
31265.0,2020-01-17,"(1058.25, 1409.0]",17,24,-7
31266.0,2020-01-17,"(3.627, 348.25]",2,7,-5
31266.0,2020-01-17,"(348.25, 691.5]",5,20,-15
31266.0,2020-01-17,"(691.5, 1034.75]",12,23,-11
31266.0,2020-01-17,"(1034.75, 1378.0]",11,25,-14
31267.0,2020-01-17,"(8.663, 344.25]",2,2,0
31267.0,2020-01-17,"(344.25, 678.5]",11,23,-12
31267.0,2020-01-17,"(678.5, 1012.75]",11,22,-11
31267.0,2020-01-17,"(1012.75, 1347.0]",13,19,-6
31268.0,2020-01-17,"(16.594, 369.5]",2,4,-2
31268.0,2020-01-17,"(369.5, 721.0]",22,51,-29
31268.0,2020-01-17,"(721.0, 1072.5]",14,28,-14
31268.0,2020-01-17,"(1072.5, 1424.0]",17,26,-9
31269.0,2020-01-17,"(345.915, 618.25]",6,12,-6
31269.0,2020-01-17,"(618.25, 889.5]",17,32,-15
31269.0,2020-01-17,"(889.5, 1160.75]",9,18,-9
31269.0,2020-01-17,"(1160.75, 1432.0]",2,7,-5
31270.0,2020-01-17,"(432.062, 667.5]",11,18,-7
31270.0,2020-01-17,"(667.5, 902.0]",5,7,-2
31270.0,2020-01-17,"(902.0, 1136.5]",9,17,-8
31270.0,2020-01-17,"(1136.5, 1371.0]",2,3,-1
31271.0,2020-01-17,"(412.032, 655.0]",9,11,-2
31271.0,2020-01-17,"(655.0, 897.0]",9,18,-9
31271.0,2020-01-17,"(897.0, 1139.0]",8,22,-14
31271.0,2020-01-17,"(1139.0, 1381.0]",1,2,-1
31272.0,2020-01-17,"(50.835, 343.25]",2,2,0
31272.0,2020-01-17,"(343.25, 634.5]",19,21,-2
31272.0,2020-01-17,"(634.5, 925.75]",12,16,-4
31272.0,2020-01-17,"(925.75, 1217.0]",3,24,-21
31273.0,2020-01-17,"(415.391, 568.25]",1,6,-5
31273.0,2020-01-17,"(720.5, 872.75]",2,2,0
31273.0,2020-01-17,"(872.75, 1025.0]",2,2,0
31274.0,2020-01-17,"(415.179, 621.25]",10,12,-2
31274.0,2020-01-17,"(621.25, 826.5]",4,5,-1
31274.0,2020-01-17,"(826.5, 1031.75]",1,4,-3
31274.0,2020-01-17,"(1031.75, 1237.0]",2,7,-5
31275.0,2020-01-17,"(41.654, 379.5]",3,4,-1
31275.0,2020-01-17,"(379.5, 716.0]",11,25,-14
31275.0,2020-01-17,"(716.0, 1052.5]",8,20,-12
31275.0,2020-01-17,"(1052.5, 1389.0]",15,25,-10
31276.0,2020-01-17,"(464.057, 700.75]",18,22,-4
31276.0,2020-01-17,"(700.75, 936.5]",5,12,-7
31276.0,2020-01-17,"(936.5, 1172.25]",5,22,-17
31276.0,2020-01-17,"(1172.25, 1408.0]",1,2,-1
31277.0,2020-01-17,"(410.997, 662.75]",32,35,-3
31277.0,2020-01-17,"(662.75, 913.5]",9,18,-9
31277.0,2020-01-17,"(913.5, 1164.25]",8,26,-18
31278.0,2020-01-17,"(146.801, 447.75]",1,5,-4
31278.0,2020-01-17,"(447.75, 747.5]",9,26,-17
31278.0,2020-01-17,"(747.5, 1047.25]",8,16,-8
31278.0,2020-01-17,"(1047.25, 1347.0]",19,28,-9
31279.0,2020-01-17,"(428.195, 630.25]",23,24,-1
31279.0,2020-01-17,"(630.25, 831.5]",5,12,-7
31279.0,2020-01-17,"(831.5, 1032.75]",4,11,-7
31279.0,2020-01-17,"(1032.75, 1234.0]",2,12,-10
31280.0,2020-01-17,"(387.015, 634.25]",5,16,-11
31280.0,2020-01-17,"(634.25, 880.5]",1,4,-3
31280.0,2020-01-17,"(880.5, 1126.75]",7,10,-3
31280.0,2020-01-17,"(1126.75, 1373.0]",5,10,-5
31000.0,2020-01-18,"(445.5, 668.25]",1,1,0
31000.0,2020-01-18,"(668.25, 891.0]",1,1,0
,,,,1.0,
,,,,1.0,
31002.0,2020-01-18,"(658.546, 772.5]",1,2,-1
31002.0,2020-01-18,"(772.5, 886.0]",1,1,0
31002.0,2020-01-18,"(886.0, 999.5]",1,1,0
31002.0,2020-01-18,"(999.5, 1113.0]",1,1,0
,,,,2.0,
,,,,2.0,
31005.0,2020-01-18,"(682.898, 708.5]",1,1,0
31005.0,2020-01-18,"(708.5, 734.0]",1,1,0
31006.0,2020-01-18,"(1080.0, 1089.0]",1,1,0
31007.0,2020-01-18,"(479.07, 712.5]",2,3,-1
31009.0,2020-01-18,"(619.867, 653.25]",1,1,0
31010.0,2020-01-18,"(1435.75, 1438.0]",1,1,0
31011.0,2020-01-18,"(422.85, 460.5]",1,1,0
,,,,2.0,
31013.0,2020-01-18,"(562.151, 775.25]",3,5,-2
31013.0,2020-01-18,"(987.5, 1199.75]",1,1,0
31013.0,2020-01-18,"(1199.75, 1412.0]",1,1,0
31014.0,2020-01-18,"(398.25, 674.5]",3,1,2
31014.0,2020-01-18,"(674.5, 950.75]",3,4,-1
31014.0,2020-01-18,"(950.75, 1227.0]",1,3,-2
31015.0,2020-01-18,"(554.294, 731.5]",1,1,0
31015.0,2020-01-18,"(908.0, 1084.5]",1,1,0
31016.0,2020-01-18,"(552.218, 748.5]",2,3,-1
31016.0,2020-01-18,"(748.5, 944.0]",1,1,0
31016.0,2020-01-18,"(1139.5, 1335.0]",1,1,0
31017.0,2020-01-18,"(565.234, 757.5]",1,2,-1
31017.0,2020-01-18,"(1140.5, 1332.0]",1,2,-1
,,,,2.0,
31019.0,2020-01-18,"(633.299, 809.25]",2,3,-1
31019.0,2020-01-18,"(809.25, 984.5]",1,2,-1
,,,,2.0,
31021.0,2020-01-18,"(835.521, 955.75]",1,2,-1
31021.0,2020-01-18,"(1195.25, 1315.0]",1,2,-1
31022.0,2020-01-18,"(586.593, 688.75]",1,1,0
31022.0,2020-01-18,"(790.5, 892.25]",1,1,0
,,,,2.0,
,,,,1.0,
31024.0,2020-01-18,"(111.822, 407.5]",2,2,0
,,,,2.0,
31026.0,2020-01-18,"(638.0, 903.5]",1,2,-1
31027.0,2020-01-18,"(64.413, 211.75]",2,2,0
31028.0,2020-01-18,"(836.75, 845.0]",1,1,0
31029.0,2020-01-18,"(721.75, 847.5]",1,2,-1
31029.0,2020-01-18,"(973.25, 1099.0]",1,1,0
31030.0,2020-01-18,"(740.5, 943.0]",1,4,-3
31030.0,2020-01-18,"(1145.5, 1348.0]",1,1,0
31031.0,2020-01-18,"(635.273, 817.75]",1,3,-2
31031.0,2020-01-18,"(1181.25, 1363.0]",1,1,0
,,,,2.0,
31033.0,2020-01-18,"(670.75, 692.0]",1,1,0
31034.0,2020-01-18,"(700.25, 916.0]",1,1,0
,,,,1.0,
,,,,2.0,
31036.0,2020-01-18,"(721.0, 775.0]",1,1,0
31037.0,2020-01-18,"(762.759, 823.25]",1,2,-1
31037.0,2020-01-18,"(883.5, 943.75]",1,1,0
31038.0,2020-01-18,"(558.56, 669.0]",1,2,-1
31038.0,2020-01-18,"(669.0, 779.0]",1,1,0
31038.0,2020-01-18,"(889.0, 999.0]",1,1,0
31039.0,2020-01-18,"(543.158, 754.5]",2,3,-1
31039.0,2020-01-18,"(965.0, 1175.5]",1,1,0
,,,,1.0,
,,,,1.0,
,,,,2.0,
31042.0,2020-01-18,"(534.788, 588.0]",1,1,0
31043.0,2020-01-18,"(638.761, 698.75]",1,2,-1
31043.0,2020-01-18,"(818.25, 878.0]",1,2,-1
31044.0,2020-01-18,"(722.792, 775.0]",1,1,0
31044.0,2020-01-18,"(879.0, 931.0]",1,1,0
,,,,2.0,
,,,,1.0,
,,,,2.0,
31047.0,2020-01-18,"(492.217, 688.75]",2,4,-2
31047.0,2020-01-18,"(1080.25, 1276.0]",3,1,2
,,,,1.0,
,,,,1.0,
31049.0,2020-01-18,"(1104.25, 1219.0]",1,1,0
31050.0,2020-01-18,"(954.0, 1272.0]",2,1,1
,,,,2.0,
31052.0,2020-01-18,"(699.75, 933.0]",1,1,0
,,,,2.0,
,,,,2.0,
,,,,2.0,
31056.0,2020-01-18,"(644.5, 695.0]",1,1,0
,,,,2.0,
31058.0,2020-01-18,"(195.25, 215.0]",1,1,0
31059.0,2020-01-18,"(537.838, 578.5]",1,1,0
31059.0,2020-01-18,"(659.5, 700.0]",1,1,0
31060.0,2020-01-18,"(501.808, 550.0]",2,2,0
31060.0,2020-01-18,"(598.0, 646.0]",1,1,0
31061.0,2020-01-18,"(462.75, 617.0]",1,1,0
31062.0,2020-01-18,"(518.781, 573.75]",2,2,0
31062.0,2020-01-18,"(573.75, 628.5]",2,3,-1
31062.0,2020-01-18,"(628.5, 683.25]",1,1,0
,,,,2.0,
31064.0,2020-01-18,"(584.651, 672.25]",2,4,-2
31064.0,2020-01-18,"(672.25, 759.5]",2,4,-2
31065.0,2020-01-18,"(882.0, 1176.0]",1,1,0
,,,,2.0,
31067.0,2020-01-18,"(140.525, 259.75]",1,2,-1
,,,,2.0,
,,,,1.0,
,,,,1.0,
31070.0,2020-01-18,"(585.889, 613.75]",1,3,-2
31070.0,2020-01-18,"(613.75, 641.5]",1,1,0
31070.0,2020-01-18,"(669.25, 697.0]",1,1,0
31071.0,2020-01-18,"(415.323, 585.25]",1,2,-1
31071.0,2020-01-18,"(754.5, 923.75]",1,3,-2
31071.0,2020-01-18,"(923.75, 1093.0]",2,1,1
,,,,2.0,
,,,,1.0,
,,,,1.0,
,,,,1.0,
,,,,1.0,
31075.0,2020-01-18,"(659.25, 879.0]",1,1,0
31076.0,2020-01-18,"(561.75, 752.5]",1,1,0
31076.0,2020-01-18,"(943.25, 1134.0]",1,1,0
,,,,1.0,
,,,,1.0,
,,,,2.0,
,,,,2.0,
31079.0,2020-01-18,"(790.75, 935.5]",1,3,-2
31079.0,2020-01-18,"(935.5, 1080.25]",1,3,-2
31080.0,2020-01-18,"(574.232, 767.0]",2,3,-1
31080.0,2020-01-18,"(1151.0, 1343.0]",1,1,0
,,,,2.0,
,,,,1.0,
,,,,1.0,
,,,,1.0,
,,,,1.0,
31084.0,2020-01-18,"(666.75, 889.0]",1,1,0
31085.0,2020-01-18,"(471.75, 629.0]",2,1,1
31086.0,2020-01-18,"(721.0, 753.0]",1,1,0
,,,,2.0,
,,,,2.0,
31089.0,2020-01-18,"(544.208, 743.0]",1,2,-1
31089.0,2020-01-18,"(941.0, 1139.0]",1,1,0
31089.0,2020-01-18,"(1139.0, 1337.0]",1,1,0
,,,,2.0,
31091.0,2020-01-18,"(12.294, 189.5]",1,1,0
31092.0,2020-01-18,"(111.0, 148.0]",1,1,0
,,,,2.0,
31094.0,2020-01-18,"(952.25, 1001.0]",1,1,0
,,,,2.0,
31096.0,2020-01-18,"(582.5, 608.75]",1,1,0
31096.0,2020-01-18,"(608.75, 635.0]",1,1,0
31097.0,2020-01-18,"(498.747, 562.25]",1,1,0
31097.0,2020-01-18,"(562.25, 625.5]",1,2,-1
31097.0,2020-01-18,"(688.75, 752.0]",1,2,-1
31098.0,2020-01-18,"(708.5, 743.0]",1,1,0
31099.0,2020-01-18,"(495.086, 724.5]",2,3,-1
31099.0,2020-01-18,"(1181.5, 1410.0]",1,2,-1
31100.0,2020-01-18,"(604.692, 682.0]",1,1,0
31100.0,2020-01-18,"(682.0, 759.0]",2,2,0
31100.0,2020-01-18,"(836.0, 913.0]",1,2,-1
31101.0,2020-01-18,"(5.594, 358.5]",2,8,-6
31101.0,2020-01-18,"(358.5, 710.0]",11,17,-6
31101.0,2020-01-18,"(710.0, 1061.5]",16,30,-14
31101.0,2020-01-18,"(1061.5, 1413.0]",11,18,-7
31102.0,2020-01-18,"(55.937, 322.75]",1,6,-5
31102.0,2020-01-18,"(322.75, 588.5]",1,2,-1
31102.0,2020-01-18,"(588.5, 854.25]",2,4,-2
31102.0,2020-01-18,"(854.25, 1120.0]",1,4,-3
31103.0,2020-01-18,"(477.051, 715.25]",4,14,-10
31103.0,2020-01-18,"(715.25, 952.5]",6,13,-7
31103.0,2020-01-18,"(952.5, 1189.75]",1,4,-3
31103.0,2020-01-18,"(1189.75, 1427.0]",1,4,-3
31104.0,2020-01-18,"(29.677, 361.75]",1,3,-2
31104.0,2020-01-18,"(361.75, 692.5]",6,18,-12
31104.0,2020-01-18,"(692.5, 1023.25]",4,7,-3
31104.0,2020-01-18,"(1023.25, 1354.0]",6,9,-3
,,,,2.0,
,,,,2.0,
,,,,1.0,
,,,,2.0,
31106.0,2020-01-18,"(1048.5, 1398.0]",2,1,1
31107.0,2020-01-18,"(345.915, 618.25]",2,6,-4
31107.0,2020-01-18,"(618.25, 889.5]",3,14,-11
31107.0,2020-01-18,"(889.5, 1160.75]",2,5,-3
31107.0,2020-01-18,"(1160.75, 1432.0]",7,9,-2
31108.0,2020-01-18,"(33.625, 378.75]",2,2,0
31108.0,2020-01-18,"(378.75, 722.5]",2,9,-7
31108.0,2020-01-18,"(722.5, 1066.25]",2,6,-4
31108.0,2020-01-18,"(1066.25, 1410.0]",5,5,0
31109.0,2020-01-18,"(2.59, 356.5]",3,8,-5
31109.0,2020-01-18,"(356.5, 709.0]",1,7,-6
31109.0,2020-01-18,"(709.0, 1061.5]",3,4,-1
31109.0,2020-01-18,"(1061.5, 1414.0]",9,14,-5
31110.0,2020-01-18,"(466.149, 679.75]",11,21,-10
31110.0,2020-01-18,"(679.75, 892.5]",9,16,-7
31110.0,2020-01-18,"(892.5, 1105.25]",2,2,0
31110.0,2020-01-18,"(1105.25, 1318.0]",1,4,-3
31111.0,2020-01-18,"(30.629, 374.75]",1,3,-2
31111.0,2020-01-18,"(374.75, 717.5]",5,12,-7
31111.0,2020-01-18,"(717.5, 1060.25]",6,14,-8
31111.0,2020-01-18,"(1060.25, 1403.0]",8,14,-6
,,,,2.0,
31113.0,2020-01-18,"(0.646, 340.5]",1,3,-2
31113.0,2020-01-18,"(340.5, 679.0]",3,7,-4
31113.0,2020-01-18,"(679.0, 1017.5]",1,6,-5
31113.0,2020-01-18,"(1017.5, 1356.0]",2,9,-7
31114.0,2020-01-18,"(7.602, 358.5]",3,5,-2
31114.0,2020-01-18,"(358.5, 708.0]",2,13,-11
31114.0,2020-01-18,"(708.0, 1057.5]",5,10,-5
31114.0,2020-01-18,"(1057.5, 1407.0]",4,9,-5
31115.0,2020-01-18,"(23.807, 323.25]",2,3,-1
31115.0,2020-01-18,"(323.25, 621.5]",2,12,-10
31115.0,2020-01-18,"(621.5, 919.75]",2,6,-4
31115.0,2020-01-18,"(919.75, 1218.0]",2,6,-4
31116.0,2020-01-18,"(21.68, 353.0]",3,5,-2
31116.0,2020-01-18,"(353.0, 683.0]",6,13,-7
31116.0,2020-01-18,"(683.0, 1013.0]",4,8,-4
31116.0,2020-01-18,"(1013.0, 1343.0]",2,5,-3
31117.0,2020-01-18,"(380.0, 726.0]",2,2,0
31117.0,2020-01-18,"(726.0, 1072.0]",4,18,-14
31117.0,2020-01-18,"(1072.0, 1418.0]",2,8,-6
31118.0,2020-01-18,"(375.026, 619.5]",1,3,-2
31118.0,2020-01-18,"(863.0, 1106.5]",1,2,-1
31118.0,2020-01-18,"(1106.5, 1350.0]",2,2,0
31119.0,2020-01-18,"(16.595, 369.25]",1,2,-1
31119.0,2020-01-18,"(369.25, 720.5]",5,11,-6
31119.0,2020-01-18,"(720.5, 1071.75]",6,11,-5
31119.0,2020-01-18,"(1071.75, 1423.0]",3,5,-2
31120.0,2020-01-18,"(401.021, 646.75]",1,5,-4
31120.0,2020-01-18,"(646.75, 891.5]",6,10,-4
31120.0,2020-01-18,"(891.5, 1136.25]",1,2,-1
31120.0,2020-01-18,"(1136.25, 1381.0]",3,4,-1
31121.0,2020-01-18,"(543.75, 683.5]",2,2,0
31121.0,2020-01-18,"(683.5, 823.25]",1,4,-3
31121.0,2020-01-18,"(823.25, 963.0]",1,2,-1
31122.0,2020-01-18,"(254.829, 548.75]",2,4,-2
31122.0,2020-01-18,"(548.75, 841.5]",4,7,-3
31122.0,2020-01-18,"(841.5, 1134.25]",1,2,-1
31122.0,2020-01-18,"(1134.25, 1427.0]",1,4,-3
31123.0,2020-01-18,"(393.009, 641.75]",1,4,-3
31123.0,2020-01-18,"(641.75, 889.5]",3,5,-2
31123.0,2020-01-18,"(889.5, 1137.25]",1,2,-1
31123.0,2020-01-18,"(1137.25, 1385.0]",1,2,-1
31124.0,2020-01-18,"(506.092, 734.0]",8,28,-20
31124.0,2020-01-18,"(734.0, 961.0]",3,11,-8
31124.0,2020-01-18,"(961.0, 1188.0]",3,6,-3
31124.0,2020-01-18,"(1188.0, 1415.0]",1,9,-8
31125.0,2020-01-18,"(5.694, 333.5]",1,1,0
31125.0,2020-01-18,"(333.5, 660.0]",3,9,-6
31125.0,2020-01-18,"(660.0, 986.5]",11,15,-4
31125.0,2020-01-18,"(986.5, 1313.0]",3,5,-2
31126.0,2020-01-18,"(40.607, 390.25]",3,5,-2
31126.0,2020-01-18,"(390.25, 738.5]",1,13,-12
31126.0,2020-01-18,"(738.5, 1086.75]",4,10,-6
31126.0,2020-01-18,"(1086.75, 1435.0]",4,10,-6
,,,,2.0,
31128.0,2020-01-18,"(35.643, 376.25]",1,3,-2
31128.0,2020-01-18,"(376.25, 715.5]",6,11,-5
31128.0,2020-01-18,"(715.5, 1054.75]",5,12,-7
31128.0,2020-01-18,"(1054.75, 1394.0]",4,7,-3
31129.0,2020-01-18,"(0.766, 310.5]",2,2,0
31129.0,2020-01-18,"(310.5, 619.0]",3,3,0
31129.0,2020-01-18,"(619.0, 927.5]",7,13,-6
31129.0,2020-01-18,"(927.5, 1236.0]",1,1,0
31130.0,2020-01-18,"(551.139, 767.25]",1,8,-7
31130.0,2020-01-18,"(982.5, 1197.75]",2,2,0
31130.0,2020-01-18,"(1197.75, 1413.0]",3,2,1
31131.0,2020-01-18,"(487.053, 724.75]",2,5,-3
31131.0,2020-01-18,"(724.75, 961.5]",1,1,0
31131.0,2020-01-18,"(961.5, 1198.25]",2,5,-3
31131.0,2020-01-18,"(1198.25, 1435.0]",1,3,-2
31200.0,2020-01-18,"(15.7, 342.0]",3,7,-4
31200.0,2020-01-18,"(342.0, 667.0]",5,6,-1
31200.0,2020-01-18,"(667.0, 992.0]",14,16,-2
31200.0,2020-01-18,"(992.0, 1317.0]",2,6,-4
31201.0,2020-01-18,"(21.689, 350.75]",2,3,-1
31201.0,2020-01-18,"(350.75, 678.5]",17,26,-9
31201.0,2020-01-18,"(678.5, 1006.25]",5,16,-11
31201.0,2020-01-18,"(1006.25, 1334.0]",8,18,-10
31202.0,2020-01-18,"(62.625, 407.75]",1,3,-2
31202.0,2020-01-18,"(407.75, 751.5]",10,16,-6
31202.0,2020-01-18,"(751.5, 1095.25]",6,10,-4
31202.0,2020-01-18,"(1095.25, 1439.0]",3,7,-4
31203.0,2020-01-18,"(7.596, 360.0]",2,4,-2
31203.0,2020-01-18,"(360.0, 711.0]",12,22,-10
31203.0,2020-01-18,"(711.0, 1062.0]",9,13,-4
31203.0,2020-01-18,"(1062.0, 1413.0]",9,20,-11
31204.0,2020-01-18,"(6.841, 297.75]",2,2,0
31204.0,2020-01-18,"(297.75, 587.5]",1,2,-1
31204.0,2020-01-18,"(587.5, 877.25]",5,7,-2
31204.0,2020-01-18,"(877.25, 1167.0]",4,9,-5
31205.0,2020-01-18,"(416.054, 653.5]",4,5,-1
31205.0,2020-01-18,"(653.5, 890.0]",3,7,-4
31205.0,2020-01-18,"(890.0, 1126.5]",1,2,-1
,,,,2.0,
,,,,1.0,
,,,,1.0,
31208.0,2020-01-18,"(479.043, 719.25]",2,3,-1
31208.0,2020-01-18,"(719.25, 958.5]",1,1,0
31209.0,2020-01-18,"(536.361, 696.75]",1,2,-1
31209.0,2020-01-18,"(696.75, 856.5]",2,2,0
31209.0,2020-01-18,"(856.5, 1016.25]",1,1,0
31211.0,2020-01-18,"(753.398, 904.5]",1,3,-2
31211.0,2020-01-18,"(1055.0, 1205.5]",1,1,0
31211.0,2020-01-18,"(1205.5, 1356.0]",1,1,0
31212.0,2020-01-18,"(107.784, 413.0]",2,3,-1
31212.0,2020-01-18,"(413.0, 717.0]",7,15,-8
31212.0,2020-01-18,"(717.0, 1021.0]",9,15,-6
31212.0,2020-01-18,"(1021.0, 1325.0]",2,2,0
31213.0,2020-01-18,"(125.908, 400.0]",2,4,-2
31213.0,2020-01-18,"(400.0, 673.0]",4,6,-2
31213.0,2020-01-18,"(673.0, 946.0]",2,4,-2
31213.0,2020-01-18,"(946.0, 1219.0]",1,2,-1
31214.0,2020-01-18,"(15.642, 356.5]",2,3,-1
31214.0,2020-01-18,"(356.5, 696.0]",6,14,-8
31214.0,2020-01-18,"(696.0, 1035.5]",15,25,-10
31214.0,2020-01-18,"(1035.5, 1375.0]",9,18,-9
31215.0,2020-01-18,"(745.672, 828.0]",1,3,-2
31215.0,2020-01-18,"(828.0, 910.0]",1,1,0
31215.0,2020-01-18,"(992.0, 1074.0]",1,1,0
31216.0,2020-01-18,"(404.993, 657.75]",3,3,0
31216.0,2020-01-18,"(657.75, 909.5]",1,2,-1
31216.0,2020-01-18,"(909.5, 1161.25]",1,1,0
31216.0,2020-01-18,"(1161.25, 1413.0]",1,3,-2
31217.0,2020-01-18,"(539.214, 736.5]",1,7,-6
31217.0,2020-01-18,"(736.5, 933.0]",1,1,0
31217.0,2020-01-18,"(933.0, 1129.5]",1,2,-1
31217.0,2020-01-18,"(1129.5, 1326.0]",2,2,0
31218.0,2020-01-18,"(377.25, 565.5]",1,2,-1
31218.0,2020-01-18,"(753.0, 940.5]",3,2,1
31219.0,2020-01-18,"(650.725, 719.75]",5,8,-3
31219.0,2020-01-18,"(788.5, 857.25]",2,3,-1
31220.0,2020-01-18,"(816.598, 917.5]",2,2,0
31221.0,2020-01-18,"(53.783, 359.25]",3,4,-1
31221.0,2020-01-18,"(359.25, 663.5]",4,4,0
31221.0,2020-01-18,"(663.5, 967.75]",1,3,-2
31221.0,2020-01-18,"(967.75, 1272.0]",1,3,-2
31222.0,2020-01-18,"(23.704, 349.0]",1,2,-1
31222.0,2020-01-18,"(349.0, 673.0]",6,6,0
31222.0,2020-01-18,"(673.0, 997.0]",3,6,-3
31222.0,2020-01-18,"(997.0, 1321.0]",1,7,-6
31223.0,2020-01-18,"(397.0, 740.0]",9,2,7
31223.0,2020-01-18,"(740.0, 1083.0]",3,13,-10
31223.0,2020-01-18,"(1083.0, 1426.0]",2,5,-3
31224.0,2020-01-18,"(692.25, 923.0]",3,1,2
31225.0,2020-01-18,"(532.156, 744.0]",7,9,-2
31225.0,2020-01-18,"(744.0, 955.0]",3,3,0
31225.0,2020-01-18,"(955.0, 1166.0]",1,1,0
31225.0,2020-01-18,"(1166.0, 1377.0]",3,5,-2
31226.0,2020-01-18,"(467.5, 696.25]",1,1,0
31226.0,2020-01-18,"(696.25, 925.0]",2,1,1
31227.0,2020-01-18,"(674.531, 792.25]",2,2,0
31227.0,2020-01-18,"(792.25, 909.5]",2,3,-1
31228.0,2020-01-18,"(14.608, 364.0]",1,2,-1
31228.0,2020-01-18,"(364.0, 712.0]",7,10,-3
31228.0,2020-01-18,"(712.0, 1060.0]",6,11,-5
31228.0,2020-01-18,"(1060.0, 1408.0]",6,10,-4
31229.0,2020-01-18,"(16.593, 369.75]",3,9,-6
31229.0,2020-01-18,"(369.75, 721.5]",16,46,-30
31229.0,2020-01-18,"(721.5, 1073.25]",19,36,-17
31229.0,2020-01-18,"(1073.25, 1425.0]",8,16,-8
31230.0,2020-01-18,"(364.0, 630.0]",2,1,1
31230.0,2020-01-18,"(630.0, 896.0]",8,3,5
31230.0,2020-01-18,"(896.0, 1162.0]",2,10,-8
31231.0,2020-01-18,"(307.5, 410.0]",1,1,0
31232.0,2020-01-18,"(13.575, 371.25]",1,3,-2
31232.0,2020-01-18,"(371.25, 727.5]",5,8,-3
31232.0,2020-01-18,"(727.5, 1083.75]",8,13,-5
31232.0,2020-01-18,"(1083.75, 1440.0]",5,8,-3
31233.0,2020-01-18,"(556.285, 735.75]",5,5,0
31233.0,2020-01-18,"(735.75, 914.5]",4,4,0
31233.0,2020-01-18,"(914.5, 1093.25]",1,3,-2
31233.0,2020-01-18,"(1093.25, 1272.0]",3,6,-3
31234.0,2020-01-18,"(5.654, 343.5]",1,3,-2
31234.0,2020-01-18,"(343.5, 680.0]",4,8,-4
31234.0,2020-01-18,"(680.0, 1016.5]",7,18,-11
31234.0,2020-01-18,"(1016.5, 1353.0]",4,6,-2
31235.0,2020-01-18,"(613.25, 795.5]",2,1,1
31236.0,2020-01-18,"(453.5, 765.0]",1,1,0
31237.0,2020-01-18,"(127.77, 436.5]",2,3,-1
31237.0,2020-01-18,"(436.5, 744.0]",5,9,-4
31237.0,2020-01-18,"(1051.5, 1359.0]",5,2,3
31238.0,2020-01-18,"(62.219, 258.25]",1,1,0
31238.0,2020-01-18,"(453.5, 648.75]",3,1,2
31238.0,2020-01-18,"(648.75, 844.0]",1,3,-2
31239.0,2020-01-18,"(554.219, 750.25]",5,5,0
31239.0,2020-01-18,"(750.25, 945.5]",1,1,0
31239.0,2020-01-18,"(1140.75, 1336.0]",1,1,0
31240.0,2020-01-18,"(720.889, 748.75]",1,1,0
31240.0,2020-01-18,"(804.25, 832.0]",1,2,-1
31241.0,2020-01-18,"(9.74, 326.0]",6,9,-3
31241.0,2020-01-18,"(326.0, 641.0]",7,15,-8
31241.0,2020-01-18,"(641.0, 956.0]",7,23,-16
31241.0,2020-01-18,"(956.0, 1271.0]",2,4,-2
31242.0,2020-01-18,"(608.426, 752.5]",3,3,0
31242.0,2020-01-18,"(1039.5, 1183.0]",1,3,-2
31243.0,2020-01-18,"(17.197, 218.75]",1,1,0
31243.0,2020-01-18,"(218.75, 419.5]",1,1,0
31243.0,2020-01-18,"(620.25, 821.0]",4,10,-6
31244.0,2020-01-18,"(140.841, 431.75]",1,1,0
31244.0,2020-01-18,"(431.75, 721.5]",2,4,-2
31244.0,2020-01-18,"(721.5, 1011.25]",2,3,-1
31244.0,2020-01-18,"(1011.25, 1301.0]",2,3,-1
31245.0,2020-01-18,"(-1.233, 308.25]",3,5,-2
31245.0,2020-01-18,"(616.5, 924.75]",13,1,12
31245.0,2020-01-18,"(924.75, 1233.0]",1,23,-22
31246.0,2020-01-18,"(4.727, 324.25]",1,2,-1
31246.0,2020-01-18,"(324.25, 642.5]",4,5,-1
31246.0,2020-01-18,"(642.5, 960.75]",6,7,-1
31246.0,2020-01-18,"(960.75, 1279.0]",4,6,-2
31247.0,2020-01-18,"(512.419, 658.25]",5,6,-1
31247.0,2020-01-18,"(658.25, 803.5]",2,4,-2
31247.0,2020-01-18,"(803.5, 948.75]",6,7,-1
31248.0,2020-01-18,"(617.595, 719.25]",8,12,-4
31248.0,2020-01-18,"(719.25, 820.5]",4,7,-3
31248.0,2020-01-18,"(820.5, 921.75]",5,11,-6
31248.0,2020-01-18,"(921.75, 1023.0]",7,9,-2
31249.0,2020-01-18,"(398.491, 526.25]",1,2,-1
31249.0,2020-01-18,"(526.25, 653.5]",1,2,-1
31249.0,2020-01-18,"(653.5, 780.75]",1,2,-1
31249.0,2020-01-18,"(780.75, 908.0]",3,8,-5
31250.0,2020-01-18,"(436.526, 555.5]",1,1,0
31250.0,2020-01-18,"(555.5, 674.0]",1,2,-1
31250.0,2020-01-18,"(792.5, 911.0]",1,1,0
31251.0,2020-01-18,"(578.16, 789.0]",4,8,-4
31251.0,2020-01-18,"(789.0, 999.0]",3,3,0
31251.0,2020-01-18,"(999.0, 1209.0]",1,1,0
31251.0,2020-01-18,"(1209.0, 1419.0]",1,1,0
31252.0,2020-01-18,"(346.5, 519.0]",1,1,0
31252.0,2020-01-18,"(519.0, 691.5]",4,1,3
31252.0,2020-01-18,"(691.5, 864.0]",1,4,-3
31253.0,2020-01-18,"(399.084, 629.0]",2,2,0
31254.0,2020-01-18,"(494.258, 680.5]",2,2,0
31254.0,2020-01-18,"(680.5, 866.0]",2,3,-1
31254.0,2020-01-18,"(866.0, 1051.5]",1,2,-1
31254.0,2020-01-18,"(1051.5, 1237.0]",2,2,0
31255.0,2020-01-18,"(517.399, 668.25]",1,4,-3
31255.0,2020-01-18,"(668.25, 818.5]",2,2,0
31255.0,2020-01-18,"(968.75, 1119.0]",1,1,0
31256.0,2020-01-18,"(2.597, 354.75]",1,1,0
31256.0,2020-01-18,"(354.75, 705.5]",4,5,-1
31256.0,2020-01-18,"(705.5, 1056.25]",9,14,-5
31256.0,2020-01-18,"(1056.25, 1407.0]",1,6,-5
31257.0,2020-01-18,"(681.269, 864.75]",2,5,-3
31257.0,2020-01-18,"(864.75, 1047.5]",1,2,-1
31257.0,2020-01-18,"(1047.5, 1230.25]",1,1,0
31257.0,2020-01-18,"(1230.25, 1413.0]",2,4,-2
31258.0,2020-01-18,"(604.393, 756.75]",3,5,-2
31258.0,2020-01-18,"(756.75, 908.5]",10,19,-9
31259.0,2020-01-18,"(951.0, 1268.0]",1,1,0
,,,,1.0,
,,,,2.0,
31261.0,2020-01-18,"(1293.75, 1428.0]",1,1,0
31262.0,2020-01-18,"(299.25, 598.5]",1,1,0
31262.0,2020-01-18,"(897.75, 1197.0]",4,1,3
31263.0,2020-01-18,"(405.026, 649.5]",4,7,-3
31263.0,2020-01-18,"(649.5, 893.0]",3,8,-5
31263.0,2020-01-18,"(893.0, 1136.5]",1,2,-1
31263.0,2020-01-18,"(1136.5, 1380.0]",1,4,-3
31264.0,2020-01-18,"(372.25, 710.5]",5,1,4
31264.0,2020-01-18,"(710.5, 1048.75]",2,5,-3
31265.0,2020-01-18,"(47.624, 393.0]",1,2,-1
31265.0,2020-01-18,"(393.0, 737.0]",5,9,-4
31265.0,2020-01-18,"(737.0, 1081.0]",3,9,-6
31265.0,2020-01-18,"(1081.0, 1425.0]",6,16,-10
31266.0,2020-01-18,"(13.595, 366.25]",8,11,-3
31266.0,2020-01-18,"(366.25, 717.5]",11,26,-15
31266.0,2020-01-18,"(717.5, 1068.75]",4,15,-11
31266.0,2020-01-18,"(1068.75, 1420.0]",8,13,-5
31267.0,2020-01-18,"(19.673, 352.75]",2,3,-1
31267.0,2020-01-18,"(352.75, 684.5]",4,8,-4
31267.0,2020-01-18,"(684.5, 1016.25]",5,10,-5
31267.0,2020-01-18,"(1016.25, 1348.0]",3,6,-3
31268.0,2020-01-18,"(35.606, 385.5]",2,7,-5
31268.0,2020-01-18,"(385.5, 734.0]",10,16,-6
31268.0,2020-01-18,"(734.0, 1082.5]",6,6,0
31268.0,2020-01-18,"(1082.5, 1431.0]",5,10,-5
31269.0,2020-01-18,"(560.285, 739.75]",4,8,-4
31269.0,2020-01-18,"(739.75, 918.5]",5,13,-8
31270.0,2020-01-18,"(22.711, 346.25]",1,2,-1
31270.0,2020-01-18,"(346.25, 668.5]",1,3,-2
31270.0,2020-01-18,"(668.5, 990.75]",2,5,-3
31270.0,2020-01-18,"(990.75, 1313.0]",1,3,-2
31271.0,2020-01-18,"(724.25, 952.0]",3,3,0
31272.0,2020-01-18,"(519.305, 693.75]",6,10,-4
31272.0,2020-01-18,"(693.75, 867.5]",4,5,-1
31272.0,2020-01-18,"(1041.25, 1215.0]",1,2,-1
31273.0,2020-01-18,"(619.886, 648.5]",1,1,0
31273.0,2020-01-18,"(648.5, 677.0]",1,1,0
31274.0,2020-01-18,"(630.225, 824.75]",5,7,-2
31274.0,2020-01-18,"(824.75, 1018.5]",1,1,0
31274.0,2020-01-18,"(1212.25, 1406.0]",1,3,-2
31275.0,2020-01-18,"(20.699, 347.25]",3,6,-3
31275.0,2020-01-18,"(347.25, 672.5]",1,4,-3
31275.0,2020-01-18,"(672.5, 997.75]",6,7,-1
31275.0,2020-01-18,"(997.75, 1323.0]",4,7,-3
31276.0,2020-01-18,"(722.389, 875.75]",3,5,-2
31277.0,2020-01-18,"(575.318, 746.5]",5,6,-1
31277.0,2020-01-18,"(917.0, 1087.5]",1,1,0
31278.0,2020-01-18,"(10.668, 345.0]",1,1,0
31278.0,2020-01-18,"(345.0, 678.0]",7,9,-2
31278.0,2020-01-18,"(678.0, 1011.0]",7,19,-12
31278.0,2020-01-18,"(1011.0, 1344.0]",6,8,-2
31279.0,2020-01-18,"(599.0, 898.5]",1,1,0
31279.0,2020-01-18,"(898.5, 1198.0]",4,1,3
31280.0,2020-01-18,"(376.5, 697.0]",5,1,4
31280.0,2020-01-18,"(697.0, 1017.5]",3,6,-3
31280.0,2020-01-18,"(1017.5, 1338.0]",2,8,-6
31000.0,2020-01-19,"(636.873, 668.75]",1,2,-1
31000.0,2020-01-19,"(668.75, 700.5]",1,1,0
31001.0,2020-01-19,"(798.5, 856.75]",1,1,0
31001.0,2020-01-19,"(856.75, 915.0]",2,2,0
,,,,1.0,
,,,,1.0,
,,,,1.0,
31003.0,2020-01-19,"(487.213, 684.75]",1,2,-1
31003.0,2020-01-19,"(881.5, 1078.25]",1,1,0
31004.0,2020-01-19,"(596.25, 795.0]",1,1,0
31005.0,2020-01-19,"(764.692, 842.0]",1,2,-1
31005.0,2020-01-19,"(996.0, 1073.0]",1,2,-1
31006.0,2020-01-19,"(749.535, 866.25]",7,9,-2
31006.0,2020-01-19,"(866.25, 982.5]",1,3,-2
31006.0,2020-01-19,"(982.5, 1098.75]",1,1,0
31007.0,2020-01-19,"(523.201, 723.75]",1,4,-3
31007.0,2020-01-19,"(923.5, 1123.25]",2,3,-1
,,,,2.0,
31010.0,2020-01-19,"(542.684, 622.0]",1,3,-2
31010.0,2020-01-19,"(780.0, 859.0]",1,1,0
31011.0,2020-01-19,"(783.5, 860.75]",1,1,0
31011.0,2020-01-19,"(860.75, 938.0]",1,1,0
31012.0,2020-01-19,"(495.75, 661.0]",1,1,0
31013.0,2020-01-19,"(599.275, 781.25]",2,4,-2
31013.0,2020-01-19,"(1143.75, 1325.0]",1,1,0
31014.0,2020-01-19,"(507.175, 714.25]",2,2,0
31014.0,2020-01-19,"(920.5, 1126.75]",5,3,2
31014.0,2020-01-19,"(1126.75, 1333.0]",1,6,-5
31015.0,2020-01-19,"(89.843, 380.25]",1,1,0
31015.0,2020-01-19,"(669.5, 958.75]",5,7,-2
31015.0,2020-01-19,"(958.75, 1248.0]",2,2,0
31016.0,2020-01-19,"(530.372, 688.0]",1,2,-1
31016.0,2020-01-19,"(688.0, 845.0]",2,7,-5
31016.0,2020-01-19,"(1002.0, 1159.0]",1,2,-1
,,,,2.0,
,,,,1.0,
,,,,2.0,
31018.0,2020-01-19,"(792.0, 1056.0]",1,1,0
31019.0,2020-01-19,"(685.364, 845.0]",2,3,-1
31019.0,2020-01-19,"(1163.0, 1322.0]",1,4,-3
31020.0,2020-01-19,"(934.868, 968.0]",1,2,-1
31021.0,2020-01-19,"(673.548, 787.0]",2,2,0
31021.0,2020-01-19,"(787.0, 900.0]",1,2,-1
31021.0,2020-01-19,"(1013.0, 1126.0]",2,2,0
31022.0,2020-01-19,"(579.237, 770.75]",4,5,-1
31022.0,2020-01-19,"(770.75, 961.5]",3,5,-2
31023.0,2020-01-19,"(462.0, 765.0]",2,1,1
31023.0,2020-01-19,"(765.0, 1068.0]",2,2,0
31023.0,2020-01-19,"(1068.0, 1371.0]",1,6,-5
31024.0,2020-01-19,"(531.185, 735.75]",2,4,-2
31024.0,2020-01-19,"(735.75, 939.5]",1,2,-1
31024.0,2020-01-19,"(939.5, 1143.25]",1,2,-1
31024.0,2020-01-19,"(1143.25, 1347.0]",1,2,-1
31025.0,2020-01-19,"(798.534, 915.5]",1,2,-1
31025.0,2020-01-19,"(1148.5, 1265.0]",1,2,-1
31026.0,2020-01-19,"(842.907, 866.25]",1,2,-1
31026.0,2020-01-19,"(889.5, 912.75]",1,1,0
31027.0,2020-01-19,"(991.5, 1165.25]",1,1,0
31027.0,2020-01-19,"(1165.25, 1339.0]",1,2,-1
31028.0,2020-01-19,"(622.267, 806.25]",1,3,-2
31028.0,2020-01-19,"(806.25, 989.5]",1,2,-1
31028.0,2020-01-19,"(1172.75, 1356.0]",1,1,0
31029.0,2020-01-19,"(717.543, 832.25]",1,2,-1
31029.0,2020-01-19,"(946.5, 1060.75]",1,1,0
31029.0,2020-01-19,"(1060.75, 1175.0]",2,2,0
31030.0,2020-01-19,"(833.5, 937.0]",2,1,1
31031.0,2020-01-19,"(1126.75, 1196.5]",1,1,0
31032.0,2020-01-19,"(780.25, 899.5]",1,1,0
31032.0,2020-01-19,"(1018.75, 1138.0]",1,2,-1
,,,,2.0,
31034.0,2020-01-19,"(156.009, 404.75]",1,1,0
31034.0,2020-01-19,"(404.75, 652.5]",1,1,0
31034.0,2020-01-19,"(652.5, 900.25]",1,2,-1
31034.0,2020-01-19,"(900.25, 1148.0]",1,2,-1
,,,,2.0,
,,,,2.0,
31037.0,2020-01-19,"(637.297, 813.75]",1,1,0
31038.0,2020-01-19,"(657.5, 699.25]",1,1,0
31039.0,2020-01-19,"(622.437, 763.75]",1,3,-2
31039.0,2020-01-19,"(763.75, 904.5]",1,4,-3
31039.0,2020-01-19,"(904.5, 1045.25]",2,3,-1
31039.0,2020-01-19,"(1045.25, 1186.0]",1,1,0
31040.0,2020-01-19,"(349.75, 545.5]",1,1,0
31040.0,2020-01-19,"(741.25, 937.0]",1,1,0
31041.0,2020-01-19,"(437.0, 655.5]",1,1,0
31041.0,2020-01-19,"(655.5, 874.0]",1,1,0
31042.0,2020-01-19,"(91.098, 317.5]",1,1,0
31042.0,2020-01-19,"(543.0, 768.5]",3,4,-1
31042.0,2020-01-19,"(768.5, 994.0]",2,3,-1
31043.0,2020-01-19,"(487.5, 650.0]",1,1,0
,,,,1.0,
,,,,1.0,
,,,,1.0,
,,,,3.0,
,,,,1.0,
,,,,2.0,
31047.0,2020-01-19,"(511.5, 743.75]",3,1,2
31047.0,2020-01-19,"(743.75, 976.0]",1,3,-2
,,,,2.0,
31049.0,2020-01-19,"(915.5, 1044.0]",1,4,-3
,,,,2.0,
,,,,1.0,
,,,,1.0,
31052.0,2020-01-19,"(690.75, 921.0]",2,1,1
,,,,1.0,
,,,,1.0,
,,,,1.0,
,,,,1.0,
31055.0,2020-01-19,"(440.25, 587.0]",1,1,0
31056.0,2020-01-19,"(161.523, 281.25]",1,1,0
,,,,2.0,
,,,,2.0,
31059.0,2020-01-19,"(684.0, 912.0]",1,1,0
31060.0,2020-01-19,"(527.0, 716.0]",2,1,1
31060.0,2020-01-19,"(716.0, 905.0]",3,2,1
31061.0,2020-01-19,"(421.5, 562.0]",1,1,0
31062.0,2020-01-19,"(594.591, 697.25]",2,4,-2
31062.0,2020-01-19,"(799.5, 901.75]",5,10,-5
31062.0,2020-01-19,"(901.75, 1004.0]",1,2,-1
,,,,2.0,
31064.0,2020-01-19,"(786.5, 930.75]",6,1,5
31064.0,2020-01-19,"(930.75, 1075.0]",4,2,2
31065.0,2020-01-19,"(647.532, 765.0]",1,2,-1
31065.0,2020-01-19,"(765.0, 882.0]",1,1,0
31065.0,2020-01-19,"(999.0, 1116.0]",1,1,0
31066.0,2020-01-19,"(640.75, 695.0]",1,1,0
31067.0,2020-01-19,"(233.424, 378.0]",1,1,0
31068.0,2020-01-19,"(597.208, 796.0]",1,2,-1
31068.0,2020-01-19,"(796.0, 994.0]",2,4,-2
31068.0,2020-01-19,"(1192.0, 1390.0]",1,1,0
31069.0,2020-01-19,"(839.75, 856.0]",1,1,0
31070.0,2020-01-19,"(1073.0, 1149.0]",1,1,0
31071.0,2020-01-19,"(550.635, 642.25]",2,7,-5
31071.0,2020-01-19,"(733.5, 824.75]",1,1,0
31071.0,2020-01-19,"(824.75, 916.0]",2,3,-1
31072.0,2020-01-19,"(771.5, 772.0]",1,1,0
31073.0,2020-01-19,"(791.0, 812.0]",1,1,0
31074.0,2020-01-19,"(768.75, 1025.0]",3,1,2
31075.0,2020-01-19,"(1375.0, 1381.0]",1,1,0
,,,,2.0,
31077.0,2020-01-19,"(662.324, 832.0]",4,7,-3
31077.0,2020-01-19,"(1001.0, 1170.0]",1,3,-2
31077.0,2020-01-19,"(1170.0, 1339.0]",1,1,0
,,,,2.0,
31079.0,2020-01-19,"(89.744, 405.0]",1,1,0
31079.0,2020-01-19,"(405.0, 719.0]",1,3,-2
31079.0,2020-01-19,"(1033.0, 1347.0]",3,3,0
31080.0,2020-01-19,"(608.246, 797.5]",2,4,-2
31080.0,2020-01-19,"(797.5, 986.0]",2,4,-2
31080.0,2020-01-19,"(1174.5, 1363.0]",2,3,-1
31081.0,2020-01-19,"(958.647, 1047.25]",1,2,-1
31081.0,2020-01-19,"(1223.75, 1312.0]",1,3,-2
31082.0,2020-01-19,"(775.799, 826.25]",2,2,0
31082.0,2020-01-19,"(926.75, 977.0]",1,3,-2
,,,,1.0,
,,,,2.0,
31084.0,2020-01-19,"(729.25, 906.0]",1,1,0
,,,,2.0,
31086.0,2020-01-19,"(1071.854, 1108.5]",1,1,0
31086.0,2020-01-19,"(1181.5, 1218.0]",1,2,-1
31087.0,2020-01-19,"(697.631, 790.25]",1,2,-1
31087.0,2020-01-19,"(790.25, 882.5]",1,1,0
31087.0,2020-01-19,"(882.5, 974.75]",1,2,-1
31088.0,2020-01-19,"(1004.968, 1013.0]",1,1,0
31089.0,2020-01-19,"(358.5, 630.0]",1,1,0
31089.0,2020-01-19,"(630.0, 901.5]",5,2,3
31089.0,2020-01-19,"(901.5, 1173.0]",2,6,-4
31090.0,2020-01-19,"(761.981, 766.75]",1,1,0
31090.0,2020-01-19,"(766.75, 771.5]",1,1,0
31091.0,2020-01-19,"(662.446, 801.5]",1,2,-1
31091.0,2020-01-19,"(1078.5, 1217.0]",1,1,0
31092.0,2020-01-19,"(497.286, 676.5]",1,2,-1
31092.0,2020-01-19,"(855.0, 1033.5]",1,2,-1
31092.0,2020-01-19,"(1033.5, 1212.0]",1,1,0
,,,,1.0,
,,,,2.0,
,,,,1.0,
,,,,1.0,
31095.0,2020-01-19,"(610.5, 814.0]",2,1,1
,,,,2.0,
31097.0,2020-01-19,"(816.75, 1089.0]",3,1,2
31098.0,2020-01-19,"(497.5, 635.0]",2,1,1
31099.0,2020-01-19,"(982.5, 1150.75]",1,1,0
31099.0,2020-01-19,"(1150.75, 1319.0]",1,1,0
31100.0,2020-01-19,"(395.0, 651.0]",1,1,0
31100.0,2020-01-19,"(651.0, 907.0]",1,1,0
31100.0,2020-01-19,"(907.0, 1163.0]",1,2,-1
31101.0,2020-01-19,"(3.644, 344.0]",4,9,-5
31101.0,2020-01-19,"(344.0, 683.0]",15,22,-7
31101.0,2020-01-19,"(683.0, 1022.0]",22,40,-18
31101.0,2020-01-19,"(1022.0, 1361.0]",11,19,-8
31102.0,2020-01-19,"(611.0, 903.0]",3,2,1
31102.0,2020-01-19,"(903.0, 1195.0]",6,12,-6
31103.0,2020-01-19,"(42.76, 354.0]",2,3,-1
31103.0,2020-01-19,"(354.0, 664.0]",6,15,-9
31103.0,2020-01-19,"(664.0, 974.0]",8,34,-26
31103.0,2020-01-19,"(974.0, 1284.0]",7,13,-6
31104.0,2020-01-19,"(3.625, 348.75]",2,10,-8
31104.0,2020-01-19,"(348.75, 692.5]",5,13,-8
31104.0,2020-01-19,"(692.5, 1036.25]",18,37,-19
31104.0,2020-01-19,"(1036.25, 1380.0]",10,16,-6
31105.0,2020-01-19,"(533.439, 674.25]",2,3,-1
31105.0,2020-01-19,"(674.25, 814.5]",1,4,-3
31105.0,2020-01-19,"(814.5, 954.75]",1,2,-1
31105.0,2020-01-19,"(954.75, 1095.0]",2,2,0
31106.0,2020-01-19,"(579.5, 845.25]",3,1,2
31106.0,2020-01-19,"(845.25, 1111.0]",2,4,-2
31107.0,2020-01-19,"(107.698, 434.5]",2,2,0
31107.0,2020-01-19,"(434.5, 760.0]",3,11,-8
31107.0,2020-01-19,"(760.0, 1085.5]",8,21,-13
31107.0,2020-01-19,"(1085.5, 1411.0]",4,9,-5
31108.0,2020-01-19,"(-1.413, 353.25]",2,2,0
31108.0,2020-01-19,"(353.25, 706.5]",5,16,-11
31108.0,2020-01-19,"(706.5, 1059.75]",14,26,-12
31108.0,2020-01-19,"(1059.75, 1413.0]",7,10,-3
31109.0,2020-01-19,"(36.618, 383.5]",2,5,-3
31109.0,2020-01-19,"(383.5, 729.0]",5,14,-9
31109.0,2020-01-19,"(729.0, 1074.5]",17,34,-17
31109.0,2020-01-19,"(1074.5, 1420.0]",8,13,-5
31110.0,2020-01-19,"(483.311, 656.25]",6,11,-5
31110.0,2020-01-19,"(656.25, 828.5]",10,18,-8
31110.0,2020-01-19,"(828.5, 1000.75]",3,13,-10
31110.0,2020-01-19,"(1000.75, 1173.0]",4,9,-5
31111.0,2020-01-19,"(42.696, 370.0]",3,7,-4
31111.0,2020-01-19,"(370.0, 696.0]",2,3,-1
31111.0,2020-01-19,"(696.0, 1022.0]",3,14,-11
31111.0,2020-01-19,"(1022.0, 1348.0]",14,17,-3
31112.0,2020-01-19,"(8.004, 258.0]",1,1,0
31112.0,2020-01-19,"(756.0, 1005.0]",2,9,-7
31113.0,2020-01-19,"(100.944, 366.0]",1,6,-5
31113.0,2020-01-19,"(630.0, 894.0]",6,4,2
31113.0,2020-01-19,"(894.0, 1158.0]",3,17,-14
31114.0,2020-01-19,"(8.653, 346.75]",4,12,-8
31114.0,2020-01-19,"(346.75, 683.5]",5,10,-5
31114.0,2020-01-19,"(683.5, 1020.25]",6,18,-12
31114.0,2020-01-19,"(1020.25, 1357.0]",7,17,-10
31115.0,2020-01-19,"(401.25, 698.5]",4,1,3
31115.0,2020-01-19,"(698.5, 995.75]",5,10,-5
31115.0,2020-01-19,"(995.75, 1293.0]",6,13,-7
31116.0,2020-01-19,"(568.193, 770.75]",5,13,-8
31116.0,2020-01-19,"(770.75, 972.5]",6,10,-4
31116.0,2020-01-19,"(972.5, 1174.25]",6,13,-7
31116.0,2020-01-19,"(1174.25, 1376.0]",7,12,-5
31117.0,2020-01-19,"(361.25, 660.5]",2,1,1
31117.0,2020-01-19,"(660.5, 959.75]",4,9,-5
31117.0,2020-01-19,"(959.75, 1259.0]",6,21,-15
31118.0,2020-01-19,"(55.951, 319.25]",1,2,-1
31118.0,2020-01-19,"(319.25, 581.5]",1,1,0
31118.0,2020-01-19,"(581.5, 843.75]",2,14,-12
31118.0,2020-01-19,"(843.75, 1106.0]",7,10,-3
31119.0,2020-01-19,"(315.0, 628.0]",4,1,3
31119.0,2020-01-19,"(628.0, 941.0]",11,8,3
31119.0,2020-01-19,"(941.0, 1254.0]",9,20,-11
31120.0,2020-01-19,"(482.25, 670.5]",2,5,-3
31120.0,2020-01-19,"(670.5, 858.0]",2,6,-4
31120.0,2020-01-19,"(858.0, 1045.5]",2,3,-1
31120.0,2020-01-19,"(1045.5, 1233.0]",7,9,-2
31121.0,2020-01-19,"(6.573, 364.75]",2,4,-2
31121.0,2020-01-19,"(364.75, 721.5]",3,7,-4
31121.0,2020-01-19,"(721.5, 1078.25]",5,8,-3
31121.0,2020-01-19,"(1078.25, 1435.0]",2,8,-6
31122.0,2020-01-19,"(513.135, 730.25]",1,5,-4
31122.0,2020-01-19,"(730.25, 946.5]",2,4,-2
31122.0,2020-01-19,"(946.5, 1162.75]",1,3,-2
31123.0,2020-01-19,"(514.131, 732.25]",2,12,-10
31123.0,2020-01-19,"(732.25, 949.5]",2,6,-4
31123.0,2020-01-19,"(949.5, 1166.75]",2,5,-3
31123.0,2020-01-19,"(1166.75, 1384.0]",1,4,-3
31124.0,2020-01-19,"(11.599, 363.25]",4,5,-1
31124.0,2020-01-19,"(363.25, 713.5]",12,26,-14
31124.0,2020-01-19,"(713.5, 1063.75]",14,42,-28
31124.0,2020-01-19,"(1063.75, 1414.0]",6,19,-13
31125.0,2020-01-19,"(51.627, 396.25]",1,4,-3
31125.0,2020-01-19,"(396.25, 739.5]",8,14,-6
31125.0,2020-01-19,"(739.5, 1082.75]",12,22,-10
31125.0,2020-01-19,"(1082.75, 1426.0]",5,11,-6
31126.0,2020-01-19,"(40.693, 368.75]",1,3,-2
31126.0,2020-01-19,"(368.75, 695.5]",4,13,-9
31126.0,2020-01-19,"(695.5, 1022.25]",7,16,-9
31126.0,2020-01-19,"(1022.25, 1349.0]",7,14,-7
,,,,2.0,
31128.0,2020-01-19,"(342.117, 563.75]",4,7,-3
31128.0,2020-01-19,"(563.75, 784.5]",3,10,-7
31128.0,2020-01-19,"(784.5, 1005.25]",10,16,-6
31128.0,2020-01-19,"(1005.25, 1226.0]",5,8,-3
31129.0,2020-01-19,"(598.5, 762.0]",3,1,2
31129.0,2020-01-19,"(762.0, 925.5]",13,3,10
31129.0,2020-01-19,"(925.5, 1089.0]",8,19,-11
31130.0,2020-01-19,"(53.872, 337.0]",1,4,-3
31130.0,2020-01-19,"(337.0, 619.0]",1,3,-2
31130.0,2020-01-19,"(619.0, 901.0]",7,10,-3
31130.0,2020-01-19,"(901.0, 1183.0]",6,8,-2
31131.0,2020-01-19,"(15.714, 338.5]",1,1,0
31131.0,2020-01-19,"(338.5, 660.0]",1,1,0
31131.0,2020-01-19,"(660.0, 981.5]",3,13,-10
31131.0,2020-01-19,"(981.5, 1303.0]",3,7,-4
31200.0,2020-01-19,"(169.772, 478.0]",1,4,-3
31200.0,2020-01-19,"(478.0, 785.0]",44,66,-22
31200.0,2020-01-19,"(785.0, 1092.0]",14,25,-11
31200.0,2020-01-19,"(1092.0, 1399.0]",5,15,-10
31201.0,2020-01-19,"(10.582, 366.5]",2,7,-5
31201.0,2020-01-19,"(366.5, 721.0]",18,30,-12
31201.0,2020-01-19,"(721.0, 1075.5]",25,58,-33
31201.0,2020-01-19,"(1075.5, 1430.0]",18,30,-12
31202.0,2020-01-19,"(410.75, 748.5]",10,3,7
31202.0,2020-01-19,"(748.5, 1086.25]",15,25,-10
31202.0,2020-01-19,"(1086.25, 1424.0]",7,32,-25
31203.0,2020-01-19,"(65.661, 401.75]",1,5,-4
31203.0,2020-01-19,"(401.75, 736.5]",11,17,-6
31203.0,2020-01-19,"(736.5, 1071.25]",25,48,-23
31203.0,2020-01-19,"(1071.25, 1406.0]",8,22,-14
31204.0,2020-01-19,"(34.761, 345.75]",1,4,-3
31204.0,2020-01-19,"(655.5, 965.25]",8,3,5
31204.0,2020-01-19,"(965.25, 1275.0]",8,17,-9
31205.0,2020-01-19,"(97.802, 398.5]",1,3,-2
31205.0,2020-01-19,"(398.5, 698.0]",2,4,-2
31205.0,2020-01-19,"(698.0, 997.5]",4,12,-8
31205.0,2020-01-19,"(997.5, 1297.0]",3,6,-3
31206.0,2020-01-19,"(781.914, 803.5]",1,2,-1
31206.0,2020-01-19,"(846.5, 868.0]",1,1,0
31207.0,2020-01-19,"(1116.0, 1176.0]",1,1,0
31207.0,2020-01-19,"(1236.0, 1296.0]",1,2,-1
31208.0,2020-01-19,"(636.428, 780.0]",1,1,0
31208.0,2020-01-19,"(1066.0, 1209.0]",3,4,-1
31209.0,2020-01-19,"(39.835, 332.25]",1,1,0
31209.0,2020-01-19,"(914.75, 1206.0]",3,1,2
31211.0,2020-01-19,"(776.617, 872.75]",5,5,0
31211.0,2020-01-19,"(872.75, 968.5]",8,11,-3
31211.0,2020-01-19,"(968.5, 1064.25]",4,8,-4
31212.0,2020-01-19,"(65.78, 372.0]",2,6,-4
31212.0,2020-01-19,"(372.0, 677.0]",6,18,-12
31212.0,2020-01-19,"(677.0, 982.0]",7,16,-9
31212.0,2020-01-19,"(982.0, 1287.0]",6,11,-5
31213.0,2020-01-19,"(631.546, 745.5]",1,10,-9
31213.0,2020-01-19,"(745.5, 859.0]",4,6,-2
31213.0,2020-01-19,"(972.5, 1086.0]",1,3,-2
31214.0,2020-01-19,"(22.585, 377.75]",1,4,-3
31214.0,2020-01-19,"(377.75, 731.5]",11,23,-12
31214.0,2020-01-19,"(731.5, 1085.25]",22,46,-24
31214.0,2020-01-19,"(1085.25, 1439.0]",16,30,-14
31215.0,2020-01-19,"(474.422, 619.5]",3,3,0
31215.0,2020-01-19,"(619.5, 764.0]",1,3,-2
31215.0,2020-01-19,"(764.0, 908.5]",7,10,-3
31215.0,2020-01-19,"(908.5, 1053.0]",5,6,-1
31216.0,2020-01-19,"(850.0, 1071.0]",1,1,0
31217.0,2020-01-19,"(624.575, 731.25]",2,5,-3
31217.0,2020-01-19,"(837.5, 943.75]",2,3,-1
31217.0,2020-01-19,"(943.75, 1050.0]",5,2,3
31218.0,2020-01-19,"(651.25, 779.5]",1,3,-2
31218.0,2020-01-19,"(779.5, 907.75]",4,1,3
31218.0,2020-01-19,"(907.75, 1036.0]",5,4,1
31219.0,2020-01-19,"(568.519, 689.25]",3,3,0
31219.0,2020-01-19,"(809.5, 929.75]",4,2,2
31219.0,2020-01-19,"(929.75, 1050.0]",4,5,-1
31220.0,2020-01-19,"(650.788, 704.0]",2,3,-1
31220.0,2020-01-19,"(810.0, 863.0]",1,1,0
31221.0,2020-01-19,"(90.674, 423.5]",4,6,-2
31221.0,2020-01-19,"(423.5, 755.0]",4,6,-2
31221.0,2020-01-19,"(755.0, 1086.5]",1,3,-2
31221.0,2020-01-19,"(1086.5, 1418.0]",2,4,-2
31222.0,2020-01-19,"(584.75, 848.5]",3,1,2
31222.0,2020-01-19,"(848.5, 1112.25]",4,7,-3
31222.0,2020-01-19,"(1112.25, 1376.0]",1,7,-6
31223.0,2020-01-19,"(366.0, 702.0]",9,2,7
31223.0,2020-01-19,"(702.0, 1038.0]",14,17,-3
31223.0,2020-01-19,"(1038.0, 1374.0]",6,27,-21
31224.0,2020-01-19,"(863.5, 958.25]",2,1,1
31224.0,2020-01-19,"(958.25, 1053.0]",1,4,-3
31225.0,2020-01-19,"(465.226, 659.5]",4,5,-1
31225.0,2020-01-19,"(659.5, 853.0]",5,12,-7
31225.0,2020-01-19,"(853.0, 1046.5]",4,12,-8
31225.0,2020-01-19,"(1046.5, 1240.0]",5,6,-1
31226.0,2020-01-19,"(478.171, 686.25]",1,3,-2
31226.0,2020-01-19,"(686.25, 893.5]",3,5,-2
31226.0,2020-01-19,"(893.5, 1100.75]",3,5,-2
31226.0,2020-01-19,"(1100.75, 1308.0]",2,2,0
31227.0,2020-01-19,"(191.854, 479.5]",1,2,-1
31227.0,2020-01-19,"(479.5, 766.0]",2,2,0
31227.0,2020-01-19,"(766.0, 1052.5]",6,11,-5
31227.0,2020-01-19,"(1052.5, 1339.0]",3,4,-1
31228.0,2020-01-19,"(399.5, 742.0]",6,1,5
31228.0,2020-01-19,"(742.0, 1084.5]",25,9,16
31228.0,2020-01-19,"(1084.5, 1427.0]",2,38,-36
31229.0,2020-01-19,"(40.611, 389.25]",3,9,-6
31229.0,2020-01-19,"(389.25, 736.5]",25,46,-21
31229.0,2020-01-19,"(736.5, 1083.75]",20,44,-24
31229.0,2020-01-19,"(1083.75, 1431.0]",12,22,-10
31230.0,2020-01-19,"(409.081, 639.75]",1,3,-2
31230.0,2020-01-19,"(639.75, 869.5]",6,9,-3
31230.0,2020-01-19,"(869.5, 1099.25]",9,12,-3
31230.0,2020-01-19,"(1099.25, 1329.0]",2,4,-2
31231.0,2020-01-19,"(817.25, 821.0]",1,1,0
31232.0,2020-01-19,"(367.75, 712.5]",3,3,0
31232.0,2020-01-19,"(712.5, 1057.25]",16,6,10
31232.0,2020-01-19,"(1057.25, 1402.0]",6,25,-19
31233.0,2020-01-19,"(25.802, 326.5]",1,1,0
31233.0,2020-01-19,"(326.5, 626.0]",2,3,-1
31233.0,2020-01-19,"(626.0, 925.5]",4,8,-4
31233.0,2020-01-19,"(925.5, 1225.0]",4,6,-2
31234.0,2020-01-19,"(7.681, 338.75]",1,2,-1
31234.0,2020-01-19,"(338.75, 668.5]",3,5,-2
31234.0,2020-01-19,"(668.5, 998.25]",12,24,-12
31234.0,2020-01-19,"(998.25, 1328.0]",15,22,-7
31235.0,2020-01-19,"(683.5, 835.0]",5,2,3
31236.0,2020-01-19,"(120.782, 426.5]",1,1,0
31236.0,2020-01-19,"(426.5, 731.0]",6,7,-1
31236.0,2020-01-19,"(731.0, 1035.5]",6,12,-6
31236.0,2020-01-19,"(1035.5, 1340.0]",1,7,-6
31237.0,2020-01-19,"(186.941, 452.75]",1,2,-1
31237.0,2020-01-19,"(452.75, 717.5]",5,12,-7
31237.0,2020-01-19,"(717.5, 982.25]",9,15,-6
31237.0,2020-01-19,"(982.25, 1247.0]",9,18,-9
31238.0,2020-01-19,"(29.966, 289.5]",1,3,-2
31238.0,2020-01-19,"(289.5, 548.0]",2,2,0
31238.0,2020-01-19,"(548.0, 806.5]",3,6,-3
31238.0,2020-01-19,"(806.5, 1065.0]",14,16,-2
31239.0,2020-01-19,"(465.1, 691.0]",6,9,-3
31239.0,2020-01-19,"(691.0, 916.0]",2,9,-7
31239.0,2020-01-19,"(916.0, 1141.0]",7,12,-5
31239.0,2020-01-19,"(1141.0, 1366.0]",2,3,-1
31240.0,2020-01-19,"(510.093, 737.75]",5,11,-6
31240.0,2020-01-19,"(737.75, 964.5]",5,10,-5
31240.0,2020-01-19,"(964.5, 1191.25]",2,5,-3
31240.0,2020-01-19,"(1191.25, 1418.0]",2,4,-2
31241.0,2020-01-19,"(53.616, 401.0]",6,11,-5
31241.0,2020-01-19,"(401.0, 747.0]",7,18,-11
31241.0,2020-01-19,"(747.0, 1093.0]",11,22,-11
31241.0,2020-01-19,"(1093.0, 1439.0]",4,8,-4
31242.0,2020-01-19,"(548.309, 721.75]",3,4,-1
31242.0,2020-01-19,"(721.75, 894.5]",6,10,-4
31242.0,2020-01-19,"(894.5, 1067.25]",1,2,-1
31243.0,2020-01-19,"(81.845, 371.75]",1,3,-2
31243.0,2020-01-19,"(371.75, 660.5]",1,2,-1
31243.0,2020-01-19,"(660.5, 949.25]",14,18,-4
31243.0,2020-01-19,"(949.25, 1238.0]",6,10,-4
31244.0,2020-01-19,"(644.24, 835.0]",2,7,-5
31244.0,2020-01-19,"(835.0, 1025.0]",3,5,-2
31244.0,2020-01-19,"(1025.0, 1215.0]",2,5,-3
31244.0,2020-01-19,"(1215.0, 1405.0]",2,2,0
31245.0,2020-01-19,"(78.728, 398.0]",3,3,0
31245.0,2020-01-19,"(398.0, 716.0]",4,7,-3
31245.0,2020-01-19,"(716.0, 1034.0]",9,17,-8
31245.0,2020-01-19,"(1034.0, 1352.0]",2,7,-5
31246.0,2020-01-19,"(65.643, 406.25]",3,3,0
31246.0,2020-01-19,"(406.25, 745.5]",10,18,-8
31246.0,2020-01-19,"(745.5, 1084.75]",15,30,-15
31246.0,2020-01-19,"(1084.75, 1424.0]",7,11,-4
31247.0,2020-01-19,"(466.027, 710.25]",5,10,-5
31247.0,2020-01-19,"(710.25, 953.5]",27,38,-11
31247.0,2020-01-19,"(953.5, 1196.75]",5,10,-5
31247.0,2020-01-19,"(1196.75, 1440.0]",1,2,-1
31248.0,2020-01-19,"(596.46, 732.0]",5,11,-6
31248.0,2020-01-19,"(732.0, 867.0]",14,28,-14
31248.0,2020-01-19,"(867.0, 1002.0]",7,16,-9
31248.0,2020-01-19,"(1002.0, 1137.0]",2,10,-8
31249.0,2020-01-19,"(698.402, 848.5]",10,19,-9
31249.0,2020-01-19,"(848.5, 998.0]",4,7,-3
31249.0,2020-01-19,"(998.0, 1147.5]",5,8,-3
31249.0,2020-01-19,"(1147.5, 1297.0]",1,2,-1
31250.0,2020-01-19,"(711.57, 819.5]",1,1,0
31250.0,2020-01-19,"(819.5, 927.0]",1,3,-2
31250.0,2020-01-19,"(1034.5, 1142.0]",2,5,-3
31251.0,2020-01-19,"(156.85, 445.5]",1,3,-2
31251.0,2020-01-19,"(445.5, 733.0]",3,8,-5
31251.0,2020-01-19,"(733.0, 1020.5]",5,10,-5
31251.0,2020-01-19,"(1020.5, 1308.0]",4,10,-6
31252.0,2020-01-19,"(982.5, 1136.0]",1,1,0
31253.0,2020-01-19,"(415.211, 613.25]",1,1,0
31254.0,2020-01-19,"(593.198, 794.5]",2,4,-2
31254.0,2020-01-19,"(794.5, 995.0]",1,2,-1
31254.0,2020-01-19,"(995.0, 1195.5]",3,3,0
31254.0,2020-01-19,"(1195.5, 1396.0]",1,1,0
31255.0,2020-01-19,"(503.307, 677.25]",2,3,-1
31255.0,2020-01-19,"(677.25, 850.5]",2,2,0
31255.0,2020-01-19,"(1023.75, 1197.0]",1,4,-3
31256.0,2020-01-19,"(543.221, 738.75]",1,6,-5
31256.0,2020-01-19,"(738.75, 933.5]",11,18,-7
31256.0,2020-01-19,"(933.5, 1128.25]",6,7,-1
31256.0,2020-01-19,"(1128.25, 1323.0]",1,5,-4
31257.0,2020-01-19,"(173.771, 482.25]",3,3,0
31257.0,2020-01-19,"(482.25, 789.5]",10,18,-8
31257.0,2020-01-19,"(789.5, 1096.75]",6,17,-11
31257.0,2020-01-19,"(1096.75, 1404.0]",6,13,-7
31258.0,2020-01-19,"(294.25, 587.5]",3,2,1
31258.0,2020-01-19,"(587.5, 880.75]",26,7,19
31258.0,2020-01-19,"(880.75, 1174.0]",17,53,-36
31259.0,2020-01-19,"(985.5, 1108.25]",1,1,0
31259.0,2020-01-19,"(1108.25, 1231.0]",1,1,0
31260.0,2020-01-19,"(713.679, 794.25]",1,5,-4
31260.0,2020-01-19,"(954.75, 1035.0]",1,3,-2
31261.0,2020-01-19,"(15.911, 289.25]",4,4,0
31261.0,2020-01-19,"(561.5, 833.75]",1,5,-4
31261.0,2020-01-19,"(833.75, 1106.0]",2,5,-3
31262.0,2020-01-19,"(518.5, 772.25]",3,1,2
31262.0,2020-01-19,"(772.25, 1026.0]",4,4,0
31263.0,2020-01-19,"(56.716, 379.0]",1,1,0
31263.0,2020-01-19,"(379.0, 700.0]",5,8,-3
31263.0,2020-01-19,"(700.0, 1021.0]",8,11,-3
31263.0,2020-01-19,"(1021.0, 1342.0]",3,7,-4
31264.0,2020-01-19,"(612.315, 784.25]",1,3,-2
31264.0,2020-01-19,"(784.25, 955.5]",6,9,-3
31264.0,2020-01-19,"(955.5, 1126.75]",1,6,-5
31264.0,2020-01-19,"(1126.75, 1298.0]",1,3,-2
31265.0,2020-01-19,"(35.726, 355.5]",5,6,-1
31265.0,2020-01-19,"(355.5, 674.0]",4,11,-7
31265.0,2020-01-19,"(674.0, 992.5]",18,41,-23
31265.0,2020-01-19,"(992.5, 1311.0]",7,10,-3
31266.0,2020-01-19,"(17.588, 372.0]",3,5,-2
31266.0,2020-01-19,"(372.0, 725.0]",8,22,-14
31266.0,2020-01-19,"(725.0, 1078.0]",15,32,-17
31266.0,2020-01-19,"(1078.0, 1431.0]",9,14,-5
31267.0,2020-01-19,"(21.641, 362.75]",1,2,-1
31267.0,2020-01-19,"(362.75, 702.5]",1,6,-5
31267.0,2020-01-19,"(702.5, 1042.25]",14,26,-12
31267.0,2020-01-19,"(1042.25, 1382.0]",8,11,-3
31268.0,2020-01-19,"(30.686, 360.5]",4,8,-4
31268.0,2020-01-19,"(360.5, 689.0]",6,10,-4
31268.0,2020-01-19,"(689.0, 1017.5]",9,15,-6
31268.0,2020-01-19,"(1017.5, 1346.0]",3,11,-8
31269.0,2020-01-19,"(430.5, 721.0]",7,1,6
31269.0,2020-01-19,"(721.0, 1011.5]",8,10,-2
31269.0,2020-01-19,"(1011.5, 1302.0]",2,15,-13
31270.0,2020-01-19,"(325.242, 515.5]",1,1,0
31270.0,2020-01-19,"(515.5, 705.0]",1,2,-1
31270.0,2020-01-19,"(705.0, 894.5]",5,8,-3
31270.0,2020-01-19,"(894.5, 1084.0]",2,6,-4
31271.0,2020-01-19,"(530.178, 736.5]",8,14,-6
31271.0,2020-01-19,"(736.5, 942.0]",8,10,-2
31271.0,2020-01-19,"(942.0, 1147.5]",2,2,0
31271.0,2020-01-19,"(1147.5, 1353.0]",1,3,-2
31272.0,2020-01-19,"(521.114, 743.5]",6,15,-9
31272.0,2020-01-19,"(743.5, 965.0]",11,11,0
31272.0,2020-01-19,"(965.0, 1186.5]",6,12,-6
31272.0,2020-01-19,"(1186.5, 1408.0]",6,8,-2
31273.0,2020-01-19,"(589.324, 759.0]",3,3,0
31273.0,2020-01-19,"(759.0, 928.0]",1,4,-3
31273.0,2020-01-19,"(928.0, 1097.0]",3,4,-1
31274.0,2020-01-19,"(568.196, 770.0]",2,3,-1
31274.0,2020-01-19,"(770.0, 971.0]",4,6,-2
31274.0,2020-01-19,"(971.0, 1172.0]",5,7,-2
31275.0,2020-01-19,"(39.673, 372.75]",3,3,0
31275.0,2020-01-19,"(372.75, 704.5]",3,9,-6
31275.0,2020-01-19,"(704.5, 1036.25]",6,15,-9
31275.0,2020-01-19,"(1036.25, 1368.0]",7,11,-4
31276.0,2020-01-19,"(523.102, 748.5]",1,2,-1
31276.0,2020-01-19,"(748.5, 973.0]",1,3,-2
31276.0,2020-01-19,"(973.0, 1197.5]",2,3,-1
31276.0,2020-01-19,"(1197.5, 1422.0]",1,1,0
31277.0,2020-01-19,"(455.25, 643.5]",5,6,-1
31277.0,2020-01-19,"(643.5, 831.0]",13,16,-3
31277.0,2020-01-19,"(831.0, 1018.5]",6,10,-4
31277.0,2020-01-19,"(1018.5, 1206.0]",3,6,-3
31278.0,2020-01-19,"(48.672, 382.0]",1,2,-1
31278.0,2020-01-19,"(382.0, 714.0]",4,10,-6
31278.0,2020-01-19,"(714.0, 1046.0]",12,26,-14
31278.0,2020-01-19,"(1046.0, 1378.0]",5,14,-9
31279.0,2020-01-19,"(556.416, 703.0]",2,2,0
31279.0,2020-01-19,"(849.0, 995.0]",1,4,-3
31280.0,2020-01-19,"(104.73, 423.5]",1,1,0
31280.0,2020-01-19,"(423.5, 741.0]",6,11,-5
31280.0,2020-01-19,"(741.0, 1058.5]",12,22,-10
31280.0,2020-01-19,"(1058.5, 1376.0]",4,5,-1
31000.0,2020-01-20,"(684.0, 912.0]",2,1,1
,,,,2.0,
31002.0,2020-01-20,"(517.447, 656.25]",1,1,0
31002.0,2020-01-20,"(794.5, 932.75]",1,1,0
31002.0,2020-01-20,"(932.75, 1071.0]",1,1,0
31003.0,2020-01-20,"(644.613, 741.75]",2,2,0
31003.0,2020-01-20,"(838.5, 935.25]",1,1,0
,,,,1.0,
,,,,3.0,
31005.0,2020-01-20,"(433.175, 640.25]",1,1,0
31005.0,2020-01-20,"(640.25, 846.5]",1,3,-2
31005.0,2020-01-20,"(1052.75, 1259.0]",1,1,0
31006.0,2020-01-20,"(719.385, 873.75]",1,2,-1
31006.0,2020-01-20,"(873.75, 1027.5]",1,2,-1
31006.0,2020-01-20,"(1181.25, 1335.0]",2,3,-1
31007.0,2020-01-20,"(471.207, 670.25]",2,4,-2
31007.0,2020-01-20,"(670.25, 868.5]",4,6,-2
31007.0,2020-01-20,"(868.5, 1066.75]",1,4,-3
31007.0,2020-01-20,"(1066.75, 1265.0]",1,3,-2
31009.0,2020-01-20,"(473.765, 532.75]",2,3,-1
31009.0,2020-01-20,"(650.25, 709.0]",1,1,0
31010.0,2020-01-20,"(103.348, 267.0]",1,1,0
31010.0,2020-01-20,"(593.0, 756.0]",1,2,-1
31011.0,2020-01-20,"(414.698, 490.5]",2,2,0
31011.0,2020-01-20,"(641.5, 717.0]",1,1,0
31012.0,2020-01-20,"(356.25, 475.0]",1,1,0
31013.0,2020-01-20,"(619.75, 847.5]",5,2,3
31013.0,2020-01-20,"(847.5, 1075.25]",3,6,-3
31014.0,2020-01-20,"(19.738, 336.5]",3,4,-1
31014.0,2020-01-20,"(336.5, 652.0]",2,3,-1
31014.0,2020-01-20,"(652.0, 967.5]",2,6,-4
31014.0,2020-01-20,"(967.5, 1283.0]",3,5,-2
31015.0,2020-01-20,"(339.302, 514.5]",1,1,0
31015.0,2020-01-20,"(514.5, 689.0]",1,1,0
31015.0,2020-01-20,"(689.0, 863.5]",1,2,-1
31015.0,2020-01-20,"(863.5, 1038.0]",3,3,0
31016.0,2020-01-20,"(897.759, 958.25]",1,1,0
31017.0,2020-01-20,"(698.264, 883.0]",2,2,0
31017.0,2020-01-20,"(883.0, 1067.0]",1,2,-1
31017.0,2020-01-20,"(1067.0, 1251.0]",1,1,0
31018.0,2020-01-20,"(761.573, 868.75]",1,3,-2
31018.0,2020-01-20,"(868.75, 975.5]",1,1,0
31018.0,2020-01-20,"(1082.25, 1189.0]",1,1,0
31019.0,2020-01-20,"(613.317, 784.75]",1,2,-1
31019.0,2020-01-20,"(955.5, 1126.25]",1,1,0
31019.0,2020-01-20,"(1126.25, 1297.0]",2,4,-2
31020.0,2020-01-20,"(934.75, 1078.5]",3,2,1
31021.0,2020-01-20,"(388.088, 617.0]",2,3,-1
31021.0,2020-01-20,"(617.0, 845.0]",2,2,0
31021.0,2020-01-20,"(845.0, 1073.0]",1,3,-2
31021.0,2020-01-20,"(1073.0, 1301.0]",1,3,-2
31022.0,2020-01-20,"(461.421, 606.75]",1,2,-1
31022.0,2020-01-20,"(606.75, 751.5]",1,3,-2
31022.0,2020-01-20,"(896.25, 1041.0]",2,1,1
31023.0,2020-01-20,"(350.105, 574.75]",1,2,-1
31023.0,2020-01-20,"(574.75, 798.5]",3,5,-2
31023.0,2020-01-20,"(798.5, 1022.25]",1,1,0
31023.0,2020-01-20,"(1022.25, 1246.0]",1,2,-1
31024.0,2020-01-20,"(518.436, 660.0]",1,1,0
31024.0,2020-01-20,"(660.0, 801.0]",1,3,-2
31024.0,2020-01-20,"(942.0, 1083.0]",1,2,-1
,,,,2.0,
31026.0,2020-01-20,"(862.5, 1097.25]",2,2,0
31027.0,2020-01-20,"(15.757, 327.75]",1,1,0
31027.0,2020-01-20,"(638.5, 949.25]",2,2,0
31027.0,2020-01-20,"(949.25, 1260.0]",1,2,-1
31028.0,2020-01-20,"(775.5, 1034.0]",1,1,0
31029.0,2020-01-20,"(665.34, 831.0]",2,9,-7
31029.0,2020-01-20,"(831.0, 996.0]",1,2,-1
31029.0,2020-01-20,"(1161.0, 1326.0]",1,1,0
31030.0,2020-01-20,"(953.5, 1160.75]",1,2,-1
31030.0,2020-01-20,"(1160.75, 1368.0]",3,3,0
31031.0,2020-01-20,"(1011.835, 1053.25]",1,1,0
31032.0,2020-01-20,"(851.25, 936.0]",2,1,1
,,,,1.0,
,,,,1.0,
31034.0,2020-01-20,"(294.5, 583.0]",1,1,0
31034.0,2020-01-20,"(871.5, 1160.0]",1,1,0
31035.0,2020-01-20,"(1246.5, 1309.75]",1,1,0
31035.0,2020-01-20,"(1309.75, 1373.0]",1,2,-1
,,,,1.0,
,,,,1.0,
31037.0,2020-01-20,"(356.179, 562.25]",2,4,-2
31037.0,2020-01-20,"(562.25, 767.5]",1,1,0
31037.0,2020-01-20,"(767.5, 972.75]",1,3,-2
31038.0,2020-01-20,"(799.5, 1066.0]",3,1,2
31039.0,2020-01-20,"(478.257, 664.75]",2,4,-2
31039.0,2020-01-20,"(664.75, 850.5]",2,3,-1
31040.0,2020-01-20,"(461.338, 627.5]",1,1,0
31041.0,2020-01-20,"(457.5, 686.25]",2,1,1
31041.0,2020-01-20,"(686.25, 915.0]",1,2,-1
31042.0,2020-01-20,"(450.376, 607.0]",2,4,-2
31042.0,2020-01-20,"(607.0, 763.0]",3,3,0
31042.0,2020-01-20,"(919.0, 1075.0]",2,5,-3
31043.0,2020-01-20,"(830.747, 894.25]",1,2,-1
31043.0,2020-01-20,"(1020.75, 1084.0]",2,4,-2
31044.0,2020-01-20,"(689.687, 768.25]",2,2,0
31044.0,2020-01-20,"(924.75, 1003.0]",1,1,0
31045.0,2020-01-20,"(174.158, 385.5]",1,1,0
31046.0,2020-01-20,"(529.761, 589.75]",1,2,-1
31046.0,2020-01-20,"(709.25, 769.0]",1,1,0
31047.0,2020-01-20,"(836.0, 1021.0]",1,4,-3
31047.0,2020-01-20,"(1021.0, 1206.0]",1,1,0
31048.0,2020-01-20,"(728.413, 875.75]",2,2,0
31049.0,2020-01-20,"(1268.25, 1276.0]",1,1,0
31050.0,2020-01-20,"(584.0, 876.0]",1,1,0
31050.0,2020-01-20,"(876.0, 1168.0]",1,1,0
31051.0,2020-01-20,"(778.0, 906.5]",1,1,0
31051.0,2020-01-20,"(906.5, 1035.0]",1,1,0
,,,,1.0,
,,,,1.0,
31053.0,2020-01-20,"(102.861, 388.75]",1,2,-1
31053.0,2020-01-20,"(958.25, 1243.0]",1,2,-1
,,,,2.0,
31055.0,2020-01-20,"(402.365, 561.75]",1,1,0
31055.0,2020-01-20,"(561.75, 720.5]",2,3,-1
31055.0,2020-01-20,"(879.25, 1038.0]",1,1,0
31056.0,2020-01-20,"(14.756, 327.0]",1,1,0
31056.0,2020-01-20,"(327.0, 638.0]",1,2,-1
31056.0,2020-01-20,"(638.0, 949.0]",1,4,-3
31056.0,2020-01-20,"(949.0, 1260.0]",2,3,-1
31057.0,2020-01-20,"(912.998, 913.5]",1,1,0
,,,,2.0,
,,,,2.0,
31060.0,2020-01-20,"(625.0, 935.5]",1,1,0
31061.0,2020-01-20,"(560.597, 661.75]",1,1,0
31062.0,2020-01-20,"(683.802, 733.5]",1,1,0
31062.0,2020-01-20,"(832.5, 882.0]",1,1,0
31063.0,2020-01-20,"(771.75, 1029.0]",2,1,1
31064.0,2020-01-20,"(692.5, 765.0]",2,1,1
,,,,1.0,
,,,,1.0,
,,,,1.0,
,,,,1.0,
,,,,2.0,
,,,,1.0,
31068.0,2020-01-20,"(1266.5, 1351.0]",1,1,0
31069.0,2020-01-20,"(842.75, 953.0]",1,1,0
31070.0,2020-01-20,"(1126.75, 1169.5]",1,1,0
31070.0,2020-01-20,"(1212.25, 1255.0]",1,1,0
31071.0,2020-01-20,"(452.353, 614.75]",1,3,-2
31071.0,2020-01-20,"(614.75, 776.5]",1,1,0
31071.0,2020-01-20,"(776.5, 938.25]",1,2,-1
31071.0,2020-01-20,"(938.25, 1100.0]",1,3,-2
,,,,2.0,
,,,,2.0,
31074.0,2020-01-20,"(1191.5, 1197.0]",1,1,0
,,,,2.0,
,,,,2.0,
31077.0,2020-01-20,"(856.911, 879.25]",3,3,0
31078.0,2020-01-20,"(763.5, 1018.0]",1,1,0
31079.0,2020-01-20,"(515.076, 747.0]",1,3,-2
31079.0,2020-01-20,"(747.0, 978.0]",1,2,-1
31079.0,2020-01-20,"(978.0, 1209.0]",2,3,-1
31079.0,2020-01-20,"(1209.0, 1440.0]",2,3,-1
31080.0,2020-01-20,"(458.155, 670.25]",1,6,-5
31080.0,2020-01-20,"(670.25, 881.5]",1,1,0
31080.0,2020-01-20,"(881.5, 1092.75]",1,2,-1
31080.0,2020-01-20,"(1092.75, 1304.0]",1,1,0
31081.0,2020-01-20,"(858.5, 877.25]",1,1,0
,,,,1.0,
,,,,1.0,
31083.0,2020-01-20,"(807.75, 1077.0]",2,1,1
31084.0,2020-01-20,"(457.75, 745.5]",2,1,1
31084.0,2020-01-20,"(1033.25, 1321.0]",1,2,-1
31085.0,2020-01-20,"(639.75, 787.5]",1,1,0
31085.0,2020-01-20,"(935.25, 1083.0]",4,1,3
31086.0,2020-01-20,"(839.878, 870.5]",1,1,0
31086.0,2020-01-20,"(931.5, 962.0]",1,2,-1
31087.0,2020-01-20,"(735.0, 980.0]",1,1,0
31088.0,2020-01-20,"(795.75, 1061.0]",2,1,1
31089.0,2020-01-20,"(333.75, 657.5]",1,2,-1
31089.0,2020-01-20,"(657.5, 981.25]",2,1,1
31089.0,2020-01-20,"(981.25, 1305.0]",2,10,-8
,,,,2.0,
31091.0,2020-01-20,"(638.75, 871.5]",1,3,-2
31091.0,2020-01-20,"(1104.25, 1337.0]",3,1,2
,,,,2.0,
,,,,1.0,
,,,,1.0,
,,,,2.0,
31094.0,2020-01-20,"(466.707, 540.25]",1,1,0
31094.0,2020-01-20,"(686.75, 760.0]",2,4,-2
31095.0,2020-01-20,"(793.25, 818.0]",1,1,0
31096.0,2020-01-20,"(516.385, 670.75]",1,2,-1
31097.0,2020-01-20,"(471.27, 654.5]",3,7,-4
31098.0,2020-01-20,"(598.0, 751.0]",1,2,-1
31098.0,2020-01-20,"(751.0, 904.0]",1,1,0
31098.0,2020-01-20,"(904.0, 1057.0]",2,1,1
,,,,1.0,
,,,,1.0,
31100.0,2020-01-20,"(641.5, 958.25]",2,2,0
31101.0,2020-01-20,"(1.583, 357.25]",1,3,-2
31101.0,2020-01-20,"(357.25, 711.5]",15,33,-18
31101.0,2020-01-20,"(711.5, 1065.75]",24,42,-18
31101.0,2020-01-20,"(1065.75, 1420.0]",16,26,-10
31102.0,2020-01-20,"(602.5, 896.25]",4,1,3
31102.0,2020-01-20,"(896.25, 1190.0]",6,2,4
31103.0,2020-01-20,"(298.988, 553.0]",3,8,-5
31103.0,2020-01-20,"(553.0, 806.0]",7,18,-11
31103.0,2020-01-20,"(806.0, 1059.0]",2,11,-9
31103.0,2020-01-20,"(1059.0, 1312.0]",5,8,-3
31104.0,2020-01-20,"(599.5, 847.0]",11,7,4
31104.0,2020-01-20,"(847.0, 1094.5]",7,19,-12
31104.0,2020-01-20,"(1094.5, 1342.0]",3,17,-14
31105.0,2020-01-20,"(536.475, 668.25]",1,3,-2
31105.0,2020-01-20,"(668.25, 799.5]",1,2,-1
31106.0,2020-01-20,"(530.187, 734.25]",2,3,-1
31106.0,2020-01-20,"(734.25, 937.5]",1,2,-1
31106.0,2020-01-20,"(1140.75, 1344.0]",3,3,0
31107.0,2020-01-20,"(368.297, 544.75]",1,6,-5
31107.0,2020-01-20,"(544.75, 720.5]",4,10,-6
31107.0,2020-01-20,"(720.5, 896.25]",8,18,-10
31107.0,2020-01-20,"(896.25, 1072.0]",5,11,-6
31108.0,2020-01-20,"(47.671, 381.25]",2,2,0
31108.0,2020-01-20,"(381.25, 713.5]",3,9,-6
31108.0,2020-01-20,"(713.5, 1045.75]",15,29,-14
31108.0,2020-01-20,"(1045.75, 1378.0]",8,13,-5
31109.0,2020-01-20,"(14.72, 336.0]",2,5,-3
31109.0,2020-01-20,"(336.0, 656.0]",3,8,-5
31109.0,2020-01-20,"(656.0, 976.0]",8,17,-9
31109.0,2020-01-20,"(976.0, 1296.0]",8,17,-9
31110.0,2020-01-20,"(440.068, 674.0]",6,10,-4
31110.0,2020-01-20,"(674.0, 907.0]",3,9,-6
31110.0,2020-01-20,"(907.0, 1140.0]",12,20,-8
31110.0,2020-01-20,"(1140.0, 1373.0]",3,7,-4
31111.0,2020-01-20,"(343.5, 663.0]",2,4,-2
31111.0,2020-01-20,"(663.0, 982.5]",9,4,5
31111.0,2020-01-20,"(982.5, 1302.0]",9,17,-8
31112.0,2020-01-20,"(695.487, 824.25]",1,1,0
31112.0,2020-01-20,"(824.25, 952.5]",3,4,-1
31112.0,2020-01-20,"(1080.75, 1209.0]",1,1,0
31113.0,2020-01-20,"(418.092, 646.0]",1,8,-7
31113.0,2020-01-20,"(646.0, 873.0]",1,3,-2
31113.0,2020-01-20,"(873.0, 1100.0]",2,7,-5
31113.0,2020-01-20,"(1100.0, 1327.0]",3,11,-8
31114.0,2020-01-20,"(5.578, 362.5]",2,3,-1
31114.0,2020-01-20,"(362.5, 718.0]",2,15,-13
31114.0,2020-01-20,"(718.0, 1073.5]",8,15,-7
31114.0,2020-01-20,"(1073.5, 1429.0]",5,17,-12
31115.0,2020-01-20,"(403.014, 650.5]",2,6,-4
31115.0,2020-01-20,"(650.5, 897.0]",2,9,-7
31115.0,2020-01-20,"(897.0, 1143.5]",3,9,-6
31115.0,2020-01-20,"(1143.5, 1390.0]",3,6,-3
31116.0,2020-01-20,"(23.66, 360.0]",3,3,0
31116.0,2020-01-20,"(360.0, 695.0]",6,14,-8
31116.0,2020-01-20,"(695.0, 1030.0]",11,19,-8
31116.0,2020-01-20,"(1030.0, 1365.0]",8,14,-6
31117.0,2020-01-20,"(381.122, 601.5]",4,12,-8
31117.0,2020-01-20,"(821.0, 1040.5]",4,11,-7
31117.0,2020-01-20,"(1040.5, 1260.0]",4,9,-5
31118.0,2020-01-20,"(492.219, 688.25]",2,9,-7
31118.0,2020-01-20,"(688.25, 883.5]",1,2,-1
31118.0,2020-01-20,"(883.5, 1078.75]",5,7,-2
31118.0,2020-01-20,"(1078.75, 1274.0]",3,5,-2
31119.0,2020-01-20,"(462.175, 669.25]",4,9,-5
31119.0,2020-01-20,"(669.25, 875.5]",5,9,-4
31119.0,2020-01-20,"(875.5, 1081.75]",3,7,-4
31119.0,2020-01-20,"(1081.75, 1288.0]",6,8,-2
31120.0,2020-01-20,"(683.5, 924.0]",6,1,5
31120.0,2020-01-20,"(924.0, 1164.5]",3,9,-6
31120.0,2020-01-20,"(1164.5, 1405.0]",2,8,-6
31121.0,2020-01-20,"(422.197, 623.75]",8,10,-2
31121.0,2020-01-20,"(623.75, 824.5]",4,5,-1
31121.0,2020-01-20,"(824.5, 1025.25]",4,8,-4
31121.0,2020-01-20,"(1025.25, 1226.0]",9,9,0
31122.0,2020-01-20,"(175.855, 463.25]",2,4,-2
31122.0,2020-01-20,"(463.25, 749.5]",3,7,-4
31122.0,2020-01-20,"(749.5, 1035.75]",3,7,-4
31122.0,2020-01-20,"(1035.75, 1322.0]",3,4,-1
31123.0,2020-01-20,"(47.653, 385.75]",1,2,-1
31123.0,2020-01-20,"(385.75, 722.5]",1,6,-5
31123.0,2020-01-20,"(722.5, 1059.25]",2,6,-4
31123.0,2020-01-20,"(1059.25, 1396.0]",6,13,-7
31124.0,2020-01-20,"(28.638, 370.5]",3,3,0
31124.0,2020-01-20,"(370.5, 711.0]",8,19,-11
31124.0,2020-01-20,"(711.0, 1051.5]",12,36,-24
31124.0,2020-01-20,"(1051.5, 1392.0]",9,27,-18
31125.0,2020-01-20,"(47.689, 376.75]",3,3,0
31125.0,2020-01-20,"(376.75, 704.5]",8,17,-9
31125.0,2020-01-20,"(704.5, 1032.25]",14,35,-21
31125.0,2020-01-20,"(1032.25, 1360.0]",11,19,-8
31126.0,2020-01-20,"(33.684, 364.0]",2,3,-1
31126.0,2020-01-20,"(693.0, 1022.0]",4,4,0
31126.0,2020-01-20,"(1022.0, 1351.0]",7,13,-6
,,,,2.0,
31128.0,2020-01-20,"(49.799, 351.25]",1,2,-1
31128.0,2020-01-20,"(351.25, 651.5]",7,10,-3
31128.0,2020-01-20,"(651.5, 951.75]",9,23,-14
31128.0,2020-01-20,"(951.75, 1252.0]",15,20,-5
31129.0,2020-01-20,"(579.469, 712.75]",1,2,-1
31129.0,2020-01-20,"(712.75, 845.5]",4,7,-3
31129.0,2020-01-20,"(845.5, 978.25]",1,2,-1
31129.0,2020-01-20,"(978.25, 1111.0]",1,3,-2
31130.0,2020-01-20,"(482.313, 654.75]",2,5,-3
31130.0,2020-01-20,"(654.75, 826.5]",3,6,-3
31130.0,2020-01-20,"(826.5, 998.25]",1,1,0
31130.0,2020-01-20,"(998.25, 1170.0]",5,10,-5
31131.0,2020-01-20,"(654.5, 870.0]",1,6,-5
31131.0,2020-01-20,"(1085.5, 1301.0]",3,2,1
31200.0,2020-01-20,"(562.143, 777.25]",9,11,-2
31200.0,2020-01-20,"(777.25, 991.5]",7,12,-5
31200.0,2020-01-20,"(991.5, 1205.75]",6,13,-7
31200.0,2020-01-20,"(1205.75, 1420.0]",3,9,-6
31201.0,2020-01-20,"(97.702, 423.5]",1,2,-1
31201.0,2020-01-20,"(423.5, 748.0]",17,35,-18
31201.0,2020-01-20,"(748.0, 1072.5]",36,60,-24
31201.0,2020-01-20,"(1072.5, 1397.0]",15,32,-17
31202.0,2020-01-20,"(46.647, 386.25]",1,3,-2
31202.0,2020-01-20,"(386.25, 724.5]",8,12,-4
31202.0,2020-01-20,"(724.5, 1062.75]",23,39,-16
31202.0,2020-01-20,"(1062.75, 1401.0]",9,20,-11
31203.0,2020-01-20,"(28.643, 369.25]",4,8,-4
31203.0,2020-01-20,"(369.25, 708.5]",6,13,-7
31203.0,2020-01-20,"(708.5, 1047.75]",22,38,-16
31203.0,2020-01-20,"(1047.75, 1387.0]",7,14,-7
31204.0,2020-01-20,"(514.098, 740.5]",1,8,-7
31204.0,2020-01-20,"(740.5, 966.0]",6,10,-4
31204.0,2020-01-20,"(966.0, 1191.5]",2,7,-5
31204.0,2020-01-20,"(1191.5, 1417.0]",2,4,-2
31205.0,2020-01-20,"(544.387, 698.25]",3,3,0
31205.0,2020-01-20,"(698.25, 851.5]",2,5,-3
31205.0,2020-01-20,"(851.5, 1004.75]",6,10,-4
31205.0,2020-01-20,"(1004.75, 1158.0]",3,10,-7
,,,,1.0,
,,,,2.0,
31207.0,2020-01-20,"(674.295, 851.25]",2,4,-2
31207.0,2020-01-20,"(1203.75, 1380.0]",2,5,-3
31208.0,2020-01-20,"(622.561, 732.75]",2,5,-3
31208.0,2020-01-20,"(952.25, 1062.0]",2,1,1
31209.0,2020-01-20,"(512.249, 700.75]",1,2,-1
31209.0,2020-01-20,"(700.75, 888.5]",2,4,-2
31209.0,2020-01-20,"(888.5, 1076.25]",2,3,-1
31209.0,2020-01-20,"(1076.25, 1264.0]",2,2,0
31211.0,2020-01-20,"(633.59, 736.5]",3,3,0
31211.0,2020-01-20,"(736.5, 839.0]",2,4,-2
31211.0,2020-01-20,"(941.5, 1044.0]",3,3,0
31212.0,2020-01-20,"(411.985, 666.75]",10,12,-2
31212.0,2020-01-20,"(666.75, 920.5]",4,7,-3
31212.0,2020-01-20,"(920.5, 1174.25]",9,13,-4
31212.0,2020-01-20,"(1174.25, 1428.0]",6,10,-4
31213.0,2020-01-20,"(487.227, 681.25]",5,8,-3
31213.0,2020-01-20,"(681.25, 874.5]",5,9,-4
31213.0,2020-01-20,"(874.5, 1067.75]",5,7,-2
31214.0,2020-01-20,"(299.868, 584.0]",3,9,-6
31214.0,2020-01-20,"(584.0, 867.0]",9,21,-12
31214.0,2020-01-20,"(867.0, 1150.0]",20,30,-10
31214.0,2020-01-20,"(1150.0, 1433.0]",8,10,-2
31215.0,2020-01-20,"(526.449, 664.75]",4,4,0
31215.0,2020-01-20,"(664.75, 802.5]",3,3,0
31215.0,2020-01-20,"(802.5, 940.25]",3,4,-1
31215.0,2020-01-20,"(940.25, 1078.0]",8,11,-3
31216.0,2020-01-20,"(332.224, 527.0]",2,3,-1
31216.0,2020-01-20,"(527.0, 721.0]",2,2,0
31216.0,2020-01-20,"(721.0, 915.0]",1,1,0
31216.0,2020-01-20,"(915.0, 1109.0]",1,3,-2
31217.0,2020-01-20,"(608.289, 786.75]",4,8,-4
31217.0,2020-01-20,"(786.75, 964.5]",2,5,-3
31217.0,2020-01-20,"(1142.25, 1320.0]",1,3,-2
31218.0,2020-01-20,"(752.362, 912.5]",1,5,-4
31218.0,2020-01-20,"(912.5, 1072.0]",1,1,0
31218.0,2020-01-20,"(1072.0, 1231.5]",2,3,-1
31218.0,2020-01-20,"(1231.5, 1391.0]",1,1,0
31219.0,2020-01-20,"(544.473, 676.75]",5,5,0
31219.0,2020-01-20,"(676.75, 808.5]",2,2,0
31219.0,2020-01-20,"(808.5, 940.25]",4,5,-1
31219.0,2020-01-20,"(940.25, 1072.0]",1,7,-6
31220.0,2020-01-20,"(782.772, 840.0]",1,4,-3
31221.0,2020-01-20,"(473.184, 678.0]",4,4,0
31221.0,2020-01-20,"(678.0, 882.0]",6,10,-4
31221.0,2020-01-20,"(882.0, 1086.0]",7,15,-8
31221.0,2020-01-20,"(1086.0, 1290.0]",2,8,-6
31222.0,2020-01-20,"(326.056, 563.0]",2,4,-2
31222.0,2020-01-20,"(563.0, 799.0]",1,1,0
31222.0,2020-01-20,"(799.0, 1035.0]",1,2,-1
31222.0,2020-01-20,"(1035.0, 1271.0]",3,4,-1
31223.0,2020-01-20,"(49.695, 377.25]",1,2,-1
31223.0,2020-01-20,"(377.25, 703.5]",6,9,-3
31223.0,2020-01-20,"(703.5, 1029.75]",14,26,-12
31223.0,2020-01-20,"(1029.75, 1356.0]",2,6,-4
31224.0,2020-01-20,"(493.393, 645.75]",4,4,0
31224.0,2020-01-20,"(645.75, 797.5]",2,3,-1
31224.0,2020-01-20,"(797.5, 949.25]",2,4,-2
31224.0,2020-01-20,"(949.25, 1101.0]",2,7,-5
31225.0,2020-01-20,"(420.204, 620.0]",2,5,-3
31225.0,2020-01-20,"(620.0, 819.0]",2,7,-5
31225.0,2020-01-20,"(819.0, 1018.0]",8,13,-5
31225.0,2020-01-20,"(1018.0, 1217.0]",3,7,-4
31226.0,2020-01-20,"(660.429, 803.75]",2,4,-2
31226.0,2020-01-20,"(803.75, 946.5]",1,3,-2
31226.0,2020-01-20,"(946.5, 1089.25]",2,5,-3
31227.0,2020-01-20,"(468.189, 671.75]",6,6,0
31227.0,2020-01-20,"(671.75, 874.5]",6,10,-4
31227.0,2020-01-20,"(874.5, 1077.25]",2,5,-3
31227.0,2020-01-20,"(1077.25, 1280.0]",1,2,-1
31228.0,2020-01-20,"(433.071, 666.25]",5,7,-2
31228.0,2020-01-20,"(666.25, 898.5]",8,12,-4
31228.0,2020-01-20,"(898.5, 1130.75]",5,10,-5
31228.0,2020-01-20,"(1130.75, 1363.0]",3,8,-5
31229.0,2020-01-20,"(13.62, 360.0]",2,3,-1
31229.0,2020-01-20,"(360.0, 705.0]",8,22,-14
31229.0,2020-01-20,"(705.0, 1050.0]",19,40,-21
31229.0,2020-01-20,"(1050.0, 1395.0]",14,30,-16
31230.0,2020-01-20,"(390.158, 601.5]",6,7,-1
31230.0,2020-01-20,"(601.5, 812.0]",9,10,-1
31230.0,2020-01-20,"(812.0, 1022.5]",8,18,-10
31230.0,2020-01-20,"(1022.5, 1233.0]",7,18,-11
31231.0,2020-01-20,"(662.7, 738.0]",3,3,0
31231.0,2020-01-20,"(738.0, 813.0]",2,2,0
31231.0,2020-01-20,"(888.0, 963.0]",2,1,1
31232.0,2020-01-20,"(476.12, 697.0]",6,7,-1
31232.0,2020-01-20,"(697.0, 917.0]",10,14,-4
31232.0,2020-01-20,"(917.0, 1137.0]",4,10,-6
31232.0,2020-01-20,"(1137.0, 1357.0]",3,6,-3
31233.0,2020-01-20,"(492.154, 704.5]",4,4,0
31233.0,2020-01-20,"(916.0, 1127.5]",2,1,1
31233.0,2020-01-20,"(1127.5, 1339.0]",1,4,-3
31234.0,2020-01-20,"(32.673, 365.75]",1,2,-1
31234.0,2020-01-20,"(365.75, 697.5]",4,7,-3
31234.0,2020-01-20,"(697.5, 1029.25]",4,8,-4
31234.0,2020-01-20,"(1029.25, 1361.0]",3,10,-7
31235.0,2020-01-20,"(614.25, 819.0]",1,1,0
31236.0,2020-01-20,"(-0.188, 298.0]",2,2,0
31236.0,2020-01-20,"(298.0, 595.0]",3,3,0
31236.0,2020-01-20,"(595.0, 892.0]",9,17,-8
31236.0,2020-01-20,"(892.0, 1189.0]",7,13,-6
31237.0,2020-01-20,"(496.169, 704.75]",1,4,-3
31237.0,2020-01-20,"(704.75, 912.5]",5,11,-6
31237.0,2020-01-20,"(912.5, 1120.25]",8,14,-6
31237.0,2020-01-20,"(1120.25, 1328.0]",2,6,-4
31238.0,2020-01-20,"(57.878, 339.5]",1,1,0
31238.0,2020-01-20,"(339.5, 620.0]",3,4,-1
31238.0,2020-01-20,"(620.0, 900.5]",5,8,-3
31238.0,2020-01-20,"(900.5, 1181.0]",1,8,-7
31239.0,2020-01-20,"(194.818, 491.5]",3,4,-1
31239.0,2020-01-20,"(491.5, 787.0]",11,15,-4
31239.0,2020-01-20,"(787.0, 1082.5]",5,14,-9
31239.0,2020-01-20,"(1082.5, 1378.0]",2,4,-2
31240.0,2020-01-20,"(624.593, 726.75]",3,3,0
31240.0,2020-01-20,"(828.5, 930.25]",6,4,2
31240.0,2020-01-20,"(930.25, 1032.0]",7,6,1
31241.0,2020-01-20,"(394.0, 676.0]",5,1,4
31241.0,2020-01-20,"(676.0, 958.0]",8,13,-5
31241.0,2020-01-20,"(958.0, 1240.0]",14,19,-5
31242.0,2020-01-20,"(135.083, 365.25]",1,1,0
31242.0,2020-01-20,"(365.25, 594.5]",2,2,0
31242.0,2020-01-20,"(594.5, 823.75]",2,2,0
31242.0,2020-01-20,"(823.75, 1053.0]",1,5,-4
31243.0,2020-01-20,"(432.151, 645.25]",2,4,-2
31243.0,2020-01-20,"(645.25, 857.5]",2,4,-2
31243.0,2020-01-20,"(857.5, 1069.75]",4,5,-1
31243.0,2020-01-20,"(1069.75, 1282.0]",3,6,-3
31244.0,2020-01-20,"(463.065, 697.75]",2,5,-3
31244.0,2020-01-20,"(697.75, 931.5]",3,6,-3
31244.0,2020-01-20,"(931.5, 1165.25]",2,6,-4
31244.0,2020-01-20,"(1165.25, 1399.0]",2,4,-2
31245.0,2020-01-20,"(417.0, 705.0]",6,2,4
31245.0,2020-01-20,"(705.0, 993.0]",3,10,-7
31245.0,2020-01-20,"(993.0, 1281.0]",4,13,-9
31246.0,2020-01-20,"(423.168, 632.0]",7,11,-4
31246.0,2020-01-20,"(632.0, 840.0]",9,14,-5
31246.0,2020-01-20,"(840.0, 1048.0]",11,27,-16
31246.0,2020-01-20,"(1048.0, 1256.0]",7,10,-3
31247.0,2020-01-20,"(541.502, 666.5]",6,8,-2
31247.0,2020-01-20,"(666.5, 791.0]",3,6,-3
31247.0,2020-01-20,"(791.0, 915.5]",6,11,-5
31247.0,2020-01-20,"(915.5, 1040.0]",3,11,-8
31248.0,2020-01-20,"(609.25, 761.5]",4,3,1
31248.0,2020-01-20,"(761.5, 913.75]",9,6,3
31248.0,2020-01-20,"(913.75, 1066.0]",7,11,-4
31249.0,2020-01-20,"(783.735, 850.25]",1,4,-3
31249.0,2020-01-20,"(850.25, 916.5]",1,2,-1
31249.0,2020-01-20,"(982.75, 1049.0]",1,1,0
31250.0,2020-01-20,"(465.354, 627.5]",7,7,0
31250.0,2020-01-20,"(950.5, 1112.0]",4,1,3
31251.0,2020-01-20,"(451.103, 676.25]",1,6,-5
31251.0,2020-01-20,"(676.25, 900.5]",4,9,-5
31251.0,2020-01-20,"(900.5, 1124.75]",3,10,-7
31251.0,2020-01-20,"(1124.75, 1349.0]",4,5,-1
31252.0,2020-01-20,"(375.446, 514.5]",1,2,-1
31252.0,2020-01-20,"(653.0, 791.5]",1,2,-1
31252.0,2020-01-20,"(791.5, 930.0]",2,3,-1
31253.0,2020-01-20,"(420.235, 612.25]",2,2,0
31253.0,2020-01-20,"(612.25, 803.5]",2,3,-1
31253.0,2020-01-20,"(803.5, 994.75]",5,5,0
31254.0,2020-01-20,"(56.826, 351.5]",1,1,0
31254.0,2020-01-20,"(351.5, 645.0]",2,2,0
31254.0,2020-01-20,"(645.0, 938.5]",4,6,-2
31255.0,2020-01-20,"(424.119, 645.25]",2,4,-2
31255.0,2020-01-20,"(645.25, 865.5]",3,3,0
31255.0,2020-01-20,"(865.5, 1085.75]",3,6,-3
31255.0,2020-01-20,"(1085.75, 1306.0]",4,5,-1
31256.0,2020-01-20,"(322.75, 607.5]",2,1,1
31256.0,2020-01-20,"(892.25, 1177.0]",4,2,2
31257.0,2020-01-20,"(388.0, 639.0]",4,6,-2
31257.0,2020-01-20,"(639.0, 889.0]",5,10,-5
31257.0,2020-01-20,"(889.0, 1139.0]",7,11,-4
31257.0,2020-01-20,"(1139.0, 1389.0]",4,9,-5
31258.0,2020-01-20,"(512.411, 660.25]",4,6,-2
31258.0,2020-01-20,"(660.25, 807.5]",2,3,-1
31258.0,2020-01-20,"(807.5, 954.75]",2,7,-5
31258.0,2020-01-20,"(954.75, 1102.0]",8,13,-5
31259.0,2020-01-20,"(716.576, 823.0]",1,2,-1
31259.0,2020-01-20,"(1035.0, 1141.0]",2,2,0
31260.0,2020-01-20,"(673.618, 769.5]",1,2,-1
31261.0,2020-01-20,"(806.692, 884.0]",1,3,-2
31261.0,2020-01-20,"(884.0, 961.0]",2,2,0
31261.0,2020-01-20,"(1038.0, 1115.0]",1,1,0
31262.0,2020-01-20,"(738.399, 889.25]",2,3,-1
31262.0,2020-01-20,"(889.25, 1039.5]",2,3,-1
31262.0,2020-01-20,"(1039.5, 1189.75]",1,7,-6
31263.0,2020-01-20,"(382.086, 611.5]",5,6,-1
31263.0,2020-01-20,"(611.5, 840.0]",5,8,-3
31263.0,2020-01-20,"(840.0, 1068.5]",6,10,-4
31263.0,2020-01-20,"(1068.5, 1297.0]",2,7,-5
31264.0,2020-01-20,"(528.238, 719.5]",3,4,-1
31264.0,2020-01-20,"(719.5, 910.0]",2,2,0
31264.0,2020-01-20,"(910.0, 1100.5]",2,5,-3
31264.0,2020-01-20,"(1100.5, 1291.0]",2,3,-1
31265.0,2020-01-20,"(403.074, 635.5]",1,2,-1
31265.0,2020-01-20,"(635.5, 867.0]",5,13,-8
31265.0,2020-01-20,"(867.0, 1098.5]",11,15,-4
31265.0,2020-01-20,"(1098.5, 1330.0]",3,9,-6
31266.0,2020-01-20,"(5.66, 342.0]",1,6,-5
31266.0,2020-01-20,"(342.0, 677.0]",4,15,-11
31266.0,2020-01-20,"(677.0, 1012.0]",12,35,-23
31266.0,2020-01-20,"(1012.0, 1347.0]",14,26,-12
31267.0,2020-01-20,"(391.5, 732.0]",3,2,1
31267.0,2020-01-20,"(732.0, 1072.5]",4,10,-6
31267.0,2020-01-20,"(1072.5, 1413.0]",7,8,-1
31268.0,2020-01-20,"(21.681, 352.75]",3,5,-2
31268.0,2020-01-20,"(352.75, 682.5]",9,20,-11
31268.0,2020-01-20,"(682.5, 1012.25]",8,18,-10
31268.0,2020-01-20,"(1012.25, 1342.0]",11,16,-5
31269.0,2020-01-20,"(600.359, 761.25]",3,6,-3
31269.0,2020-01-20,"(761.25, 921.5]",1,2,-1
31269.0,2020-01-20,"(921.5, 1081.75]",1,4,-3
31269.0,2020-01-20,"(1081.75, 1242.0]",2,5,-3
31270.0,2020-01-20,"(331.162, 541.5]",1,2,-1
31270.0,2020-01-20,"(541.5, 751.0]",4,4,0
31270.0,2020-01-20,"(751.0, 960.5]",2,5,-3
31270.0,2020-01-20,"(960.5, 1170.0]",4,9,-5
31271.0,2020-01-20,"(585.509, 708.75]",1,1,0
31271.0,2020-01-20,"(708.75, 831.5]",2,2,0
31271.0,2020-01-20,"(831.5, 954.25]",3,6,-3
31271.0,2020-01-20,"(954.25, 1077.0]",2,4,-2
31272.0,2020-01-20,"(510.109, 733.75]",4,5,-1
31272.0,2020-01-20,"(733.75, 956.5]",1,4,-3
31272.0,2020-01-20,"(956.5, 1179.25]",4,10,-6
31272.0,2020-01-20,"(1179.25, 1402.0]",2,3,-1
31273.0,2020-01-20,"(784.75, 865.5]",1,2,-1
31273.0,2020-01-20,"(946.25, 1027.0]",1,1,0
31274.0,2020-01-20,"(583.3, 759.0]",4,6,-2
31274.0,2020-01-20,"(759.0, 934.0]",3,8,-5
31274.0,2020-01-20,"(934.0, 1109.0]",2,4,-2
31275.0,2020-01-20,"(332.962, 593.5]",5,11,-6
31275.0,2020-01-20,"(593.5, 853.0]",2,10,-8
31275.0,2020-01-20,"(853.0, 1112.5]",6,9,-3
31275.0,2020-01-20,"(1112.5, 1372.0]",6,8,-2
31276.0,2020-01-20,"(546.206, 745.5]",5,5,0
31276.0,2020-01-20,"(745.5, 944.0]",1,2,-1
31276.0,2020-01-20,"(944.0, 1142.5]",4,7,-3
31277.0,2020-01-20,"(544.384, 699.0]",3,4,-1
31277.0,2020-01-20,"(699.0, 853.0]",4,6,-2
31277.0,2020-01-20,"(853.0, 1007.0]",1,3,-2
31277.0,2020-01-20,"(1007.0, 1161.0]",1,3,-2
31278.0,2020-01-20,"(10.752, 324.0]",1,1,0
31278.0,2020-01-20,"(324.0, 636.0]",8,12,-4
31278.0,2020-01-20,"(636.0, 948.0]",11,19,-8
31278.0,2020-01-20,"(948.0, 1260.0]",7,13,-6
31279.0,2020-01-20,"(1019.5, 1100.0]",1,1,0
31280.0,2020-01-20,"(73.705, 398.75]",1,2,-1
31280.0,2020-01-20,"(398.75, 722.5]",5,11,-6
31280.0,2020-01-20,"(722.5, 1046.25]",7,16,-9
31280.0,2020-01-20,"(1046.25, 1370.0]",3,7,-4
31000.0,2020-01-21,"(816.0, 1088.0]",2,1,1
,,,,1.0,
,,,,2.0,
31002.0,2020-01-21,"(506.423, 651.25]",1,3,-2
31002.0,2020-01-21,"(939.75, 1084.0]",1,3,-2
31003.0,2020-01-21,"(379.243, 569.25]",1,3,-2
31003.0,2020-01-21,"(569.25, 758.5]",1,2,-1
31003.0,2020-01-21,"(758.5, 947.75]",1,1,0
31003.0,2020-01-21,"(947.75, 1137.0]",2,7,-5
31004.0,2020-01-21,"(820.5, 1094.0]",1,1,0
31005.0,2020-01-21,"(435.286, 614.5]",2,2,0
31005.0,2020-01-21,"(793.0, 971.5]",1,1,0
31005.0,2020-01-21,"(971.5, 1150.0]",1,4,-3
31006.0,2020-01-21,"(1123.862, 1158.5]",1,1,0
31007.0,2020-01-21,"(362.101, 587.75]",7,20,-13
31007.0,2020-01-21,"(587.75, 812.5]",3,7,-4
31007.0,2020-01-21,"(812.5, 1037.25]",3,7,-4
31007.0,2020-01-21,"(1037.25, 1262.0]",5,11,-6
31009.0,2020-01-21,"(472.644, 562.0]",3,3,0
31009.0,2020-01-21,"(740.0, 829.0]",2,3,-1
31010.0,2020-01-21,"(428.074, 660.5]",1,1,0
31011.0,2020-01-21,"(434.301, 609.75]",6,6,0
31011.0,2020-01-21,"(784.5, 959.25]",1,2,-1
31011.0,2020-01-21,"(959.25, 1134.0]",3,7,-4
31012.0,2020-01-21,"(365.336, 532.0]",6,6,0
31013.0,2020-01-21,"(762.0, 948.0]",1,1,0
31013.0,2020-01-21,"(948.0, 1134.0]",1,1,0
31014.0,2020-01-21,"(399.072, 632.0]",14,18,-4
31014.0,2020-01-21,"(632.0, 864.0]",1,4,-3
31014.0,2020-01-21,"(864.0, 1096.0]",9,12,-3
31014.0,2020-01-21,"(1096.0, 1328.0]",6,12,-6
31015.0,2020-01-21,"(428.155, 640.25]",14,15,-1
31015.0,2020-01-21,"(640.25, 851.5]",2,2,0
31015.0,2020-01-21,"(851.5, 1062.75]",4,6,-2
31015.0,2020-01-21,"(1062.75, 1274.0]",4,5,-1
31016.0,2020-01-21,"(384.055, 621.25]",6,11,-5
31016.0,2020-01-21,"(621.25, 857.5]",1,3,-2
31016.0,2020-01-21,"(857.5, 1093.75]",2,5,-3
31016.0,2020-01-21,"(1093.75, 1330.0]",1,2,-1
31017.0,2020-01-21,"(490.115, 712.25]",8,9,-1
31017.0,2020-01-21,"(712.25, 933.5]",2,5,-3
31017.0,2020-01-21,"(1154.75, 1376.0]",1,5,-4
31018.0,2020-01-21,"(1044.75, 1255.0]",2,6,-4
31019.0,2020-01-21,"(977.5, 1150.75]",1,1,0
31019.0,2020-01-21,"(1150.75, 1324.0]",1,1,0
31020.0,2020-01-21,"(1121.984, 1126.0]",1,1,0
31021.0,2020-01-21,"(378.083, 608.25]",2,5,-3
31021.0,2020-01-21,"(608.25, 837.5]",1,2,-1
31021.0,2020-01-21,"(837.5, 1066.75]",1,4,-3
31021.0,2020-01-21,"(1066.75, 1296.0]",2,7,-5
31022.0,2020-01-21,"(494.364, 654.0]",3,7,-4
31022.0,2020-01-21,"(972.0, 1131.0]",2,8,-6
31023.0,2020-01-21,"(391.062, 626.5]",1,2,-1
31024.0,2020-01-21,"(379.092, 607.0]",5,6,-1
31024.0,2020-01-21,"(607.0, 834.0]",1,1,0
31024.0,2020-01-21,"(834.0, 1061.0]",1,5,-4
31024.0,2020-01-21,"(1061.0, 1288.0]",4,9,-5
31025.0,2020-01-21,"(1217.991, 1220.25]",1,1,0
31026.0,2020-01-21,"(869.0, 1102.0]",1,1,0
31027.0,2020-01-21,"(554.258, 740.5]",1,2,-1
31027.0,2020-01-21,"(1111.5, 1297.0]",1,1,0
31028.0,2020-01-21,"(467.184, 672.0]",2,5,-3
31028.0,2020-01-21,"(672.0, 876.0]",1,1,0
31028.0,2020-01-21,"(1080.0, 1284.0]",2,1,1
31029.0,2020-01-21,"(926.0, 1132.0]",4,6,-2
31029.0,2020-01-21,"(1132.0, 1338.0]",2,1,1
31030.0,2020-01-21,"(376.079, 607.25]",1,11,-10
31030.0,2020-01-21,"(837.5, 1067.75]",3,3,0
31030.0,2020-01-21,"(1067.75, 1298.0]",4,4,0
31031.0,2020-01-21,"(570.277, 751.75]",1,1,0
31031.0,2020-01-21,"(932.5, 1113.25]",1,1,0
31032.0,2020-01-21,"(805.0, 972.0]",1,2,-1
31032.0,2020-01-21,"(972.0, 1139.0]",4,1,3
31033.0,2020-01-21,"(531.82, 577.0]",1,1,0
31034.0,2020-01-21,"(538.281, 718.75]",1,4,-3
31034.0,2020-01-21,"(1078.25, 1258.0]",2,1,1
31035.0,2020-01-21,"(413.994, 666.5]",1,3,-2
31035.0,2020-01-21,"(666.5, 918.0]",2,5,-3
31035.0,2020-01-21,"(918.0, 1169.5]",4,6,-2
31035.0,2020-01-21,"(1169.5, 1421.0]",2,4,-2
31036.0,2020-01-21,"(831.0, 985.0]",2,1,1
31036.0,2020-01-21,"(985.0, 1139.0]",2,1,1
31037.0,2020-01-21,"(412.128, 631.0]",7,10,-3
31037.0,2020-01-21,"(631.0, 849.0]",2,3,-1
31037.0,2020-01-21,"(849.0, 1067.0]",1,5,-4
31037.0,2020-01-21,"(1067.0, 1285.0]",1,5,-4
,,,,1.0,
,,,,1.0,
,,,,1.0,
31039.0,2020-01-21,"(377.194, 579.5]",2,5,-3
31039.0,2020-01-21,"(982.5, 1184.0]",2,3,-1
31040.0,2020-01-21,"(455.263, 640.25]",2,2,0
31040.0,2020-01-21,"(640.25, 824.5]",1,1,0
31040.0,2020-01-21,"(1008.75, 1193.0]",1,1,0
31041.0,2020-01-21,"(708.75, 888.5]",3,1,2
31041.0,2020-01-21,"(888.5, 1068.25]",1,3,-2
31041.0,2020-01-21,"(1068.25, 1248.0]",1,5,-4
31042.0,2020-01-21,"(446.238, 637.5]",6,7,-1
31043.0,2020-01-21,"(502.311, 675.25]",1,2,-1
31043.0,2020-01-21,"(675.25, 847.5]",1,2,-1
31043.0,2020-01-21,"(1019.75, 1192.0]",2,3,-1
31044.0,2020-01-21,"(481.19, 684.5]",1,2,-1
31044.0,2020-01-21,"(1089.5, 1292.0]",1,4,-3
31045.0,2020-01-21,"(552.5, 734.0]",1,2,-1
31045.0,2020-01-21,"(915.5, 1097.0]",3,2,1
31046.0,2020-01-21,"(916.5, 1222.0]",1,1,0
31047.0,2020-01-21,"(349.044, 589.0]",6,10,-4
31047.0,2020-01-21,"(589.0, 828.0]",2,2,0
31047.0,2020-01-21,"(828.0, 1067.0]",4,10,-6
31047.0,2020-01-21,"(1067.0, 1306.0]",5,16,-11
31048.0,2020-01-21,"(911.5, 1075.25]",2,2,0
31049.0,2020-01-21,"(891.75, 1189.0]",1,1,0
,,,,2.0,
31051.0,2020-01-21,"(813.5, 993.75]",2,5,-3
31051.0,2020-01-21,"(993.75, 1174.0]",9,2,7
31052.0,2020-01-21,"(927.0, 1236.0]",1,1,0
31053.0,2020-01-21,"(820.0, 924.0]",1,1,0
31054.0,2020-01-21,"(831.0, 1108.0]",1,1,0
31055.0,2020-01-21,"(302.25, 403.0]",1,1,0
31056.0,2020-01-21,"(905.5, 1135.75]",1,1,0
31056.0,2020-01-21,"(1135.75, 1366.0]",1,2,-1
,,,,2.0,
,,,,2.0,
,,,,2.0,
31060.0,2020-01-21,"(579.226, 773.5]",1,1,0
31060.0,2020-01-21,"(967.0, 1160.5]",1,1,0
31061.0,2020-01-21,"(541.5, 722.0]",1,1,0
31062.0,2020-01-21,"(513.404, 663.0]",2,4,-2
31062.0,2020-01-21,"(663.0, 812.0]",1,2,-1
31062.0,2020-01-21,"(961.0, 1110.0]",1,2,-1
,,,,2.0,
31064.0,2020-01-21,"(863.751, 926.25]",1,2,-1
31064.0,2020-01-21,"(988.5, 1050.75]",1,1,0
31064.0,2020-01-21,"(1050.75, 1113.0]",2,6,-4
31065.0,2020-01-21,"(830.0, 982.0]",1,1,0
,,,,2.0,
31067.0,2020-01-21,"(811.5, 999.0]",1,1,0
31067.0,2020-01-21,"(999.0, 1186.5]",2,2,0
31067.0,2020-01-21,"(1186.5, 1374.0]",1,2,-1
31068.0,2020-01-21,"(749.0, 951.0]",2,1,1
31068.0,2020-01-21,"(1153.0, 1355.0]",1,4,-3
31069.0,2020-01-21,"(842.0, 962.0]",2,1,1
31070.0,2020-01-21,"(577.214, 774.5]",1,2,-1
31070.0,2020-01-21,"(1167.5, 1364.0]",1,2,-1
31071.0,2020-01-21,"(903.5, 1092.75]",3,1,2
31071.0,2020-01-21,"(1092.75, 1282.0]",3,4,-1
,,,,2.0,
31073.0,2020-01-21,"(485.42, 631.0]",2,4,-2
31073.0,2020-01-21,"(921.0, 1066.0]",2,3,-1
31074.0,2020-01-21,"(507.22, 703.0]",1,4,-3
31074.0,2020-01-21,"(898.0, 1093.0]",4,5,-1
31074.0,2020-01-21,"(1093.0, 1288.0]",2,5,-3
31075.0,2020-01-21,"(976.5, 1122.0]",1,2,-1
31076.0,2020-01-21,"(901.5, 1202.0]",1,1,0
31077.0,2020-01-21,"(892.75, 1032.0]",1,1,0
31078.0,2020-01-21,"(489.386, 643.5]",2,4,-2
31078.0,2020-01-21,"(950.5, 1104.0]",2,2,0
31079.0,2020-01-21,"(463.084, 693.0]",1,7,-6
31079.0,2020-01-21,"(922.0, 1151.0]",4,2,2
31079.0,2020-01-21,"(1151.0, 1380.0]",7,7,0
31080.0,2020-01-21,"(618.75, 840.5]",1,7,-6
31080.0,2020-01-21,"(840.5, 1062.25]",2,1,1
31080.0,2020-01-21,"(1062.25, 1284.0]",7,3,4
31081.0,2020-01-21,"(474.281, 654.75]",2,2,0
,,,,2.0,
31083.0,2020-01-21,"(756.5, 935.25]",1,2,-1
31083.0,2020-01-21,"(935.25, 1114.0]",2,1,1
31084.0,2020-01-21,"(377.17, 585.5]",1,1,0
31084.0,2020-01-21,"(585.5, 793.0]",2,3,-1
31084.0,2020-01-21,"(793.0, 1000.5]",1,2,-1
31084.0,2020-01-21,"(1000.5, 1208.0]",1,4,-3
31085.0,2020-01-21,"(927.0, 1074.0]",2,1,1
31086.0,2020-01-21,"(761.5, 914.25]",1,2,-1
31086.0,2020-01-21,"(914.25, 1067.0]",3,2,1
31087.0,2020-01-21,"(738.441, 878.75]",1,2,-1
31087.0,2020-01-21,"(1018.5, 1158.25]",2,2,0
31087.0,2020-01-21,"(1158.25, 1298.0]",1,1,0
31088.0,2020-01-21,"(563.25, 740.5]",1,1,0
31088.0,2020-01-21,"(917.75, 1095.0]",3,2,1
31089.0,2020-01-21,"(475.218, 671.5]",4,6,-2
31089.0,2020-01-21,"(671.5, 867.0]",2,4,-2
31089.0,2020-01-21,"(867.0, 1062.5]",5,17,-12
31089.0,2020-01-21,"(1062.5, 1258.0]",2,7,-5
,,,,2.0,
31091.0,2020-01-21,"(870.0, 1088.0]",2,4,-2
31091.0,2020-01-21,"(1088.0, 1306.0]",2,2,0
31092.0,2020-01-21,"(1116.87, 1149.5]",2,3,-1
,,,,1.0,
,,,,2.0,
,,,,2.0,
,,,,4.0,
,,,,2.0,
,,,,1.0,
,,,,1.0,
31096.0,2020-01-21,"(1039.681, 1119.75]",1,2,-1
31096.0,2020-01-21,"(1119.75, 1199.5]",1,1,0
31096.0,2020-01-21,"(1199.5, 1279.25]",1,1,0
31096.0,2020-01-21,"(1279.25, 1359.0]",1,2,-1
31097.0,2020-01-21,"(470.328, 639.0]",1,2,-1
31097.0,2020-01-21,"(639.0, 807.0]",1,2,-1
31097.0,2020-01-21,"(975.0, 1143.0]",1,3,-2
31098.0,2020-01-21,"(439.161, 649.75]",6,9,-3
31098.0,2020-01-21,"(649.75, 859.5]",1,1,0
31098.0,2020-01-21,"(859.5, 1069.25]",3,4,-1
31098.0,2020-01-21,"(1069.25, 1279.0]",2,6,-4
31099.0,2020-01-21,"(668.5, 879.0]",1,2,-1
31099.0,2020-01-21,"(1089.5, 1300.0]",2,1,1
31100.0,2020-01-21,"(371.984, 627.0]",5,7,-2
31100.0,2020-01-21,"(627.0, 881.0]",2,5,-3
31100.0,2020-01-21,"(881.0, 1135.0]",5,16,-11
31101.0,2020-01-21,"(353.0, 691.0]",9,1,8
31101.0,2020-01-21,"(691.0, 1029.0]",18,34,-16
31101.0,2020-01-21,"(1029.0, 1367.0]",22,29,-7
31102.0,2020-01-21,"(361.968, 621.0]",1,10,-9
31102.0,2020-01-21,"(879.0, 1137.0]",8,6,2
31102.0,2020-01-21,"(1137.0, 1395.0]",4,13,-9
31103.0,2020-01-21,"(433.087, 662.25]",2,22,-20
31103.0,2020-01-21,"(662.25, 890.5]",1,10,-9
31103.0,2020-01-21,"(890.5, 1118.75]",4,14,-10
31103.0,2020-01-21,"(1118.75, 1347.0]",2,6,-4
31104.0,2020-01-21,"(385.25, 714.5]",4,3,1
31104.0,2020-01-21,"(714.5, 1043.75]",10,23,-13
31104.0,2020-01-21,"(1043.75, 1373.0]",12,18,-6
31105.0,2020-01-21,"(328.026, 572.5]",1,10,-9
31105.0,2020-01-21,"(572.5, 816.0]",1,3,-2
31105.0,2020-01-21,"(816.0, 1059.5]",1,5,-4
31105.0,2020-01-21,"(1059.5, 1303.0]",1,4,-3
31106.0,2020-01-21,"(858.5, 1071.25]",1,6,-5
31106.0,2020-01-21,"(1071.25, 1284.0]",4,2,2
31107.0,2020-01-21,"(374.5, 693.0]",4,6,-2
31107.0,2020-01-21,"(693.0, 1011.5]",3,27,-24
31107.0,2020-01-21,"(1011.5, 1330.0]",20,11,9
31108.0,2020-01-21,"(408.071, 641.25]",5,19,-14
31108.0,2020-01-21,"(641.25, 873.5]",5,11,-6
31108.0,2020-01-21,"(873.5, 1105.75]",9,19,-10
31108.0,2020-01-21,"(1105.75, 1338.0]",11,14,-3
31109.0,2020-01-21,"(400.09, 628.5]",4,15,-11
31109.0,2020-01-21,"(628.5, 856.0]",3,5,-2
31109.0,2020-01-21,"(856.0, 1083.5]",9,17,-8
31109.0,2020-01-21,"(1083.5, 1311.0]",16,21,-5
31110.0,2020-01-21,"(138.785, 443.75]",3,6,-3
31110.0,2020-01-21,"(443.75, 747.5]",13,26,-13
31110.0,2020-01-21,"(747.5, 1051.25]",10,20,-10
31110.0,2020-01-21,"(1051.25, 1355.0]",11,26,-15
31111.0,2020-01-21,"(348.996, 601.0]",5,14,-9
31111.0,2020-01-21,"(601.0, 852.0]",3,4,-1
31111.0,2020-01-21,"(852.0, 1103.0]",6,7,-1
31111.0,2020-01-21,"(1103.0, 1354.0]",6,9,-3
31112.0,2020-01-21,"(923.0, 1127.5]",1,3,-2
31112.0,2020-01-21,"(1127.5, 1332.0]",1,2,-1
31113.0,2020-01-21,"(343.013, 590.75]",1,20,-19
31113.0,2020-01-21,"(590.75, 837.5]",1,9,-8
31113.0,2020-01-21,"(837.5, 1084.25]",2,4,-2
31113.0,2020-01-21,"(1084.25, 1331.0]",10,18,-8
31114.0,2020-01-21,"(23.623, 369.25]",4,5,-1
31114.0,2020-01-21,"(369.25, 713.5]",4,23,-19
31114.0,2020-01-21,"(713.5, 1057.75]",9,21,-12
31114.0,2020-01-21,"(1057.75, 1402.0]",19,29,-10
31115.0,2020-01-21,"(446.062, 681.5]",3,21,-18
31115.0,2020-01-21,"(916.0, 1150.5]",12,3,9
31115.0,2020-01-21,"(1150.5, 1385.0]",4,16,-12
31116.0,2020-01-21,"(307.941, 573.75]",6,23,-17
31116.0,2020-01-21,"(573.75, 838.5]",2,3,-1
31116.0,2020-01-21,"(838.5, 1103.25]",12,14,-2
31116.0,2020-01-21,"(1103.25, 1368.0]",10,14,-4
31117.0,2020-01-21,"(315.965, 575.75]",2,19,-17
31117.0,2020-01-21,"(575.75, 834.5]",2,10,-8
31117.0,2020-01-21,"(834.5, 1093.25]",10,19,-9
31117.0,2020-01-21,"(1093.25, 1352.0]",9,20,-11
31118.0,2020-01-21,"(416.082, 646.5]",1,13,-12
31118.0,2020-01-21,"(876.0, 1105.5]",7,9,-2
31118.0,2020-01-21,"(1105.5, 1335.0]",9,13,-4
31119.0,2020-01-21,"(270.956, 533.0]",9,23,-14
31119.0,2020-01-21,"(533.0, 794.0]",2,3,-1
31119.0,2020-01-21,"(794.0, 1055.0]",6,10,-4
31119.0,2020-01-21,"(1055.0, 1316.0]",16,27,-11
31120.0,2020-01-21,"(488.16, 699.0]",2,10,-8
31120.0,2020-01-21,"(909.0, 1119.0]",5,6,-1
31120.0,2020-01-21,"(1119.0, 1329.0]",10,7,3
31121.0,2020-01-21,"(342.02, 588.0]",14,19,-5
31121.0,2020-01-21,"(588.0, 833.0]",1,3,-2
31121.0,2020-01-21,"(833.0, 1078.0]",4,10,-6
31121.0,2020-01-21,"(1078.0, 1323.0]",3,15,-12
31122.0,2020-01-21,"(469.096, 696.0]",4,11,-7
31122.0,2020-01-21,"(696.0, 922.0]",1,5,-4
31122.0,2020-01-21,"(922.0, 1148.0]",8,15,-7
31122.0,2020-01-21,"(1148.0, 1374.0]",4,6,-2
31123.0,2020-01-21,"(389.013, 636.75]",3,21,-18
31123.0,2020-01-21,"(636.75, 883.5]",1,1,0
31123.0,2020-01-21,"(883.5, 1130.25]",4,7,-3
31123.0,2020-01-21,"(1130.25, 1377.0]",4,6,-2
31124.0,2020-01-21,"(28.598, 380.5]",5,5,0
31124.0,2020-01-21,"(380.5, 731.0]",16,32,-16
31124.0,2020-01-21,"(731.0, 1081.5]",13,33,-20
31124.0,2020-01-21,"(1081.5, 1432.0]",11,42,-31
31125.0,2020-01-21,"(343.987, 598.25]",4,26,-22
31125.0,2020-01-21,"(598.25, 851.5]",6,13,-7
31125.0,2020-01-21,"(851.5, 1104.75]",18,25,-7
31125.0,2020-01-21,"(1104.75, 1358.0]",19,23,-4
31126.0,2020-01-21,"(345.006, 594.5]",3,19,-16
31126.0,2020-01-21,"(594.5, 843.0]",1,5,-4
31126.0,2020-01-21,"(843.0, 1091.5]",12,19,-7
31126.0,2020-01-21,"(1091.5, 1340.0]",13,17,-4
31127.0,2020-01-21,"(752.363, 912.25]",2,3,-1
31127.0,2020-01-21,"(912.25, 1071.5]",6,16,-10
31127.0,2020-01-21,"(1071.5, 1230.75]",5,13,-8
31127.0,2020-01-21,"(1230.75, 1390.0]",2,8,-6
31128.0,2020-01-21,"(350.991, 604.25]",19,27,-8
31128.0,2020-01-21,"(604.25, 856.5]",9,21,-12
31128.0,2020-01-21,"(856.5, 1108.75]",16,23,-7
31128.0,2020-01-21,"(1108.75, 1361.0]",7,15,-8
31129.0,2020-01-21,"(417.124, 637.0]",7,10,-3
31129.0,2020-01-21,"(637.0, 856.0]",4,7,-3
31129.0,2020-01-21,"(856.0, 1075.0]",1,8,-7
31129.0,2020-01-21,"(1075.0, 1294.0]",1,5,-4
31130.0,2020-01-21,"(292.874, 575.5]",5,11,-6
31130.0,2020-01-21,"(575.5, 857.0]",1,1,0
31130.0,2020-01-21,"(857.0, 1138.5]",9,14,-5
31130.0,2020-01-21,"(1138.5, 1420.0]",1,3,-2
31131.0,2020-01-21,"(683.0, 930.0]",1,6,-5
31131.0,2020-01-21,"(930.0, 1177.0]",4,3,1
31131.0,2020-01-21,"(1177.0, 1424.0]",2,5,-3
31200.0,2020-01-21,"(348.997, 600.75]",18,28,-10
31200.0,2020-01-21,"(600.75, 851.5]",4,9,-5
31200.0,2020-01-21,"(851.5, 1102.25]",14,30,-16
31200.0,2020-01-21,"(1102.25, 1353.0]",11,26,-15
31201.0,2020-01-21,"(38.649, 377.75]",4,6,-2
31201.0,2020-01-21,"(377.75, 715.5]",19,45,-26
31201.0,2020-01-21,"(715.5, 1053.25]",26,36,-10
31201.0,2020-01-21,"(1053.25, 1391.0]",22,50,-28
31202.0,2020-01-21,"(350.937, 617.75]",10,27,-17
31202.0,2020-01-21,"(617.75, 883.5]",8,16,-8
31202.0,2020-01-21,"(883.5, 1149.25]",21,34,-13
31202.0,2020-01-21,"(1149.25, 1415.0]",8,16,-8
31203.0,2020-01-21,"(30.644, 371.0]",1,3,-2
31203.0,2020-01-21,"(371.0, 710.0]",6,16,-10
31203.0,2020-01-21,"(710.0, 1049.0]",16,25,-9
31203.0,2020-01-21,"(1049.0, 1388.0]",28,45,-17
31204.0,2020-01-21,"(0.62, 347.0]",1,1,0
31204.0,2020-01-21,"(347.0, 692.0]",13,18,-5
31204.0,2020-01-21,"(692.0, 1037.0]",8,19,-11
31204.0,2020-01-21,"(1037.0, 1382.0]",7,19,-12
31205.0,2020-01-21,"(388.0, 728.0]",23,1,22
31205.0,2020-01-21,"(728.0, 1068.0]",20,25,-5
31205.0,2020-01-21,"(1068.0, 1408.0]",6,31,-25
31206.0,2020-01-21,"(342.231, 535.25]",3,3,0
31206.0,2020-01-21,"(535.25, 727.5]",1,3,-2
31206.0,2020-01-21,"(727.5, 919.75]",1,1,0
31206.0,2020-01-21,"(919.75, 1112.0]",4,7,-3
31207.0,2020-01-21,"(340.983, 596.25]",1,5,-4
31207.0,2020-01-21,"(596.25, 850.5]",1,1,0
31207.0,2020-01-21,"(850.5, 1104.75]",1,2,-1
31207.0,2020-01-21,"(1104.75, 1359.0]",5,11,-6
31208.0,2020-01-21,"(388.135, 605.25]",13,15,-2
31208.0,2020-01-21,"(605.25, 821.5]",1,2,-1
31208.0,2020-01-21,"(821.5, 1037.75]",1,10,-9
31208.0,2020-01-21,"(1037.75, 1254.0]",2,10,-8
31209.0,2020-01-21,"(537.301, 712.75]",1,3,-2
31209.0,2020-01-21,"(887.5, 1062.25]",1,1,0
31209.0,2020-01-21,"(1062.25, 1237.0]",1,2,-1
31211.0,2020-01-21,"(480.147, 694.25]",5,5,0
31211.0,2020-01-21,"(694.25, 907.5]",1,2,-1
31211.0,2020-01-21,"(907.5, 1120.75]",2,6,-4
31211.0,2020-01-21,"(1120.75, 1334.0]",3,6,-3
31212.0,2020-01-21,"(41.641, 382.75]",3,4,-1
31212.0,2020-01-21,"(382.75, 722.5]",31,41,-10
31212.0,2020-01-21,"(722.5, 1062.25]",13,26,-13
31212.0,2020-01-21,"(1062.25, 1402.0]",3,12,-9
31213.0,2020-01-21,"(18.643, 359.25]",1,2,-1
31213.0,2020-01-21,"(359.25, 698.5]",28,38,-10
31213.0,2020-01-21,"(698.5, 1037.75]",6,13,-7
31213.0,2020-01-21,"(1037.75, 1377.0]",15,27,-12
31214.0,2020-01-21,"(11.729, 330.75]",1,2,-1
31214.0,2020-01-21,"(330.75, 648.5]",6,25,-19
31214.0,2020-01-21,"(648.5, 966.25]",10,19,-9
31214.0,2020-01-21,"(966.25, 1284.0]",32,47,-15
31215.0,2020-01-21,"(400.193, 602.75]",21,22,-1
31215.0,2020-01-21,"(804.5, 1006.25]",2,1,1
31215.0,2020-01-21,"(1006.25, 1208.0]",7,3,4
31216.0,2020-01-21,"(334.062, 569.5]",16,18,-2
31216.0,2020-01-21,"(569.5, 804.0]",2,5,-3
31216.0,2020-01-21,"(804.0, 1038.5]",4,8,-4
31216.0,2020-01-21,"(1038.5, 1273.0]",3,12,-9
31217.0,2020-01-21,"(367.273, 549.75]",13,14,-1
31217.0,2020-01-21,"(549.75, 731.5]",1,2,-1
31217.0,2020-01-21,"(731.5, 913.25]",2,2,0
31218.0,2020-01-21,"(376.239, 567.25]",13,24,-11
31218.0,2020-01-21,"(567.25, 757.5]",3,4,-1
31218.0,2020-01-21,"(757.5, 947.75]",6,7,-1
31218.0,2020-01-21,"(947.75, 1138.0]",9,15,-6
31219.0,2020-01-21,"(355.173, 562.75]",6,6,0
31219.0,2020-01-21,"(562.75, 769.5]",5,5,0
31219.0,2020-01-21,"(769.5, 976.25]",1,3,-2
31220.0,2020-01-21,"(284.221, 479.75]",5,7,-2
31220.0,2020-01-21,"(479.75, 674.5]",7,9,-2
31221.0,2020-01-21,"(454.3, 630.0]",29,33,-4
31221.0,2020-01-21,"(630.0, 805.0]",5,10,-5
31221.0,2020-01-21,"(805.0, 980.0]",5,8,-3
31221.0,2020-01-21,"(980.0, 1155.0]",2,27,-25
31222.0,2020-01-21,"(390.06, 626.0]",20,21,-1
31222.0,2020-01-21,"(861.0, 1096.0]",5,1,4
31222.0,2020-01-21,"(1096.0, 1331.0]",2,16,-14
31223.0,2020-01-21,"(52.641, 393.75]",1,3,-2
31223.0,2020-01-21,"(393.75, 733.5]",13,35,-22
31223.0,2020-01-21,"(733.5, 1073.25]",9,23,-14
31223.0,2020-01-21,"(1073.25, 1413.0]",9,19,-10
31224.0,2020-01-21,"(395.238, 586.5]",9,10,-1
31224.0,2020-01-21,"(586.5, 777.0]",3,5,-2
31224.0,2020-01-21,"(777.0, 967.5]",3,5,-2
31224.0,2020-01-21,"(967.5, 1158.0]",4,16,-12
31225.0,2020-01-21,"(436.024, 681.0]",7,13,-6
31225.0,2020-01-21,"(681.0, 925.0]",2,2,0
31225.0,2020-01-21,"(925.0, 1169.0]",8,14,-6
31225.0,2020-01-21,"(1169.0, 1413.0]",2,9,-7
31226.0,2020-01-21,"(298.948, 563.0]",3,4,-1
31226.0,2020-01-21,"(1089.0, 1352.0]",4,3,1
31227.0,2020-01-21,"(439.051, 677.25]",24,26,-2
31227.0,2020-01-21,"(677.25, 914.5]",9,11,-2
31227.0,2020-01-21,"(914.5, 1151.75]",3,14,-11
31228.0,2020-01-21,"(352.967, 612.25]",10,14,-4
31228.0,2020-01-21,"(612.25, 870.5]",6,9,-3
31228.0,2020-01-21,"(870.5, 1128.75]",14,35,-21
31228.0,2020-01-21,"(1128.75, 1387.0]",7,15,-8
31229.0,2020-01-21,"(1.599, 353.25]",1,4,-3
31229.0,2020-01-21,"(353.25, 703.5]",11,50,-39
31229.0,2020-01-21,"(703.5, 1053.75]",16,33,-17
31229.0,2020-01-21,"(1053.75, 1404.0]",22,37,-15
31230.0,2020-01-21,"(307.02, 553.0]",37,42,-5
31230.0,2020-01-21,"(553.0, 798.0]",10,16,-6
31230.0,2020-01-21,"(798.0, 1043.0]",9,15,-6
31230.0,2020-01-21,"(1043.0, 1288.0]",5,22,-17
31231.0,2020-01-21,"(310.197, 511.75]",9,9,0
31231.0,2020-01-21,"(511.75, 712.5]",9,12,-3
31231.0,2020-01-21,"(712.5, 913.25]",1,5,-4
31231.0,2020-01-21,"(913.25, 1114.0]",6,15,-9
31232.0,2020-01-21,"(292.901, 568.75]",9,11,-2
31232.0,2020-01-21,"(568.75, 843.5]",7,11,-4
31232.0,2020-01-21,"(843.5, 1118.25]",8,21,-13
31232.0,2020-01-21,"(1118.25, 1393.0]",2,5,-3
31233.0,2020-01-21,"(378.043, 618.25]",26,29,-3
31233.0,2020-01-21,"(618.25, 857.5]",9,11,-2
31233.0,2020-01-21,"(857.5, 1096.75]",12,25,-13
31233.0,2020-01-21,"(1096.75, 1336.0]",3,12,-9
31234.0,2020-01-21,"(376.036, 618.0]",22,34,-12
31234.0,2020-01-21,"(618.0, 859.0]",8,11,-3
31234.0,2020-01-21,"(859.0, 1100.0]",11,18,-7
31234.0,2020-01-21,"(1100.0, 1341.0]",10,15,-5
31235.0,2020-01-21,"(510.414, 657.5]",5,5,0
31235.0,2020-01-21,"(657.5, 804.0]",1,1,0
31235.0,2020-01-21,"(804.0, 950.5]",1,1,0
31236.0,2020-01-21,"(462.189, 665.75]",13,16,-3
31236.0,2020-01-21,"(665.75, 868.5]",4,6,-2
31236.0,2020-01-21,"(868.5, 1071.25]",5,17,-12
31236.0,2020-01-21,"(1071.25, 1274.0]",3,15,-12
31237.0,2020-01-21,"(48.687, 378.25]",2,2,0
31237.0,2020-01-21,"(378.25, 706.5]",3,16,-13
31237.0,2020-01-21,"(706.5, 1034.75]",8,13,-5
31237.0,2020-01-21,"(1034.75, 1363.0]",15,22,-7
31238.0,2020-01-21,"(57.814, 355.5]",2,2,0
31238.0,2020-01-21,"(355.5, 652.0]",9,11,-2
31238.0,2020-01-21,"(652.0, 948.5]",1,3,-2
31238.0,2020-01-21,"(948.5, 1245.0]",5,21,-16
31239.0,2020-01-21,"(433.128, 652.0]",25,27,-2
31239.0,2020-01-21,"(652.0, 870.0]",3,10,-7
31239.0,2020-01-21,"(870.0, 1088.0]",7,14,-7
31239.0,2020-01-21,"(1088.0, 1306.0]",1,10,-9
31240.0,2020-01-21,"(517.994, 519.5]",1,1,0
31241.0,2020-01-21,"(358.5, 686.0]",21,3,18
31241.0,2020-01-21,"(686.0, 1013.5]",6,48,-42
31241.0,2020-01-21,"(1013.5, 1341.0]",16,17,-1
31242.0,2020-01-21,"(294.941, 560.75]",16,19,-3
31242.0,2020-01-21,"(560.75, 825.5]",6,10,-4
31242.0,2020-01-21,"(825.5, 1090.25]",6,21,-15
31242.0,2020-01-21,"(1090.25, 1355.0]",4,15,-11
31243.0,2020-01-21,"(378.235, 570.25]",17,22,-5
31243.0,2020-01-21,"(570.25, 761.5]",6,10,-4
31243.0,2020-01-21,"(761.5, 952.75]",3,9,-6
31243.0,2020-01-21,"(952.75, 1144.0]",3,16,-13
31244.0,2020-01-21,"(414.081, 644.75]",13,18,-5
31244.0,2020-01-21,"(644.75, 874.5]",2,4,-2
31244.0,2020-01-21,"(874.5, 1104.25]",3,14,-11
31244.0,2020-01-21,"(1104.25, 1334.0]",2,4,-2
31245.0,2020-01-21,"(160.853, 448.75]",3,4,-1
31245.0,2020-01-21,"(448.75, 735.5]",5,13,-8
31245.0,2020-01-21,"(735.5, 1022.25]",9,13,-4
31245.0,2020-01-21,"(1022.25, 1309.0]",8,18,-10
31246.0,2020-01-21,"(400.987, 655.25]",9,16,-7
31246.0,2020-01-21,"(655.25, 908.5]",5,7,-2
31246.0,2020-01-21,"(908.5, 1161.75]",15,27,-12
31246.0,2020-01-21,"(1161.75, 1415.0]",5,10,-5
31247.0,2020-01-21,"(430.231, 623.25]",8,9,-1
31247.0,2020-01-21,"(623.25, 815.5]",6,8,-2
31247.0,2020-01-21,"(815.5, 1007.75]",3,9,-6
31247.0,2020-01-21,"(1007.75, 1200.0]",4,10,-6
31248.0,2020-01-21,"(401.198, 602.5]",5,10,-5
31248.0,2020-01-21,"(602.5, 803.0]",1,1,0
31248.0,2020-01-21,"(803.0, 1003.5]",3,7,-4
31248.0,2020-01-21,"(1003.5, 1204.0]",7,16,-9
31249.0,2020-01-21,"(405.271, 588.25]",4,8,-4
31249.0,2020-01-21,"(770.5, 952.75]",1,1,0
31249.0,2020-01-21,"(952.75, 1135.0]",4,8,-4
31250.0,2020-01-21,"(354.022, 599.5]",11,14,-3
31250.0,2020-01-21,"(599.5, 844.0]",3,4,-1
31250.0,2020-01-21,"(844.0, 1088.5]",4,14,-10
31250.0,2020-01-21,"(1088.5, 1333.0]",1,10,-9
31251.0,2020-01-21,"(32.633, 375.75]",1,2,-1
31251.0,2020-01-21,"(375.75, 717.5]",14,30,-16
31251.0,2020-01-21,"(717.5, 1059.25]",11,22,-11
31251.0,2020-01-21,"(1059.25, 1401.0]",12,21,-9
31252.0,2020-01-21,"(491.423, 636.25]",20,21,-1
31252.0,2020-01-21,"(636.25, 780.5]",2,5,-3
31252.0,2020-01-21,"(924.75, 1069.0]",2,9,-7
31253.0,2020-01-21,"(396.053, 633.75]",24,27,-3
31253.0,2020-01-21,"(633.75, 870.5]",5,9,-4
31253.0,2020-01-21,"(870.5, 1107.25]",11,18,-7
31253.0,2020-01-21,"(1107.25, 1344.0]",2,9,-7
31254.0,2020-01-21,"(410.109, 633.75]",19,20,-1
31254.0,2020-01-21,"(633.75, 856.5]",2,4,-2
31254.0,2020-01-21,"(856.5, 1079.25]",3,26,-23
31254.0,2020-01-21,"(1079.25, 1302.0]",3,8,-5
31255.0,2020-01-21,"(436.147, 650.25]",16,20,-4
31255.0,2020-01-21,"(650.25, 863.5]",3,7,-4
31255.0,2020-01-21,"(863.5, 1076.75]",4,13,-9
31255.0,2020-01-21,"(1076.75, 1290.0]",4,13,-9
31256.0,2020-01-21,"(273.084, 503.0]",5,6,-1
31256.0,2020-01-21,"(503.0, 732.0]",7,7,0
31256.0,2020-01-21,"(732.0, 961.0]",4,5,-1
31256.0,2020-01-21,"(961.0, 1190.0]",4,15,-11
31257.0,2020-01-21,"(319.903, 595.25]",14,27,-13
31257.0,2020-01-21,"(595.25, 869.5]",10,13,-3
31257.0,2020-01-21,"(869.5, 1143.75]",17,39,-22
31257.0,2020-01-21,"(1143.75, 1418.0]",6,19,-13
31258.0,2020-01-21,"(438.211, 636.25]",3,6,-3
31258.0,2020-01-21,"(833.5, 1030.75]",8,15,-7
31258.0,2020-01-21,"(1030.75, 1228.0]",4,6,-2
31259.0,2020-01-21,"(400.148, 614.0]",11,11,0
31259.0,2020-01-21,"(614.0, 827.0]",2,4,-2
31259.0,2020-01-21,"(827.0, 1040.0]",1,5,-4
31260.0,2020-01-21,"(464.187, 668.25]",11,13,-2
31260.0,2020-01-21,"(668.25, 871.5]",6,8,-2
31260.0,2020-01-21,"(871.5, 1074.75]",1,11,-10
31260.0,2020-01-21,"(1074.75, 1278.0]",2,6,-4
31261.0,2020-01-21,"(392.284, 572.0]",7,7,0
31261.0,2020-01-21,"(751.0, 930.0]",1,5,-4
31262.0,2020-01-21,"(424.156, 636.0]",6,8,-2
31262.0,2020-01-21,"(847.0, 1058.0]",4,9,-5
31262.0,2020-01-21,"(1058.0, 1269.0]",5,13,-8
31263.0,2020-01-21,"(338.108, 562.0]",13,17,-4
31263.0,2020-01-21,"(562.0, 785.0]",6,10,-4
31263.0,2020-01-21,"(785.0, 1008.0]",3,4,-1
31263.0,2020-01-21,"(1008.0, 1231.0]",2,14,-12
31264.0,2020-01-21,"(421.219, 617.25]",10,15,-5
31264.0,2020-01-21,"(617.25, 812.5]",2,4,-2
31264.0,2020-01-21,"(812.5, 1007.75]",2,6,-4
31264.0,2020-01-21,"(1007.75, 1203.0]",3,13,-10
31265.0,2020-01-21,"(34.67, 368.5]",1,2,-1
31265.0,2020-01-21,"(368.5, 701.0]",9,28,-19
31265.0,2020-01-21,"(701.0, 1033.5]",9,18,-9
31265.0,2020-01-21,"(1033.5, 1366.0]",12,21,-9
31266.0,2020-01-21,"(288.924, 559.0]",4,24,-20
31266.0,2020-01-21,"(559.0, 828.0]",8,13,-5
31266.0,2020-01-21,"(828.0, 1097.0]",14,29,-15
31266.0,2020-01-21,"(1097.0, 1366.0]",12,19,-7
31267.0,2020-01-21,"(350.5, 684.0]",10,1,9
31267.0,2020-01-21,"(684.0, 1017.5]",13,25,-12
31267.0,2020-01-21,"(1017.5, 1351.0]",15,22,-7
31268.0,2020-01-21,"(334.963, 595.25]",12,28,-16
31268.0,2020-01-21,"(595.25, 854.5]",4,11,-7
31268.0,2020-01-21,"(854.5, 1113.75]",15,20,-5
31268.0,2020-01-21,"(1113.75, 1373.0]",14,18,-4
31269.0,2020-01-21,"(350.045, 589.75]",5,12,-7
31269.0,2020-01-21,"(589.75, 828.5]",8,13,-5
31269.0,2020-01-21,"(828.5, 1067.25]",6,13,-7
31269.0,2020-01-21,"(1067.25, 1306.0]",5,12,-7
31270.0,2020-01-21,"(393.101, 618.75]",11,14,-3
31270.0,2020-01-21,"(618.75, 843.5]",4,11,-7
31270.0,2020-01-21,"(843.5, 1068.25]",1,3,-2
31270.0,2020-01-21,"(1068.25, 1293.0]",3,6,-3
31271.0,2020-01-21,"(460.271, 643.25]",11,15,-4
31271.0,2020-01-21,"(643.25, 825.5]",2,3,-1
31271.0,2020-01-21,"(825.5, 1007.75]",4,11,-7
31272.0,2020-01-21,"(297.11, 520.5]",7,11,-4
31272.0,2020-01-21,"(520.5, 743.0]",15,15,0
31272.0,2020-01-21,"(743.0, 965.5]",4,8,-4
31272.0,2020-01-21,"(965.5, 1188.0]",3,17,-14
31273.0,2020-01-21,"(799.0, 932.0]",1,3,-2
31273.0,2020-01-21,"(932.0, 1065.0]",1,1,0
31274.0,2020-01-21,"(464.301, 639.75]",8,8,0
31274.0,2020-01-21,"(814.5, 989.25]",4,1,3
31274.0,2020-01-21,"(989.25, 1164.0]",3,7,-4
31275.0,2020-01-21,"(38.666, 373.5]",2,4,-2
31275.0,2020-01-21,"(373.5, 707.0]",13,32,-19
31275.0,2020-01-21,"(707.0, 1040.5]",7,12,-5
31275.0,2020-01-21,"(1040.5, 1374.0]",10,24,-14
31276.0,2020-01-21,"(410.017, 656.75]",20,25,-5
31276.0,2020-01-21,"(656.75, 902.5]",8,12,-4
31276.0,2020-01-21,"(902.5, 1148.25]",3,17,-14
31277.0,2020-01-21,"(414.17, 622.5]",31,33,-2
31277.0,2020-01-21,"(622.5, 830.0]",10,10,0
31277.0,2020-01-21,"(830.0, 1037.5]",3,14,-11
31277.0,2020-01-21,"(1037.5, 1245.0]",5,23,-18
31278.0,2020-01-21,"(380.095, 607.25]",11,35,-24
31278.0,2020-01-21,"(607.25, 833.5]",5,9,-4
31278.0,2020-01-21,"(833.5, 1059.75]",6,8,-2
31278.0,2020-01-21,"(1059.75, 1286.0]",16,24,-8
31279.0,2020-01-21,"(381.039, 622.25]",15,19,-4
31279.0,2020-01-21,"(622.25, 862.5]",2,5,-3
31279.0,2020-01-21,"(862.5, 1102.75]",11,28,-17
31279.0,2020-01-21,"(1102.75, 1343.0]",3,13,-10
31280.0,2020-01-21,"(359.061, 594.75]",5,14,-9
31280.0,2020-01-21,"(594.75, 829.5]",1,4,-3
31280.0,2020-01-21,"(829.5, 1064.25]",7,8,-1
31280.0,2020-01-21,"(1064.25, 1299.0]",5,7,-2
31000.0,2020-01-22,"(1058.5, 1248.0]",2,1,1
31001.0,2020-01-22,"(1134.5, 1220.0]",2,1,1
31002.0,2020-01-22,"(374.168, 583.0]",3,7,-4
31002.0,2020-01-22,"(583.0, 791.0]",2,2,0
31002.0,2020-01-22,"(791.0, 999.0]",1,1,0
31002.0,2020-01-22,"(999.0, 1207.0]",4,5,-1
31003.0,2020-01-22,"(377.159, 588.25]",3,6,-3
31003.0,2020-01-22,"(588.25, 798.5]",2,2,0
31003.0,2020-01-22,"(798.5, 1008.75]",1,1,0
31003.0,2020-01-22,"(1008.75, 1219.0]",2,6,-4
31004.0,2020-01-22,"(547.18, 753.0]",1,1,0
31004.0,2020-01-22,"(958.0, 1163.0]",4,5,-1
31004.0,2020-01-22,"(1163.0, 1368.0]",2,4,-2
31005.0,2020-01-22,"(437.323, 607.25]",3,3,0
31005.0,2020-01-22,"(607.25, 776.5]",1,1,0
31005.0,2020-01-22,"(945.75, 1115.0]",2,1,1
31006.0,2020-01-22,"(515.0, 772.5]",1,1,0
31006.0,2020-01-22,"(772.5, 1030.0]",1,1,0
31007.0,2020-01-22,"(402.041, 642.75]",7,17,-10
31007.0,2020-01-22,"(642.75, 882.5]",4,6,-2
31007.0,2020-01-22,"(882.5, 1122.25]",6,15,-9
31009.0,2020-01-22,"(499.381, 654.75]",4,7,-3
31010.0,2020-01-22,"(502.381, 657.75]",1,2,-1
31010.0,2020-01-22,"(967.25, 1122.0]",1,1,0
31011.0,2020-01-22,"(334.213, 531.75]",3,3,0
31011.0,2020-01-22,"(531.75, 728.5]",1,1,0
31011.0,2020-01-22,"(925.25, 1122.0]",3,8,-5
31012.0,2020-01-22,"(83.818, 380.5]",1,1,0
31012.0,2020-01-22,"(380.5, 676.0]",2,3,-1
31012.0,2020-01-22,"(971.5, 1267.0]",2,3,-1
31013.0,2020-01-22,"(393.261, 578.75]",1,2,-1
31013.0,2020-01-22,"(763.5, 948.25]",1,4,-3
31013.0,2020-01-22,"(948.25, 1133.0]",4,1,3
31014.0,2020-01-22,"(399.122, 619.5]",12,20,-8
31014.0,2020-01-22,"(619.5, 839.0]",2,3,-1
31014.0,2020-01-22,"(839.0, 1058.5]",5,9,-4
31014.0,2020-01-22,"(1058.5, 1278.0]",8,11,-3
31015.0,2020-01-22,"(424.997, 676.75]",12,14,-2
31015.0,2020-01-22,"(676.75, 927.5]",1,2,-1
31015.0,2020-01-22,"(927.5, 1178.25]",4,9,-5
31015.0,2020-01-22,"(1178.25, 1429.0]",1,3,-2
31016.0,2020-01-22,"(350.926, 620.5]",4,7,-3
31016.0,2020-01-22,"(620.5, 889.0]",3,4,-1
31016.0,2020-01-22,"(889.0, 1157.5]",2,5,-3
31016.0,2020-01-22,"(1157.5, 1426.0]",3,5,-2
31017.0,2020-01-22,"(504.17, 712.5]",7,8,-1
31017.0,2020-01-22,"(712.5, 920.0]",1,2,-1
31017.0,2020-01-22,"(920.0, 1127.5]",1,7,-6
31017.0,2020-01-22,"(1127.5, 1335.0]",2,6,-4
31018.0,2020-01-22,"(979.5, 1159.0]",1,4,-3
31019.0,2020-01-22,"(821.425, 965.75]",1,1,0
31019.0,2020-01-22,"(965.75, 1109.5]",1,2,-1
31019.0,2020-01-22,"(1109.5, 1253.25]",2,3,-1
31020.0,2020-01-22,"(384.0, 512.0]",1,1,0
31021.0,2020-01-22,"(377.121, 597.75]",2,6,-4
31021.0,2020-01-22,"(597.75, 817.5]",1,2,-1
31021.0,2020-01-22,"(1037.25, 1257.0]",1,1,0
31022.0,2020-01-22,"(488.071, 721.25]",1,3,-2
31022.0,2020-01-22,"(953.5, 1185.75]",1,3,-2
31022.0,2020-01-22,"(1185.75, 1418.0]",1,6,-5
31023.0,2020-01-22,"(941.669, 1024.75]",2,3,-1
31023.0,2020-01-22,"(1107.5, 1190.25]",1,2,-1
31024.0,2020-01-22,"(418.158, 629.5]",7,9,-2
31024.0,2020-01-22,"(840.0, 1050.5]",2,1,1
31024.0,2020-01-22,"(1050.5, 1261.0]",3,4,-1
31025.0,2020-01-22,"(1077.82, 1123.0]",1,1,0
31026.0,2020-01-22,"(1095.0, 1324.0]",1,2,-1
31027.0,2020-01-22,"(589.266, 773.5]",1,1,0
31027.0,2020-01-22,"(1140.5, 1324.0]",1,1,0
31028.0,2020-01-22,"(470.19, 673.5]",1,1,0
31028.0,2020-01-22,"(673.5, 876.0]",1,4,-3
31028.0,2020-01-22,"(1078.5, 1281.0]",2,1,1
31029.0,2020-01-22,"(1025.25, 1194.0]",3,4,-1
31030.0,2020-01-22,"(940.25, 1139.0]",5,5,0
31031.0,2020-01-22,"(627.75, 893.5]",1,2,-1
31031.0,2020-01-22,"(1159.25, 1425.0]",1,2,-1
31032.0,2020-01-22,"(968.5, 1040.0]",1,2,-1
31033.0,2020-01-22,"(1157.0, 1159.0]",1,1,0
31034.0,2020-01-22,"(494.221, 689.75]",2,5,-3
31034.0,2020-01-22,"(884.5, 1079.25]",1,1,0
31035.0,2020-01-22,"(455.155, 667.25]",1,3,-2
31035.0,2020-01-22,"(667.25, 878.5]",1,2,-1
31035.0,2020-01-22,"(878.5, 1089.75]",3,4,-1
31035.0,2020-01-22,"(1089.75, 1301.0]",2,6,-4
31036.0,2020-01-22,"(795.75, 1061.0]",2,1,1
31037.0,2020-01-22,"(418.035, 660.25]",7,11,-4
31037.0,2020-01-22,"(660.25, 901.5]",2,4,-2
31037.0,2020-01-22,"(901.5, 1142.75]",4,15,-11
31038.0,2020-01-22,"(779.562, 889.5]",1,2,-1
31038.0,2020-01-22,"(999.0, 1108.5]",1,1,0
31039.0,2020-01-22,"(464.162, 674.5]",2,4,-2
31039.0,2020-01-22,"(1093.5, 1303.0]",3,1,2
31040.0,2020-01-22,"(451.178, 657.5]",3,3,0
31040.0,2020-01-22,"(657.5, 863.0]",1,1,0
31040.0,2020-01-22,"(1068.5, 1274.0]",1,1,0
31041.0,2020-01-22,"(471.5, 474.0]",1,1,0
31042.0,2020-01-22,"(445.189, 648.75]",9,10,-1
31042.0,2020-01-22,"(648.75, 851.5]",1,2,-1
31042.0,2020-01-22,"(1054.25, 1257.0]",3,3,0
31043.0,2020-01-22,"(452.215, 649.25]",1,2,-1
31043.0,2020-01-22,"(845.5, 1041.75]",2,3,-1
31043.0,2020-01-22,"(1041.75, 1238.0]",1,4,-3
31044.0,2020-01-22,"(540.128, 759.0]",4,6,-2
31044.0,2020-01-22,"(977.0, 1195.0]",1,3,-2
31044.0,2020-01-22,"(1195.0, 1413.0]",2,3,-1
31045.0,2020-01-22,"(356.12, 577.0]",1,2,-1
31045.0,2020-01-22,"(577.0, 797.0]",1,1,0
31045.0,2020-01-22,"(1017.0, 1237.0]",3,1,2
31046.0,2020-01-22,"(609.25, 818.5]",1,2,-1
31046.0,2020-01-22,"(1027.75, 1237.0]",2,1,1
31047.0,2020-01-22,"(351.923, 622.25]",9,20,-11
31047.0,2020-01-22,"(891.5, 1160.75]",6,3,3
31048.0,2020-01-22,"(407.12, 628.0]",2,5,-3
31048.0,2020-01-22,"(628.0, 848.0]",2,3,-1
31048.0,2020-01-22,"(1068.0, 1288.0]",2,1,1
31049.0,2020-01-22,"(1084.0, 1106.0]",1,1,0
31050.0,2020-01-22,"(711.0, 789.0]",1,2,-1
31051.0,2020-01-22,"(854.5, 1072.25]",5,5,0
31051.0,2020-01-22,"(1072.25, 1290.0]",2,1,1
31052.0,2020-01-22,"(521.35, 684.5]",3,5,-2
31052.0,2020-01-22,"(684.5, 847.0]",1,2,-1
31052.0,2020-01-22,"(847.0, 1009.5]",2,2,0
31052.0,2020-01-22,"(1009.5, 1172.0]",2,5,-3
,,,,2.0,
,,,,2.0,
31055.0,2020-01-22,"(405.272, 588.0]",1,2,-1
31055.0,2020-01-22,"(952.0, 1134.0]",2,3,-1
31056.0,2020-01-22,"(966.5, 1090.0]",1,1,0
31057.0,2020-01-22,"(785.25, 813.0]",1,1,0
,,,,1.0,
,,,,1.0,
31059.0,2020-01-22,"(837.75, 1117.0]",1,1,0
31060.0,2020-01-22,"(404.351, 567.25]",1,1,0
31060.0,2020-01-22,"(567.25, 729.5]",2,2,0
31060.0,2020-01-22,"(891.75, 1054.0]",2,1,1
31061.0,2020-01-22,"(394.5, 526.0]",1,1,0
,,,,1.0,
,,,,1.0,
,,,,1.0,
,,,,1.0,
31064.0,2020-01-22,"(496.315, 668.25]",2,4,-2
31064.0,2020-01-22,"(1010.75, 1182.0]",1,2,-1
31065.0,2020-01-22,"(785.0, 991.0]",1,2,-1
31065.0,2020-01-22,"(991.0, 1197.0]",3,1,2
31066.0,2020-01-22,"(753.0, 1004.0]",1,1,0
31067.0,2020-01-22,"(921.0, 1152.5]",5,3,2
31067.0,2020-01-22,"(1152.5, 1384.0]",1,6,-5
31068.0,2020-01-22,"(716.5, 926.0]",1,2,-1
31068.0,2020-01-22,"(1135.5, 1345.0]",1,1,0
31069.0,2020-01-22,"(777.0, 946.5]",2,3,-1
31069.0,2020-01-22,"(946.5, 1116.0]",5,1,4
31070.0,2020-01-22,"(557.584, 662.0]",1,2,-1
31071.0,2020-01-22,"(569.5, 810.0]",1,2,-1
31071.0,2020-01-22,"(810.0, 1050.5]",2,1,1
31071.0,2020-01-22,"(1050.5, 1291.0]",2,3,-1
,,,,1.0,
,,,,1.0,
31073.0,2020-01-22,"(497.441, 637.75]",2,4,-2
31073.0,2020-01-22,"(917.25, 1057.0]",1,1,0
31074.0,2020-01-22,"(840.0, 1019.5]",2,2,0
31074.0,2020-01-22,"(1019.5, 1199.0]",4,5,-1
31075.0,2020-01-22,"(976.0, 1119.0]",1,1,0
31076.0,2020-01-22,"(1019.5, 1205.0]",3,2,1
31077.0,2020-01-22,"(461.325, 630.75]",4,7,-3
31077.0,2020-01-22,"(799.5, 968.25]",1,1,0
31077.0,2020-01-22,"(968.25, 1137.0]",5,3,2
31078.0,2020-01-22,"(472.284, 652.0]",5,6,-1
31078.0,2020-01-22,"(1010.0, 1189.0]",1,1,0
31079.0,2020-01-22,"(468.129, 686.75]",1,10,-9
31079.0,2020-01-22,"(686.75, 904.5]",2,4,-2
31079.0,2020-01-22,"(904.5, 1122.25]",2,2,0
31079.0,2020-01-22,"(1122.25, 1340.0]",2,4,-2
31080.0,2020-01-22,"(395.134, 612.5]",1,11,-10
31080.0,2020-01-22,"(829.0, 1045.5]",1,1,0
31080.0,2020-01-22,"(1045.5, 1262.0]",4,4,0
31081.0,2020-01-22,"(462.337, 628.75]",2,2,0
,,,,2.0,
31083.0,2020-01-22,"(659.5, 918.0]",1,3,-2
31083.0,2020-01-22,"(918.0, 1176.5]",5,2,3
31083.0,2020-01-22,"(1176.5, 1435.0]",1,6,-5
31084.0,2020-01-22,"(376.144, 591.0]",4,5,-1
31084.0,2020-01-22,"(591.0, 805.0]",4,6,-2
31084.0,2020-01-22,"(1019.0, 1233.0]",1,2,-1
31085.0,2020-01-22,"(857.5, 1034.25]",1,2,-1
31085.0,2020-01-22,"(1034.25, 1211.0]",1,1,0
31086.0,2020-01-22,"(408.298, 584.5]",1,2,-1
31086.0,2020-01-22,"(935.5, 1111.0]",2,3,-1
31087.0,2020-01-22,"(668.25, 866.5]",1,2,-1
31087.0,2020-01-22,"(866.5, 1064.75]",1,2,-1
31087.0,2020-01-22,"(1064.75, 1263.0]",4,2,2
31088.0,2020-01-22,"(585.25, 783.5]",1,3,-2
31088.0,2020-01-22,"(981.75, 1180.0]",5,1,4
31089.0,2020-01-22,"(479.223, 674.25]",5,9,-4
31089.0,2020-01-22,"(674.25, 868.5]",2,3,-1
31089.0,2020-01-22,"(868.5, 1062.75]",2,10,-8
31089.0,2020-01-22,"(1062.75, 1257.0]",1,8,-7
,,,,2.0,
31091.0,2020-01-22,"(112.836, 405.0]",1,1,0
31091.0,2020-01-22,"(987.0, 1278.0]",3,4,-1
31092.0,2020-01-22,"(760.5, 909.75]",1,1,0
31092.0,2020-01-22,"(909.75, 1059.0]",2,1,1
,,,,1.0,
,,,,2.0,
,,,,2.0,
,,,,2.0,
31094.0,2020-01-22,"(830.25, 1107.0]",1,1,0
,,,,1.0,
,,,,1.0,
31096.0,2020-01-22,"(540.526, 659.5]",1,2,-1
31096.0,2020-01-22,"(896.5, 1015.0]",3,1,2
31097.0,2020-01-22,"(491.26, 677.0]",2,3,-1
31098.0,2020-01-22,"(437.031, 680.25]",3,9,-6
31098.0,2020-01-22,"(922.5, 1164.75]",5,10,-5
31098.0,2020-01-22,"(1164.75, 1407.0]",1,3,-2
31099.0,2020-01-22,"(780.604, 880.0]",1,2,-1
31099.0,2020-01-22,"(979.0, 1078.0]",1,1,0
31100.0,2020-01-22,"(415.19, 618.5]",10,12,-2
31100.0,2020-01-22,"(618.5, 821.0]",1,3,-2
31100.0,2020-01-22,"(821.0, 1023.5]",4,7,-3
31100.0,2020-01-22,"(1023.5, 1226.0]",1,15,-14
31101.0,2020-01-22,"(212.777, 519.75]",8,23,-15
31101.0,2020-01-22,"(519.75, 825.5]",13,32,-19
31101.0,2020-01-22,"(825.5, 1131.25]",26,43,-17
31101.0,2020-01-22,"(1131.25, 1437.0]",18,28,-10
31102.0,2020-01-22,"(375.072, 608.0]",1,18,-17
31102.0,2020-01-22,"(608.0, 840.0]",2,5,-3
31102.0,2020-01-22,"(840.0, 1072.0]",6,12,-6
31102.0,2020-01-22,"(1072.0, 1304.0]",6,10,-4
31103.0,2020-01-22,"(360.935, 628.25]",3,31,-28
31103.0,2020-01-22,"(628.25, 894.5]",2,5,-3
31103.0,2020-01-22,"(894.5, 1160.75]",10,22,-12
31103.0,2020-01-22,"(1160.75, 1427.0]",4,14,-10
31104.0,2020-01-22,"(376.5, 731.0]",2,3,-1
31104.0,2020-01-22,"(731.0, 1085.5]",15,15,0
31104.0,2020-01-22,"(1085.5, 1440.0]",15,23,-8
31105.0,2020-01-22,"(337.078, 568.5]",2,10,-8
31105.0,2020-01-22,"(568.5, 799.0]",1,4,-3
31105.0,2020-01-22,"(799.0, 1029.5]",1,5,-4
31105.0,2020-01-22,"(1029.5, 1260.0]",5,9,-4
31106.0,2020-01-22,"(1037.25, 1220.0]",3,6,-3
31107.0,2020-01-22,"(330.046, 569.5]",3,21,-18
31107.0,2020-01-22,"(569.5, 808.0]",4,7,-3
31107.0,2020-01-22,"(808.0, 1046.5]",13,23,-10
31107.0,2020-01-22,"(1046.5, 1285.0]",9,15,-6
31108.0,2020-01-22,"(381.99, 635.5]",4,18,-14
31108.0,2020-01-22,"(635.5, 888.0]",6,10,-4
31108.0,2020-01-22,"(888.0, 1140.5]",23,35,-12
31108.0,2020-01-22,"(1140.5, 1393.0]",8,13,-5
31109.0,2020-01-22,"(426.063, 661.25]",3,20,-17
31109.0,2020-01-22,"(661.25, 895.5]",4,6,-2
31109.0,2020-01-22,"(895.5, 1129.75]",16,24,-8
31109.0,2020-01-22,"(1129.75, 1364.0]",9,15,-6
31110.0,2020-01-22,"(195.814, 493.5]",10,17,-7
31110.0,2020-01-22,"(493.5, 790.0]",13,31,-18
31110.0,2020-01-22,"(790.0, 1086.5]",14,26,-12
31110.0,2020-01-22,"(1086.5, 1383.0]",11,19,-8
31111.0,2020-01-22,"(335.013, 582.75]",9,19,-10
31111.0,2020-01-22,"(582.75, 829.5]",1,6,-5
31111.0,2020-01-22,"(829.5, 1076.25]",2,4,-2
31111.0,2020-01-22,"(1076.25, 1323.0]",10,12,-2
31112.0,2020-01-22,"(362.062, 597.5]",2,5,-3
31112.0,2020-01-22,"(832.0, 1066.5]",1,1,0
31112.0,2020-01-22,"(1066.5, 1301.0]",2,3,-1
31113.0,2020-01-22,"(593.0, 869.0]",2,17,-15
31113.0,2020-01-22,"(869.0, 1145.0]",10,7,3
31113.0,2020-01-22,"(1145.0, 1421.0]",8,15,-7
31114.0,2020-01-22,"(339.999, 591.25]",3,23,-20
31114.0,2020-01-22,"(591.25, 841.5]",1,3,-2
31114.0,2020-01-22,"(841.5, 1091.75]",17,22,-5
31114.0,2020-01-22,"(1091.75, 1342.0]",11,23,-12
31115.0,2020-01-22,"(344.966, 604.5]",2,17,-15
31115.0,2020-01-22,"(863.0, 1121.5]",7,2,5
31115.0,2020-01-22,"(1121.5, 1380.0]",10,11,-1
31116.0,2020-01-22,"(314.943, 580.25]",3,24,-21
31116.0,2020-01-22,"(580.25, 844.5]",3,6,-3
31116.0,2020-01-22,"(844.5, 1108.75]",17,22,-5
31116.0,2020-01-22,"(1108.75, 1373.0]",11,16,-5
31117.0,2020-01-22,"(303.962, 564.5]",5,26,-21
31117.0,2020-01-22,"(564.5, 824.0]",5,11,-6
31117.0,2020-01-22,"(824.0, 1083.5]",5,19,-14
31117.0,2020-01-22,"(1083.5, 1343.0]",14,23,-9
31118.0,2020-01-22,"(312.979, 569.25]",3,13,-10
31118.0,2020-01-22,"(569.25, 824.5]",1,3,-2
31118.0,2020-01-22,"(824.5, 1079.75]",3,4,-1
31118.0,2020-01-22,"(1079.75, 1335.0]",9,11,-2
31119.0,2020-01-22,"(13.701, 339.75]",2,2,0
31119.0,2020-01-22,"(339.75, 664.5]",9,29,-20
31119.0,2020-01-22,"(664.5, 989.25]",8,11,-3
31119.0,2020-01-22,"(989.25, 1314.0]",14,23,-9
31120.0,2020-01-22,"(414.035, 656.25]",2,13,-11
31120.0,2020-01-22,"(656.25, 897.5]",1,3,-2
31120.0,2020-01-22,"(897.5, 1138.75]",2,2,0
31120.0,2020-01-22,"(1138.75, 1380.0]",7,10,-3
31121.0,2020-01-22,"(338.972, 597.0]",11,18,-7
31121.0,2020-01-22,"(854.0, 1111.0]",6,18,-12
31121.0,2020-01-22,"(1111.0, 1368.0]",5,9,-4
31122.0,2020-01-22,"(360.0, 710.0]",2,1,1
31122.0,2020-01-22,"(710.0, 1060.0]",1,15,-14
31122.0,2020-01-22,"(1060.0, 1410.0]",11,9,2
31123.0,2020-01-22,"(643.5, 873.0]",1,18,-17
31123.0,2020-01-22,"(873.0, 1102.5]",6,2,4
31123.0,2020-01-22,"(1102.5, 1332.0]",6,8,-2
31124.0,2020-01-22,"(319.947, 584.25]",17,34,-17
31124.0,2020-01-22,"(584.25, 847.5]",3,13,-10
31124.0,2020-01-22,"(847.5, 1110.75]",16,34,-18
31124.0,2020-01-22,"(1110.75, 1374.0]",11,40,-29
31125.0,2020-01-22,"(353.992, 607.0]",5,29,-24
31125.0,2020-01-22,"(607.0, 859.0]",2,4,-2
31125.0,2020-01-22,"(859.0, 1111.0]",22,29,-7
31125.0,2020-01-22,"(1111.0, 1363.0]",19,27,-8
31126.0,2020-01-22,"(30.719, 352.25]",1,3,-2
31126.0,2020-01-22,"(352.25, 672.5]",5,25,-20
31126.0,2020-01-22,"(672.5, 992.75]",1,2,-1
31126.0,2020-01-22,"(992.75, 1313.0]",22,33,-11
31127.0,2020-01-22,"(25.613, 373.75]",1,3,-2
31127.0,2020-01-22,"(373.75, 720.5]",13,15,-2
31127.0,2020-01-22,"(720.5, 1067.25]",13,27,-14
31127.0,2020-01-22,"(1067.25, 1414.0]",8,21,-13
31128.0,2020-01-22,"(7.582, 363.5]",2,3,-1
31128.0,2020-01-22,"(363.5, 718.0]",31,43,-12
31128.0,2020-01-22,"(718.0, 1072.5]",22,37,-15
31128.0,2020-01-22,"(1072.5, 1427.0]",11,20,-9
31129.0,2020-01-22,"(423.109, 646.75]",7,7,0
31129.0,2020-01-22,"(646.75, 869.5]",6,9,-3
31129.0,2020-01-22,"(869.5, 1092.25]",8,13,-5
31130.0,2020-01-22,"(352.924, 623.0]",3,18,-15
31130.0,2020-01-22,"(623.0, 892.0]",1,3,-2
31130.0,2020-01-22,"(892.0, 1161.0]",5,9,-4
31130.0,2020-01-22,"(1161.0, 1430.0]",4,7,-3
31131.0,2020-01-22,"(94.656, 432.0]",1,2,-1
31131.0,2020-01-22,"(768.0, 1104.0]",5,10,-5
31131.0,2020-01-22,"(1104.0, 1440.0]",6,9,-3
31200.0,2020-01-22,"(362.047, 601.25]",19,30,-11
31200.0,2020-01-22,"(601.25, 839.5]",8,15,-7
31200.0,2020-01-22,"(839.5, 1077.75]",16,35,-19
31200.0,2020-01-22,"(1077.75, 1316.0]",15,38,-23
31201.0,2020-01-22,"(333.902, 609.5]",31,59,-28
31201.0,2020-01-22,"(609.5, 884.0]",11,22,-11
31201.0,2020-01-22,"(884.0, 1158.5]",42,76,-34
31201.0,2020-01-22,"(1158.5, 1433.0]",17,41,-24
31202.0,2020-01-22,"(337.967, 597.25]",7,22,-15
31202.0,2020-01-22,"(597.25, 855.5]",4,9,-5
31202.0,2020-01-22,"(855.5, 1113.75]",19,28,-9
31202.0,2020-01-22,"(1113.75, 1372.0]",9,20,-11
31203.0,2020-01-22,"(338.986, 593.5]",8,32,-24
31203.0,2020-01-22,"(593.5, 847.0]",9,15,-6
31203.0,2020-01-22,"(847.0, 1100.5]",17,27,-10
31203.0,2020-01-22,"(1100.5, 1354.0]",9,20,-11
31204.0,2020-01-22,"(407.077, 638.75]",9,12,-3
31204.0,2020-01-22,"(638.75, 869.5]",8,17,-9
31204.0,2020-01-22,"(869.5, 1100.25]",2,9,-7
31204.0,2020-01-22,"(1100.25, 1331.0]",7,16,-9
31205.0,2020-01-22,"(418.021, 663.75]",19,22,-3
31205.0,2020-01-22,"(663.75, 908.5]",20,26,-6
31205.0,2020-01-22,"(908.5, 1153.25]",12,30,-18
31205.0,2020-01-22,"(1153.25, 1398.0]",2,18,-16
31206.0,2020-01-22,"(768.0, 874.0]",1,2,-1
31206.0,2020-01-22,"(980.0, 1086.0]",3,2,1
31207.0,2020-01-22,"(519.357, 680.75]",1,6,-5
31207.0,2020-01-22,"(680.75, 841.5]",1,1,0
31207.0,2020-01-22,"(841.5, 1002.25]",1,3,-2
31207.0,2020-01-22,"(1002.25, 1163.0]",1,5,-4
31208.0,2020-01-22,"(386.164, 596.0]",14,15,-1
31208.0,2020-01-22,"(1014.0, 1223.0]",1,1,0
31209.0,2020-01-22,"(401.305, 575.75]",1,3,-2
31209.0,2020-01-22,"(575.75, 749.5]",1,3,-2
31209.0,2020-01-22,"(749.5, 923.25]",1,3,-2
31209.0,2020-01-22,"(923.25, 1097.0]",3,4,-1
31211.0,2020-01-22,"(444.091, 672.25]",9,12,-3
31211.0,2020-01-22,"(672.25, 899.5]",3,6,-3
31211.0,2020-01-22,"(899.5, 1126.75]",6,14,-8
31211.0,2020-01-22,"(1126.75, 1354.0]",4,8,-4
31212.0,2020-01-22,"(361.963, 622.25]",30,43,-13
31212.0,2020-01-22,"(622.25, 881.5]",6,13,-7
31212.0,2020-01-22,"(881.5, 1140.75]",11,27,-16
31212.0,2020-01-22,"(1140.75, 1400.0]",9,12,-3
31213.0,2020-01-22,"(327.951, 591.25]",28,41,-13
31213.0,2020-01-22,"(591.25, 853.5]",13,21,-8
31213.0,2020-01-22,"(853.5, 1115.75]",12,27,-15
31213.0,2020-01-22,"(1115.75, 1378.0]",10,15,-5
31214.0,2020-01-22,"(355.095, 582.25]",5,27,-22
31214.0,2020-01-22,"(582.25, 808.5]",5,12,-7
31214.0,2020-01-22,"(808.5, 1034.75]",9,15,-6
31214.0,2020-01-22,"(1034.75, 1261.0]",31,46,-15
31215.0,2020-01-22,"(428.261, 613.75]",18,19,-1
31215.0,2020-01-22,"(613.75, 798.5]",3,4,-1
31215.0,2020-01-22,"(983.25, 1168.0]",5,1,4
31216.0,2020-01-22,"(439.75, 708.5]",22,1,21
31216.0,2020-01-22,"(708.5, 977.25]",4,25,-21
31216.0,2020-01-22,"(977.25, 1246.0]",2,7,-5
31217.0,2020-01-22,"(322.173, 529.75]",11,12,-1
31217.0,2020-01-22,"(529.75, 736.5]",7,7,0
31217.0,2020-01-22,"(736.5, 943.25]",1,3,-2
31217.0,2020-01-22,"(943.25, 1150.0]",4,15,-11
31218.0,2020-01-22,"(342.944, 608.0]",13,29,-16
31218.0,2020-01-22,"(608.0, 872.0]",3,3,0
31218.0,2020-01-22,"(872.0, 1136.0]",10,21,-11
31218.0,2020-01-22,"(1136.0, 1400.0]",2,3,-1
31219.0,2020-01-22,"(416.341, 581.75]",10,10,0
31219.0,2020-01-22,"(581.75, 746.5]",1,1,0
31219.0,2020-01-22,"(746.5, 911.25]",2,4,-2
31220.0,2020-01-22,"(413.338, 579.5]",15,19,-4
31220.0,2020-01-22,"(579.5, 745.0]",2,2,0
31220.0,2020-01-22,"(745.0, 910.5]",2,4,-2
31221.0,2020-01-22,"(412.991, 666.25]",30,33,-3
31221.0,2020-01-22,"(666.25, 918.5]",13,19,-6
31221.0,2020-01-22,"(918.5, 1170.75]",7,27,-20
31221.0,2020-01-22,"(1170.75, 1423.0]",3,9,-6
31222.0,2020-01-22,"(457.073, 689.75]",13,13,0
31222.0,2020-01-22,"(689.75, 921.5]",2,4,-2
31222.0,2020-01-22,"(921.5, 1153.25]",2,17,-15
31222.0,2020-01-22,"(1153.25, 1385.0]",2,3,-1
31223.0,2020-01-22,"(41.628, 386.0]",2,4,-2
31223.0,2020-01-22,"(386.0, 729.0]",13,37,-24
31223.0,2020-01-22,"(729.0, 1072.0]",6,20,-14
31223.0,2020-01-22,"(1072.0, 1415.0]",10,18,-8
31224.0,2020-01-22,"(410.071, 643.25]",13,14,-1
31224.0,2020-01-22,"(643.25, 875.5]",6,10,-4
31224.0,2020-01-22,"(875.5, 1107.75]",2,11,-9
31224.0,2020-01-22,"(1107.75, 1340.0]",3,10,-7
31225.0,2020-01-22,"(338.045, 577.75]",8,14,-6
31225.0,2020-01-22,"(816.5, 1055.25]",6,3,3
31225.0,2020-01-22,"(1055.25, 1294.0]",5,11,-6
31226.0,2020-01-22,"(299.01, 547.5]",5,11,-6
31226.0,2020-01-22,"(795.0, 1042.5]",3,5,-2
31226.0,2020-01-22,"(1042.5, 1290.0]",5,6,-1
31227.0,2020-01-22,"(356.198, 557.5]",25,29,-4
31227.0,2020-01-22,"(557.5, 758.0]",4,9,-5
31227.0,2020-01-22,"(758.0, 958.5]",9,14,-5
31227.0,2020-01-22,"(958.5, 1159.0]",6,23,-17
31228.0,2020-01-22,"(389.971, 648.25]",14,19,-5
31228.0,2020-01-22,"(648.25, 905.5]",7,19,-12
31228.0,2020-01-22,"(905.5, 1162.75]",16,33,-17
31228.0,2020-01-22,"(1162.75, 1420.0]",5,18,-13
31229.0,2020-01-22,"(351.913, 624.75]",15,51,-36
31229.0,2020-01-22,"(624.75, 896.5]",11,27,-16
31229.0,2020-01-22,"(896.5, 1168.25]",33,47,-14
31229.0,2020-01-22,"(1168.25, 1440.0]",6,15,-9
31230.0,2020-01-22,"(364.015, 611.25]",47,54,-7
31230.0,2020-01-22,"(611.25, 857.5]",7,11,-4
31230.0,2020-01-22,"(857.5, 1103.75]",15,33,-18
31230.0,2020-01-22,"(1103.75, 1350.0]",4,19,-15
31231.0,2020-01-22,"(327.219, 523.25]",11,13,-2
31231.0,2020-01-22,"(523.25, 718.5]",6,7,-1
31231.0,2020-01-22,"(718.5, 913.75]",3,5,-2
31231.0,2020-01-22,"(913.75, 1109.0]",3,17,-14
31232.0,2020-01-22,"(84.701, 410.75]",5,8,-3
31232.0,2020-01-22,"(410.75, 735.5]",16,24,-8
31232.0,2020-01-22,"(735.5, 1060.25]",11,18,-7
31232.0,2020-01-22,"(1060.25, 1385.0]",6,19,-13
31233.0,2020-01-22,"(443.233, 635.75]",38,41,-3
31233.0,2020-01-22,"(635.75, 827.5]",5,10,-5
31233.0,2020-01-22,"(827.5, 1019.25]",5,11,-6
31233.0,2020-01-22,"(1019.25, 1211.0]",3,22,-19
31234.0,2020-01-22,"(384.085, 613.75]",23,35,-12
31234.0,2020-01-22,"(613.75, 842.5]",6,10,-4
31234.0,2020-01-22,"(842.5, 1071.25]",10,17,-7
31234.0,2020-01-22,"(1071.25, 1300.0]",12,23,-11
31235.0,2020-01-22,"(480.418, 626.5]",4,4,0
31235.0,2020-01-22,"(772.0, 917.5]",1,2,-1
31236.0,2020-01-22,"(337.5, 663.0]",13,1,12
31236.0,2020-01-22,"(663.0, 988.5]",15,15,0
31236.0,2020-01-22,"(988.5, 1314.0]",2,30,-28
31237.0,2020-01-22,"(380.018, 626.5]",7,23,-16
31237.0,2020-01-22,"(626.5, 872.0]",4,10,-6
31237.0,2020-01-22,"(872.0, 1117.5]",10,16,-6
31237.0,2020-01-22,"(1117.5, 1363.0]",11,18,-7
31238.0,2020-01-22,"(48.754, 361.5]",1,2,-1
31238.0,2020-01-22,"(361.5, 673.0]",16,20,-4
31238.0,2020-01-22,"(673.0, 984.5]",5,13,-8
31238.0,2020-01-22,"(984.5, 1296.0]",10,29,-19
31239.0,2020-01-22,"(381.132, 599.0]",22,28,-6
31239.0,2020-01-22,"(599.0, 816.0]",9,12,-3
31239.0,2020-01-22,"(816.0, 1033.0]",6,15,-9
31239.0,2020-01-22,"(1033.0, 1250.0]",11,32,-21
31240.0,2020-01-22,"(749.758, 810.5]",1,2,-1
31240.0,2020-01-22,"(931.5, 992.0]",1,2,-1
31241.0,2020-01-22,"(17.625, 362.75]",2,4,-2
31241.0,2020-01-22,"(362.75, 706.5]",23,48,-25
31241.0,2020-01-22,"(706.5, 1050.25]",8,25,-17
31241.0,2020-01-22,"(1050.25, 1394.0]",25,41,-16
31242.0,2020-01-22,"(365.053, 602.75]",19,20,-1
31242.0,2020-01-22,"(602.75, 839.5]",3,6,-3
31242.0,2020-01-22,"(839.5, 1076.25]",2,19,-17
31243.0,2020-01-22,"(376.176, 583.0]",22,25,-3
31243.0,2020-01-22,"(583.0, 789.0]",5,8,-3
31243.0,2020-01-22,"(789.0, 995.0]",2,13,-11
31243.0,2020-01-22,"(995.0, 1201.0]",1,13,-12
31244.0,2020-01-22,"(376.75, 696.5]",18,1,17
31244.0,2020-01-22,"(696.5, 1016.25]",3,25,-22
31244.0,2020-01-22,"(1016.25, 1336.0]",7,10,-3
31245.0,2020-01-22,"(386.957, 648.75]",7,17,-10
31245.0,2020-01-22,"(648.75, 909.5]",6,10,-4
31245.0,2020-01-22,"(909.5, 1170.25]",16,31,-15
31245.0,2020-01-22,"(1170.25, 1431.0]",4,10,-6
31246.0,2020-01-22,"(453.16, 664.0]",12,22,-10
31246.0,2020-01-22,"(664.0, 874.0]",6,11,-5
31246.0,2020-01-22,"(874.0, 1084.0]",7,15,-8
31246.0,2020-01-22,"(1084.0, 1294.0]",4,13,-9
31247.0,2020-01-22,"(354.121, 574.75]",9,13,-4
31247.0,2020-01-22,"(574.75, 794.5]",1,3,-2
31247.0,2020-01-22,"(794.5, 1014.25]",3,6,-3
31247.0,2020-01-22,"(1014.25, 1234.0]",3,11,-8
31248.0,2020-01-22,"(356.205, 555.75]",5,7,-2
31248.0,2020-01-22,"(555.75, 754.5]",2,3,-1
31248.0,2020-01-22,"(754.5, 953.25]",6,10,-4
31248.0,2020-01-22,"(953.25, 1152.0]",4,11,-7
31249.0,2020-01-22,"(430.353, 592.75]",4,8,-4
31249.0,2020-01-22,"(592.75, 754.5]",1,2,-1
31249.0,2020-01-22,"(754.5, 916.25]",1,2,-1
31249.0,2020-01-22,"(916.25, 1078.0]",5,10,-5
31250.0,2020-01-22,"(418.992, 672.0]",15,17,-2
31250.0,2020-01-22,"(672.0, 924.0]",8,17,-9
31250.0,2020-01-22,"(924.0, 1176.0]",5,20,-15
31250.0,2020-01-22,"(1176.0, 1428.0]",2,7,-5
31251.0,2020-01-22,"(517.0, 790.0]",21,2,19
31251.0,2020-01-22,"(790.0, 1063.0]",7,30,-23
31251.0,2020-01-22,"(1063.0, 1336.0]",10,18,-8
31252.0,2020-01-22,"(463.347, 627.25]",17,17,0
31252.0,2020-01-22,"(627.25, 790.5]",1,4,-3
31252.0,2020-01-22,"(790.5, 953.75]",4,13,-9
31252.0,2020-01-22,"(953.75, 1117.0]",5,22,-17
31253.0,2020-01-22,"(392.096, 619.0]",28,30,-2
31253.0,2020-01-22,"(619.0, 845.0]",4,6,-2
31253.0,2020-01-22,"(845.0, 1071.0]",8,16,-8
31254.0,2020-01-22,"(409.02, 655.0]",25,28,-3
31254.0,2020-01-22,"(655.0, 900.0]",3,5,-2
31254.0,2020-01-22,"(900.0, 1145.0]",2,15,-13
31254.0,2020-01-22,"(1145.0, 1390.0]",1,5,-4
31255.0,2020-01-22,"(398.137, 614.75]",16,21,-5
31255.0,2020-01-22,"(614.75, 830.5]",2,6,-4
31255.0,2020-01-22,"(830.5, 1046.25]",2,13,-11
31255.0,2020-01-22,"(1046.25, 1262.0]",5,10,-5
31256.0,2020-01-22,"(270.03, 513.5]",8,8,0
31256.0,2020-01-22,"(513.5, 756.0]",6,6,0
31256.0,2020-01-22,"(998.5, 1241.0]",4,2,2
31257.0,2020-01-22,"(338.979, 595.25]",10,19,-9
31257.0,2020-01-22,"(595.25, 850.5]",14,21,-7
31257.0,2020-01-22,"(850.5, 1105.75]",21,35,-14
31257.0,2020-01-22,"(1105.75, 1361.0]",6,22,-16
31258.0,2020-01-22,"(77.787, 382.25]",2,3,-1
31258.0,2020-01-22,"(382.25, 685.5]",4,18,-14
31258.0,2020-01-22,"(685.5, 988.75]",4,7,-3
31258.0,2020-01-22,"(988.75, 1292.0]",7,19,-12
31259.0,2020-01-22,"(392.204, 592.0]",8,9,-1
31259.0,2020-01-22,"(592.0, 791.0]",1,2,-1
31259.0,2020-01-22,"(791.0, 990.0]",1,3,-2
31259.0,2020-01-22,"(990.0, 1189.0]",3,9,-6
31260.0,2020-01-22,"(-0.415, 354.75]",1,1,0
31260.0,2020-01-22,"(354.75, 708.5]",14,21,-7
31260.0,2020-01-22,"(708.5, 1062.25]",5,16,-11
31260.0,2020-01-22,"(1062.25, 1416.0]",6,12,-6
31261.0,2020-01-22,"(388.274, 570.5]",12,12,0
31262.0,2020-01-22,"(450.193, 652.75]",7,8,-1
31262.0,2020-01-22,"(652.75, 854.5]",3,4,-1
31262.0,2020-01-22,"(854.5, 1056.25]",4,7,-3
31262.0,2020-01-22,"(1056.25, 1258.0]",1,6,-5
31263.0,2020-01-22,"(352.976, 610.0]",20,31,-11
31263.0,2020-01-22,"(610.0, 866.0]",6,13,-7
31263.0,2020-01-22,"(866.0, 1122.0]",7,22,-15
31263.0,2020-01-22,"(1122.0, 1378.0]",3,6,-3
31264.0,2020-01-22,"(421.028, 665.0]",10,14,-4
31264.0,2020-01-22,"(665.0, 908.0]",6,9,-3
31264.0,2020-01-22,"(908.0, 1151.0]",7,22,-15
31264.0,2020-01-22,"(1151.0, 1394.0]",1,5,-4
31265.0,2020-01-22,"(327.897, 604.75]",11,24,-13
31265.0,2020-01-22,"(604.75, 880.5]",9,17,-8
31265.0,2020-01-22,"(880.5, 1156.25]",23,38,-15
31265.0,2020-01-22,"(1156.25, 1432.0]",14,22,-8
31266.0,2020-01-22,"(16.661, 352.75]",1,5,-4
31266.0,2020-01-22,"(352.75, 687.5]",5,24,-19
31266.0,2020-01-22,"(687.5, 1022.25]",10,18,-8
31266.0,2020-01-22,"(1022.25, 1357.0]",27,40,-13
31267.0,2020-01-22,"(26.75, 340.5]",1,1,0
31267.0,2020-01-22,"(340.5, 653.0]",22,33,-11
31267.0,2020-01-22,"(653.0, 965.5]",6,12,-6
31267.0,2020-01-22,"(965.5, 1278.0]",13,31,-18
31268.0,2020-01-22,"(334.941, 600.75]",11,31,-20
31268.0,2020-01-22,"(600.75, 865.5]",10,19,-9
31268.0,2020-01-22,"(865.5, 1130.25]",16,21,-5
31268.0,2020-01-22,"(1130.25, 1395.0]",10,14,-4
31269.0,2020-01-22,"(316.089, 544.75]",11,17,-6
31269.0,2020-01-22,"(544.75, 772.5]",8,12,-4
31269.0,2020-01-22,"(772.5, 1000.25]",7,12,-5
31269.0,2020-01-22,"(1000.25, 1228.0]",3,6,-3
31270.0,2020-01-22,"(424.084, 654.0]",15,19,-4
31270.0,2020-01-22,"(654.0, 883.0]",3,7,-4
31270.0,2020-01-22,"(883.0, 1112.0]",11,18,-7
31270.0,2020-01-22,"(1112.0, 1341.0]",4,9,-5
31271.0,2020-01-22,"(452.289, 630.75]",12,13,-1
31271.0,2020-01-22,"(630.75, 808.5]",1,3,-2
31271.0,2020-01-22,"(808.5, 986.25]",5,12,-7
31271.0,2020-01-22,"(986.25, 1164.0]",7,20,-13
31272.0,2020-01-22,"(297.934, 565.5]",22,24,-2
31272.0,2020-01-22,"(565.5, 832.0]",7,13,-6
31272.0,2020-01-22,"(832.0, 1098.5]",5,20,-15
31272.0,2020-01-22,"(1098.5, 1365.0]",2,7,-5
31273.0,2020-01-22,"(818.5, 929.0]",1,3,-2
31274.0,2020-01-22,"(333.129, 551.75]",7,8,-1
31274.0,2020-01-22,"(551.75, 769.5]",5,5,0
31274.0,2020-01-22,"(769.5, 987.25]",1,1,0
31274.0,2020-01-22,"(987.25, 1205.0]",3,12,-9
31275.0,2020-01-22,"(352.942, 618.5]",16,26,-10
31275.0,2020-01-22,"(618.5, 883.0]",8,15,-7
31275.0,2020-01-22,"(883.0, 1147.5]",12,20,-8
31275.0,2020-01-22,"(1147.5, 1412.0]",4,9,-5
31276.0,2020-01-22,"(435.112, 658.0]",22,23,-1
31276.0,2020-01-22,"(658.0, 880.0]",3,5,-2
31276.0,2020-01-22,"(880.0, 1102.0]",3,19,-16
31277.0,2020-01-22,"(413.104, 638.0]",37,43,-6
31277.0,2020-01-22,"(638.0, 862.0]",5,6,-1
31277.0,2020-01-22,"(862.0, 1086.0]",7,22,-15
31277.0,2020-01-22,"(1086.0, 1310.0]",2,13,-11
31278.0,2020-01-22,"(371.034, 613.5]",7,32,-25
31278.0,2020-01-22,"(613.5, 855.0]",5,10,-5
31278.0,2020-01-22,"(855.0, 1096.5]",11,15,-4
31278.0,2020-01-22,"(1096.5, 1338.0]",18,28,-10
31279.0,2020-01-22,"(384.165, 593.75]",21,25,-4
31279.0,2020-01-22,"(593.75, 802.5]",6,13,-7
31279.0,2020-01-22,"(802.5, 1011.25]",7,14,-7
31279.0,2020-01-22,"(1011.25, 1220.0]",7,30,-23
31280.0,2020-01-22,"(347.024, 592.0]",4,23,-19
31280.0,2020-01-22,"(836.0, 1080.0]",9,2,7
31280.0,2020-01-22,"(1080.0, 1324.0]",12,11,1
31000.0,2020-01-23,"(875.25, 1000.0]",1,1,0
31001.0,2020-01-23,"(1164.0, 1200.0]",1,1,0
31002.0,2020-01-23,"(536.497, 662.75]",1,3,-2
31002.0,2020-01-23,"(914.25, 1040.0]",4,1,3
31003.0,2020-01-23,"(436.286, 615.5]",2,4,-2
31003.0,2020-01-23,"(615.5, 794.0]",2,3,-1
31003.0,2020-01-23,"(972.5, 1151.0]",4,5,-1
31004.0,2020-01-23,"(933.0, 1074.0]",2,3,-1
31005.0,2020-01-23,"(436.183, 641.25]",5,5,0
31005.0,2020-01-23,"(1049.75, 1254.0]",1,1,0
31006.0,2020-01-23,"(898.75, 1065.0]",2,2,0
31007.0,2020-01-23,"(361.071, 594.25]",7,16,-9
31007.0,2020-01-23,"(594.25, 826.5]",5,11,-6
31007.0,2020-01-23,"(826.5, 1058.75]",3,9,-6
31007.0,2020-01-23,"(1058.75, 1291.0]",3,8,-5
31009.0,2020-01-23,"(427.392, 580.0]",2,2,0
31009.0,2020-01-23,"(580.0, 732.0]",2,2,0
31009.0,2020-01-23,"(732.0, 884.0]",1,1,0
31010.0,2020-01-23,"(436.464, 571.0]",1,1,0
31010.0,2020-01-23,"(705.0, 839.0]",2,4,-2
31010.0,2020-01-23,"(839.0, 973.0]",1,1,0
31011.0,2020-01-23,"(340.173, 547.75]",4,4,0
31011.0,2020-01-23,"(547.75, 754.5]",1,1,0
31011.0,2020-01-23,"(754.5, 961.25]",1,1,0
31011.0,2020-01-23,"(961.25, 1168.0]",1,4,-3
31012.0,2020-01-23,"(365.315, 537.25]",4,6,-2
31012.0,2020-01-23,"(708.5, 879.75]",1,1,0
31012.0,2020-01-23,"(879.75, 1051.0]",1,2,-1
31013.0,2020-01-23,"(584.5, 821.0]",1,2,-1
31013.0,2020-01-23,"(821.0, 1057.5]",2,3,-1
31013.0,2020-01-23,"(1057.5, 1294.0]",3,5,-2
31014.0,2020-01-23,"(347.084, 577.0]",11,14,-3
31014.0,2020-01-23,"(577.0, 806.0]",4,6,-2
31014.0,2020-01-23,"(806.0, 1035.0]",6,8,-2
31014.0,2020-01-23,"(1035.0, 1264.0]",15,29,-14
31015.0,2020-01-23,"(368.062, 603.5]",10,13,-3
31015.0,2020-01-23,"(603.5, 838.0]",1,3,-2
31015.0,2020-01-23,"(838.0, 1072.5]",6,7,-1
31015.0,2020-01-23,"(1072.5, 1307.0]",10,20,-10
31016.0,2020-01-23,"(353.088, 582.0]",4,9,-5
31016.0,2020-01-23,"(582.0, 810.0]",3,7,-4
31016.0,2020-01-23,"(810.0, 1038.0]",2,5,-3
31016.0,2020-01-23,"(1038.0, 1266.0]",3,6,-3
31017.0,2020-01-23,"(504.356, 666.0]",3,5,-2
31017.0,2020-01-23,"(988.0, 1149.0]",2,1,1
31018.0,2020-01-23,"(817.0, 1010.0]",2,2,0
31018.0,2020-01-23,"(1010.0, 1203.0]",1,2,-1
31019.0,2020-01-23,"(581.526, 700.5]",1,2,-1
31019.0,2020-01-23,"(819.0, 937.5]",1,1,0
31020.0,2020-01-23,"(1005.0, 1221.5]",1,1,0
31021.0,2020-01-23,"(473.2, 674.0]",2,5,-3
31021.0,2020-01-23,"(674.0, 874.0]",3,5,-2
31021.0,2020-01-23,"(874.0, 1074.0]",1,4,-3
31021.0,2020-01-23,"(1074.0, 1274.0]",3,9,-6
31022.0,2020-01-23,"(474.157, 685.75]",3,7,-4
31022.0,2020-01-23,"(896.5, 1107.25]",4,1,3
31022.0,2020-01-23,"(1107.25, 1318.0]",2,5,-3
31023.0,2020-01-23,"(526.252, 714.0]",2,2,0
31023.0,2020-01-23,"(1088.0, 1275.0]",3,5,-2
31024.0,2020-01-23,"(424.148, 638.0]",9,14,-5
31024.0,2020-01-23,"(638.0, 851.0]",2,3,-1
31024.0,2020-01-23,"(851.0, 1064.0]",2,7,-5
31024.0,2020-01-23,"(1064.0, 1277.0]",6,17,-11
31025.0,2020-01-23,"(501.241, 691.75]",2,4,-2
31025.0,2020-01-23,"(1071.25, 1261.0]",5,1,4
31026.0,2020-01-23,"(409.225, 603.75]",1,2,-1
31026.0,2020-01-23,"(603.75, 797.5]",1,1,0
31026.0,2020-01-23,"(797.5, 991.25]",2,5,-3
31026.0,2020-01-23,"(991.25, 1185.0]",5,10,-5
31027.0,2020-01-23,"(575.5, 863.25]",1,1,0
31027.0,2020-01-23,"(863.25, 1151.0]",2,1,1
31028.0,2020-01-23,"(460.269, 643.75]",2,2,0
31028.0,2020-01-23,"(643.75, 826.5]",1,2,-1
31028.0,2020-01-23,"(1009.25, 1192.0]",1,7,-6
31029.0,2020-01-23,"(1039.0, 1213.0]",4,7,-3
31030.0,2020-01-23,"(549.25, 751.5]",1,7,-6
31030.0,2020-01-23,"(751.5, 953.75]",1,5,-4
31030.0,2020-01-23,"(953.75, 1156.0]",5,5,0
31031.0,2020-01-23,"(422.99, 676.5]",2,6,-4
31031.0,2020-01-23,"(929.0, 1181.5]",3,5,-2
31031.0,2020-01-23,"(1181.5, 1434.0]",2,2,0
,,,,1.0,
,,,,2.0,
,,,,1.0,
,,,,1.0,
,,,,1.0,
31034.0,2020-01-23,"(505.071, 738.25]",3,6,-3
31034.0,2020-01-23,"(970.5, 1202.75]",2,1,1
31035.0,2020-01-23,"(428.255, 615.25]",1,3,-2
31035.0,2020-01-23,"(615.25, 801.5]",1,1,0
31035.0,2020-01-23,"(801.5, 987.75]",1,2,-1
31035.0,2020-01-23,"(987.75, 1174.0]",2,5,-3
31036.0,2020-01-23,"(594.5, 783.0]",1,3,-2
31036.0,2020-01-23,"(971.5, 1160.0]",4,1,3
31037.0,2020-01-23,"(409.048, 648.0]",12,16,-4
31037.0,2020-01-23,"(648.0, 886.0]",5,8,-3
31037.0,2020-01-23,"(886.0, 1124.0]",4,22,-18
31037.0,2020-01-23,"(1124.0, 1362.0]",8,16,-8
31038.0,2020-01-23,"(390.325, 559.75]",1,2,-1
31038.0,2020-01-23,"(728.5, 897.25]",1,1,0
31039.0,2020-01-23,"(440.219, 636.25]",1,4,-3
31039.0,2020-01-23,"(636.25, 831.5]",1,2,-1
31039.0,2020-01-23,"(831.5, 1026.75]",1,2,-1
31039.0,2020-01-23,"(1026.75, 1222.0]",1,4,-3
31040.0,2020-01-23,"(375.0, 625.0]",3,1,2
31040.0,2020-01-23,"(625.0, 875.0]",1,4,-3
31040.0,2020-01-23,"(875.0, 1125.0]",1,3,-2
,,,,1.0,
,,,,1.0,
31042.0,2020-01-23,"(446.304, 621.0]",8,9,-1
31042.0,2020-01-23,"(795.0, 969.0]",1,3,-2
31043.0,2020-01-23,"(417.323, 587.25]",1,2,-1
31043.0,2020-01-23,"(587.25, 756.5]",1,2,-1
31043.0,2020-01-23,"(925.75, 1095.0]",4,7,-3
31044.0,2020-01-23,"(424.064, 659.0]",3,5,-2
31044.0,2020-01-23,"(893.0, 1127.0]",1,2,-1
31045.0,2020-01-23,"(556.42, 702.0]",2,3,-1
31045.0,2020-01-23,"(992.0, 1137.0]",3,1,2
31046.0,2020-01-23,"(460.0, 492.0]",1,1,0
31047.0,2020-01-23,"(345.161, 555.75]",8,13,-5
31047.0,2020-01-23,"(555.75, 765.5]",2,4,-2
31047.0,2020-01-23,"(765.5, 975.25]",3,4,-1
31047.0,2020-01-23,"(975.25, 1185.0]",5,18,-13
31048.0,2020-01-23,"(968.5, 1181.25]",4,4,0
31048.0,2020-01-23,"(1181.25, 1394.0]",1,2,-1
31049.0,2020-01-23,"(545.127, 764.25]",1,1,0
31049.0,2020-01-23,"(982.5, 1200.75]",1,4,-3
31049.0,2020-01-23,"(1200.75, 1419.0]",1,2,-1
31050.0,2020-01-23,"(817.5, 967.25]",1,1,0
31050.0,2020-01-23,"(967.25, 1117.0]",1,1,0
31051.0,2020-01-23,"(667.0, 897.0]",1,5,-4
31051.0,2020-01-23,"(897.0, 1127.0]",1,1,0
31051.0,2020-01-23,"(1127.0, 1357.0]",5,1,4
31052.0,2020-01-23,"(498.25, 537.5]",1,1,0
,,,,2.0,
,,,,2.0,
31055.0,2020-01-23,"(360.292, 538.0]",1,1,0
31055.0,2020-01-23,"(892.0, 1069.0]",2,3,-1
31056.0,2020-01-23,"(946.5, 1046.0]",4,1,3
,,,,2.0,
31058.0,2020-01-23,"(13.5, 18.0]",1,1,0
31059.0,2020-01-23,"(691.25, 814.5]",1,2,-1
31059.0,2020-01-23,"(937.75, 1061.0]",2,1,1
31060.0,2020-01-23,"(492.314, 664.5]",2,3,-1
31060.0,2020-01-23,"(1007.5, 1179.0]",2,1,1
,,,,2.0,
31062.0,2020-01-23,"(1166.75, 1188.0]",1,1,0
31063.0,2020-01-23,"(353.0, 706.0]",1,1,0
31063.0,2020-01-23,"(1059.0, 1412.0]",1,1,0
31064.0,2020-01-23,"(427.271, 610.25]",3,6,-3
31064.0,2020-01-23,"(974.75, 1157.0]",2,3,-1
31065.0,2020-01-23,"(612.0, 770.0]",2,1,1
31065.0,2020-01-23,"(928.0, 1086.0]",1,4,-3
,,,,1.0,
,,,,1.0,
31067.0,2020-01-23,"(944.5, 1255.0]",2,1,1
31068.0,2020-01-23,"(909.5, 1081.25]",1,1,0
31069.0,2020-01-23,"(429.152, 642.0]",1,8,-7
31069.0,2020-01-23,"(642.0, 854.0]",1,5,-4
31069.0,2020-01-23,"(1066.0, 1278.0]",2,1,1
31070.0,2020-01-23,"(976.5, 1302.0]",3,1,2
31071.0,2020-01-23,"(434.178, 640.5]",1,4,-3
31071.0,2020-01-23,"(640.5, 846.0]",2,4,-2
31071.0,2020-01-23,"(846.0, 1051.5]",6,9,-3
31071.0,2020-01-23,"(1051.5, 1257.0]",4,7,-3
31072.0,2020-01-23,"(932.0, 1084.0]",1,1,0
31073.0,2020-01-23,"(496.426, 640.5]",2,3,-1
31073.0,2020-01-23,"(927.5, 1071.0]",1,1,0
31074.0,2020-01-23,"(1010.75, 1182.0]",1,2,-1
31075.0,2020-01-23,"(980.5, 1113.0]",1,1,0
,,,,2.0,
31077.0,2020-01-23,"(430.346, 594.5]",1,4,-3
31077.0,2020-01-23,"(921.5, 1085.0]",1,4,-3
31078.0,2020-01-23,"(482.548, 596.0]",5,5,0
31078.0,2020-01-23,"(596.0, 709.0]",1,4,-3
31078.0,2020-01-23,"(709.0, 822.0]",1,3,-2
31079.0,2020-01-23,"(882.0, 1121.0]",2,5,-3
31079.0,2020-01-23,"(1121.0, 1360.0]",8,2,6
31080.0,2020-01-23,"(610.0, 875.0]",1,7,-6
31080.0,2020-01-23,"(875.0, 1140.0]",8,3,5
31080.0,2020-01-23,"(1140.0, 1405.0]",5,14,-9
31081.0,2020-01-23,"(475.259, 661.25]",3,3,0
31081.0,2020-01-23,"(846.5, 1031.75]",1,2,-1
31081.0,2020-01-23,"(1031.75, 1217.0]",1,2,-1
31082.0,2020-01-23,"(730.837, 771.75]",1,1,0
31083.0,2020-01-23,"(531.375, 688.25]",1,2,-1
31083.0,2020-01-23,"(844.5, 1000.75]",1,1,0
31083.0,2020-01-23,"(1000.75, 1157.0]",4,1,3
31084.0,2020-01-23,"(407.183, 612.25]",2,3,-1
31084.0,2020-01-23,"(612.25, 816.5]",6,7,-1
31084.0,2020-01-23,"(816.5, 1020.75]",1,1,0
31084.0,2020-01-23,"(1020.75, 1225.0]",1,8,-7
31085.0,2020-01-23,"(798.5, 964.75]",1,5,-4
31085.0,2020-01-23,"(964.75, 1131.0]",2,2,0
31086.0,2020-01-23,"(965.5, 1135.0]",1,2,-1
31087.0,2020-01-23,"(402.312, 575.0]",1,3,-2
31087.0,2020-01-23,"(575.0, 747.0]",1,2,-1
31087.0,2020-01-23,"(919.0, 1091.0]",3,4,-1
31088.0,2020-01-23,"(668.5, 825.0]",1,3,-2
31088.0,2020-01-23,"(981.5, 1138.0]",4,1,3
31089.0,2020-01-23,"(379.026, 623.5]",6,12,-6
31089.0,2020-01-23,"(623.5, 867.0]",2,3,-1
31089.0,2020-01-23,"(867.0, 1110.5]",4,20,-16
31089.0,2020-01-23,"(1110.5, 1354.0]",1,6,-5
31090.0,2020-01-23,"(985.907, 1009.25]",1,2,-1
31090.0,2020-01-23,"(1055.75, 1079.0]",1,1,0
31091.0,2020-01-23,"(975.75, 1156.0]",1,4,-3
31092.0,2020-01-23,"(1006.5, 1182.0]",1,1,0
31093.0,2020-01-23,"(526.586, 630.5]",1,4,-3
31094.0,2020-01-23,"(497.369, 655.75]",1,1,0
31094.0,2020-01-23,"(971.25, 1129.0]",1,2,-1
,,,,2.0,
31096.0,2020-01-23,"(856.5, 969.0]",1,1,0
31096.0,2020-01-23,"(1081.5, 1194.0]",1,1,0
31097.0,2020-01-23,"(537.346, 701.5]",2,2,0
31097.0,2020-01-23,"(865.0, 1028.5]",1,3,-2
31097.0,2020-01-23,"(1028.5, 1192.0]",1,3,-2
31098.0,2020-01-23,"(440.325, 609.75]",4,10,-6
31098.0,2020-01-23,"(609.75, 778.5]",1,1,0
31098.0,2020-01-23,"(778.5, 947.25]",1,1,0
31098.0,2020-01-23,"(947.25, 1116.0]",10,15,-5
31099.0,2020-01-23,"(471.283, 651.25]",1,3,-2
31099.0,2020-01-23,"(830.5, 1009.75]",1,1,0
31099.0,2020-01-23,"(1009.75, 1189.0]",2,6,-4
31100.0,2020-01-23,"(448.319, 619.25]",14,15,-1
31100.0,2020-01-23,"(619.25, 789.5]",1,3,-2
31100.0,2020-01-23,"(789.5, 959.75]",4,7,-3
31100.0,2020-01-23,"(959.75, 1130.0]",2,18,-16
31101.0,2020-01-23,"(68.65, 407.5]",1,3,-2
31101.0,2020-01-23,"(407.5, 745.0]",13,49,-36
31101.0,2020-01-23,"(745.0, 1082.5]",22,30,-8
31101.0,2020-01-23,"(1082.5, 1420.0]",27,41,-14
31102.0,2020-01-23,"(75.64, 417.0]",1,2,-1
31102.0,2020-01-23,"(417.0, 757.0]",1,22,-21
31102.0,2020-01-23,"(757.0, 1097.0]",4,11,-7
31102.0,2020-01-23,"(1097.0, 1437.0]",7,11,-4
31103.0,2020-01-23,"(369.041, 609.75]",1,25,-24
31103.0,2020-01-23,"(609.75, 849.5]",3,13,-10
31103.0,2020-01-23,"(849.5, 1089.25]",3,10,-7
31103.0,2020-01-23,"(1089.25, 1329.0]",10,22,-12
31104.0,2020-01-23,"(335.945, 600.75]",8,24,-16
31104.0,2020-01-23,"(600.75, 864.5]",2,7,-5
31104.0,2020-01-23,"(864.5, 1128.25]",13,28,-15
31104.0,2020-01-23,"(1128.25, 1392.0]",13,22,-9
31105.0,2020-01-23,"(356.088, 585.0]",2,10,-8
31105.0,2020-01-23,"(813.0, 1041.0]",3,3,0
31105.0,2020-01-23,"(1041.0, 1269.0]",4,7,-3
31106.0,2020-01-23,"(451.231, 644.25]",1,8,-7
31106.0,2020-01-23,"(836.5, 1028.75]",3,4,-1
31106.0,2020-01-23,"(1028.75, 1221.0]",3,3,0
31107.0,2020-01-23,"(350.956, 613.0]",3,23,-20
31107.0,2020-01-23,"(613.0, 874.0]",1,8,-7
31107.0,2020-01-23,"(874.0, 1135.0]",13,25,-12
31107.0,2020-01-23,"(1135.0, 1396.0]",8,10,-2
31108.0,2020-01-23,"(407.126, 626.5]",5,26,-21
31108.0,2020-01-23,"(626.5, 845.0]",4,7,-3
31108.0,2020-01-23,"(845.0, 1063.5]",13,20,-7
31108.0,2020-01-23,"(1063.5, 1282.0]",19,24,-5
31109.0,2020-01-23,"(418.014, 665.5]",5,14,-9
31109.0,2020-01-23,"(665.5, 912.0]",2,5,-3
31109.0,2020-01-23,"(912.0, 1158.5]",11,16,-5
31109.0,2020-01-23,"(1158.5, 1405.0]",5,10,-5
31110.0,2020-01-23,"(0.573, 358.75]",3,5,-2
31110.0,2020-01-23,"(358.75, 715.5]",20,42,-22
31110.0,2020-01-23,"(715.5, 1072.25]",14,34,-20
31110.0,2020-01-23,"(1072.25, 1429.0]",22,36,-14
31111.0,2020-01-23,"(348.913, 621.75]",6,20,-14
31111.0,2020-01-23,"(621.75, 893.5]",3,5,-2
31111.0,2020-01-23,"(893.5, 1165.25]",20,27,-7
31111.0,2020-01-23,"(1165.25, 1437.0]",3,9,-6
31112.0,2020-01-23,"(789.0, 1025.5]",1,2,-1
31112.0,2020-01-23,"(1025.5, 1262.0]",3,3,0
31113.0,2020-01-23,"(-0.432, 359.0]",2,4,-2
31113.0,2020-01-23,"(359.0, 717.0]",2,27,-25
31113.0,2020-01-23,"(717.0, 1075.0]",3,7,-4
31113.0,2020-01-23,"(1075.0, 1433.0]",5,17,-12
31114.0,2020-01-23,"(321.019, 567.25]",8,33,-25
31114.0,2020-01-23,"(812.5, 1057.75]",13,22,-9
31114.0,2020-01-23,"(1057.75, 1303.0]",20,34,-14
31115.0,2020-01-23,"(532.0, 816.0]",2,15,-13
31115.0,2020-01-23,"(816.0, 1100.0]",9,9,0
31115.0,2020-01-23,"(1100.0, 1384.0]",10,17,-7
31116.0,2020-01-23,"(70.668, 405.0]",1,2,-1
31116.0,2020-01-23,"(405.0, 738.0]",9,29,-20
31116.0,2020-01-23,"(738.0, 1071.0]",8,16,-8
31116.0,2020-01-23,"(1071.0, 1404.0]",21,28,-7
31117.0,2020-01-23,"(307.981, 563.75]",3,29,-26
31117.0,2020-01-23,"(563.75, 818.5]",3,10,-7
31117.0,2020-01-23,"(818.5, 1073.25]",2,12,-10
31117.0,2020-01-23,"(1073.25, 1328.0]",8,17,-9
31118.0,2020-01-23,"(403.083, 633.25]",2,16,-14
31118.0,2020-01-23,"(633.25, 862.5]",2,5,-3
31118.0,2020-01-23,"(862.5, 1091.75]",7,7,0
31118.0,2020-01-23,"(1091.75, 1321.0]",5,6,-1
31119.0,2020-01-23,"(0.716, 323.0]",1,3,-2
31119.0,2020-01-23,"(323.0, 644.0]",7,21,-14
31119.0,2020-01-23,"(644.0, 965.0]",4,8,-4
31119.0,2020-01-23,"(965.0, 1286.0]",17,26,-9
31120.0,2020-01-23,"(739.0, 1089.0]",6,1,5
31120.0,2020-01-23,"(1089.0, 1439.0]",6,11,-5
31121.0,2020-01-23,"(363.123, 583.25]",16,18,-2
31121.0,2020-01-23,"(583.25, 802.5]",1,4,-3
31121.0,2020-01-23,"(802.5, 1021.75]",2,5,-3
31121.0,2020-01-23,"(1021.75, 1241.0]",5,17,-12
31122.0,2020-01-23,"(460.077, 691.75]",1,9,-8
31122.0,2020-01-23,"(691.75, 922.5]",2,4,-2
31122.0,2020-01-23,"(922.5, 1153.25]",8,15,-7
31122.0,2020-01-23,"(1153.25, 1384.0]",7,19,-12
31123.0,2020-01-23,"(302.907, 577.25]",2,19,-17
31123.0,2020-01-23,"(577.25, 850.5]",2,3,-1
31123.0,2020-01-23,"(850.5, 1123.75]",3,8,-5
31123.0,2020-01-23,"(1123.75, 1397.0]",3,4,-1
31124.0,2020-01-23,"(18.584, 374.0]",3,5,-2
31124.0,2020-01-23,"(374.0, 728.0]",20,48,-28
31124.0,2020-01-23,"(728.0, 1082.0]",18,35,-17
31124.0,2020-01-23,"(1082.0, 1436.0]",14,42,-28
31125.0,2020-01-23,"(66.723, 387.25]",2,4,-2
31125.0,2020-01-23,"(387.25, 706.5]",5,27,-22
31125.0,2020-01-23,"(706.5, 1025.75]",5,11,-6
31125.0,2020-01-23,"(1025.75, 1345.0]",28,37,-9
31126.0,2020-01-23,"(317.959, 579.25]",2,21,-19
31126.0,2020-01-23,"(579.25, 839.5]",1,1,0
31126.0,2020-01-23,"(839.5, 1099.75]",7,12,-5
31126.0,2020-01-23,"(1099.75, 1360.0]",13,19,-6
31127.0,2020-01-23,"(392.25, 725.5]",12,1,11
31127.0,2020-01-23,"(725.5, 1058.75]",10,21,-11
31127.0,2020-01-23,"(1058.75, 1392.0]",13,21,-8
31128.0,2020-01-23,"(346.022, 591.5]",18,28,-10
31128.0,2020-01-23,"(591.5, 836.0]",9,15,-6
31128.0,2020-01-23,"(836.0, 1080.5]",20,32,-12
31128.0,2020-01-23,"(1080.5, 1325.0]",12,27,-15
31129.0,2020-01-23,"(428.024, 673.0]",11,13,-2
31129.0,2020-01-23,"(673.0, 917.0]",9,10,-1
31129.0,2020-01-23,"(917.0, 1161.0]",7,13,-6
31129.0,2020-01-23,"(1161.0, 1405.0]",1,1,0
31130.0,2020-01-23,"(406.08, 637.0]",3,11,-8
31130.0,2020-01-23,"(637.0, 867.0]",2,4,-2
31130.0,2020-01-23,"(867.0, 1097.0]",6,7,-1
31130.0,2020-01-23,"(1097.0, 1327.0]",8,13,-5
31131.0,2020-01-23,"(615.25, 862.5]",1,13,-12
31131.0,2020-01-23,"(1109.75, 1357.0]",4,2,2
31200.0,2020-01-23,"(420.988, 675.0]",21,36,-15
31200.0,2020-01-23,"(675.0, 928.0]",8,17,-9
31200.0,2020-01-23,"(928.0, 1181.0]",21,44,-23
31200.0,2020-01-23,"(1181.0, 1434.0]",7,21,-14
31201.0,2020-01-23,"(298.905, 573.75]",15,31,-16
31201.0,2020-01-23,"(573.75, 847.5]",12,20,-8
31201.0,2020-01-23,"(847.5, 1121.25]",32,50,-18
31201.0,2020-01-23,"(1121.25, 1395.0]",20,43,-23
31202.0,2020-01-23,"(19.65, 358.5]",2,4,-2
31202.0,2020-01-23,"(358.5, 696.0]",12,30,-18
31202.0,2020-01-23,"(696.0, 1033.5]",10,19,-9
31202.0,2020-01-23,"(1033.5, 1371.0]",21,37,-16
31203.0,2020-01-23,"(46.611, 395.25]",1,4,-3
31203.0,2020-01-23,"(395.25, 742.5]",13,30,-17
31203.0,2020-01-23,"(742.5, 1089.75]",20,32,-12
31203.0,2020-01-23,"(1089.75, 1437.0]",25,42,-17
31204.0,2020-01-23,"(393.993, 646.75]",12,18,-6
31204.0,2020-01-23,"(646.75, 898.5]",9,15,-6
31204.0,2020-01-23,"(898.5, 1150.25]",10,29,-19
31204.0,2020-01-23,"(1150.25, 1402.0]",4,7,-3
31205.0,2020-01-23,"(417.979, 674.25]",21,24,-3
31205.0,2020-01-23,"(674.25, 929.5]",16,24,-8
31205.0,2020-01-23,"(929.5, 1184.75]",6,24,-18
31205.0,2020-01-23,"(1184.75, 1440.0]",1,15,-14
31206.0,2020-01-23,"(500.357, 661.75]",6,6,0
31206.0,2020-01-23,"(822.5, 983.25]",1,6,-5
31206.0,2020-01-23,"(983.25, 1144.0]",2,7,-5
31207.0,2020-01-23,"(342.007, 591.25]",1,5,-4
31207.0,2020-01-23,"(839.5, 1087.75]",1,1,0
31207.0,2020-01-23,"(1087.75, 1336.0]",2,3,-1
31208.0,2020-01-23,"(358.005, 607.75]",12,13,-1
31208.0,2020-01-23,"(607.75, 856.5]",2,2,0
31208.0,2020-01-23,"(856.5, 1105.25]",3,14,-11
31208.0,2020-01-23,"(1105.25, 1354.0]",2,6,-4
31209.0,2020-01-23,"(437.269, 620.75]",1,4,-3
31209.0,2020-01-23,"(620.75, 803.5]",1,1,0
31209.0,2020-01-23,"(986.25, 1169.0]",7,8,-1
31211.0,2020-01-23,"(443.113, 665.75]",9,12,-3
31211.0,2020-01-23,"(887.5, 1109.25]",7,10,-3
31211.0,2020-01-23,"(1109.25, 1331.0]",5,9,-4
31212.0,2020-01-23,"(283.864, 569.0]",33,47,-14
31212.0,2020-01-23,"(569.0, 853.0]",16,23,-7
31212.0,2020-01-23,"(853.0, 1137.0]",15,32,-17
31212.0,2020-01-23,"(1137.0, 1421.0]",5,12,-7
31213.0,2020-01-23,"(342.929, 611.75]",31,42,-11
31213.0,2020-01-23,"(611.75, 879.5]",15,25,-10
31213.0,2020-01-23,"(879.5, 1147.25]",15,32,-17
31213.0,2020-01-23,"(1147.25, 1415.0]",10,20,-10
31214.0,2020-01-23,"(367.03, 610.5]",9,35,-26
31214.0,2020-01-23,"(610.5, 853.0]",8,15,-7
31214.0,2020-01-23,"(853.0, 1095.5]",17,31,-14
31214.0,2020-01-23,"(1095.5, 1338.0]",26,38,-12
31215.0,2020-01-23,"(456.051, 694.25]",24,26,-2
31215.0,2020-01-23,"(694.25, 931.5]",2,3,-1
31215.0,2020-01-23,"(931.5, 1168.75]",7,16,-9
31215.0,2020-01-23,"(1168.75, 1406.0]",1,5,-4
31216.0,2020-01-23,"(404.142, 619.5]",25,28,-3
31216.0,2020-01-23,"(619.5, 834.0]",6,12,-6
31216.0,2020-01-23,"(834.0, 1048.5]",3,10,-7
31216.0,2020-01-23,"(1048.5, 1263.0]",5,20,-15
31217.0,2020-01-23,"(323.053, 560.75]",7,7,0
31217.0,2020-01-23,"(560.75, 797.5]",1,2,-1
31217.0,2020-01-23,"(797.5, 1034.25]",3,8,-5
31218.0,2020-01-23,"(374.116, 596.0]",12,26,-14
31218.0,2020-01-23,"(596.0, 817.0]",2,2,0
31218.0,2020-01-23,"(817.0, 1038.0]",4,9,-5
31218.0,2020-01-23,"(1038.0, 1259.0]",4,8,-4
31219.0,2020-01-23,"(355.283, 535.25]",5,5,0
31219.0,2020-01-23,"(535.25, 714.5]",3,4,-1
31219.0,2020-01-23,"(714.5, 893.75]",1,4,-3
31219.0,2020-01-23,"(893.75, 1073.0]",7,19,-12
31220.0,2020-01-23,"(431.336, 598.0]",15,15,0
31220.0,2020-01-23,"(930.0, 1096.0]",1,1,0
31221.0,2020-01-23,"(333.112, 556.0]",19,19,0
31221.0,2020-01-23,"(556.0, 778.0]",12,19,-7
31221.0,2020-01-23,"(778.0, 1000.0]",5,11,-6
31221.0,2020-01-23,"(1000.0, 1222.0]",5,27,-22
31222.0,2020-01-23,"(316.077, 547.75]",11,14,-3
31222.0,2020-01-23,"(547.75, 778.5]",13,14,-1
31222.0,2020-01-23,"(778.5, 1009.25]",3,8,-5
31222.0,2020-01-23,"(1009.25, 1240.0]",6,22,-16
31223.0,2020-01-23,"(22.663, 358.25]",1,2,-1
31223.0,2020-01-23,"(358.25, 692.5]",11,30,-19
31223.0,2020-01-23,"(692.5, 1026.75]",8,16,-8
31223.0,2020-01-23,"(1026.75, 1361.0]",14,34,-20
31224.0,2020-01-23,"(430.158, 641.5]",11,12,-1
31224.0,2020-01-23,"(641.5, 852.0]",4,7,-3
31224.0,2020-01-23,"(852.0, 1062.5]",2,10,-8
31224.0,2020-01-23,"(1062.5, 1273.0]",3,15,-12
31225.0,2020-01-23,"(63.657, 400.75]",1,1,0
31225.0,2020-01-23,"(400.75, 736.5]",15,24,-9
31225.0,2020-01-23,"(736.5, 1072.25]",6,15,-9
31225.0,2020-01-23,"(1072.25, 1408.0]",7,15,-8
31226.0,2020-01-23,"(292.977, 549.75]",3,6,-3
31226.0,2020-01-23,"(549.75, 805.5]",3,7,-4
31226.0,2020-01-23,"(805.5, 1061.25]",4,10,-6
31226.0,2020-01-23,"(1061.25, 1317.0]",4,7,-3
31227.0,2020-01-23,"(408.12, 629.0]",24,26,-2
31227.0,2020-01-23,"(629.0, 849.0]",3,5,-2
31227.0,2020-01-23,"(849.0, 1069.0]",3,9,-6
31227.0,2020-01-23,"(1069.0, 1289.0]",6,20,-14
31228.0,2020-01-23,"(4.611, 353.25]",2,2,0
31228.0,2020-01-23,"(353.25, 700.5]",10,16,-6
31228.0,2020-01-23,"(700.5, 1047.75]",24,45,-21
31228.0,2020-01-23,"(1047.75, 1395.0]",17,34,-17
31229.0,2020-01-23,"(25.589, 379.75]",2,5,-3
31229.0,2020-01-23,"(379.75, 732.5]",16,66,-50
31229.0,2020-01-23,"(732.5, 1085.25]",31,50,-19
31229.0,2020-01-23,"(1085.25, 1438.0]",22,43,-21
31230.0,2020-01-23,"(364.0, 615.0]",44,51,-7
31230.0,2020-01-23,"(615.0, 865.0]",12,18,-6
31230.0,2020-01-23,"(865.0, 1115.0]",11,23,-12
31230.0,2020-01-23,"(1115.0, 1365.0]",3,24,-21
31231.0,2020-01-23,"(326.167, 535.25]",8,9,-1
31231.0,2020-01-23,"(535.25, 743.5]",8,13,-5
31231.0,2020-01-23,"(743.5, 951.75]",5,11,-6
31231.0,2020-01-23,"(951.75, 1160.0]",5,21,-16
31232.0,2020-01-23,"(114.688, 444.0]",5,7,-2
31232.0,2020-01-23,"(444.0, 772.0]",16,29,-13
31232.0,2020-01-23,"(772.0, 1100.0]",8,21,-13
31232.0,2020-01-23,"(1100.0, 1428.0]",12,24,-12
31233.0,2020-01-23,"(445.113, 667.75]",35,39,-4
31233.0,2020-01-23,"(667.75, 889.5]",7,12,-5
31233.0,2020-01-23,"(889.5, 1111.25]",22,45,-23
31233.0,2020-01-23,"(1111.25, 1333.0]",6,13,-7
31234.0,2020-01-23,"(388.965, 648.75]",21,33,-12
31234.0,2020-01-23,"(648.75, 907.5]",13,19,-6
31234.0,2020-01-23,"(907.5, 1166.25]",15,24,-9
31234.0,2020-01-23,"(1166.25, 1425.0]",9,16,-7
31235.0,2020-01-23,"(387.326, 556.5]",4,5,-1
31235.0,2020-01-23,"(556.5, 725.0]",4,4,0
31235.0,2020-01-23,"(893.5, 1062.0]",6,1,5
31236.0,2020-01-23,"(432.059, 668.25]",18,23,-5
31236.0,2020-01-23,"(668.25, 903.5]",12,22,-10
31236.0,2020-01-23,"(903.5, 1138.75]",5,19,-14
31237.0,2020-01-23,"(332.965, 592.75]",5,14,-9
31237.0,2020-01-23,"(592.75, 851.5]",4,10,-6
31237.0,2020-01-23,"(851.5, 1110.25]",13,22,-9
31237.0,2020-01-23,"(1110.25, 1369.0]",12,23,-11
31238.0,2020-01-23,"(29.842, 320.5]",1,1,0
31238.0,2020-01-23,"(320.5, 610.0]",12,14,-2
31238.0,2020-01-23,"(610.0, 899.5]",5,11,-6
31238.0,2020-01-23,"(899.5, 1189.0]",5,23,-18
31239.0,2020-01-23,"(381.978, 638.5]",29,35,-6
31239.0,2020-01-23,"(638.5, 894.0]",14,23,-9
31239.0,2020-01-23,"(894.0, 1149.5]",11,39,-28
31239.0,2020-01-23,"(1149.5, 1405.0]",2,4,-2
31240.0,2020-01-23,"(668.75, 895.5]",1,4,-3
31240.0,2020-01-23,"(1122.25, 1349.0]",1,2,-1
31241.0,2020-01-23,"(93.667, 428.25]",1,4,-3
31241.0,2020-01-23,"(428.25, 761.5]",27,53,-26
31241.0,2020-01-23,"(761.5, 1094.75]",9,28,-19
31241.0,2020-01-23,"(1094.75, 1428.0]",16,29,-13
31242.0,2020-01-23,"(391.077, 622.75]",27,28,-1
31242.0,2020-01-23,"(622.75, 853.5]",4,8,-4
31242.0,2020-01-23,"(853.5, 1084.25]",4,27,-23
31242.0,2020-01-23,"(1084.25, 1315.0]",3,13,-10
31243.0,2020-01-23,"(375.057, 611.75]",26,29,-3
31243.0,2020-01-23,"(611.75, 847.5]",3,7,-4
31243.0,2020-01-23,"(847.5, 1083.25]",4,18,-14
31243.0,2020-01-23,"(1083.25, 1319.0]",5,13,-8
31244.0,2020-01-23,"(350.935, 618.25]",20,30,-10
31244.0,2020-01-23,"(618.25, 884.5]",2,8,-6
31244.0,2020-01-23,"(884.5, 1150.75]",7,23,-16
31244.0,2020-01-23,"(1150.75, 1417.0]",5,12,-7
31245.0,2020-01-23,"(343.952, 607.0]",9,21,-12
31245.0,2020-01-23,"(607.0, 869.0]",4,10,-6
31245.0,2020-01-23,"(869.0, 1131.0]",11,25,-14
31245.0,2020-01-23,"(1131.0, 1393.0]",9,18,-9
31246.0,2020-01-23,"(-1.374, 343.5]",1,1,0
31246.0,2020-01-23,"(343.5, 687.0]",15,21,-6
31246.0,2020-01-23,"(687.0, 1030.5]",5,13,-8
31246.0,2020-01-23,"(1030.5, 1374.0]",17,32,-15
31247.0,2020-01-23,"(432.198, 633.5]",9,13,-4
31247.0,2020-01-23,"(633.5, 834.0]",1,6,-5
31247.0,2020-01-23,"(834.0, 1034.5]",18,33,-15
31247.0,2020-01-23,"(1034.5, 1235.0]",4,16,-12
31248.0,2020-01-23,"(358.97, 617.5]",9,14,-5
31248.0,2020-01-23,"(617.5, 875.0]",5,9,-4
31248.0,2020-01-23,"(875.0, 1132.5]",11,27,-16
31248.0,2020-01-23,"(1132.5, 1390.0]",4,6,-2
31249.0,2020-01-23,"(322.034, 564.5]",2,4,-2
31249.0,2020-01-23,"(564.5, 806.0]",7,10,-3
31249.0,2020-01-23,"(806.0, 1047.5]",1,3,-2
31249.0,2020-01-23,"(1047.5, 1289.0]",4,8,-4
31250.0,2020-01-23,"(415.029, 658.75]",22,27,-5
31250.0,2020-01-23,"(658.75, 901.5]",3,6,-3
31250.0,2020-01-23,"(901.5, 1144.25]",4,22,-18
31250.0,2020-01-23,"(1144.25, 1387.0]",3,5,-2
31251.0,2020-01-23,"(3.653, 341.75]",1,2,-1
31251.0,2020-01-23,"(341.75, 678.5]",19,37,-18
31251.0,2020-01-23,"(678.5, 1015.25]",8,16,-8
31251.0,2020-01-23,"(1015.25, 1352.0]",12,28,-16
31252.0,2020-01-23,"(500.095, 727.25]",20,22,-2
31252.0,2020-01-23,"(727.25, 953.5]",3,10,-7
31252.0,2020-01-23,"(953.5, 1179.75]",3,19,-16
31252.0,2020-01-23,"(1179.75, 1406.0]",1,3,-2
31253.0,2020-01-23,"(7.86, 294.0]",1,1,0
31253.0,2020-01-23,"(294.0, 579.0]",22,23,-1
31253.0,2020-01-23,"(579.0, 864.0]",10,14,-4
31253.0,2020-01-23,"(864.0, 1149.0]",9,33,-24
31254.0,2020-01-23,"(408.244, 598.0]",19,22,-3
31254.0,2020-01-23,"(598.0, 787.0]",5,11,-6
31254.0,2020-01-23,"(787.0, 976.0]",3,5,-2
31254.0,2020-01-23,"(976.0, 1165.0]",3,22,-19
31255.0,2020-01-23,"(424.082, 654.5]",16,22,-6
31255.0,2020-01-23,"(654.5, 884.0]",3,6,-3
31255.0,2020-01-23,"(884.0, 1113.5]",8,21,-13
31255.0,2020-01-23,"(1113.5, 1343.0]",5,9,-4
31256.0,2020-01-23,"(274.889, 553.75]",9,11,-2
31256.0,2020-01-23,"(553.75, 831.5]",7,13,-6
31256.0,2020-01-23,"(831.5, 1109.25]",5,12,-7
31256.0,2020-01-23,"(1109.25, 1387.0]",3,11,-8
31257.0,2020-01-23,"(7.61, 356.5]",1,3,-2
31257.0,2020-01-23,"(356.5, 704.0]",15,25,-10
31257.0,2020-01-23,"(704.0, 1051.5]",21,36,-15
31257.0,2020-01-23,"(1051.5, 1399.0]",11,37,-26
31258.0,2020-01-23,"(444.095, 671.25]",6,9,-3
31258.0,2020-01-23,"(671.25, 897.5]",16,28,-12
31258.0,2020-01-23,"(897.5, 1123.75]",11,22,-11
31258.0,2020-01-23,"(1123.75, 1350.0]",7,12,-5
31259.0,2020-01-23,"(394.245, 583.75]",7,8,-1
31259.0,2020-01-23,"(772.5, 961.25]",1,2,-1
31259.0,2020-01-23,"(961.25, 1150.0]",1,10,-9
31260.0,2020-01-23,"(388.01, 636.5]",12,14,-2
31260.0,2020-01-23,"(636.5, 884.0]",4,7,-3
31260.0,2020-01-23,"(884.0, 1131.5]",4,19,-15
31260.0,2020-01-23,"(1131.5, 1379.0]",1,4,-3
31261.0,2020-01-23,"(391.014, 638.5]",11,12,-1
31261.0,2020-01-23,"(638.5, 885.0]",1,5,-4
31262.0,2020-01-23,"(471.109, 694.75]",7,9,-2
31262.0,2020-01-23,"(694.75, 917.5]",2,2,0
31262.0,2020-01-23,"(917.5, 1140.25]",3,9,-6
31262.0,2020-01-23,"(1140.25, 1363.0]",1,3,-2
31263.0,2020-01-23,"(363.953, 626.75]",20,30,-10
31263.0,2020-01-23,"(626.75, 888.5]",8,15,-7
31263.0,2020-01-23,"(888.5, 1150.25]",8,26,-18
31263.0,2020-01-23,"(1150.25, 1412.0]",1,10,-9
31264.0,2020-01-23,"(443.061, 678.75]",14,20,-6
31264.0,2020-01-23,"(678.75, 913.5]",2,4,-2
31264.0,2020-01-23,"(913.5, 1148.25]",4,14,-10
31264.0,2020-01-23,"(1148.25, 1383.0]",1,2,-1
31265.0,2020-01-23,"(127.703, 453.25]",2,5,-3
31265.0,2020-01-23,"(453.25, 777.5]",17,37,-20
31265.0,2020-01-23,"(777.5, 1101.75]",20,37,-17
31265.0,2020-01-23,"(1101.75, 1426.0]",16,33,-17
31266.0,2020-01-23,"(372.034, 614.5]",2,19,-17
31266.0,2020-01-23,"(614.5, 856.0]",5,9,-4
31266.0,2020-01-23,"(856.0, 1097.5]",15,25,-10
31266.0,2020-01-23,"(1097.5, 1339.0]",18,27,-9
31267.0,2020-01-23,"(123.705, 448.75]",2,4,-2
31267.0,2020-01-23,"(448.75, 772.5]",20,36,-16
31267.0,2020-01-23,"(772.5, 1096.25]",19,35,-16
31267.0,2020-01-23,"(1096.25, 1420.0]",13,29,-16
31268.0,2020-01-23,"(341.943, 607.25]",10,39,-29
31268.0,2020-01-23,"(607.25, 871.5]",4,6,-2
31268.0,2020-01-23,"(871.5, 1135.75]",18,23,-5
31268.0,2020-01-23,"(1135.75, 1400.0]",22,33,-11
31269.0,2020-01-23,"(361.003, 611.25]",5,7,-2
31269.0,2020-01-23,"(611.25, 860.5]",3,8,-5
31269.0,2020-01-23,"(860.5, 1109.75]",5,15,-10
31269.0,2020-01-23,"(1109.75, 1359.0]",2,8,-6
31270.0,2020-01-23,"(321.916, 594.0]",7,9,-2
31270.0,2020-01-23,"(594.0, 865.0]",7,18,-11
31270.0,2020-01-23,"(865.0, 1136.0]",9,18,-9
31270.0,2020-01-23,"(1136.0, 1407.0]",5,11,-6
31271.0,2020-01-23,"(463.238, 654.5]",17,19,-2
31271.0,2020-01-23,"(654.5, 845.0]",5,7,-2
31271.0,2020-01-23,"(845.0, 1035.5]",4,12,-8
31271.0,2020-01-23,"(1035.5, 1226.0]",6,17,-11
31272.0,2020-01-23,"(300.912, 574.0]",22,25,-3
31272.0,2020-01-23,"(574.0, 846.0]",10,18,-8
31272.0,2020-01-23,"(846.0, 1118.0]",9,30,-21
31272.0,2020-01-23,"(1118.0, 1390.0]",2,4,-2
31273.0,2020-01-23,"(669.0, 796.0]",2,3,-1
31273.0,2020-01-23,"(796.0, 923.0]",2,4,-2
31273.0,2020-01-23,"(923.0, 1050.0]",2,2,0
31274.0,2020-01-23,"(392.146, 606.5]",9,10,-1
31274.0,2020-01-23,"(606.5, 820.0]",5,10,-5
31274.0,2020-01-23,"(820.0, 1033.5]",1,4,-3
31274.0,2020-01-23,"(1033.5, 1247.0]",4,16,-12
31275.0,2020-01-23,"(7.625, 352.75]",1,3,-2
31275.0,2020-01-23,"(352.75, 696.5]",20,38,-18
31275.0,2020-01-23,"(696.5, 1040.25]",9,18,-9
31275.0,2020-01-23,"(1040.25, 1384.0]",14,35,-21
31276.0,2020-01-23,"(410.002, 660.5]",22,26,-4
31276.0,2020-01-23,"(660.5, 910.0]",6,10,-4
31276.0,2020-01-23,"(910.0, 1159.5]",6,21,-15
31276.0,2020-01-23,"(1159.5, 1409.0]",1,8,-7
31277.0,2020-01-23,"(410.018, 656.5]",28,33,-5
31277.0,2020-01-23,"(656.5, 902.0]",5,12,-7
31277.0,2020-01-23,"(902.0, 1147.5]",9,39,-30
31277.0,2020-01-23,"(1147.5, 1393.0]",1,6,-5
31278.0,2020-01-23,"(98.685, 428.75]",2,5,-3
31278.0,2020-01-23,"(428.75, 757.5]",10,31,-21
31278.0,2020-01-23,"(757.5, 1086.25]",9,18,-9
31278.0,2020-01-23,"(1086.25, 1415.0]",17,26,-9
31279.0,2020-01-23,"(434.134, 651.5]",24,27,-3
31279.0,2020-01-23,"(651.5, 868.0]",1,5,-4
31279.0,2020-01-23,"(868.0, 1084.5]",8,19,-11
31279.0,2020-01-23,"(1084.5, 1301.0]",2,16,-14
31280.0,2020-01-23,"(63.731, 382.25]",2,4,-2
31280.0,2020-01-23,"(382.25, 699.5]",7,23,-16
31280.0,2020-01-23,"(699.5, 1016.75]",3,3,0
31280.0,2020-01-23,"(1016.75, 1334.0]",17,21,-4
31000.0,2020-01-24,"(839.75, 969.0]",2,1,1
31001.0,2020-01-24,"(1197.25, 1322.0]",1,1,0
31002.0,2020-01-24,"(478.396, 630.0]",3,6,-3
31002.0,2020-01-24,"(630.0, 781.0]",1,3,-2
31002.0,2020-01-24,"(932.0, 1083.0]",5,3,2
31003.0,2020-01-24,"(327.205, 526.75]",2,6,-4
31003.0,2020-01-24,"(526.75, 725.5]",1,3,-2
31003.0,2020-01-24,"(725.5, 924.25]",5,6,-1
31003.0,2020-01-24,"(924.25, 1123.0]",2,4,-2
31004.0,2020-01-24,"(972.0, 1296.0]",2,1,1
31005.0,2020-01-24,"(442.15, 655.5]",3,3,0
31005.0,2020-01-24,"(655.5, 868.0]",1,2,-1
31005.0,2020-01-24,"(868.0, 1080.5]",4,8,-4
31005.0,2020-01-24,"(1080.5, 1293.0]",3,5,-2
31006.0,2020-01-24,"(582.0, 765.0]",1,2,-1
31006.0,2020-01-24,"(765.0, 948.0]",1,1,0
31006.0,2020-01-24,"(948.0, 1131.0]",2,3,-1
31007.0,2020-01-24,"(363.094, 590.5]",5,18,-13
31007.0,2020-01-24,"(590.5, 817.0]",6,13,-7
31007.0,2020-01-24,"(817.0, 1043.5]",8,18,-10
31007.0,2020-01-24,"(1043.5, 1270.0]",8,19,-11
31009.0,2020-01-24,"(473.373, 630.75]",3,3,0
31009.0,2020-01-24,"(944.25, 1101.0]",1,2,-1
31010.0,2020-01-24,"(446.317, 617.75]",1,3,-2
31010.0,2020-01-24,"(617.75, 788.5]",1,2,-1
31010.0,2020-01-24,"(959.25, 1130.0]",2,3,-1
31011.0,2020-01-24,"(413.146, 627.5]",8,11,-3
31011.0,2020-01-24,"(627.5, 841.0]",4,5,-1
31011.0,2020-01-24,"(841.0, 1054.5]",6,12,-6
31011.0,2020-01-24,"(1054.5, 1268.0]",2,5,-3
31012.0,2020-01-24,"(367.265, 551.75]",3,3,0
31012.0,2020-01-24,"(735.5, 919.25]",1,2,-1
31012.0,2020-01-24,"(919.25, 1103.0]",1,5,-4
31013.0,2020-01-24,"(611.0, 831.0]",1,2,-1
31013.0,2020-01-24,"(831.0, 1051.0]",3,2,1
31013.0,2020-01-24,"(1051.0, 1271.0]",1,4,-3
31014.0,2020-01-24,"(319.036, 561.0]",8,13,-5
31014.0,2020-01-24,"(561.0, 802.0]",6,9,-3
31014.0,2020-01-24,"(802.0, 1043.0]",9,17,-8
31014.0,2020-01-24,"(1043.0, 1284.0]",10,12,-2
31015.0,2020-01-24,"(306.012, 554.0]",13,14,-1
31015.0,2020-01-24,"(554.0, 801.0]",2,2,0
31015.0,2020-01-24,"(801.0, 1048.0]",3,6,-3
31015.0,2020-01-24,"(1048.0, 1295.0]",4,7,-3
31016.0,2020-01-24,"(427.117, 648.75]",3,6,-3
31016.0,2020-01-24,"(869.5, 1090.25]",2,4,-2
31016.0,2020-01-24,"(1090.25, 1311.0]",3,4,-1
31017.0,2020-01-24,"(491.185, 695.75]",2,4,-2
31017.0,2020-01-24,"(695.75, 899.5]",1,3,-2
31017.0,2020-01-24,"(899.5, 1103.25]",2,5,-3
31017.0,2020-01-24,"(1103.25, 1307.0]",1,5,-4
31018.0,2020-01-24,"(888.5, 1037.0]",1,4,-3
31019.0,2020-01-24,"(707.541, 822.75]",2,4,-2
31020.0,2020-01-24,"(544.329, 712.75]",1,1,0
31021.0,2020-01-24,"(515.324, 685.0]",1,4,-3
31021.0,2020-01-24,"(854.0, 1023.0]",1,2,-1
31021.0,2020-01-24,"(1023.0, 1192.0]",1,1,0
31022.0,2020-01-24,"(424.5, 744.0]",3,1,2
31022.0,2020-01-24,"(744.0, 1063.5]",6,7,-1
31022.0,2020-01-24,"(1063.5, 1383.0]",2,10,-8
31023.0,2020-01-24,"(340.25, 666.5]",2,1,1
31023.0,2020-01-24,"(666.5, 992.75]",1,3,-2
31023.0,2020-01-24,"(992.75, 1319.0]",1,3,-2
31024.0,2020-01-24,"(466.152, 679.0]",3,4,-1
31024.0,2020-01-24,"(891.0, 1103.0]",3,1,2
31024.0,2020-01-24,"(1103.0, 1315.0]",1,12,-11
,,,,1.0,
,,,,1.0,
,,,,1.0,
31026.0,2020-01-24,"(385.074, 617.5]",1,3,-2
31026.0,2020-01-24,"(849.0, 1080.5]",3,5,-2
31026.0,2020-01-24,"(1080.5, 1312.0]",1,7,-6
31027.0,2020-01-24,"(489.309, 662.75]",3,6,-3
31027.0,2020-01-24,"(1008.25, 1181.0]",3,8,-5
31028.0,2020-01-24,"(490.37, 648.5]",3,3,0
31028.0,2020-01-24,"(648.5, 806.0]",1,1,0
31029.0,2020-01-24,"(853.0, 1014.0]",1,6,-5
31029.0,2020-01-24,"(1014.0, 1175.0]",4,2,2
31030.0,2020-01-24,"(-0.118, 280.5]",1,1,0
31030.0,2020-01-24,"(560.0, 839.5]",1,7,-6
31030.0,2020-01-24,"(839.5, 1119.0]",5,1,4
31031.0,2020-01-24,"(823.0, 1060.5]",1,4,-3
31031.0,2020-01-24,"(1060.5, 1298.0]",4,1,3
31032.0,2020-01-24,"(107.806, 407.5]",1,1,0
31032.0,2020-01-24,"(1004.5, 1303.0]",2,2,0
31033.0,2020-01-24,"(920.939, 936.25]",1,1,0
31033.0,2020-01-24,"(966.75, 982.0]",2,2,0
31034.0,2020-01-24,"(399.179, 605.25]",4,7,-3
31034.0,2020-01-24,"(605.25, 810.5]",1,2,-1
31034.0,2020-01-24,"(810.5, 1015.75]",1,5,-4
31034.0,2020-01-24,"(1015.75, 1221.0]",3,6,-3
31035.0,2020-01-24,"(438.016, 685.0]",1,3,-2
31035.0,2020-01-24,"(685.0, 931.0]",1,1,0
31035.0,2020-01-24,"(931.0, 1177.0]",4,5,-1
31035.0,2020-01-24,"(1177.0, 1423.0]",1,1,0
31036.0,2020-01-24,"(375.323, 545.25]",1,3,-2
31036.0,2020-01-24,"(714.5, 883.75]",1,1,0
31036.0,2020-01-24,"(883.75, 1053.0]",2,5,-3
31037.0,2020-01-24,"(404.194, 606.5]",10,16,-6
31037.0,2020-01-24,"(606.5, 808.0]",1,1,0
31037.0,2020-01-24,"(808.0, 1009.5]",3,6,-3
31038.0,2020-01-24,"(392.336, 559.0]",1,2,-1
31038.0,2020-01-24,"(891.0, 1057.0]",1,1,0
31039.0,2020-01-24,"(17.778, 324.5]",1,1,0
31039.0,2020-01-24,"(324.5, 630.0]",2,6,-4
31039.0,2020-01-24,"(630.0, 935.5]",2,5,-3
31039.0,2020-01-24,"(935.5, 1241.0]",4,6,-2
31040.0,2020-01-24,"(484.243, 674.25]",1,1,0
31041.0,2020-01-24,"(610.416, 757.0]",1,3,-2
31041.0,2020-01-24,"(903.0, 1049.0]",3,3,0
31041.0,2020-01-24,"(1049.0, 1195.0]",1,2,-1
31042.0,2020-01-24,"(466.082, 696.5]",12,12,0
31042.0,2020-01-24,"(696.5, 926.0]",2,6,-4
31042.0,2020-01-24,"(926.0, 1155.5]",3,12,-9
31042.0,2020-01-24,"(1155.5, 1385.0]",2,4,-2
31043.0,2020-01-24,"(518.316, 690.0]",1,1,0
31043.0,2020-01-24,"(690.0, 861.0]",1,1,0
31043.0,2020-01-24,"(861.0, 1032.0]",1,4,-3
31043.0,2020-01-24,"(1032.0, 1203.0]",1,4,-3
31044.0,2020-01-24,"(582.231, 775.25]",2,3,-1
31044.0,2020-01-24,"(1159.75, 1352.0]",2,1,1
31045.0,2020-01-24,"(597.303, 772.25]",2,3,-1
31045.0,2020-01-24,"(946.5, 1120.75]",2,3,-1
31045.0,2020-01-24,"(1120.75, 1295.0]",1,2,-1
31046.0,2020-01-24,"(878.25, 1039.0]",1,1,0
31047.0,2020-01-24,"(358.966, 618.5]",9,14,-5
31047.0,2020-01-24,"(618.5, 877.0]",3,8,-5
31047.0,2020-01-24,"(877.0, 1135.5]",3,14,-11
31047.0,2020-01-24,"(1135.5, 1394.0]",2,4,-2
31048.0,2020-01-24,"(407.062, 642.5]",1,2,-1
31048.0,2020-01-24,"(642.5, 877.0]",3,4,-1
31048.0,2020-01-24,"(877.0, 1111.5]",1,4,-3
31049.0,2020-01-24,"(564.32, 735.0]",1,1,0
31049.0,2020-01-24,"(1075.0, 1245.0]",1,3,-2
31050.0,2020-01-24,"(751.0, 904.0]",1,3,-2
31050.0,2020-01-24,"(904.0, 1057.0]",2,1,1
31051.0,2020-01-24,"(810.5, 1064.25]",5,5,0
31051.0,2020-01-24,"(1064.25, 1318.0]",2,7,-5
31052.0,2020-01-24,"(513.451, 651.25]",2,2,0
31052.0,2020-01-24,"(651.25, 788.5]",1,3,-2
31052.0,2020-01-24,"(925.75, 1063.0]",3,4,-1
31053.0,2020-01-24,"(541.26, 727.0]",1,2,-1
31053.0,2020-01-24,"(1097.0, 1282.0]",1,1,0
31054.0,2020-01-24,"(444.5, 666.75]",1,1,0
31054.0,2020-01-24,"(666.75, 889.0]",1,1,0
31055.0,2020-01-24,"(402.921, 422.75]",1,1,0
31056.0,2020-01-24,"(1063.25, 1223.0]",1,1,0
,,,,2.0,
31058.0,2020-01-24,"(786.75, 1049.0]",2,1,1
31059.0,2020-01-24,"(893.5, 1054.0]",3,1,2
31060.0,2020-01-24,"(594.47, 727.5]",2,2,0
31060.0,2020-01-24,"(992.5, 1125.0]",2,1,1
31061.0,2020-01-24,"(525.75, 701.0]",1,1,0
31062.0,2020-01-24,"(666.581, 771.75]",1,2,-1
31062.0,2020-01-24,"(876.5, 981.25]",4,9,-5
31062.0,2020-01-24,"(981.25, 1086.0]",5,7,-2
,,,,1.0,
,,,,1.0,
31064.0,2020-01-24,"(692.525, 811.75]",2,5,-3
31064.0,2020-01-24,"(811.75, 930.5]",2,4,-2
31064.0,2020-01-24,"(930.5, 1049.25]",3,5,-2
31064.0,2020-01-24,"(1049.25, 1168.0]",9,16,-7
31065.0,2020-01-24,"(686.0, 822.0]",1,1,0
31065.0,2020-01-24,"(958.0, 1094.0]",3,1,2
31066.0,2020-01-24,"(456.395, 608.25]",1,2,-1
31066.0,2020-01-24,"(910.75, 1062.0]",1,1,0
31067.0,2020-01-24,"(872.0, 1096.5]",1,3,-2
31067.0,2020-01-24,"(1096.5, 1321.0]",2,3,-1
31068.0,2020-01-24,"(975.75, 1109.0]",2,1,1
31069.0,2020-01-24,"(791.0, 971.5]",2,2,0
31069.0,2020-01-24,"(971.5, 1152.0]",1,2,-1
31070.0,2020-01-24,"(1142.5, 1328.0]",2,2,0
31071.0,2020-01-24,"(453.135, 670.25]",1,6,-5
31071.0,2020-01-24,"(670.25, 886.5]",2,4,-2
31071.0,2020-01-24,"(886.5, 1102.75]",3,7,-4
31071.0,2020-01-24,"(1102.75, 1319.0]",1,2,-1
,,,,1.0,
,,,,2.0,
31073.0,2020-01-24,"(480.396, 632.0]",2,4,-2
31073.0,2020-01-24,"(934.0, 1085.0]",3,3,0
31074.0,2020-01-24,"(8.023, 253.25]",1,1,0
31074.0,2020-01-24,"(741.75, 986.0]",1,2,-1
31075.0,2020-01-24,"(943.75, 1116.0]",1,1,0
31076.0,2020-01-24,"(265.25, 530.5]",1,1,0
31076.0,2020-01-24,"(795.75, 1061.0]",1,1,0
31077.0,2020-01-24,"(429.145, 643.75]",2,5,-3
31077.0,2020-01-24,"(643.75, 857.5]",1,3,-2
31077.0,2020-01-24,"(857.5, 1071.25]",1,2,-1
31077.0,2020-01-24,"(1071.25, 1285.0]",2,3,-1
31078.0,2020-01-24,"(459.482, 589.5]",5,6,-1
31079.0,2020-01-24,"(710.75, 952.5]",1,10,-9
31079.0,2020-01-24,"(952.5, 1194.25]",4,2,2
31079.0,2020-01-24,"(1194.25, 1436.0]",2,6,-4
31080.0,2020-01-24,"(867.5, 1071.75]",4,7,-3
31080.0,2020-01-24,"(1071.75, 1276.0]",2,4,-2
31081.0,2020-01-24,"(472.362, 632.5]",1,2,-1
31081.0,2020-01-24,"(951.5, 1111.0]",1,2,-1
31082.0,2020-01-24,"(837.75, 1117.0]",1,1,0
31083.0,2020-01-24,"(846.0, 1012.5]",3,2,1
31083.0,2020-01-24,"(1012.5, 1179.0]",1,1,0
31084.0,2020-01-24,"(543.275, 725.25]",2,3,-1
31084.0,2020-01-24,"(725.25, 906.5]",1,3,-2
31084.0,2020-01-24,"(906.5, 1087.75]",1,2,-1
31084.0,2020-01-24,"(1087.75, 1269.0]",2,6,-4
31085.0,2020-01-24,"(401.296, 578.0]",1,2,-1
31085.0,2020-01-24,"(930.0, 1106.0]",1,1,0
,,,,1.0,
,,,,1.0,
,,,,1.0,
31087.0,2020-01-24,"(680.0, 856.0]",2,2,0
31087.0,2020-01-24,"(856.0, 1032.0]",1,3,-2
31087.0,2020-01-24,"(1032.0, 1208.0]",1,2,-1
31088.0,2020-01-24,"(855.5, 1085.75]",4,4,0
31088.0,2020-01-24,"(1085.75, 1316.0]",3,1,2
31089.0,2020-01-24,"(454.024, 699.0]",12,16,-4
31089.0,2020-01-24,"(699.0, 943.0]",5,10,-5
31089.0,2020-01-24,"(943.0, 1187.0]",1,16,-15
31089.0,2020-01-24,"(1187.0, 1431.0]",1,6,-5
,,,,1.0,
,,,,1.0,
31091.0,2020-01-24,"(30.968, 290.0]",1,1,0
31091.0,2020-01-24,"(290.0, 548.0]",1,3,-2
31091.0,2020-01-24,"(806.0, 1064.0]",3,1,2
,,,,2.0,
,,,,1.0,
,,,,3.0,
,,,,2.0,
31094.0,2020-01-24,"(673.5, 1010.25]",1,1,0
31094.0,2020-01-24,"(1010.25, 1347.0]",1,1,0
,,,,1.0,
,,,,1.0,
31096.0,2020-01-24,"(853.25, 942.5]",1,1,0
31096.0,2020-01-24,"(1031.75, 1121.0]",1,2,-1
31097.0,2020-01-24,"(403.0, 689.0]",2,1,1
31097.0,2020-01-24,"(975.0, 1261.0]",1,2,-1
31098.0,2020-01-24,"(477.366, 636.5]",2,9,-7
31098.0,2020-01-24,"(636.5, 795.0]",2,4,-2
31098.0,2020-01-24,"(953.5, 1112.0]",10,16,-6
31099.0,2020-01-24,"(773.5, 932.25]",1,1,0
31099.0,2020-01-24,"(932.25, 1091.0]",2,2,0
31100.0,2020-01-24,"(430.1, 656.0]",13,14,-1
31100.0,2020-01-24,"(656.0, 881.0]",5,13,-8
31100.0,2020-01-24,"(881.0, 1106.0]",8,20,-12
31100.0,2020-01-24,"(1106.0, 1331.0]",1,7,-6
31101.0,2020-01-24,"(99.693, 427.75]",1,6,-5
31101.0,2020-01-24,"(427.75, 754.5]",18,55,-37
31101.0,2020-01-24,"(754.5, 1081.25]",34,48,-14
31101.0,2020-01-24,"(1081.25, 1408.0]",39,60,-21
31102.0,2020-01-24,"(294.877, 576.75]",2,17,-15
31102.0,2020-01-24,"(576.75, 857.5]",3,6,-3
31102.0,2020-01-24,"(857.5, 1138.25]",3,9,-6
31102.0,2020-01-24,"(1138.25, 1419.0]",4,10,-6
31103.0,2020-01-24,"(329.945, 594.75]",4,30,-26
31103.0,2020-01-24,"(594.75, 858.5]",6,18,-12
31103.0,2020-01-24,"(858.5, 1122.25]",5,18,-13
31103.0,2020-01-24,"(1122.25, 1386.0]",6,12,-6
31104.0,2020-01-24,"(368.938, 635.5]",12,32,-20
31104.0,2020-01-24,"(635.5, 901.0]",7,20,-13
31104.0,2020-01-24,"(901.0, 1166.5]",21,29,-8
31104.0,2020-01-24,"(1166.5, 1432.0]",10,24,-14
31105.0,2020-01-24,"(60.779, 367.25]",1,3,-2
31105.0,2020-01-24,"(367.25, 672.5]",2,7,-5
31105.0,2020-01-24,"(672.5, 977.75]",4,13,-9
31105.0,2020-01-24,"(977.75, 1283.0]",4,8,-4
31106.0,2020-01-24,"(462.158, 673.5]",1,5,-4
31106.0,2020-01-24,"(673.5, 884.0]",3,5,-2
31106.0,2020-01-24,"(884.0, 1094.5]",3,4,-1
31106.0,2020-01-24,"(1094.5, 1305.0]",7,8,-1
31107.0,2020-01-24,"(51.616, 399.0]",1,4,-3
31107.0,2020-01-24,"(399.0, 745.0]",5,33,-28
31107.0,2020-01-24,"(745.0, 1091.0]",15,28,-13
31107.0,2020-01-24,"(1091.0, 1437.0]",18,33,-15
31108.0,2020-01-24,"(403.103, 628.25]",3,27,-24
31108.0,2020-01-24,"(628.25, 852.5]",12,20,-8
31108.0,2020-01-24,"(852.5, 1076.75]",20,29,-9
31108.0,2020-01-24,"(1076.75, 1301.0]",15,23,-8
31109.0,2020-01-24,"(440.012, 688.0]",10,26,-16
31109.0,2020-01-24,"(688.0, 935.0]",9,19,-10
31109.0,2020-01-24,"(935.0, 1182.0]",21,29,-8
31109.0,2020-01-24,"(1182.0, 1429.0]",5,10,-5
31110.0,2020-01-24,"(240.815, 538.25]",11,26,-15
31110.0,2020-01-24,"(538.25, 834.5]",8,20,-12
31110.0,2020-01-24,"(834.5, 1130.75]",25,37,-12
31110.0,2020-01-24,"(1130.75, 1427.0]",8,15,-7
31111.0,2020-01-24,"(66.662, 402.5]",4,5,-1
31111.0,2020-01-24,"(402.5, 737.0]",4,18,-14
31111.0,2020-01-24,"(737.0, 1071.5]",11,19,-8
31111.0,2020-01-24,"(1071.5, 1406.0]",12,17,-5
31112.0,2020-01-24,"(311.193, 513.75]",1,3,-2
31112.0,2020-01-24,"(917.25, 1119.0]",3,3,0
31113.0,2020-01-24,"(583.75, 848.5]",3,19,-16
31113.0,2020-01-24,"(848.5, 1113.25]",4,14,-10
31113.0,2020-01-24,"(1113.25, 1378.0]",10,13,-3
31114.0,2020-01-24,"(57.619, 404.25]",5,8,-3
31114.0,2020-01-24,"(404.25, 749.5]",1,19,-18
31114.0,2020-01-24,"(749.5, 1094.75]",19,24,-5
31114.0,2020-01-24,"(1094.75, 1440.0]",14,32,-18
31115.0,2020-01-24,"(349.026, 593.5]",1,16,-15
31115.0,2020-01-24,"(593.5, 837.0]",2,11,-9
31115.0,2020-01-24,"(837.0, 1080.5]",6,17,-11
31115.0,2020-01-24,"(1080.5, 1324.0]",9,14,-5
31116.0,2020-01-24,"(381.954, 644.5]",3,24,-21
31116.0,2020-01-24,"(644.5, 906.0]",5,9,-4
31116.0,2020-01-24,"(906.0, 1167.5]",22,29,-7
31116.0,2020-01-24,"(1167.5, 1429.0]",7,13,-6
31117.0,2020-01-24,"(320.893, 598.75]",2,22,-20
31117.0,2020-01-24,"(598.75, 875.5]",8,25,-17
31117.0,2020-01-24,"(875.5, 1152.25]",9,20,-11
31117.0,2020-01-24,"(1152.25, 1429.0]",6,8,-2
31118.0,2020-01-24,"(53.668, 388.0]",1,2,-1
31118.0,2020-01-24,"(388.0, 721.0]",2,16,-14
31118.0,2020-01-24,"(721.0, 1054.0]",9,11,-2
31118.0,2020-01-24,"(1054.0, 1387.0]",11,14,-3
31119.0,2020-01-24,"(101.679, 433.25]",2,6,-4
31119.0,2020-01-24,"(433.25, 763.5]",12,29,-17
31119.0,2020-01-24,"(763.5, 1093.75]",15,25,-10
31119.0,2020-01-24,"(1093.75, 1424.0]",12,25,-13
31120.0,2020-01-24,"(32.668, 367.0]",2,2,0
31120.0,2020-01-24,"(367.0, 700.0]",4,21,-17
31120.0,2020-01-24,"(700.0, 1033.0]",6,8,-2
31120.0,2020-01-24,"(1033.0, 1366.0]",15,22,-7
31121.0,2020-01-24,"(358.921, 629.75]",14,17,-3
31121.0,2020-01-24,"(629.75, 899.5]",2,6,-4
31121.0,2020-01-24,"(899.5, 1169.25]",9,22,-13
31121.0,2020-01-24,"(1169.25, 1439.0]",6,9,-3
31122.0,2020-01-24,"(423.022, 668.5]",4,14,-10
31122.0,2020-01-24,"(668.5, 913.0]",5,7,-2
31122.0,2020-01-24,"(913.0, 1157.5]",7,14,-7
31122.0,2020-01-24,"(1157.5, 1402.0]",3,8,-5
31123.0,2020-01-24,"(345.93, 614.5]",1,22,-21
31123.0,2020-01-24,"(614.5, 882.0]",1,4,-3
31123.0,2020-01-24,"(882.0, 1149.5]",4,7,-3
31123.0,2020-01-24,"(1149.5, 1417.0]",4,8,-4
31124.0,2020-01-24,"(-0.437, 360.25]",1,4,-3
31124.0,2020-01-24,"(360.25, 719.5]",13,34,-21
31124.0,2020-01-24,"(719.5, 1078.75]",16,52,-36
31124.0,2020-01-24,"(1078.75, 1438.0]",19,49,-30
31125.0,2020-01-24,"(353.028, 597.0]",6,30,-24
31125.0,2020-01-24,"(597.0, 840.0]",6,10,-4
31125.0,2020-01-24,"(840.0, 1083.0]",22,27,-5
31125.0,2020-01-24,"(1083.0, 1326.0]",16,23,-7
31126.0,2020-01-24,"(347.924, 618.0]",4,26,-22
31126.0,2020-01-24,"(618.0, 887.0]",7,10,-3
31126.0,2020-01-24,"(887.0, 1156.0]",10,13,-3
31126.0,2020-01-24,"(1156.0, 1425.0]",9,16,-7
31127.0,2020-01-24,"(350.952, 614.0]",11,17,-6
31127.0,2020-01-24,"(614.0, 876.0]",8,14,-6
31127.0,2020-01-24,"(876.0, 1138.0]",13,33,-20
31127.0,2020-01-24,"(1138.0, 1400.0]",3,8,-5
31128.0,2020-01-24,"(402.039, 643.25]",20,32,-12
31128.0,2020-01-24,"(643.25, 883.5]",12,21,-9
31128.0,2020-01-24,"(883.5, 1123.75]",16,28,-12
31128.0,2020-01-24,"(1123.75, 1364.0]",7,12,-5
31129.0,2020-01-24,"(278.25, 535.5]",6,4,2
31129.0,2020-01-24,"(535.5, 792.75]",10,7,3
31129.0,2020-01-24,"(792.75, 1050.0]",13,19,-6
31130.0,2020-01-24,"(356.063, 591.25]",1,10,-9
31130.0,2020-01-24,"(825.5, 1059.75]",5,4,1
31130.0,2020-01-24,"(1059.75, 1294.0]",16,8,8
31131.0,2020-01-24,"(693.5, 924.0]",1,11,-10
31131.0,2020-01-24,"(924.0, 1154.5]",2,3,-1
31131.0,2020-01-24,"(1154.5, 1385.0]",3,3,0
31200.0,2020-01-24,"(343.916, 616.0]",19,30,-11
31200.0,2020-01-24,"(616.0, 887.0]",13,20,-7
31200.0,2020-01-24,"(887.0, 1158.0]",20,43,-23
31200.0,2020-01-24,"(1158.0, 1429.0]",11,23,-12
31201.0,2020-01-24,"(299.862, 585.5]",14,38,-24
31201.0,2020-01-24,"(585.5, 870.0]",27,49,-22
31201.0,2020-01-24,"(870.0, 1154.5]",38,69,-31
31201.0,2020-01-24,"(1154.5, 1439.0]",7,13,-6
31202.0,2020-01-24,"(74.411, 222.25]",1,1,0
31202.0,2020-01-24,"(222.25, 369.5]",1,3,-2
31202.0,2020-01-24,"(369.5, 516.75]",2,10,-8
31202.0,2020-01-24,"(516.75, 664.0]",8,15,-7
31203.0,2020-01-24,"(-1.437, 359.25]",3,5,-2
31203.0,2020-01-24,"(359.25, 718.5]",11,31,-20
31203.0,2020-01-24,"(718.5, 1077.75]",43,70,-27
31203.0,2020-01-24,"(1077.75, 1437.0]",16,32,-16
31204.0,2020-01-24,"(433.036, 675.0]",11,14,-3
31204.0,2020-01-24,"(675.0, 916.0]",5,11,-6
31204.0,2020-01-24,"(916.0, 1157.0]",7,21,-14
31204.0,2020-01-24,"(1157.0, 1398.0]",11,21,-10
31205.0,2020-01-24,"(416.076, 648.0]",14,21,-7
31205.0,2020-01-24,"(648.0, 879.0]",23,30,-7
31205.0,2020-01-24,"(879.0, 1110.0]",9,28,-19
31205.0,2020-01-24,"(1110.0, 1341.0]",1,13,-12
31206.0,2020-01-24,"(385.053, 622.75]",7,8,-1
31206.0,2020-01-24,"(622.75, 859.5]",1,2,-1
31206.0,2020-01-24,"(859.5, 1096.25]",3,11,-8
31207.0,2020-01-24,"(30.743, 346.25]",1,2,-1
31207.0,2020-01-24,"(346.25, 660.5]",1,3,-2
31207.0,2020-01-24,"(660.5, 974.75]",2,4,-2
31207.0,2020-01-24,"(974.75, 1289.0]",4,6,-2
31208.0,2020-01-24,"(389.19, 592.5]",11,13,-2
31208.0,2020-01-24,"(795.0, 997.5]",2,8,-6
31208.0,2020-01-24,"(997.5, 1200.0]",3,8,-5
31209.0,2020-01-24,"(886.5, 1089.25]",2,4,-2
31209.0,2020-01-24,"(1089.25, 1292.0]",5,2,3
31211.0,2020-01-24,"(398.053, 635.75]",12,14,-2
31211.0,2020-01-24,"(635.75, 872.5]",3,5,-2
31211.0,2020-01-24,"(872.5, 1109.25]",9,17,-8
31211.0,2020-01-24,"(1109.25, 1346.0]",2,10,-8
31212.0,2020-01-24,"(350.75, 700.5]",45,1,44
31212.0,2020-01-24,"(700.5, 1050.25]",22,61,-39
31212.0,2020-01-24,"(1050.25, 1400.0]",14,45,-31
31213.0,2020-01-24,"(334.973, 592.75]",33,48,-15
31213.0,2020-01-24,"(592.75, 849.5]",7,14,-7
31213.0,2020-01-24,"(849.5, 1106.25]",8,23,-15
31213.0,2020-01-24,"(1106.25, 1363.0]",7,16,-9
31214.0,2020-01-24,"(360.933, 628.75]",6,31,-25
31214.0,2020-01-24,"(628.75, 895.5]",7,13,-6
31214.0,2020-01-24,"(895.5, 1162.25]",30,42,-12
31214.0,2020-01-24,"(1162.25, 1429.0]",7,14,-7
31215.0,2020-01-24,"(442.32, 613.0]",22,24,-2
31215.0,2020-01-24,"(613.0, 783.0]",7,8,-1
31215.0,2020-01-24,"(783.0, 953.0]",6,11,-5
31215.0,2020-01-24,"(953.0, 1123.0]",5,10,-5
31216.0,2020-01-24,"(332.925, 602.75]",30,37,-7
31216.0,2020-01-24,"(602.75, 871.5]",7,11,-4
31216.0,2020-01-24,"(871.5, 1140.25]",9,31,-22
31216.0,2020-01-24,"(1140.25, 1409.0]",1,4,-3
31217.0,2020-01-24,"(320.91, 594.5]",12,13,-1
31217.0,2020-01-24,"(594.5, 867.0]",1,4,-3
31217.0,2020-01-24,"(867.0, 1139.5]",2,9,-7
31217.0,2020-01-24,"(1139.5, 1412.0]",1,5,-4
31218.0,2020-01-24,"(374.271, 557.25]",10,29,-19
31218.0,2020-01-24,"(557.25, 739.5]",11,17,-6
31218.0,2020-01-24,"(739.5, 921.75]",5,6,-1
31218.0,2020-01-24,"(921.75, 1104.0]",7,13,-6
31219.0,2020-01-24,"(350.979, 607.25]",8,14,-6
31219.0,2020-01-24,"(607.25, 862.5]",19,27,-8
31219.0,2020-01-24,"(862.5, 1117.75]",2,10,-8
31219.0,2020-01-24,"(1117.75, 1373.0]",3,4,-1
31220.0,2020-01-24,"(457.414, 604.5]",16,18,-2
31220.0,2020-01-24,"(604.5, 751.0]",2,4,-2
31220.0,2020-01-24,"(751.0, 897.5]",1,2,-1
31220.0,2020-01-24,"(897.5, 1044.0]",1,16,-15
31221.0,2020-01-24,"(66.733, 384.75]",2,2,0
31221.0,2020-01-24,"(384.75, 701.5]",31,37,-6
31221.0,2020-01-24,"(701.5, 1018.25]",9,19,-10
31221.0,2020-01-24,"(1018.25, 1335.0]",14,48,-34
31222.0,2020-01-24,"(322.104, 547.0]",7,8,-1
31222.0,2020-01-24,"(547.0, 771.0]",18,23,-5
31222.0,2020-01-24,"(771.0, 995.0]",2,5,-3
31222.0,2020-01-24,"(995.0, 1219.0]",4,19,-15
31223.0,2020-01-24,"(38.608, 388.0]",1,2,-1
31223.0,2020-01-24,"(388.0, 736.0]",15,32,-17
31223.0,2020-01-24,"(736.0, 1084.0]",16,31,-15
31223.0,2020-01-24,"(1084.0, 1432.0]",13,25,-12
31224.0,2020-01-24,"(421.149, 634.75]",18,21,-3
31224.0,2020-01-24,"(634.75, 847.5]",9,14,-5
31224.0,2020-01-24,"(847.5, 1060.25]",4,17,-13
31224.0,2020-01-24,"(1060.25, 1273.0]",1,6,-5
31225.0,2020-01-24,"(375.976, 633.0]",12,20,-8
31225.0,2020-01-24,"(633.0, 889.0]",3,4,-1
31225.0,2020-01-24,"(889.0, 1145.0]",7,15,-8
31225.0,2020-01-24,"(1145.0, 1401.0]",4,8,-4
31226.0,2020-01-24,"(286.921, 557.75]",4,8,-4
31226.0,2020-01-24,"(557.75, 827.5]",3,5,-2
31226.0,2020-01-24,"(827.5, 1097.25]",7,18,-11
31226.0,2020-01-24,"(1097.25, 1367.0]",3,5,-2
31227.0,2020-01-24,"(406.078, 637.5]",23,26,-3
31227.0,2020-01-24,"(637.5, 868.0]",14,22,-8
31227.0,2020-01-24,"(868.0, 1098.5]",6,22,-16
31227.0,2020-01-24,"(1098.5, 1329.0]",3,10,-7
31228.0,2020-01-24,"(415.979, 672.25]",16,24,-8
31228.0,2020-01-24,"(672.25, 927.5]",17,31,-14
31228.0,2020-01-24,"(927.5, 1182.75]",16,39,-23
31228.0,2020-01-24,"(1182.75, 1438.0]",6,12,-6
31229.0,2020-01-24,"(349.912, 623.0]",14,48,-34
31229.0,2020-01-24,"(623.0, 895.0]",10,29,-19
31229.0,2020-01-24,"(895.0, 1167.0]",35,53,-18
31229.0,2020-01-24,"(1167.0, 1439.0]",17,35,-18
31230.0,2020-01-24,"(352.925, 622.75]",51,60,-9
31230.0,2020-01-24,"(622.75, 891.5]",24,35,-11
31230.0,2020-01-24,"(891.5, 1160.25]",8,31,-23
31230.0,2020-01-24,"(1160.25, 1429.0]",2,11,-9
31231.0,2020-01-24,"(422.273, 604.75]",15,17,-2
31231.0,2020-01-24,"(604.75, 786.5]",7,9,-2
31231.0,2020-01-24,"(786.5, 968.25]",7,14,-7
31231.0,2020-01-24,"(968.25, 1150.0]",4,12,-8
31232.0,2020-01-24,"(294.879, 576.25]",14,19,-5
31232.0,2020-01-24,"(576.25, 856.5]",11,18,-7
31232.0,2020-01-24,"(856.5, 1136.75]",14,23,-9
31232.0,2020-01-24,"(1136.75, 1417.0]",9,15,-6
31233.0,2020-01-24,"(412.058, 648.5]",30,34,-4
31233.0,2020-01-24,"(648.5, 884.0]",17,26,-9
31233.0,2020-01-24,"(884.0, 1119.5]",10,39,-29
31233.0,2020-01-24,"(1119.5, 1355.0]",1,8,-7
31234.0,2020-01-24,"(19.617, 366.75]",1,1,0
31234.0,2020-01-24,"(366.75, 712.5]",17,30,-13
31234.0,2020-01-24,"(712.5, 1058.25]",16,29,-13
31234.0,2020-01-24,"(1058.25, 1404.0]",21,36,-15
31235.0,2020-01-24,"(361.046, 600.5]",5,6,-1
31235.0,2020-01-24,"(600.5, 839.0]",6,12,-6
31235.0,2020-01-24,"(839.0, 1077.5]",3,10,-7
31235.0,2020-01-24,"(1077.5, 1316.0]",4,9,-5
31236.0,2020-01-24,"(494.136, 711.0]",18,22,-4
31236.0,2020-01-24,"(711.0, 927.0]",6,19,-13
31236.0,2020-01-24,"(927.0, 1143.0]",7,24,-17
31236.0,2020-01-24,"(1143.0, 1359.0]",5,9,-4
31237.0,2020-01-24,"(37.681, 368.75]",1,2,-1
31237.0,2020-01-24,"(368.75, 698.5]",10,25,-15
31237.0,2020-01-24,"(698.5, 1028.25]",17,28,-11
31237.0,2020-01-24,"(1028.25, 1358.0]",20,38,-18
31238.0,2020-01-24,"(45.62, 392.0]",1,2,-1
31238.0,2020-01-24,"(392.0, 737.0]",16,19,-3
31238.0,2020-01-24,"(737.0, 1082.0]",8,25,-17
31238.0,2020-01-24,"(1082.0, 1427.0]",10,19,-9
31239.0,2020-01-24,"(302.75, 587.5]",25,1,24
31239.0,2020-01-24,"(587.5, 872.25]",5,30,-25
31239.0,2020-01-24,"(872.25, 1157.0]",10,10,0
31240.0,2020-01-24,"(954.625, 1048.75]",7,8,-1
31240.0,2020-01-24,"(1236.25, 1330.0]",2,7,-5
31241.0,2020-01-24,"(39.606, 389.5]",1,4,-3
31241.0,2020-01-24,"(389.5, 738.0]",32,63,-31
31241.0,2020-01-24,"(738.0, 1086.5]",17,35,-18
31241.0,2020-01-24,"(1086.5, 1435.0]",22,31,-9
31242.0,2020-01-24,"(415.171, 623.25]",20,20,0
31242.0,2020-01-24,"(623.25, 830.5]",9,13,-4
31242.0,2020-01-24,"(830.5, 1037.75]",1,7,-6
31243.0,2020-01-24,"(387.073, 619.75]",18,22,-4
31243.0,2020-01-24,"(619.75, 851.5]",1,2,-1
31243.0,2020-01-24,"(851.5, 1083.25]",10,27,-17
31243.0,2020-01-24,"(1083.25, 1315.0]",5,15,-10
31244.0,2020-01-24,"(415.993, 668.75]",10,15,-5
31244.0,2020-01-24,"(668.75, 920.5]",5,11,-6
31244.0,2020-01-24,"(920.5, 1172.25]",4,14,-10
31244.0,2020-01-24,"(1172.25, 1424.0]",4,6,-2
31245.0,2020-01-24,"(18.714, 341.5]",3,3,0
31245.0,2020-01-24,"(341.5, 663.0]",14,26,-12
31245.0,2020-01-24,"(663.0, 984.5]",7,19,-12
31245.0,2020-01-24,"(984.5, 1306.0]",11,21,-10
31246.0,2020-01-24,"(362.5, 709.0]",12,1,11
31246.0,2020-01-24,"(709.0, 1055.5]",27,25,2
31246.0,2020-01-24,"(1055.5, 1402.0]",12,41,-29
31247.0,2020-01-24,"(422.031, 665.25]",21,28,-7
31247.0,2020-01-24,"(665.25, 907.5]",4,19,-15
31247.0,2020-01-24,"(907.5, 1149.75]",6,15,-9
31247.0,2020-01-24,"(1149.75, 1392.0]",7,15,-8
31248.0,2020-01-24,"(844.415, 991.25]",5,14,-9
31248.0,2020-01-24,"(991.25, 1137.5]",11,21,-10
31248.0,2020-01-24,"(1137.5, 1283.75]",2,3,-1
31248.0,2020-01-24,"(1283.75, 1430.0]",3,4,-1
31249.0,2020-01-24,"(480.216, 677.0]",3,6,-3
31249.0,2020-01-24,"(677.0, 873.0]",5,23,-18
31249.0,2020-01-24,"(873.0, 1069.0]",16,22,-6
31249.0,2020-01-24,"(1069.0, 1265.0]",10,16,-6
31250.0,2020-01-24,"(361.031, 604.25]",21,26,-5
31250.0,2020-01-24,"(604.25, 846.5]",6,8,-2
31250.0,2020-01-24,"(846.5, 1088.75]",6,20,-14
31250.0,2020-01-24,"(1088.75, 1331.0]",2,9,-7
31251.0,2020-01-24,"(474.183, 679.25]",23,46,-23
31251.0,2020-01-24,"(679.25, 883.5]",6,13,-7
31251.0,2020-01-24,"(883.5, 1087.75]",13,24,-11
31251.0,2020-01-24,"(1087.75, 1292.0]",3,14,-11
31252.0,2020-01-24,"(468.247, 657.25]",21,24,-3
31252.0,2020-01-24,"(657.25, 845.5]",3,9,-6
31252.0,2020-01-24,"(845.5, 1033.75]",3,9,-6
31252.0,2020-01-24,"(1033.75, 1222.0]",5,20,-15
31253.0,2020-01-24,"(369.103, 594.25]",24,26,-2
31253.0,2020-01-24,"(594.25, 818.5]",8,10,-2
31253.0,2020-01-24,"(818.5, 1042.75]",7,15,-8
31253.0,2020-01-24,"(1042.75, 1267.0]",3,17,-14
31254.0,2020-01-24,"(427.061, 662.75]",23,27,-4
31254.0,2020-01-24,"(662.75, 897.5]",4,10,-6
31254.0,2020-01-24,"(897.5, 1132.25]",3,21,-18
31254.0,2020-01-24,"(1132.25, 1367.0]",6,10,-4
31255.0,2020-01-24,"(391.17, 599.5]",10,15,-5
31255.0,2020-01-24,"(599.5, 807.0]",4,9,-5
31255.0,2020-01-24,"(807.0, 1014.5]",5,11,-6
31255.0,2020-01-24,"(1014.5, 1222.0]",2,8,-6
31256.0,2020-01-24,"(272.877, 554.75]",10,10,0
31256.0,2020-01-24,"(554.75, 835.5]",3,8,-5
31256.0,2020-01-24,"(835.5, 1116.25]",9,21,-12
31256.0,2020-01-24,"(1116.25, 1397.0]",6,15,-9
31257.0,2020-01-24,"(340.0, 591.0]",14,24,-10
31257.0,2020-01-24,"(591.0, 841.0]",12,21,-9
31257.0,2020-01-24,"(841.0, 1091.0]",14,34,-20
31257.0,2020-01-24,"(1091.0, 1341.0]",8,17,-9
31258.0,2020-01-24,"(-1.339, 334.75]",5,6,-1
31258.0,2020-01-24,"(334.75, 669.5]",5,13,-8
31258.0,2020-01-24,"(669.5, 1004.25]",24,43,-19
31258.0,2020-01-24,"(1004.25, 1339.0]",10,29,-19
31259.0,2020-01-24,"(447.359, 608.25]",7,9,-2
31259.0,2020-01-24,"(768.5, 928.75]",1,3,-2
31259.0,2020-01-24,"(928.75, 1089.0]",1,2,-1
31260.0,2020-01-24,"(349.013, 596.75]",21,24,-3
31260.0,2020-01-24,"(596.75, 843.5]",5,14,-9
31260.0,2020-01-24,"(843.5, 1090.25]",7,19,-12
31260.0,2020-01-24,"(1090.25, 1337.0]",3,3,0
31261.0,2020-01-24,"(198.023, 443.25]",4,5,-1
31261.0,2020-01-24,"(443.25, 687.5]",7,7,0
31261.0,2020-01-24,"(687.5, 931.75]",4,18,-14
31261.0,2020-01-24,"(931.75, 1176.0]",3,7,-4
31262.0,2020-01-24,"(409.222, 604.5]",9,10,-1
31262.0,2020-01-24,"(604.5, 799.0]",1,4,-3
31262.0,2020-01-24,"(799.0, 993.5]",3,8,-5
31262.0,2020-01-24,"(993.5, 1188.0]",8,13,-5
31263.0,2020-01-24,"(492.186, 696.5]",25,33,-8
31263.0,2020-01-24,"(696.5, 900.0]",6,13,-7
31263.0,2020-01-24,"(900.0, 1103.5]",11,23,-12
31263.0,2020-01-24,"(1103.5, 1307.0]",4,17,-13
31264.0,2020-01-24,"(370.988, 625.0]",11,16,-5
31264.0,2020-01-24,"(625.0, 878.0]",4,9,-5
31264.0,2020-01-24,"(878.0, 1131.0]",9,17,-8
31264.0,2020-01-24,"(1131.0, 1384.0]",2,6,-4
31265.0,2020-01-24,"(76.786, 381.5]",1,3,-2
31265.0,2020-01-24,"(381.5, 685.0]",15,34,-19
31265.0,2020-01-24,"(685.0, 988.5]",13,25,-12
31265.0,2020-01-24,"(988.5, 1292.0]",21,37,-16
31266.0,2020-01-24,"(289.887, 569.25]",5,25,-20
31266.0,2020-01-24,"(569.25, 847.5]",6,17,-11
31266.0,2020-01-24,"(847.5, 1125.75]",20,37,-17
31266.0,2020-01-24,"(1125.75, 1404.0]",14,23,-9
31267.0,2020-01-24,"(20.643, 361.25]",1,1,0
31267.0,2020-01-24,"(361.25, 700.5]",25,53,-28
31267.0,2020-01-24,"(700.5, 1039.75]",10,29,-19
31267.0,2020-01-24,"(1039.75, 1379.0]",17,27,-10
31268.0,2020-01-24,"(387.953, 650.75]",12,42,-30
31268.0,2020-01-24,"(650.75, 912.5]",8,14,-6
31268.0,2020-01-24,"(912.5, 1174.25]",26,37,-11
31268.0,2020-01-24,"(1174.25, 1436.0]",9,17,-8
31269.0,2020-01-24,"(375.069, 608.75]",9,14,-5
31269.0,2020-01-24,"(608.75, 841.5]",8,13,-5
31269.0,2020-01-24,"(841.5, 1074.25]",6,17,-11
31269.0,2020-01-24,"(1074.25, 1307.0]",7,18,-11
31270.0,2020-01-24,"(326.154, 538.5]",13,17,-4
31270.0,2020-01-24,"(538.5, 750.0]",6,11,-5
31270.0,2020-01-24,"(750.0, 961.5]",4,15,-11
31270.0,2020-01-24,"(961.5, 1173.0]",9,15,-6
31271.0,2020-01-24,"(410.087, 639.25]",14,18,-4
31271.0,2020-01-24,"(639.25, 867.5]",12,18,-6
31271.0,2020-01-24,"(867.5, 1095.75]",3,11,-8
31271.0,2020-01-24,"(1095.75, 1324.0]",5,9,-4
31272.0,2020-01-24,"(8.641, 349.75]",2,2,0
31272.0,2020-01-24,"(349.75, 689.5]",18,21,-3
31272.0,2020-01-24,"(689.5, 1029.25]",11,38,-27
31272.0,2020-01-24,"(1029.25, 1369.0]",5,14,-9
31273.0,2020-01-24,"(414.41, 562.5]",1,3,-2
31273.0,2020-01-24,"(857.5, 1005.0]",3,1,2
31274.0,2020-01-24,"(391.144, 606.0]",16,16,0
31274.0,2020-01-24,"(606.0, 820.0]",5,6,-1
31274.0,2020-01-24,"(820.0, 1034.0]",3,6,-3
31274.0,2020-01-24,"(1034.0, 1248.0]",3,7,-4
31275.0,2020-01-24,"(40.624, 386.0]",2,4,-2
31275.0,2020-01-24,"(386.0, 730.0]",17,31,-14
31275.0,2020-01-24,"(730.0, 1074.0]",14,35,-21
31275.0,2020-01-24,"(1074.0, 1418.0]",8,19,-11
31276.0,2020-01-24,"(89.673, 422.75]",1,2,-1
31276.0,2020-01-24,"(422.75, 754.5]",29,35,-6
31276.0,2020-01-24,"(754.5, 1086.25]",8,33,-25
31276.0,2020-01-24,"(1086.25, 1418.0]",2,7,-5
31277.0,2020-01-24,"(417.998, 669.5]",35,41,-6
31277.0,2020-01-24,"(669.5, 920.0]",1,1,0
31277.0,2020-01-24,"(920.0, 1170.5]",3,26,-23
31277.0,2020-01-24,"(1170.5, 1421.0]",1,5,-4
31278.0,2020-01-24,"(86.718, 408.5]",1,2,-1
31278.0,2020-01-24,"(408.5, 729.0]",9,28,-19
31278.0,2020-01-24,"(729.0, 1049.5]",8,13,-5
31278.0,2020-01-24,"(1049.5, 1370.0]",21,28,-7
31279.0,2020-01-24,"(27.65, 366.5]",1,1,0
31279.0,2020-01-24,"(366.5, 704.0]",20,25,-5
31279.0,2020-01-24,"(704.0, 1041.5]",9,22,-13
31279.0,2020-01-24,"(1041.5, 1379.0]",4,20,-16
31280.0,2020-01-24,"(354.934, 622.5]",6,27,-21
31280.0,2020-01-24,"(622.5, 889.0]",3,3,0
31280.0,2020-01-24,"(889.0, 1155.5]",17,25,-8
31280.0,2020-01-24,"(1155.5, 1422.0]",8,11,-3
,,,,1.0,
,,,,2.0,
,,,,2.0,
31001.0,2020-01-25,"(1195.0, 1355.0]",3,1,2
31002.0,2020-01-25,"(725.643, 815.25]",1,3,-2
31002.0,2020-01-25,"(993.75, 1083.0]",2,3,-1
31003.0,2020-01-25,"(1072.0, 1148.0]",3,1,2
31004.0,2020-01-25,"(686.25, 915.0]",2,1,1
31005.0,2020-01-25,"(533.275, 715.25]",2,3,-1
31005.0,2020-01-25,"(715.25, 896.5]",1,2,-1
31005.0,2020-01-25,"(896.5, 1077.75]",1,3,-2
31005.0,2020-01-25,"(1077.75, 1259.0]",3,4,-1
31006.0,2020-01-25,"(716.58, 822.0]",1,2,-1
31006.0,2020-01-25,"(822.0, 927.0]",1,2,-1
31006.0,2020-01-25,"(927.0, 1032.0]",1,2,-1
31006.0,2020-01-25,"(1032.0, 1137.0]",3,6,-3
31007.0,2020-01-25,"(516.0, 765.5]",2,1,1
31007.0,2020-01-25,"(765.5, 1015.0]",4,3,1
31009.0,2020-01-25,"(758.41, 906.5]",1,2,-1
31010.0,2020-01-25,"(674.796, 726.0]",1,2,-1
31010.0,2020-01-25,"(726.0, 777.0]",1,2,-1
31010.0,2020-01-25,"(828.0, 879.0]",4,7,-3
31011.0,2020-01-25,"(17.974, 275.5]",1,1,0
31011.0,2020-01-25,"(532.0, 788.5]",2,5,-3
31011.0,2020-01-25,"(788.5, 1045.0]",3,5,-2
,,,,2.0,
31013.0,2020-01-25,"(667.5, 772.0]",3,1,2
31013.0,2020-01-25,"(772.0, 876.5]",1,4,-3
31013.0,2020-01-25,"(876.5, 981.0]",1,2,-1
31014.0,2020-01-25,"(559.273, 741.75]",3,4,-1
31014.0,2020-01-25,"(741.75, 923.5]",1,2,-1
31014.0,2020-01-25,"(923.5, 1105.25]",5,7,-2
31014.0,2020-01-25,"(1105.25, 1287.0]",1,3,-2
31015.0,2020-01-25,"(585.315, 757.25]",1,1,0
31015.0,2020-01-25,"(757.25, 928.5]",3,5,-2
31015.0,2020-01-25,"(928.5, 1099.75]",4,7,-3
31016.0,2020-01-25,"(724.742, 789.5]",2,2,0
31017.0,2020-01-25,"(1192.25, 1358.0]",2,2,0
31018.0,2020-01-25,"(702.401, 852.75]",1,1,0
31018.0,2020-01-25,"(1002.5, 1152.25]",3,1,2
31019.0,2020-01-25,"(625.294, 802.5]",2,2,0
31019.0,2020-01-25,"(1155.5, 1332.0]",3,6,-3
31020.0,2020-01-25,"(698.595, 800.25]",3,5,-2
31020.0,2020-01-25,"(1002.75, 1104.0]",1,3,-2
31021.0,2020-01-25,"(685.365, 844.75]",1,3,-2
31021.0,2020-01-25,"(844.75, 1003.5]",1,1,0
31021.0,2020-01-25,"(1003.5, 1162.25]",2,4,-2
31021.0,2020-01-25,"(1162.25, 1321.0]",1,2,-1
31022.0,2020-01-25,"(476.167, 685.25]",2,5,-3
31022.0,2020-01-25,"(685.25, 893.5]",1,5,-4
31022.0,2020-01-25,"(893.5, 1101.75]",2,6,-4
31022.0,2020-01-25,"(1101.75, 1310.0]",2,2,0
31023.0,2020-01-25,"(445.137, 661.75]",3,4,-1
31023.0,2020-01-25,"(661.75, 877.5]",4,6,-2
31024.0,2020-01-25,"(606.189, 809.75]",2,4,-2
31024.0,2020-01-25,"(809.75, 1012.5]",2,2,0
31024.0,2020-01-25,"(1012.5, 1215.25]",3,8,-5
31024.0,2020-01-25,"(1215.25, 1418.0]",2,2,0
31025.0,2020-01-25,"(647.706, 721.5]",2,3,-1
31025.0,2020-01-25,"(721.5, 795.0]",1,1,0
31025.0,2020-01-25,"(868.5, 942.0]",1,1,0
31026.0,2020-01-25,"(428.289, 606.75]",1,1,0
31026.0,2020-01-25,"(606.75, 784.5]",1,1,0
31026.0,2020-01-25,"(962.25, 1140.0]",2,2,0
31027.0,2020-01-25,"(646.58, 752.0]",1,2,-1
31027.0,2020-01-25,"(857.0, 962.0]",1,1,0
31028.0,2020-01-25,"(700.54, 816.0]",1,3,-2
31028.0,2020-01-25,"(1046.0, 1161.0]",1,1,0
31029.0,2020-01-25,"(622.285, 801.75]",1,4,-3
31029.0,2020-01-25,"(801.75, 980.5]",3,6,-3
31029.0,2020-01-25,"(980.5, 1159.25]",2,3,-1
31029.0,2020-01-25,"(1159.25, 1338.0]",1,1,0
31030.0,2020-01-25,"(836.25, 953.5]",1,1,0
31030.0,2020-01-25,"(953.5, 1070.75]",1,3,-2
31031.0,2020-01-25,"(917.0, 1038.0]",2,1,1
31032.0,2020-01-25,"(1048.913, 1070.75]",1,2,-1
31032.0,2020-01-25,"(1114.25, 1136.0]",1,3,-2
,,,,2.0,
31034.0,2020-01-25,"(622.22, 818.0]",3,7,-4
31034.0,2020-01-25,"(1013.0, 1208.0]",1,2,-1
31034.0,2020-01-25,"(1208.0, 1403.0]",1,5,-4
31035.0,2020-01-25,"(906.0, 1057.5]",1,1,0
31035.0,2020-01-25,"(1057.5, 1209.0]",1,1,0
31036.0,2020-01-25,"(569.324, 739.0]",1,3,-2
31036.0,2020-01-25,"(739.0, 908.0]",1,2,-1
31036.0,2020-01-25,"(908.0, 1077.0]",2,2,0
31036.0,2020-01-25,"(1077.0, 1246.0]",2,3,-1
31037.0,2020-01-25,"(532.278, 713.5]",3,4,-1
31037.0,2020-01-25,"(713.5, 894.0]",1,1,0
31037.0,2020-01-25,"(894.0, 1074.5]",3,7,-4
31037.0,2020-01-25,"(1074.5, 1255.0]",2,8,-6
31038.0,2020-01-25,"(515.46, 651.0]",2,3,-1
31038.0,2020-01-25,"(651.0, 786.0]",2,5,-3
31039.0,2020-01-25,"(535.19, 738.5]",3,6,-3
31040.0,2020-01-25,"(607.319, 778.25]",1,1,0
31041.0,2020-01-25,"(570.547, 684.25]",1,1,0
31041.0,2020-01-25,"(684.25, 797.5]",1,1,0
31041.0,2020-01-25,"(797.5, 910.75]",1,1,0
31042.0,2020-01-25,"(556.0, 834.0]",1,1,0
31042.0,2020-01-25,"(834.0, 1112.0]",4,1,3
,,,,1.0,
,,,,1.0,
31044.0,2020-01-25,"(681.378, 837.5]",1,4,-3
31044.0,2020-01-25,"(837.5, 993.0]",2,2,0
31044.0,2020-01-25,"(1148.5, 1304.0]",3,2,1
31045.0,2020-01-25,"(1045.75, 1156.0]",2,1,1
31046.0,2020-01-25,"(1233.25, 1410.0]",1,1,0
31047.0,2020-01-25,"(639.0, 795.0]",1,3,-2
31047.0,2020-01-25,"(951.0, 1107.0]",2,2,0
31048.0,2020-01-25,"(788.497, 914.75]",2,3,-1
31048.0,2020-01-25,"(914.75, 1040.5]",1,2,-1
,,,,1.0,
,,,,2.0,
,,,,1.0,
31050.0,2020-01-25,"(957.75, 1277.0]",1,1,0
31051.0,2020-01-25,"(524.101, 749.75]",1,2,-1
31051.0,2020-01-25,"(749.75, 974.5]",1,3,-2
31051.0,2020-01-25,"(974.5, 1199.25]",1,3,-2
31051.0,2020-01-25,"(1199.25, 1424.0]",1,1,0
31052.0,2020-01-25,"(930.924, 950.0]",2,2,0
31053.0,2020-01-25,"(706.7, 782.0]",1,1,0
,,,,1.0,
,,,,2.0,
31055.0,2020-01-25,"(1012.25, 1027.0]",1,1,0
31056.0,2020-01-25,"(842.5, 941.75]",1,1,0
31056.0,2020-01-25,"(941.75, 1041.0]",1,1,0
31057.0,2020-01-25,"(754.783, 809.25]",2,4,-2
31057.0,2020-01-25,"(917.75, 972.0]",1,1,0
31058.0,2020-01-25,"(1173.802, 1223.5]",1,1,0
31058.0,2020-01-25,"(1322.5, 1372.0]",1,2,-1
31059.0,2020-01-25,"(657.51, 780.5]",2,6,-4
31059.0,2020-01-25,"(780.5, 903.0]",2,2,0
31060.0,2020-01-25,"(643.408, 792.0]",2,2,0
31060.0,2020-01-25,"(792.0, 940.0]",1,1,0
31060.0,2020-01-25,"(940.0, 1088.0]",1,2,-1
31061.0,2020-01-25,"(528.541, 643.75]",1,1,0
31061.0,2020-01-25,"(758.5, 873.25]",1,1,0
31061.0,2020-01-25,"(873.25, 988.0]",1,2,-1
31062.0,2020-01-25,"(596.418, 742.5]",2,2,0
31062.0,2020-01-25,"(742.5, 888.0]",2,4,-2
31062.0,2020-01-25,"(888.0, 1033.5]",9,15,-6
31062.0,2020-01-25,"(1033.5, 1179.0]",3,5,-2
,,,,2.0,
31064.0,2020-01-25,"(695.632, 788.0]",2,4,-2
31064.0,2020-01-25,"(788.0, 880.0]",3,7,-4
31064.0,2020-01-25,"(880.0, 972.0]",2,3,-1
31064.0,2020-01-25,"(972.0, 1064.0]",3,6,-3
31065.0,2020-01-25,"(817.25, 948.0]",1,1,0
31066.0,2020-01-25,"(876.625, 970.75]",2,4,-2
31066.0,2020-01-25,"(970.75, 1064.5]",2,2,0
31066.0,2020-01-25,"(1158.25, 1252.0]",1,3,-2
31067.0,2020-01-25,"(1006.25, 1135.0]",1,1,0
31068.0,2020-01-25,"(646.269, 829.75]",3,6,-3
31068.0,2020-01-25,"(1195.25, 1378.0]",1,2,-1
31069.0,2020-01-25,"(991.5, 1142.25]",2,1,1
31069.0,2020-01-25,"(1142.25, 1293.0]",2,4,-2
31070.0,2020-01-25,"(1125.5, 1317.0]",2,1,1
31071.0,2020-01-25,"(648.35, 811.5]",4,6,-2
31071.0,2020-01-25,"(811.5, 974.0]",4,6,-2
31071.0,2020-01-25,"(974.0, 1136.5]",1,4,-3
31071.0,2020-01-25,"(1136.5, 1299.0]",1,2,-1
31072.0,2020-01-25,"(640.5, 854.0]",1,1,0
,,,,1.0,
,,,,1.0,
31074.0,2020-01-25,"(437.265, 621.75]",1,2,-1
31074.0,2020-01-25,"(621.75, 805.5]",1,1,0
31074.0,2020-01-25,"(989.25, 1173.0]",3,1,2
31075.0,2020-01-25,"(1012.25, 1036.0]",1,1,0
31076.0,2020-01-25,"(658.827, 702.25]",1,1,0
31076.0,2020-01-25,"(788.75, 832.0]",1,2,-1
31077.0,2020-01-25,"(483.128, 702.0]",3,3,0
31077.0,2020-01-25,"(702.0, 920.0]",3,4,-1
31077.0,2020-01-25,"(920.0, 1138.0]",5,10,-5
31077.0,2020-01-25,"(1138.0, 1356.0]",1,2,-1
,,,,2.0,
31079.0,2020-01-25,"(622.326, 791.5]",1,4,-3
31079.0,2020-01-25,"(791.5, 960.0]",2,3,-1
31079.0,2020-01-25,"(960.0, 1128.5]",3,4,-1
31079.0,2020-01-25,"(1128.5, 1297.0]",1,3,-2
31080.0,2020-01-25,"(484.121, 704.75]",1,7,-6
31080.0,2020-01-25,"(704.75, 924.5]",1,1,0
31080.0,2020-01-25,"(924.5, 1144.25]",1,2,-1
31080.0,2020-01-25,"(1144.25, 1364.0]",1,1,0
31081.0,2020-01-25,"(675.381, 830.75]",2,2,0
31081.0,2020-01-25,"(985.5, 1140.25]",1,2,-1
31082.0,2020-01-25,"(686.0, 1029.0]",2,1,1
31082.0,2020-01-25,"(1029.0, 1372.0]",1,2,-1
31083.0,2020-01-25,"(631.429, 774.75]",1,3,-2
31083.0,2020-01-25,"(774.75, 917.5]",3,5,-2
31083.0,2020-01-25,"(1060.25, 1203.0]",3,5,-2
31084.0,2020-01-25,"(719.322, 889.5]",2,2,0
31085.0,2020-01-25,"(745.868, 779.0]",1,2,-1
31085.0,2020-01-25,"(812.0, 845.0]",1,2,-1
31085.0,2020-01-25,"(845.0, 878.0]",1,1,0
31086.0,2020-01-25,"(564.366, 723.5]",2,3,-1
31086.0,2020-01-25,"(1040.5, 1199.0]",3,1,2
31087.0,2020-01-25,"(577.462, 712.5]",1,1,0
31087.0,2020-01-25,"(712.5, 847.0]",1,1,0
31088.0,2020-01-25,"(741.683, 821.25]",1,3,-2
31088.0,2020-01-25,"(979.75, 1059.0]",1,1,0
31089.0,2020-01-25,"(528.228, 722.0]",2,4,-2
31089.0,2020-01-25,"(722.0, 915.0]",2,7,-5
31089.0,2020-01-25,"(915.0, 1108.0]",1,3,-2
31089.0,2020-01-25,"(1108.0, 1301.0]",1,4,-3
31090.0,2020-01-25,"(834.879, 865.25]",2,2,0
31091.0,2020-01-25,"(25.68, 357.0]",1,1,0
31091.0,2020-01-25,"(687.0, 1017.0]",4,2,2
31091.0,2020-01-25,"(1017.0, 1347.0]",1,6,-5
31092.0,2020-01-25,"(635.437, 776.75]",2,5,-3
31092.0,2020-01-25,"(776.75, 917.5]",2,3,-1
,,,,1.0,
,,,,1.0,
,,,,2.0,
,,,,2.0,
,,,,1.0,
,,,,1.0,
31096.0,2020-01-25,"(562.273, 744.75]",1,2,-1
31096.0,2020-01-25,"(926.5, 1108.25]",2,2,0
31096.0,2020-01-25,"(1108.25, 1290.0]",1,3,-2
31097.0,2020-01-25,"(799.835, 841.25]",1,2,-1
31097.0,2020-01-25,"(841.25, 882.5]",2,2,0
31097.0,2020-01-25,"(923.75, 965.0]",1,4,-3
,,,,1.0,
,,,,4.0,
31099.0,2020-01-25,"(562.439, 703.25]",1,1,0
31099.0,2020-01-25,"(983.75, 1124.0]",1,2,-1
31100.0,2020-01-25,"(459.221, 654.75]",1,1,0
31100.0,2020-01-25,"(654.75, 849.5]",3,5,-2
31101.0,2020-01-25,"(40.786, 345.5]",1,2,-1
31101.0,2020-01-25,"(345.5, 649.0]",10,14,-4
31101.0,2020-01-25,"(649.0, 952.5]",40,59,-19
31101.0,2020-01-25,"(952.5, 1256.0]",34,57,-23
31102.0,2020-01-25,"(76.691, 405.25]",1,1,0
31102.0,2020-01-25,"(405.25, 732.5]",1,13,-12
31102.0,2020-01-25,"(732.5, 1059.75]",8,14,-6
31102.0,2020-01-25,"(1059.75, 1387.0]",6,12,-6
31103.0,2020-01-25,"(25.587, 380.25]",1,1,0
31103.0,2020-01-25,"(380.25, 733.5]",4,12,-8
31103.0,2020-01-25,"(733.5, 1086.75]",8,34,-26
31103.0,2020-01-25,"(1086.75, 1440.0]",4,18,-14
31104.0,2020-01-25,"(372.75, 725.5]",3,9,-6
31104.0,2020-01-25,"(725.5, 1078.25]",16,18,-2
31104.0,2020-01-25,"(1078.25, 1431.0]",11,34,-23
31105.0,2020-01-25,"(19.792, 323.0]",1,1,0
31105.0,2020-01-25,"(625.0, 927.0]",3,7,-4
31105.0,2020-01-25,"(927.0, 1229.0]",1,6,-5
31106.0,2020-01-25,"(430.001, 680.75]",1,4,-3
31106.0,2020-01-25,"(680.75, 930.5]",3,10,-7
31106.0,2020-01-25,"(930.5, 1180.25]",2,6,-4
31106.0,2020-01-25,"(1180.25, 1430.0]",2,3,-1
31107.0,2020-01-25,"(40.613, 388.75]",1,2,-1
31107.0,2020-01-25,"(388.75, 735.5]",9,16,-7
31107.0,2020-01-25,"(735.5, 1082.25]",11,36,-25
31107.0,2020-01-25,"(1082.25, 1429.0]",8,18,-10
31108.0,2020-01-25,"(486.054, 723.5]",5,10,-5
31108.0,2020-01-25,"(723.5, 960.0]",10,27,-17
31108.0,2020-01-25,"(960.0, 1196.5]",15,28,-13
31108.0,2020-01-25,"(1196.5, 1433.0]",14,16,-2
31109.0,2020-01-25,"(7.619, 354.25]",1,2,-1
31109.0,2020-01-25,"(354.25, 699.5]",2,4,-2
31109.0,2020-01-25,"(699.5, 1044.75]",14,27,-13
31109.0,2020-01-25,"(1044.75, 1390.0]",12,20,-8
31110.0,2020-01-25,"(363.75, 717.5]",10,1,9
31110.0,2020-01-25,"(717.5, 1071.25]",19,20,-1
31110.0,2020-01-25,"(1071.25, 1425.0]",8,45,-37
31111.0,2020-01-25,"(127.691, 456.25]",1,2,-1
31111.0,2020-01-25,"(456.25, 783.5]",3,8,-5
31111.0,2020-01-25,"(783.5, 1110.75]",9,16,-7
31111.0,2020-01-25,"(1110.75, 1438.0]",6,15,-9
31112.0,2020-01-25,"(778.5, 877.0]",1,1,0
31112.0,2020-01-25,"(975.5, 1074.0]",2,1,1
31113.0,2020-01-25,"(74.678, 406.5]",1,3,-2
31113.0,2020-01-25,"(406.5, 737.0]",4,13,-9
31113.0,2020-01-25,"(737.0, 1067.5]",7,21,-14
31113.0,2020-01-25,"(1067.5, 1398.0]",5,12,-7
31114.0,2020-01-25,"(533.16, 744.0]",11,22,-11
31114.0,2020-01-25,"(744.0, 954.0]",16,30,-14
31114.0,2020-01-25,"(954.0, 1164.0]",7,18,-11
31114.0,2020-01-25,"(1164.0, 1374.0]",4,14,-10
31115.0,2020-01-25,"(29.601, 380.75]",1,1,0
31115.0,2020-01-25,"(380.75, 730.5]",2,11,-9
31115.0,2020-01-25,"(730.5, 1080.25]",9,27,-18
31115.0,2020-01-25,"(1080.25, 1430.0]",8,13,-5
31116.0,2020-01-25,"(71.661, 407.75]",1,2,-1
31116.0,2020-01-25,"(407.75, 742.5]",8,17,-9
31116.0,2020-01-25,"(742.5, 1077.25]",16,33,-17
31116.0,2020-01-25,"(1077.25, 1412.0]",5,9,-4
31117.0,2020-01-25,"(-1.337, 334.25]",1,3,-2
31117.0,2020-01-25,"(334.25, 668.5]",2,12,-10
31117.0,2020-01-25,"(668.5, 1002.75]",4,18,-14
31117.0,2020-01-25,"(1002.75, 1337.0]",5,21,-16
31118.0,2020-01-25,"(543.298, 719.5]",1,5,-4
31118.0,2020-01-25,"(719.5, 895.0]",1,6,-5
31118.0,2020-01-25,"(895.0, 1070.5]",7,14,-7
31118.0,2020-01-25,"(1070.5, 1246.0]",5,7,-2
31119.0,2020-01-25,"(39.613, 387.75]",2,3,-1
31119.0,2020-01-25,"(387.75, 734.5]",5,14,-9
31119.0,2020-01-25,"(734.5, 1081.25]",17,35,-18
31119.0,2020-01-25,"(1081.25, 1428.0]",10,13,-3
31120.0,2020-01-25,"(411.107, 635.25]",3,6,-3
31120.0,2020-01-25,"(635.25, 858.5]",10,15,-5
31120.0,2020-01-25,"(858.5, 1081.75]",6,15,-9
31120.0,2020-01-25,"(1081.75, 1305.0]",9,13,-4
31121.0,2020-01-25,"(51.615, 399.25]",3,3,0
31121.0,2020-01-25,"(399.25, 745.5]",3,7,-4
31121.0,2020-01-25,"(745.5, 1091.75]",10,19,-9
31121.0,2020-01-25,"(1091.75, 1438.0]",4,11,-7
31122.0,2020-01-25,"(1.628, 346.0]",1,1,0
31122.0,2020-01-25,"(346.0, 689.0]",4,10,-6
31122.0,2020-01-25,"(689.0, 1032.0]",9,18,-9
31122.0,2020-01-25,"(1032.0, 1375.0]",3,8,-5
31123.0,2020-01-25,"(406.989, 660.75]",3,6,-3
31123.0,2020-01-25,"(660.75, 913.5]",2,12,-10
31123.0,2020-01-25,"(913.5, 1166.25]",1,7,-6
31123.0,2020-01-25,"(1166.25, 1419.0]",2,4,-2
31124.0,2020-01-25,"(11.578, 368.5]",3,5,-2
31124.0,2020-01-25,"(368.5, 724.0]",8,27,-19
31124.0,2020-01-25,"(724.0, 1079.5]",17,64,-47
31124.0,2020-01-25,"(1079.5, 1435.0]",7,21,-14
31125.0,2020-01-25,"(516.307, 690.25]",6,16,-10
31125.0,2020-01-25,"(690.25, 863.5]",9,18,-9
31125.0,2020-01-25,"(863.5, 1036.75]",9,20,-11
31125.0,2020-01-25,"(1036.75, 1210.0]",9,13,-4
31126.0,2020-01-25,"(25.637, 367.75]",2,2,0
31126.0,2020-01-25,"(708.5, 1049.25]",11,11,0
31126.0,2020-01-25,"(1049.25, 1390.0]",14,24,-10
31127.0,2020-01-25,"(554.12, 775.0]",6,10,-4
31127.0,2020-01-25,"(775.0, 995.0]",9,14,-5
31127.0,2020-01-25,"(995.0, 1215.0]",4,14,-10
31127.0,2020-01-25,"(1215.0, 1435.0]",3,5,-2
31128.0,2020-01-25,"(26.61, 375.5]",1,1,0
31128.0,2020-01-25,"(375.5, 723.0]",19,29,-10
31128.0,2020-01-25,"(723.0, 1070.5]",12,25,-13
31128.0,2020-01-25,"(1070.5, 1418.0]",8,17,-9
31129.0,2020-01-25,"(505.066, 739.5]",4,5,-1
31129.0,2020-01-25,"(739.5, 973.0]",10,21,-11
31129.0,2020-01-25,"(973.0, 1206.5]",12,16,-4
31129.0,2020-01-25,"(1206.5, 1440.0]",2,2,0
31130.0,2020-01-25,"(428.157, 639.75]",2,2,0
31130.0,2020-01-25,"(639.75, 850.5]",3,10,-7
31130.0,2020-01-25,"(850.5, 1061.25]",3,6,-3
31130.0,2020-01-25,"(1061.25, 1272.0]",4,4,0
31131.0,2020-01-25,"(85.655, 423.25]",1,1,0
31131.0,2020-01-25,"(423.25, 759.5]",3,10,-7
31131.0,2020-01-25,"(759.5, 1095.75]",4,7,-3
31131.0,2020-01-25,"(1095.75, 1432.0]",5,13,-8
31200.0,2020-01-25,"(15.623, 361.25]",1,5,-4
31200.0,2020-01-25,"(361.25, 705.5]",15,21,-6
31200.0,2020-01-25,"(705.5, 1049.75]",13,28,-15
31200.0,2020-01-25,"(1049.75, 1394.0]",5,15,-10
31201.0,2020-01-25,"(370.0, 707.0]",20,4,16
31201.0,2020-01-25,"(707.0, 1044.0]",42,37,5
31201.0,2020-01-25,"(1044.0, 1381.0]",24,84,-60
,,,,2.0,
31203.0,2020-01-25,"(371.25, 724.5]",15,2,13
31203.0,2020-01-25,"(724.5, 1077.75]",46,26,20
31203.0,2020-01-25,"(1077.75, 1431.0]",21,70,-49
31204.0,2020-01-25,"(101.732, 420.0]",1,1,0
31204.0,2020-01-25,"(420.0, 737.0]",3,8,-5
31204.0,2020-01-25,"(737.0, 1054.0]",6,13,-7
31204.0,2020-01-25,"(1054.0, 1371.0]",7,12,-5
31205.0,2020-01-25,"(635.267, 819.25]",3,8,-5
31205.0,2020-01-25,"(819.25, 1002.5]",4,6,-2
31205.0,2020-01-25,"(1185.75, 1369.0]",5,7,-2
31206.0,2020-01-25,"(889.881, 919.75]",1,1,0
31207.0,2020-01-25,"(533.298, 709.5]",1,2,-1
31207.0,2020-01-25,"(709.5, 885.0]",2,4,-2
31208.0,2020-01-25,"(17.864, 303.0]",1,2,-1
31208.0,2020-01-25,"(587.0, 871.0]",4,8,-4
31208.0,2020-01-25,"(871.0, 1155.0]",11,12,-1
31209.0,2020-01-25,"(559.211, 757.25]",2,4,-2
31209.0,2020-01-25,"(757.25, 954.5]",2,3,-1
31209.0,2020-01-25,"(954.5, 1151.75]",4,6,-2
31209.0,2020-01-25,"(1151.75, 1349.0]",4,4,0
31211.0,2020-01-25,"(796.397, 947.75]",4,5,-1
31211.0,2020-01-25,"(947.75, 1098.5]",13,14,-1
31211.0,2020-01-25,"(1098.5, 1249.25]",3,6,-3
31211.0,2020-01-25,"(1249.25, 1400.0]",1,6,-5
31212.0,2020-01-25,"(30.605, 380.75]",1,1,0
31212.0,2020-01-25,"(380.75, 729.5]",3,6,-3
31212.0,2020-01-25,"(729.5, 1078.25]",13,19,-6
31212.0,2020-01-25,"(1078.25, 1427.0]",5,11,-6
31213.0,2020-01-25,"(6.699, 333.25]",3,3,0
31213.0,2020-01-25,"(333.25, 658.5]",5,7,-2
31213.0,2020-01-25,"(658.5, 983.75]",13,24,-11
31213.0,2020-01-25,"(983.75, 1309.0]",1,7,-6
31214.0,2020-01-25,"(381.0, 722.0]",13,1,12
31214.0,2020-01-25,"(722.0, 1063.0]",30,30,0
31214.0,2020-01-25,"(1063.0, 1404.0]",15,67,-52
31215.0,2020-01-25,"(612.261, 797.75]",6,7,-1
31215.0,2020-01-25,"(797.75, 982.5]",3,6,-3
31215.0,2020-01-25,"(982.5, 1167.25]",9,9,0
31215.0,2020-01-25,"(1167.25, 1352.0]",1,2,-1
31216.0,2020-01-25,"(708.548, 822.0]",1,1,0
31216.0,2020-01-25,"(822.0, 935.0]",1,1,0
31217.0,2020-01-25,"(708.75, 938.5]",8,5,3
31217.0,2020-01-25,"(938.5, 1168.25]",3,9,-6
31217.0,2020-01-25,"(1168.25, 1398.0]",1,4,-3
31218.0,2020-01-25,"(695.75, 857.5]",4,1,3
31218.0,2020-01-25,"(857.5, 1019.25]",1,7,-6
31218.0,2020-01-25,"(1019.25, 1181.0]",1,1,0
31219.0,2020-01-25,"(559.524, 679.0]",2,2,0
31219.0,2020-01-25,"(679.0, 798.0]",2,2,0
31219.0,2020-01-25,"(798.0, 917.0]",1,3,-2
31219.0,2020-01-25,"(917.0, 1036.0]",1,4,-3
,,,,2.0,
31221.0,2020-01-25,"(379.75, 721.5]",5,2,3
31221.0,2020-01-25,"(721.5, 1063.25]",6,8,-2
31221.0,2020-01-25,"(1063.25, 1405.0]",5,13,-8
31222.0,2020-01-25,"(13.654, 351.5]",2,2,0
31222.0,2020-01-25,"(688.0, 1024.5]",5,1,4
31222.0,2020-01-25,"(1024.5, 1361.0]",9,8,1
31223.0,2020-01-25,"(-0.419, 355.75]",5,7,-2
31223.0,2020-01-25,"(355.75, 710.5]",6,10,-4
31223.0,2020-01-25,"(710.5, 1065.25]",12,21,-9
31223.0,2020-01-25,"(1065.25, 1420.0]",3,10,-7
31224.0,2020-01-25,"(545.184, 750.0]",5,6,-1
31224.0,2020-01-25,"(750.0, 954.0]",3,8,-5
31224.0,2020-01-25,"(954.0, 1158.0]",7,10,-3
31224.0,2020-01-25,"(1158.0, 1362.0]",2,3,-1
31225.0,2020-01-25,"(441.01, 689.5]",5,9,-4
31225.0,2020-01-25,"(689.5, 937.0]",3,7,-4
31225.0,2020-01-25,"(937.0, 1184.5]",7,11,-4
31225.0,2020-01-25,"(1184.5, 1432.0]",3,7,-4
31226.0,2020-01-25,"(375.092, 603.0]",3,5,-2
31226.0,2020-01-25,"(603.0, 830.0]",2,4,-2
31226.0,2020-01-25,"(830.0, 1057.0]",5,8,-3
31227.0,2020-01-25,"(644.436, 786.0]",4,7,-3
31227.0,2020-01-25,"(786.0, 927.0]",4,5,-1
31227.0,2020-01-25,"(927.0, 1068.0]",5,10,-5
31227.0,2020-01-25,"(1068.0, 1209.0]",1,2,-1
31228.0,2020-01-25,"(468.068, 702.0]",8,11,-3
31228.0,2020-01-25,"(702.0, 935.0]",8,19,-11
31228.0,2020-01-25,"(935.0, 1168.0]",14,21,-7
31228.0,2020-01-25,"(1168.0, 1401.0]",12,25,-13
31229.0,2020-01-25,"(1.59, 355.5]",4,6,-2
31229.0,2020-01-25,"(355.5, 708.0]",25,57,-32
31229.0,2020-01-25,"(708.0, 1060.5]",44,81,-37
31229.0,2020-01-25,"(1060.5, 1413.0]",13,27,-14
31230.0,2020-01-25,"(395.5, 679.0]",6,1,5
31230.0,2020-01-25,"(679.0, 962.5]",20,8,12
31230.0,2020-01-25,"(962.5, 1246.0]",10,27,-17
31231.0,2020-01-25,"(619.472, 752.0]",2,4,-2
31231.0,2020-01-25,"(752.0, 884.0]",2,2,0
31231.0,2020-01-25,"(1016.0, 1148.0]",4,7,-3
31232.0,2020-01-25,"(504.079, 735.25]",8,9,-1
31232.0,2020-01-25,"(735.25, 965.5]",10,16,-6
31232.0,2020-01-25,"(965.5, 1195.75]",10,21,-11
31232.0,2020-01-25,"(1195.75, 1426.0]",5,13,-8
31233.0,2020-01-25,"(558.133, 775.75]",5,7,-2
31233.0,2020-01-25,"(775.75, 992.5]",7,12,-5
31233.0,2020-01-25,"(992.5, 1209.25]",3,7,-4
31233.0,2020-01-25,"(1209.25, 1426.0]",1,2,-1
31234.0,2020-01-25,"(502.091, 730.25]",6,12,-6
31234.0,2020-01-25,"(730.25, 957.5]",17,28,-11
31234.0,2020-01-25,"(957.5, 1184.75]",8,19,-11
31234.0,2020-01-25,"(1184.75, 1412.0]",4,9,-5
31235.0,2020-01-25,"(590.407, 739.25]",1,1,0
31235.0,2020-01-25,"(739.25, 887.5]",7,11,-4
31235.0,2020-01-25,"(887.5, 1035.75]",2,7,-5
31235.0,2020-01-25,"(1035.75, 1184.0]",4,6,-2
31236.0,2020-01-25,"(696.5, 1027.25]",8,1,7
31236.0,2020-01-25,"(1027.25, 1358.0]",3,14,-11
31237.0,2020-01-25,"(505.206, 704.5]",7,16,-9
31237.0,2020-01-25,"(704.5, 903.0]",7,12,-5
31237.0,2020-01-25,"(903.0, 1101.5]",6,11,-5
31237.0,2020-01-25,"(1101.5, 1300.0]",5,11,-6
31238.0,2020-01-25,"(43.631, 387.25]",1,1,0
31238.0,2020-01-25,"(387.25, 729.5]",3,3,0
31238.0,2020-01-25,"(729.5, 1071.75]",6,14,-8
31238.0,2020-01-25,"(1071.75, 1414.0]",5,7,-2
31239.0,2020-01-25,"(44.816, 342.0]",1,1,0
31239.0,2020-01-25,"(342.0, 638.0]",2,3,-1
31239.0,2020-01-25,"(638.0, 934.0]",17,23,-6
31239.0,2020-01-25,"(934.0, 1230.0]",11,24,-13
31240.0,2020-01-25,"(677.513, 799.75]",4,8,-4
31240.0,2020-01-25,"(921.5, 1043.25]",8,5,3
31240.0,2020-01-25,"(1043.25, 1165.0]",3,12,-9
31241.0,2020-01-25,"(42.633, 385.75]",1,2,-1
31241.0,2020-01-25,"(385.75, 727.5]",6,19,-13
31241.0,2020-01-25,"(727.5, 1069.25]",12,38,-26
31241.0,2020-01-25,"(1069.25, 1411.0]",9,15,-6
31242.0,2020-01-25,"(895.623, 990.25]",1,2,-1
31242.0,2020-01-25,"(1178.75, 1273.0]",1,3,-2
31243.0,2020-01-25,"(662.537, 778.75]",1,3,-2
31243.0,2020-01-25,"(778.75, 894.5]",4,4,0
31243.0,2020-01-25,"(894.5, 1010.25]",3,8,-5
31243.0,2020-01-25,"(1010.25, 1126.0]",3,6,-3
31244.0,2020-01-25,"(505.168, 714.0]",4,6,-2
31244.0,2020-01-25,"(714.0, 922.0]",2,8,-6
31244.0,2020-01-25,"(922.0, 1130.0]",7,11,-4
31244.0,2020-01-25,"(1130.0, 1338.0]",6,8,-2
31245.0,2020-01-25,"(410.5, 751.0]",6,2,4
31245.0,2020-01-25,"(751.0, 1091.5]",15,12,3
31245.0,2020-01-25,"(1091.5, 1432.0]",9,26,-17
31246.0,2020-01-25,"(2.658, 339.5]",1,1,0
31246.0,2020-01-25,"(339.5, 675.0]",2,6,-4
31246.0,2020-01-25,"(675.0, 1010.5]",33,59,-26
31246.0,2020-01-25,"(1010.5, 1346.0]",6,15,-9
31247.0,2020-01-25,"(547.158, 758.5]",26,37,-11
31247.0,2020-01-25,"(758.5, 969.0]",18,48,-30
31247.0,2020-01-25,"(969.0, 1179.5]",7,16,-9
31247.0,2020-01-25,"(1179.5, 1390.0]",2,2,0
31248.0,2020-01-25,"(620.198, 821.5]",9,15,-6
31248.0,2020-01-25,"(821.5, 1022.0]",10,23,-13
31248.0,2020-01-25,"(1022.0, 1222.5]",7,23,-16
31248.0,2020-01-25,"(1222.5, 1423.0]",4,5,-1
31249.0,2020-01-25,"(607.564, 717.0]",3,6,-3
31249.0,2020-01-25,"(717.0, 826.0]",3,6,-3
31249.0,2020-01-25,"(826.0, 935.0]",3,9,-6
31249.0,2020-01-25,"(935.0, 1044.0]",9,16,-7
31250.0,2020-01-25,"(498.27, 681.5]",2,3,-1
31250.0,2020-01-25,"(681.5, 864.0]",3,4,-1
31250.0,2020-01-25,"(864.0, 1046.5]",1,1,0
31251.0,2020-01-25,"(460.039, 701.25]",9,19,-10
31251.0,2020-01-25,"(701.25, 941.5]",4,10,-6
31251.0,2020-01-25,"(941.5, 1181.75]",4,7,-3
31251.0,2020-01-25,"(1181.75, 1422.0]",2,2,0
31252.0,2020-01-25,"(540.412, 688.0]",2,4,-2
31252.0,2020-01-25,"(835.0, 982.0]",2,1,1
31252.0,2020-01-25,"(982.0, 1129.0]",3,3,0
31253.0,2020-01-25,"(846.63, 939.5]",1,2,-1
31253.0,2020-01-25,"(1124.5, 1217.0]",1,2,-1
31254.0,2020-01-25,"(456.75, 750.5]",3,1,2
31254.0,2020-01-25,"(750.5, 1044.25]",2,6,-4
31254.0,2020-01-25,"(1044.25, 1338.0]",1,3,-2
31255.0,2020-01-25,"(0.909, 274.75]",1,2,-1
31255.0,2020-01-25,"(274.75, 547.5]",1,2,-1
31255.0,2020-01-25,"(547.5, 820.25]",6,7,-1
31255.0,2020-01-25,"(820.25, 1093.0]",2,4,-2
31256.0,2020-01-25,"(569.148, 783.0]",4,8,-4
31256.0,2020-01-25,"(783.0, 996.0]",12,16,-4
31256.0,2020-01-25,"(996.0, 1209.0]",1,1,0
31256.0,2020-01-25,"(1209.0, 1422.0]",2,9,-7
31257.0,2020-01-25,"(517.116, 739.0]",7,8,-1
31257.0,2020-01-25,"(739.0, 960.0]",8,13,-5
31257.0,2020-01-25,"(960.0, 1181.0]",5,14,-9
31257.0,2020-01-25,"(1181.0, 1402.0]",3,11,-8
31258.0,2020-01-25,"(1.625, 346.75]",1,2,-1
31258.0,2020-01-25,"(346.75, 690.5]",1,4,-3
31258.0,2020-01-25,"(690.5, 1034.25]",27,56,-29
31258.0,2020-01-25,"(1034.25, 1378.0]",1,5,-4
31259.0,2020-01-25,"(1056.0, 1408.0]",1,1,0
31260.0,2020-01-25,"(583.301, 758.75]",3,4,-1
31260.0,2020-01-25,"(758.75, 933.5]",1,4,-3
31260.0,2020-01-25,"(933.5, 1108.25]",3,6,-3
31260.0,2020-01-25,"(1108.25, 1283.0]",2,4,-2
31261.0,2020-01-25,"(694.289, 872.75]",2,3,-1
31261.0,2020-01-25,"(1228.25, 1406.0]",8,1,7
31262.0,2020-01-25,"(550.419, 696.25]",3,5,-2
31262.0,2020-01-25,"(696.25, 841.5]",1,3,-2
31262.0,2020-01-25,"(841.5, 986.75]",6,8,-2
31262.0,2020-01-25,"(986.75, 1132.0]",6,7,-1
31263.0,2020-01-25,"(429.5, 760.0]",7,1,6
31263.0,2020-01-25,"(760.0, 1090.5]",8,12,-4
31263.0,2020-01-25,"(1090.5, 1421.0]",7,18,-11
31264.0,2020-01-25,"(586.202, 786.5]",2,3,-1
31264.0,2020-01-25,"(786.5, 986.0]",5,11,-6
31264.0,2020-01-25,"(986.0, 1185.5]",2,5,-3
31264.0,2020-01-25,"(1185.5, 1385.0]",1,2,-1
31265.0,2020-01-25,"(169.769, 478.75]",1,2,-1
31265.0,2020-01-25,"(478.75, 786.5]",8,19,-11
31265.0,2020-01-25,"(786.5, 1094.25]",16,28,-12
31265.0,2020-01-25,"(1094.25, 1402.0]",6,9,-3
31266.0,2020-01-25,"(1.568, 361.0]",3,3,0
31266.0,2020-01-25,"(361.0, 719.0]",4,19,-15
31266.0,2020-01-25,"(719.0, 1077.0]",24,45,-21
31266.0,2020-01-25,"(1077.0, 1435.0]",19,32,-13
31267.0,2020-01-25,"(8.69, 337.5]",2,2,0
31267.0,2020-01-25,"(337.5, 665.0]",6,8,-2
31267.0,2020-01-25,"(665.0, 992.5]",9,26,-17
31267.0,2020-01-25,"(992.5, 1320.0]",10,18,-8
31268.0,2020-01-25,"(104.685, 434.75]",2,3,-1
31268.0,2020-01-25,"(434.75, 763.5]",14,25,-11
31268.0,2020-01-25,"(763.5, 1092.25]",21,36,-15
31268.0,2020-01-25,"(1092.25, 1421.0]",15,20,-5
31269.0,2020-01-25,"(351.5, 685.0]",1,1,0
31269.0,2020-01-25,"(685.0, 1018.5]",15,3,12
31269.0,2020-01-25,"(1018.5, 1352.0]",3,37,-34
31270.0,2020-01-25,"(568.29, 746.5]",1,1,0
31270.0,2020-01-25,"(746.5, 924.0]",6,7,-1
31270.0,2020-01-25,"(924.0, 1101.5]",3,9,-6
31270.0,2020-01-25,"(1101.5, 1279.0]",5,11,-6
31271.0,2020-01-25,"(561.486, 690.5]",4,9,-5
31271.0,2020-01-25,"(690.5, 819.0]",3,8,-5
31271.0,2020-01-25,"(819.0, 947.5]",1,6,-5
31271.0,2020-01-25,"(947.5, 1076.0]",8,9,-1
31272.0,2020-01-25,"(580.164, 790.0]",9,14,-5
31272.0,2020-01-25,"(790.0, 999.0]",7,16,-9
31272.0,2020-01-25,"(999.0, 1208.0]",3,9,-6
31272.0,2020-01-25,"(1208.0, 1417.0]",1,1,0
31273.0,2020-01-25,"(649.507, 773.25]",1,2,-1
31273.0,2020-01-25,"(773.25, 896.5]",3,5,-2
31273.0,2020-01-25,"(896.5, 1019.75]",2,3,-1
31273.0,2020-01-25,"(1019.75, 1143.0]",1,2,-1
31274.0,2020-01-25,"(588.153, 800.75]",3,6,-3
31274.0,2020-01-25,"(800.75, 1012.5]",2,3,-1
31274.0,2020-01-25,"(1224.25, 1436.0]",1,1,0
31275.0,2020-01-25,"(325.895, 603.25]",2,2,0
31275.0,2020-01-25,"(603.25, 879.5]",4,9,-5
31275.0,2020-01-25,"(879.5, 1155.75]",9,15,-6
31275.0,2020-01-25,"(1155.75, 1432.0]",5,11,-6
31276.0,2020-01-25,"(165.761, 476.75]",1,1,0
31276.0,2020-01-25,"(476.75, 786.5]",1,3,-2
31276.0,2020-01-25,"(786.5, 1096.25]",5,11,-6
31276.0,2020-01-25,"(1096.25, 1406.0]",2,3,-1
31277.0,2020-01-25,"(439.129, 657.75]",1,1,0
31277.0,2020-01-25,"(875.5, 1093.25]",5,4,1
31277.0,2020-01-25,"(1093.25, 1311.0]",2,9,-7
31278.0,2020-01-25,"(415.5, 752.0]",7,1,6
31278.0,2020-01-25,"(752.0, 1088.5]",13,14,-1
31278.0,2020-01-25,"(1088.5, 1425.0]",8,31,-23
31279.0,2020-01-25,"(494.27, 677.5]",2,3,-1
31279.0,2020-01-25,"(677.5, 860.0]",3,7,-4
31279.0,2020-01-25,"(860.0, 1042.5]",1,3,-2
31279.0,2020-01-25,"(1042.5, 1225.0]",1,2,-1
31280.0,2020-01-25,"(84.682, 415.5]",1,1,0
31280.0,2020-01-25,"(415.5, 745.0]",14,20,-6
31280.0,2020-01-25,"(745.0, 1074.5]",10,20,-10
31280.0,2020-01-25,"(1074.5, 1404.0]",8,18,-10
31000.0,2020-01-26,"(637.619, 733.25]",1,3,-2
31001.0,2020-01-26,"(536.333, 703.75]",1,2,-1
31001.0,2020-01-26,"(703.75, 870.5]",2,3,-1
31001.0,2020-01-26,"(1037.25, 1204.0]",1,1,0
31002.0,2020-01-26,"(687.634, 779.5]",2,2,0
31002.0,2020-01-26,"(779.5, 871.0]",3,4,-1
31002.0,2020-01-26,"(962.5, 1054.0]",2,3,-1
31003.0,2020-01-26,"(580.456, 717.0]",3,6,-3
31003.0,2020-01-26,"(717.0, 853.0]",2,2,0
31003.0,2020-01-26,"(989.0, 1125.0]",3,1,2
31004.0,2020-01-26,"(891.637, 982.75]",2,3,-1
31004.0,2020-01-26,"(1164.25, 1255.0]",2,1,1
31005.0,2020-01-26,"(573.377, 729.75]",4,6,-2
31005.0,2020-01-26,"(729.75, 885.5]",3,5,-2
31005.0,2020-01-26,"(885.5, 1041.25]",2,3,-1
31005.0,2020-01-26,"(1041.25, 1197.0]",1,3,-2
31006.0,2020-01-26,"(786.0, 913.5]",2,1,1
31007.0,2020-01-26,"(641.22, 837.0]",1,2,-1
31007.0,2020-01-26,"(837.0, 1032.0]",3,5,-2
31007.0,2020-01-26,"(1032.0, 1227.0]",2,4,-2
31007.0,2020-01-26,"(1227.0, 1422.0]",1,2,-1
31009.0,2020-01-26,"(1029.0, 1162.0]",1,2,-1
31010.0,2020-01-26,"(723.0, 802.0]",2,2,0
31011.0,2020-01-26,"(556.551, 669.25]",2,3,-1
31011.0,2020-01-26,"(781.5, 893.75]",2,2,0
,,,,2.0,
31013.0,2020-01-26,"(658.61, 756.5]",1,1,0
31013.0,2020-01-26,"(854.0, 951.5]",1,1,0
31013.0,2020-01-26,"(951.5, 1049.0]",5,4,1
31014.0,2020-01-26,"(83.938, 350.5]",2,2,0
31014.0,2020-01-26,"(350.5, 616.0]",1,1,0
31014.0,2020-01-26,"(616.0, 881.5]",6,8,-2
31014.0,2020-01-26,"(881.5, 1147.0]",3,4,-1
31015.0,2020-01-26,"(143.085, 372.75]",1,1,0
31015.0,2020-01-26,"(601.5, 830.25]",4,4,0
31015.0,2020-01-26,"(830.25, 1059.0]",2,4,-2
31016.0,2020-01-26,"(650.511, 773.25]",2,6,-4
31016.0,2020-01-26,"(773.25, 895.5]",1,2,-1
31016.0,2020-01-26,"(895.5, 1017.75]",2,3,-1
31016.0,2020-01-26,"(1017.75, 1140.0]",5,7,-2
31017.0,2020-01-26,"(969.5, 1096.25]",1,1,0
31018.0,2020-01-26,"(597.75, 764.5]",4,2,2
31018.0,2020-01-26,"(931.25, 1098.0]",1,5,-4
31019.0,2020-01-26,"(715.351, 878.25]",1,5,-4
31019.0,2020-01-26,"(878.25, 1040.5]",2,2,0
31019.0,2020-01-26,"(1040.5, 1202.75]",1,2,-1
31019.0,2020-01-26,"(1202.75, 1365.0]",1,3,-2
31020.0,2020-01-26,"(679.863, 714.25]",3,4,-1
31020.0,2020-01-26,"(714.25, 748.5]",2,2,0
31020.0,2020-01-26,"(782.75, 817.0]",1,2,-1
31021.0,2020-01-26,"(629.5, 903.75]",2,1,1
31021.0,2020-01-26,"(903.75, 1178.0]",3,4,-1
31022.0,2020-01-26,"(16.81, 315.5]",1,2,-1
31022.0,2020-01-26,"(315.5, 613.0]",2,2,0
31022.0,2020-01-26,"(613.0, 910.5]",2,4,-2
31022.0,2020-01-26,"(910.5, 1208.0]",2,6,-4
31023.0,2020-01-26,"(723.433, 865.75]",3,4,-1
31023.0,2020-01-26,"(865.75, 1007.5]",1,2,-1
31023.0,2020-01-26,"(1007.5, 1149.25]",1,2,-1
31023.0,2020-01-26,"(1149.25, 1291.0]",1,3,-2
31024.0,2020-01-26,"(524.204, 724.0]",1,4,-3
31024.0,2020-01-26,"(923.0, 1122.0]",3,3,0
31024.0,2020-01-26,"(1122.0, 1321.0]",1,5,-4
31025.0,2020-01-26,"(636.376, 793.0]",1,2,-1
31025.0,2020-01-26,"(793.0, 949.0]",2,3,-1
31025.0,2020-01-26,"(1105.0, 1261.0]",1,3,-2
31026.0,2020-01-26,"(989.638, 1080.5]",3,3,0
31027.0,2020-01-26,"(952.75, 1018.0]",1,1,0
31028.0,2020-01-26,"(714.616, 811.0]",1,1,0
31028.0,2020-01-26,"(907.0, 1003.0]",1,2,-1
31029.0,2020-01-26,"(99.686, 429.5]",1,1,0
31029.0,2020-01-26,"(429.5, 758.0]",1,4,-3
31029.0,2020-01-26,"(758.0, 1086.5]",3,8,-5
31029.0,2020-01-26,"(1086.5, 1415.0]",4,4,0
31030.0,2020-01-26,"(83.996, 336.0]",1,1,0
31030.0,2020-01-26,"(838.0, 1089.0]",4,4,0
31031.0,2020-01-26,"(803.5, 880.75]",1,1,0
31031.0,2020-01-26,"(880.75, 958.0]",2,2,0
31032.0,2020-01-26,"(888.627, 982.25]",1,1,0
31032.0,2020-01-26,"(1168.75, 1262.0]",1,1,0
31033.0,2020-01-26,"(794.0, 893.0]",1,1,0
31033.0,2020-01-26,"(992.0, 1091.0]",1,1,0
31034.0,2020-01-26,"(918.25, 1033.0]",1,1,0
31035.0,2020-01-26,"(38.054, 275.5]",1,1,0
31035.0,2020-01-26,"(748.5, 985.0]",1,1,0
31036.0,2020-01-26,"(880.25, 974.0]",2,1,1
31037.0,2020-01-26,"(604.587, 708.25]",1,2,-1
31037.0,2020-01-26,"(708.25, 811.5]",2,2,0
31037.0,2020-01-26,"(811.5, 914.75]",2,4,-2
31037.0,2020-01-26,"(914.75, 1018.0]",3,3,0
31038.0,2020-01-26,"(578.632, 671.0]",1,1,0
31038.0,2020-01-26,"(855.0, 947.0]",2,3,-1
31039.0,2020-01-26,"(92.027, 336.25]",1,2,-1
31039.0,2020-01-26,"(579.5, 822.75]",2,3,-1
31039.0,2020-01-26,"(822.75, 1066.0]",2,5,-3
31040.0,2020-01-26,"(78.838, 370.5]",1,1,0
31040.0,2020-01-26,"(370.5, 661.0]",1,1,0
31040.0,2020-01-26,"(661.0, 951.5]",1,2,-1
31040.0,2020-01-26,"(951.5, 1242.0]",1,3,-2
31041.0,2020-01-26,"(499.577, 605.75]",2,2,0
31041.0,2020-01-26,"(605.75, 711.5]",1,1,0
31041.0,2020-01-26,"(711.5, 817.25]",1,2,-1
31041.0,2020-01-26,"(817.25, 923.0]",1,1,0
31042.0,2020-01-26,"(605.578, 711.5]",1,1,0
31042.0,2020-01-26,"(711.5, 817.0]",3,6,-3
31042.0,2020-01-26,"(922.5, 1028.0]",1,4,-3
31043.0,2020-01-26,"(22.75, 23.0]",1,1,0
31044.0,2020-01-26,"(683.397, 834.75]",1,1,0
31044.0,2020-01-26,"(834.75, 985.5]",1,1,0
31045.0,2020-01-26,"(680.0, 704.0]",1,1,0
,,,,2.0,
31047.0,2020-01-26,"(744.496, 871.0]",2,4,-2
31047.0,2020-01-26,"(871.0, 997.0]",1,1,0
31047.0,2020-01-26,"(997.0, 1123.0]",2,3,-1
31047.0,2020-01-26,"(1123.0, 1249.0]",1,2,-1
,,,,2.0,
31049.0,2020-01-26,"(715.0, 811.0]",1,1,0
31049.0,2020-01-26,"(811.0, 907.0]",1,1,0
,,,,2.0,
31051.0,2020-01-26,"(68.04, 309.0]",1,1,0
31051.0,2020-01-26,"(789.0, 1029.0]",1,3,-2
31052.0,2020-01-26,"(1102.25, 1251.0]",1,2,-1
,,,,1.0,
,,,,1.0,
,,,,1.0,
,,,,1.0,
31055.0,2020-01-26,"(515.329, 683.75]",2,2,0
31055.0,2020-01-26,"(683.75, 851.5]",3,3,0
31055.0,2020-01-26,"(851.5, 1019.25]",1,1,0
31055.0,2020-01-26,"(1019.25, 1187.0]",1,3,-2
31056.0,2020-01-26,"(30.638, 372.5]",1,1,0
31056.0,2020-01-26,"(372.5, 713.0]",1,2,-1
31056.0,2020-01-26,"(713.0, 1053.5]",1,6,-5
31056.0,2020-01-26,"(1053.5, 1394.0]",1,1,0
31057.0,2020-01-26,"(1036.861, 1071.75]",1,2,-1
31057.0,2020-01-26,"(1141.25, 1176.0]",1,2,-1
,,,,1.0,
,,,,1.0,
31059.0,2020-01-26,"(616.68, 697.0]",1,2,-1
31059.0,2020-01-26,"(697.0, 777.0]",1,1,0
31060.0,2020-01-26,"(360.5, 701.0]",2,1,1
31060.0,2020-01-26,"(701.0, 1041.5]",3,2,1
31060.0,2020-01-26,"(1041.5, 1382.0]",3,10,-7
31061.0,2020-01-26,"(682.769, 740.75]",1,1,0
31061.0,2020-01-26,"(856.25, 914.0]",1,1,0
31062.0,2020-01-26,"(532.538, 648.5]",1,2,-1
31062.0,2020-01-26,"(648.5, 764.0]",1,1,0
31062.0,2020-01-26,"(764.0, 879.5]",5,10,-5
31062.0,2020-01-26,"(879.5, 995.0]",3,8,-5
31063.0,2020-01-26,"(623.685, 702.75]",1,2,-1
31063.0,2020-01-26,"(860.25, 939.0]",1,2,-1
31064.0,2020-01-26,"(453.34, 619.0]",2,4,-2
31064.0,2020-01-26,"(619.0, 784.0]",1,2,-1
31064.0,2020-01-26,"(784.0, 949.0]",4,7,-3
31064.0,2020-01-26,"(949.0, 1114.0]",4,8,-4
31065.0,2020-01-26,"(825.996, 827.0]",2,2,0
31066.0,2020-01-26,"(681.825, 725.75]",1,3,-2
31066.0,2020-01-26,"(769.5, 813.25]",2,4,-2
31067.0,2020-01-26,"(49.051, 287.25]",1,1,0
31067.0,2020-01-26,"(761.75, 999.0]",1,2,-1
31068.0,2020-01-26,"(608.236, 800.0]",2,4,-2
31068.0,2020-01-26,"(800.0, 991.0]",1,3,-2
31068.0,2020-01-26,"(1182.0, 1373.0]",1,1,0
31069.0,2020-01-26,"(1052.0, 1072.0]",1,1,0
31070.0,2020-01-26,"(940.25, 1046.0]",1,1,0
31071.0,2020-01-26,"(548.419, 694.25]",3,5,-2
31071.0,2020-01-26,"(694.25, 839.5]",3,5,-2
31071.0,2020-01-26,"(839.5, 984.75]",4,5,-1
31071.0,2020-01-26,"(984.75, 1130.0]",2,3,-1
31072.0,2020-01-26,"(980.25, 1307.0]",1,1,0
31073.0,2020-01-26,"(698.446, 837.5]",1,2,-1
31073.0,2020-01-26,"(1114.5, 1253.0]",1,2,-1
31074.0,2020-01-26,"(133.758, 445.5]",1,1,0
31074.0,2020-01-26,"(445.5, 756.0]",2,4,-2
31074.0,2020-01-26,"(756.0, 1066.5]",1,1,0
31074.0,2020-01-26,"(1066.5, 1377.0]",2,3,-1
31075.0,2020-01-26,"(960.585, 1064.75]",1,1,0
31076.0,2020-01-26,"(568.5, 852.75]",1,1,0
31076.0,2020-01-26,"(852.75, 1137.0]",2,1,1
31077.0,2020-01-26,"(585.348, 749.0]",5,7,-2
31077.0,2020-01-26,"(749.0, 912.0]",3,6,-3
31078.0,2020-01-26,"(817.0, 889.0]",1,1,0
31079.0,2020-01-26,"(87.968, 347.0]",1,1,0
31079.0,2020-01-26,"(863.0, 1121.0]",4,2,2
31080.0,2020-01-26,"(690.789, 743.75]",1,2,-1
31080.0,2020-01-26,"(849.25, 902.0]",1,3,-2
31081.0,2020-01-26,"(779.634, 871.5]",1,1,0
31081.0,2020-01-26,"(1054.5, 1146.0]",4,9,-5
31082.0,2020-01-26,"(1015.75, 1080.0]",1,1,0
,,,,2.0,
,,,,2.0,
31085.0,2020-01-26,"(506.571, 614.25]",1,2,-1
31085.0,2020-01-26,"(614.25, 721.5]",1,3,-2
31086.0,2020-01-26,"(462.75, 617.0]",1,1,0
31087.0,2020-01-26,"(815.575, 922.25]",2,2,0
31088.0,2020-01-26,"(500.225, 694.75]",2,4,-2
31088.0,2020-01-26,"(694.75, 888.5]",1,1,0
31089.0,2020-01-26,"(659.5, 956.25]",5,3,2
31089.0,2020-01-26,"(956.25, 1253.0]",2,1,1
,,,,2.0,
31091.0,2020-01-26,"(826.0, 885.0]",1,1,0
31091.0,2020-01-26,"(944.0, 1003.0]",2,1,1
31092.0,2020-01-26,"(577.278, 758.5]",1,2,-1
31092.0,2020-01-26,"(1119.5, 1300.0]",2,1,1
31093.0,2020-01-26,"(954.711, 1027.25]",1,4,-3
31093.0,2020-01-26,"(1027.25, 1099.5]",2,2,0
,,,,1.0,
,,,,2.0,
31095.0,2020-01-26,"(717.25, 767.0]",2,1,1
31096.0,2020-01-26,"(1099.0, 1222.0]",1,1,0
31097.0,2020-01-26,"(490.422, 635.5]",1,1,0
31097.0,2020-01-26,"(635.5, 780.0]",1,2,-1
31097.0,2020-01-26,"(780.0, 924.5]",1,3,-2
31097.0,2020-01-26,"(924.5, 1069.0]",2,3,-1
31098.0,2020-01-26,"(637.366, 796.5]",1,4,-3
31098.0,2020-01-26,"(796.5, 955.0]",1,5,-4
31098.0,2020-01-26,"(1113.5, 1272.0]",1,2,-1
31099.0,2020-01-26,"(486.21, 684.5]",1,3,-2
31099.0,2020-01-26,"(1079.5, 1277.0]",1,1,0
31100.0,2020-01-26,"(706.0, 1035.0]",1,1,0
31100.0,2020-01-26,"(1035.0, 1364.0]",1,1,0
31101.0,2020-01-26,"(117.75, 431.5]",2,6,-4
31101.0,2020-01-26,"(431.5, 744.0]",22,30,-8
31101.0,2020-01-26,"(744.0, 1056.5]",13,21,-8
31101.0,2020-01-26,"(1056.5, 1369.0]",2,4,-2
31102.0,2020-01-26,"(18.657, 355.75]",1,7,-6
31102.0,2020-01-26,"(355.75, 691.5]",1,5,-4
31102.0,2020-01-26,"(691.5, 1027.25]",8,23,-15
31102.0,2020-01-26,"(1027.25, 1363.0]",5,10,-5
31103.0,2020-01-26,"(18.596, 371.0]",7,8,-1
31103.0,2020-01-26,"(371.0, 722.0]",12,30,-18
31103.0,2020-01-26,"(722.0, 1073.0]",7,30,-23
31103.0,2020-01-26,"(1073.0, 1424.0]",6,12,-6
31104.0,2020-01-26,"(1.688, 331.0]",2,8,-6
31104.0,2020-01-26,"(331.0, 659.0]",4,13,-9
31104.0,2020-01-26,"(659.0, 987.0]",19,36,-17
31104.0,2020-01-26,"(987.0, 1315.0]",16,27,-11
31105.0,2020-01-26,"(422.0, 686.0]",1,2,-1
31105.0,2020-01-26,"(686.0, 950.0]",4,3,1
31105.0,2020-01-26,"(950.0, 1214.0]",2,11,-9
31106.0,2020-01-26,"(990.25, 1263.0]",3,1,2
31107.0,2020-01-26,"(0.647, 340.25]",3,4,-1
31107.0,2020-01-26,"(340.25, 678.5]",4,7,-3
31107.0,2020-01-26,"(678.5, 1016.75]",14,39,-25
31107.0,2020-01-26,"(1016.75, 1355.0]",8,20,-12
31108.0,2020-01-26,"(90.756, 403.0]",2,2,0
31108.0,2020-01-26,"(403.0, 714.0]",2,15,-13
31108.0,2020-01-26,"(714.0, 1025.0]",23,38,-15
31108.0,2020-01-26,"(1025.0, 1336.0]",12,20,-8
31109.0,2020-01-26,"(9.683, 340.25]",2,7,-5
31109.0,2020-01-26,"(340.25, 669.5]",4,12,-8
31109.0,2020-01-26,"(669.5, 998.75]",20,33,-13
31109.0,2020-01-26,"(998.75, 1328.0]",7,14,-7
31110.0,2020-01-26,"(28.791, 332.25]",2,6,-4
31110.0,2020-01-26,"(332.25, 634.5]",10,18,-8
31110.0,2020-01-26,"(634.5, 936.75]",15,26,-11
31110.0,2020-01-26,"(936.75, 1239.0]",13,22,-9
31111.0,2020-01-26,"(4.602, 355.5]",6,16,-10
31111.0,2020-01-26,"(355.5, 705.0]",9,14,-5
31111.0,2020-01-26,"(705.0, 1054.5]",14,26,-12
31111.0,2020-01-26,"(1054.5, 1404.0]",9,16,-7
31112.0,2020-01-26,"(42.784, 348.0]",1,1,0
31112.0,2020-01-26,"(348.0, 652.0]",1,1,0
31112.0,2020-01-26,"(652.0, 956.0]",6,10,-4
31112.0,2020-01-26,"(956.0, 1260.0]",2,5,-3
31113.0,2020-01-26,"(51.688, 381.0]",2,3,-1
31113.0,2020-01-26,"(381.0, 709.0]",6,17,-11
31113.0,2020-01-26,"(709.0, 1037.0]",4,21,-17
31113.0,2020-01-26,"(1037.0, 1365.0]",6,19,-13
31114.0,2020-01-26,"(17.682, 348.5]",2,10,-8
31114.0,2020-01-26,"(348.5, 678.0]",8,15,-7
31114.0,2020-01-26,"(678.0, 1007.5]",23,41,-18
31114.0,2020-01-26,"(1007.5, 1337.0]",16,36,-20
31115.0,2020-01-26,"(20.663, 356.25]",3,4,-1
31115.0,2020-01-26,"(356.25, 690.5]",5,13,-8
31115.0,2020-01-26,"(690.5, 1024.75]",3,14,-11
31115.0,2020-01-26,"(1024.75, 1359.0]",5,7,-2
31116.0,2020-01-26,"(2.939, 269.25]",2,3,-1
31116.0,2020-01-26,"(269.25, 534.5]",2,4,-2
31116.0,2020-01-26,"(534.5, 799.75]",8,15,-7
31116.0,2020-01-26,"(799.75, 1065.0]",12,24,-12
31117.0,2020-01-26,"(2.644, 343.0]",5,6,-1
31117.0,2020-01-26,"(343.0, 682.0]",1,9,-8
31117.0,2020-01-26,"(682.0, 1021.0]",12,30,-18
31117.0,2020-01-26,"(1021.0, 1360.0]",4,9,-5
31118.0,2020-01-26,"(37.824, 333.0]",2,2,0
31118.0,2020-01-26,"(333.0, 627.0]",3,6,-3
31118.0,2020-01-26,"(627.0, 921.0]",3,13,-10
31118.0,2020-01-26,"(921.0, 1215.0]",6,9,-3
31119.0,2020-01-26,"(437.0, 758.0]",9,2,7
31119.0,2020-01-26,"(758.0, 1079.0]",16,24,-8
31119.0,2020-01-26,"(1079.0, 1400.0]",11,32,-21
31120.0,2020-01-26,"(351.0, 690.0]",4,2,2
31120.0,2020-01-26,"(690.0, 1029.0]",6,8,-2
31120.0,2020-01-26,"(1029.0, 1368.0]",10,12,-2
31121.0,2020-01-26,"(9.721, 330.75]",1,1,0
31121.0,2020-01-26,"(330.75, 650.5]",3,9,-6
31121.0,2020-01-26,"(650.5, 970.25]",11,17,-6
31121.0,2020-01-26,"(970.25, 1290.0]",4,7,-3
31122.0,2020-01-26,"(145.76, 457.0]",1,3,-2
31122.0,2020-01-26,"(457.0, 767.0]",5,12,-7
31122.0,2020-01-26,"(767.0, 1077.0]",5,14,-9
31122.0,2020-01-26,"(1077.0, 1387.0]",5,15,-10
31123.0,2020-01-26,"(27.731, 346.25]",1,1,0
31123.0,2020-01-26,"(346.25, 663.5]",1,8,-7
31123.0,2020-01-26,"(663.5, 980.75]",4,17,-13
31123.0,2020-01-26,"(980.75, 1298.0]",4,12,-8
31124.0,2020-01-26,"(17.613, 365.75]",3,6,-3
31124.0,2020-01-26,"(365.75, 712.5]",9,23,-14
31124.0,2020-01-26,"(712.5, 1059.25]",20,59,-39
31124.0,2020-01-26,"(1059.25, 1406.0]",13,33,-20
31125.0,2020-01-26,"(464.114, 686.5]",8,14,-6
31125.0,2020-01-26,"(686.5, 908.0]",25,58,-33
31125.0,2020-01-26,"(908.0, 1129.5]",26,46,-20
31125.0,2020-01-26,"(1129.5, 1351.0]",13,17,-4
31126.0,2020-01-26,"(1.617, 348.75]",1,3,-2
31126.0,2020-01-26,"(348.75, 694.5]",1,10,-9
31126.0,2020-01-26,"(694.5, 1040.25]",8,27,-19
31126.0,2020-01-26,"(1040.25, 1386.0]",13,18,-5
31127.0,2020-01-26,"(424.005, 673.75]",2,3,-1
31127.0,2020-01-26,"(673.75, 922.5]",10,17,-7
31127.0,2020-01-26,"(922.5, 1171.25]",10,13,-3
31127.0,2020-01-26,"(1171.25, 1420.0]",1,3,-2
31128.0,2020-01-26,"(38.739, 355.25]",1,5,-4
31128.0,2020-01-26,"(355.25, 670.5]",13,17,-4
31128.0,2020-01-26,"(670.5, 985.75]",12,24,-12
31128.0,2020-01-26,"(985.75, 1301.0]",9,18,-9
31129.0,2020-01-26,"(567.374, 724.5]",5,6,-1
31129.0,2020-01-26,"(724.5, 881.0]",9,19,-10
31129.0,2020-01-26,"(881.0, 1037.5]",6,14,-8
31130.0,2020-01-26,"(425.5, 722.0]",1,2,-1
31130.0,2020-01-26,"(722.0, 1018.5]",8,6,2
31130.0,2020-01-26,"(1018.5, 1315.0]",7,13,-6
31131.0,2020-01-26,"(72.742, 388.5]",2,2,0
31131.0,2020-01-26,"(388.5, 703.0]",1,8,-7
31131.0,2020-01-26,"(703.0, 1017.5]",6,17,-11
31131.0,2020-01-26,"(1017.5, 1332.0]",2,5,-3
31200.0,2020-01-26,"(180.786, 485.5]",4,5,-1
31200.0,2020-01-26,"(485.5, 789.0]",27,51,-24
31200.0,2020-01-26,"(789.0, 1092.5]",24,53,-29
31200.0,2020-01-26,"(1092.5, 1396.0]",8,12,-4
31201.0,2020-01-26,"(365.75, 716.5]",28,3,25
31201.0,2020-01-26,"(716.5, 1067.25]",49,53,-4
31201.0,2020-01-26,"(1067.25, 1418.0]",17,91,-74
,,,,2.0,
31203.0,2020-01-26,"(1.585, 356.75]",3,8,-5
31203.0,2020-01-26,"(356.75, 710.5]",12,25,-13
31203.0,2020-01-26,"(710.5, 1064.25]",47,77,-30
31203.0,2020-01-26,"(1064.25, 1418.0]",3,9,-6
31204.0,2020-01-26,"(15.63, 359.5]",4,6,-2
31204.0,2020-01-26,"(359.5, 702.0]",2,8,-6
31204.0,2020-01-26,"(702.0, 1044.5]",5,12,-7
31204.0,2020-01-26,"(1044.5, 1387.0]",5,9,-4
31205.0,2020-01-26,"(484.75, 784.5]",6,2,4
31205.0,2020-01-26,"(784.5, 1084.25]",4,10,-6
31205.0,2020-01-26,"(1084.25, 1384.0]",3,8,-5
,,,,1.0,
,,,,8.0,
31207.0,2020-01-26,"(764.0, 967.0]",1,4,-3
31207.0,2020-01-26,"(967.0, 1170.0]",3,5,-2
31207.0,2020-01-26,"(1170.0, 1373.0]",1,4,-3
31208.0,2020-01-26,"(430.314, 602.5]",2,2,0
31208.0,2020-01-26,"(602.5, 774.0]",2,3,-1
31208.0,2020-01-26,"(774.0, 945.5]",3,4,-1
31208.0,2020-01-26,"(945.5, 1117.0]",2,4,-2
31209.0,2020-01-26,"(648.0, 952.0]",5,4,1
31209.0,2020-01-26,"(952.0, 1256.0]",4,2,2
31211.0,2020-01-26,"(76.985, 331.75]",1,2,-1
31211.0,2020-01-26,"(331.75, 585.5]",1,1,0
31211.0,2020-01-26,"(585.5, 839.25]",9,13,-4
31211.0,2020-01-26,"(839.25, 1093.0]",7,10,-3
31212.0,2020-01-26,"(65.741, 381.75]",2,4,-2
31212.0,2020-01-26,"(381.75, 696.5]",7,11,-4
31212.0,2020-01-26,"(696.5, 1011.25]",10,16,-6
31212.0,2020-01-26,"(1011.25, 1326.0]",6,9,-3
31213.0,2020-01-26,"(479.18, 685.0]",4,6,-2
31213.0,2020-01-26,"(685.0, 890.0]",4,5,-1
31213.0,2020-01-26,"(890.0, 1095.0]",2,4,-2
31213.0,2020-01-26,"(1095.0, 1300.0]",1,2,-1
31214.0,2020-01-26,"(33.615, 381.25]",3,6,-3
31214.0,2020-01-26,"(381.25, 727.5]",20,39,-19
31214.0,2020-01-26,"(727.5, 1073.75]",35,64,-29
31214.0,2020-01-26,"(1073.75, 1420.0]",14,22,-8
31215.0,2020-01-26,"(398.278, 579.5]",1,3,-2
31215.0,2020-01-26,"(760.0, 940.5]",5,1,4
31215.0,2020-01-26,"(940.5, 1121.0]",9,8,1
31216.0,2020-01-26,"(385.013, 632.75]",4,4,0
31216.0,2020-01-26,"(632.75, 879.5]",3,7,-4
31217.0,2020-01-26,"(474.0, 711.0]",1,1,0
31217.0,2020-01-26,"(711.0, 948.0]",3,1,2
31218.0,2020-01-26,"(541.304, 716.0]",1,1,0
31218.0,2020-01-26,"(716.0, 890.0]",6,13,-7
31218.0,2020-01-26,"(890.0, 1064.0]",3,5,-2
31218.0,2020-01-26,"(1064.0, 1238.0]",1,2,-1
31219.0,2020-01-26,"(533.351, 696.25]",5,6,-1
31219.0,2020-01-26,"(696.25, 858.5]",11,21,-10
31219.0,2020-01-26,"(858.5, 1020.75]",7,21,-14
31219.0,2020-01-26,"(1020.75, 1183.0]",1,6,-5
31220.0,2020-01-26,"(525.549, 638.75]",1,1,0
31221.0,2020-01-26,"(95.8, 397.0]",1,2,-1
31221.0,2020-01-26,"(397.0, 697.0]",2,4,-2
31221.0,2020-01-26,"(697.0, 997.0]",7,9,-2
31221.0,2020-01-26,"(997.0, 1297.0]",3,7,-4
31222.0,2020-01-26,"(398.075, 630.25]",1,1,0
31222.0,2020-01-26,"(630.25, 861.5]",13,14,-1
31222.0,2020-01-26,"(861.5, 1092.75]",7,9,-2
31222.0,2020-01-26,"(1092.75, 1324.0]",1,1,0
31223.0,2020-01-26,"(14.664, 350.0]",2,5,-3
31223.0,2020-01-26,"(350.0, 684.0]",4,9,-5
31223.0,2020-01-26,"(684.0, 1018.0]",13,17,-4
31223.0,2020-01-26,"(1018.0, 1352.0]",4,9,-5
31224.0,2020-01-26,"(605.393, 757.75]",1,2,-1
31224.0,2020-01-26,"(757.75, 909.5]",5,5,0
31224.0,2020-01-26,"(909.5, 1061.25]",1,1,0
31224.0,2020-01-26,"(1061.25, 1213.0]",1,4,-3
31225.0,2020-01-26,"(167.819, 464.25]",2,3,-1
31225.0,2020-01-26,"(464.25, 759.5]",6,11,-5
31225.0,2020-01-26,"(759.5, 1054.75]",14,25,-11
31225.0,2020-01-26,"(1054.75, 1350.0]",5,7,-2
31226.0,2020-01-26,"(576.334, 743.5]",3,6,-3
31226.0,2020-01-26,"(743.5, 910.0]",5,8,-3
31226.0,2020-01-26,"(910.0, 1076.5]",4,6,-2
31226.0,2020-01-26,"(1076.5, 1243.0]",2,4,-2
31227.0,2020-01-26,"(597.348, 761.0]",6,12,-6
31227.0,2020-01-26,"(761.0, 924.0]",2,5,-3
31227.0,2020-01-26,"(924.0, 1087.0]",1,4,-3
31228.0,2020-01-26,"(87.755, 400.25]",1,3,-2
31228.0,2020-01-26,"(400.25, 711.5]",7,12,-5
31228.0,2020-01-26,"(711.5, 1022.75]",25,39,-14
31228.0,2020-01-26,"(1022.75, 1334.0]",6,10,-4
31229.0,2020-01-26,"(27.617, 374.75]",3,9,-6
31229.0,2020-01-26,"(374.75, 720.5]",17,41,-24
31229.0,2020-01-26,"(720.5, 1066.25]",35,81,-46
31229.0,2020-01-26,"(1066.25, 1412.0]",14,29,-15
31230.0,2020-01-26,"(581.25, 752.5]",9,1,8
31230.0,2020-01-26,"(752.5, 923.75]",9,14,-5
31230.0,2020-01-26,"(923.75, 1095.0]",7,14,-7
31231.0,2020-01-26,"(730.0, 827.0]",6,1,5
31231.0,2020-01-26,"(827.0, 924.0]",4,13,-9
31232.0,2020-01-26,"(369.75, 708.5]",7,1,6
31232.0,2020-01-26,"(708.5, 1047.25]",24,9,15
31232.0,2020-01-26,"(1047.25, 1386.0]",5,37,-32
31233.0,2020-01-26,"(557.291, 735.25]",5,6,-1
31233.0,2020-01-26,"(735.25, 912.5]",4,8,-4
31233.0,2020-01-26,"(912.5, 1089.75]",1,4,-3
31233.0,2020-01-26,"(1089.75, 1267.0]",1,4,-3
31234.0,2020-01-26,"(66.63, 410.5]",3,4,-1
31234.0,2020-01-26,"(410.5, 753.0]",22,34,-12
31234.0,2020-01-26,"(753.0, 1095.5]",12,24,-12
31234.0,2020-01-26,"(1095.5, 1438.0]",5,12,-7
31235.0,2020-01-26,"(646.562, 756.5]",1,7,-6
31235.0,2020-01-26,"(866.0, 975.5]",2,1,1
31236.0,2020-01-26,"(28.629, 372.75]",1,1,0
31236.0,2020-01-26,"(372.75, 715.5]",7,9,-2
31236.0,2020-01-26,"(715.5, 1058.25]",15,30,-15
31236.0,2020-01-26,"(1058.25, 1401.0]",4,11,-7
31237.0,2020-01-26,"(29.727, 349.25]",2,3,-1
31237.0,2020-01-26,"(349.25, 667.5]",7,14,-7
31237.0,2020-01-26,"(667.5, 985.75]",11,26,-15
31237.0,2020-01-26,"(985.75, 1304.0]",10,19,-9
31238.0,2020-01-26,"(1.894, 279.5]",2,2,0
31238.0,2020-01-26,"(279.5, 556.0]",3,4,-1
31238.0,2020-01-26,"(556.0, 832.5]",2,5,-3
31239.0,2020-01-26,"(346.75, 677.5]",4,3,1
31239.0,2020-01-26,"(677.5, 1008.25]",11,5,6
31239.0,2020-01-26,"(1008.25, 1339.0]",7,17,-10
31240.0,2020-01-26,"(533.256, 720.0]",1,1,0
31240.0,2020-01-26,"(720.0, 906.0]",2,5,-3
31240.0,2020-01-26,"(906.0, 1092.0]",5,8,-3
31240.0,2020-01-26,"(1092.0, 1278.0]",1,1,0
31241.0,2020-01-26,"(18.73, 337.5]",3,4,-1
31241.0,2020-01-26,"(337.5, 655.0]",3,13,-10
31241.0,2020-01-26,"(655.0, 972.5]",10,28,-18
31241.0,2020-01-26,"(972.5, 1290.0]",12,17,-5
31242.0,2020-01-26,"(352.955, 615.25]",4,5,-1
31242.0,2020-01-26,"(615.25, 876.5]",6,19,-13
31242.0,2020-01-26,"(876.5, 1137.75]",25,40,-15
31243.0,2020-01-26,"(348.25, 675.5]",5,1,4
31243.0,2020-01-26,"(675.5, 1002.75]",7,7,0
31244.0,2020-01-26,"(478.203, 678.25]",4,5,-1
31244.0,2020-01-26,"(678.25, 877.5]",2,5,-3
31244.0,2020-01-26,"(877.5, 1076.75]",2,5,-3
31244.0,2020-01-26,"(1076.75, 1276.0]",4,5,-1
31245.0,2020-01-26,"(71.854, 359.5]",1,2,-1
31245.0,2020-01-26,"(359.5, 646.0]",3,3,0
31245.0,2020-01-26,"(646.0, 932.5]",16,29,-13
31245.0,2020-01-26,"(932.5, 1219.0]",10,22,-12
31246.0,2020-01-26,"(10.587, 365.25]",4,9,-5
31246.0,2020-01-26,"(365.25, 718.5]",11,16,-5
31246.0,2020-01-26,"(718.5, 1071.75]",28,48,-20
31246.0,2020-01-26,"(1071.75, 1425.0]",3,6,-3
31247.0,2020-01-26,"(100.042, 340.5]",1,2,-1
31247.0,2020-01-26,"(340.5, 580.0]",4,5,-1
31247.0,2020-01-26,"(580.0, 819.5]",17,23,-6
31247.0,2020-01-26,"(819.5, 1059.0]",4,26,-22
31248.0,2020-01-26,"(568.427, 712.25]",14,28,-14
31248.0,2020-01-26,"(712.25, 855.5]",13,25,-12
31248.0,2020-01-26,"(855.5, 998.75]",13,20,-7
31248.0,2020-01-26,"(998.75, 1142.0]",13,24,-11
31249.0,2020-01-26,"(58.655, 396.25]",1,2,-1
31249.0,2020-01-26,"(396.25, 732.5]",3,6,-3
31249.0,2020-01-26,"(732.5, 1068.75]",11,20,-9
31249.0,2020-01-26,"(1068.75, 1405.0]",2,7,-5
31250.0,2020-01-26,"(591.294, 768.5]",1,2,-1
31250.0,2020-01-26,"(768.5, 945.0]",1,2,-1
31250.0,2020-01-26,"(945.0, 1121.5]",3,7,-4
31250.0,2020-01-26,"(1121.5, 1298.0]",4,6,-2
31251.0,2020-01-26,"(51.722, 372.5]",4,4,0
31251.0,2020-01-26,"(372.5, 692.0]",4,7,-3
31251.0,2020-01-26,"(692.0, 1011.5]",8,23,-15
31251.0,2020-01-26,"(1011.5, 1331.0]",3,11,-8
31252.0,2020-01-26,"(34.796, 337.0]",1,2,-1
31252.0,2020-01-26,"(337.0, 638.0]",3,4,-1
31252.0,2020-01-26,"(638.0, 939.0]",5,6,-1
31252.0,2020-01-26,"(939.0, 1240.0]",1,3,-2
31253.0,2020-01-26,"(386.036, 628.0]",3,3,0
31253.0,2020-01-26,"(628.0, 869.0]",3,6,-3
31253.0,2020-01-26,"(869.0, 1110.0]",2,4,-2
31253.0,2020-01-26,"(1110.0, 1351.0]",2,4,-2
31254.0,2020-01-26,"(124.994, 377.5]",1,1,0
31254.0,2020-01-26,"(629.0, 880.5]",3,6,-3
31254.0,2020-01-26,"(880.5, 1132.0]",8,11,-3
31255.0,2020-01-26,"(462.074, 694.5]",6,9,-3
31255.0,2020-01-26,"(694.5, 926.0]",3,5,-2
31255.0,2020-01-26,"(1157.5, 1389.0]",2,4,-2
31256.0,2020-01-26,"(610.321, 780.75]",5,11,-6
31256.0,2020-01-26,"(780.75, 950.5]",9,12,-3
31257.0,2020-01-26,"(631.319, 802.25]",9,13,-4
31257.0,2020-01-26,"(802.25, 972.5]",8,14,-6
31257.0,2020-01-26,"(972.5, 1142.75]",9,12,-3
31257.0,2020-01-26,"(1142.75, 1313.0]",3,5,-2
31258.0,2020-01-26,"(503.382, 658.5]",5,14,-9
31258.0,2020-01-26,"(658.5, 813.0]",19,41,-22
31258.0,2020-01-26,"(813.0, 967.5]",3,10,-7
31258.0,2020-01-26,"(967.5, 1122.0]",14,25,-11
,,,,1.0,
,,,,1.0,
31260.0,2020-01-26,"(60.822, 356.5]",1,1,0
31260.0,2020-01-26,"(651.0, 945.5]",1,2,-1
31260.0,2020-01-26,"(945.5, 1240.0]",11,23,-12
31261.0,2020-01-26,"(659.761, 719.75]",1,5,-4
31262.0,2020-01-26,"(707.414, 854.5]",1,3,-2
31262.0,2020-01-26,"(854.5, 1001.0]",6,13,-7
31262.0,2020-01-26,"(1001.0, 1147.5]",3,6,-3
31263.0,2020-01-26,"(385.053, 622.75]",7,10,-3
31263.0,2020-01-26,"(622.75, 859.5]",4,10,-6
31263.0,2020-01-26,"(859.5, 1096.25]",11,16,-5
31263.0,2020-01-26,"(1096.25, 1333.0]",1,4,-3
31264.0,2020-01-26,"(503.327, 672.25]",1,1,0
31264.0,2020-01-26,"(672.25, 840.5]",2,4,-2
31264.0,2020-01-26,"(840.5, 1008.75]",6,9,-3
31264.0,2020-01-26,"(1008.75, 1177.0]",7,8,-1
31265.0,2020-01-26,"(91.711, 415.25]",2,2,0
31265.0,2020-01-26,"(415.25, 737.5]",9,26,-17
31265.0,2020-01-26,"(737.5, 1059.75]",24,47,-23
31265.0,2020-01-26,"(1059.75, 1382.0]",3,11,-8
31266.0,2020-01-26,"(170.827, 465.25]",1,2,-1
31266.0,2020-01-26,"(465.25, 758.5]",12,37,-25
31266.0,2020-01-26,"(758.5, 1051.75]",14,29,-15
31266.0,2020-01-26,"(1051.75, 1345.0]",13,19,-6
31267.0,2020-01-26,"(8.83, 302.5]",1,4,-3
31267.0,2020-01-26,"(595.0, 887.5]",9,3,6
31267.0,2020-01-26,"(887.5, 1180.0]",4,21,-17
31268.0,2020-01-26,"(6.679, 338.25]",5,7,-2
31268.0,2020-01-26,"(338.25, 668.5]",7,17,-10
31268.0,2020-01-26,"(668.5, 998.75]",27,47,-20
31268.0,2020-01-26,"(998.75, 1329.0]",6,10,-4
31269.0,2020-01-26,"(495.333, 662.75]",8,10,-2
31269.0,2020-01-26,"(662.75, 829.5]",6,13,-7
31269.0,2020-01-26,"(829.5, 996.25]",11,12,-1
31269.0,2020-01-26,"(996.25, 1163.0]",1,5,-4
31270.0,2020-01-26,"(595.312, 768.0]",7,11,-4
31270.0,2020-01-26,"(768.0, 940.0]",7,9,-2
31270.0,2020-01-26,"(940.0, 1112.0]",2,9,-7
31270.0,2020-01-26,"(1112.0, 1284.0]",2,4,-2
31271.0,2020-01-26,"(588.445, 727.75]",3,5,-2
31271.0,2020-01-26,"(727.75, 866.5]",1,3,-2
31271.0,2020-01-26,"(866.5, 1005.25]",3,6,-3
31271.0,2020-01-26,"(1005.25, 1144.0]",14,26,-12
31272.0,2020-01-26,"(11.918, 283.5]",1,1,0
31272.0,2020-01-26,"(283.5, 554.0]",1,1,0
31272.0,2020-01-26,"(554.0, 824.5]",3,6,-3
31272.0,2020-01-26,"(824.5, 1095.0]",13,23,-10
31273.0,2020-01-26,"(489.459, 625.25]",3,8,-5
31273.0,2020-01-26,"(625.25, 760.5]",2,2,0
31273.0,2020-01-26,"(760.5, 895.75]",4,7,-3
31273.0,2020-01-26,"(895.75, 1031.0]",3,5,-2
31274.0,2020-01-26,"(531.393, 683.75]",7,7,0
31274.0,2020-01-26,"(683.75, 835.5]",6,10,-4
31274.0,2020-01-26,"(835.5, 987.25]",10,13,-3
31274.0,2020-01-26,"(987.25, 1139.0]",6,9,-3
31275.0,2020-01-26,"(1.612, 350.0]",3,4,-1
31275.0,2020-01-26,"(350.0, 697.0]",3,10,-7
31275.0,2020-01-26,"(697.0, 1044.0]",11,19,-8
31275.0,2020-01-26,"(1044.0, 1391.0]",5,10,-5
31276.0,2020-01-26,"(588.276, 770.0]",1,3,-2
31276.0,2020-01-26,"(770.0, 951.0]",2,2,0
31276.0,2020-01-26,"(951.0, 1132.0]",4,6,-2
31276.0,2020-01-26,"(1132.0, 1313.0]",2,3,-1
31277.0,2020-01-26,"(469.283, 649.25]",3,6,-3
31277.0,2020-01-26,"(649.25, 828.5]",9,12,-3
31277.0,2020-01-26,"(828.5, 1007.75]",2,7,-5
31277.0,2020-01-26,"(1007.75, 1187.0]",3,7,-4
31278.0,2020-01-26,"(-0.371, 343.75]",1,5,-4
31278.0,2020-01-26,"(343.75, 686.5]",7,13,-6
31278.0,2020-01-26,"(686.5, 1029.25]",13,27,-14
31278.0,2020-01-26,"(1029.25, 1372.0]",9,13,-4
31279.0,2020-01-26,"(536.652, 624.0]",2,3,-1
31279.0,2020-01-26,"(711.0, 798.0]",3,2,1
31280.0,2020-01-26,"(52.666, 387.5]",1,1,0
31280.0,2020-01-26,"(387.5, 721.0]",8,17,-9
31280.0,2020-01-26,"(721.0, 1054.5]",20,33,-13
31280.0,2020-01-26,"(1054.5, 1388.0]",2,6,-4
31000.0,2020-01-27,"(1010.0, 1183.0]",1,1,0
31001.0,2020-01-27,"(596.221, 791.75]",1,2,-1
31001.0,2020-01-27,"(791.75, 986.5]",1,3,-2
31001.0,2020-01-27,"(986.5, 1181.25]",1,1,0
31001.0,2020-01-27,"(1181.25, 1376.0]",2,3,-1
31002.0,2020-01-27,"(457.425, 601.75]",4,4,0
31002.0,2020-01-27,"(601.75, 745.5]",1,2,-1
31002.0,2020-01-27,"(889.25, 1033.0]",3,3,0
31003.0,2020-01-27,"(377.176, 584.0]",5,10,-5
31003.0,2020-01-27,"(584.0, 790.0]",1,2,-1
31003.0,2020-01-27,"(790.0, 996.0]",2,4,-2
31004.0,2020-01-27,"(882.0, 1075.0]",1,1,0
31004.0,2020-01-27,"(1075.0, 1268.0]",2,1,1
31005.0,2020-01-27,"(435.215, 632.25]",4,6,-2
31005.0,2020-01-27,"(632.25, 828.5]",1,5,-4
31005.0,2020-01-27,"(828.5, 1024.75]",2,4,-2
31005.0,2020-01-27,"(1024.75, 1221.0]",2,10,-8
31006.0,2020-01-27,"(491.268, 675.0]",3,3,0
31006.0,2020-01-27,"(858.0, 1041.0]",1,4,-3
31006.0,2020-01-27,"(1041.0, 1224.0]",2,6,-4
31007.0,2020-01-27,"(362.059, 598.25]",5,18,-13
31007.0,2020-01-27,"(598.25, 833.5]",5,9,-4
31007.0,2020-01-27,"(833.5, 1068.75]",12,20,-8
31007.0,2020-01-27,"(1068.75, 1304.0]",6,12,-6
31009.0,2020-01-27,"(455.032, 698.0]",4,4,0
31010.0,2020-01-27,"(441.015, 688.25]",1,1,0
31010.0,2020-01-27,"(688.25, 934.5]",2,3,-1
31010.0,2020-01-27,"(1180.75, 1427.0]",1,1,0
31011.0,2020-01-27,"(380.24, 571.0]",5,8,-3
31011.0,2020-01-27,"(571.0, 761.0]",1,1,0
31011.0,2020-01-27,"(761.0, 951.0]",2,2,0
31012.0,2020-01-27,"(366.22, 562.0]",8,10,-2
31012.0,2020-01-27,"(562.0, 757.0]",1,1,0
31013.0,2020-01-27,"(395.089, 623.75]",1,5,-4
31013.0,2020-01-27,"(623.75, 851.5]",2,2,0
31013.0,2020-01-27,"(851.5, 1079.25]",3,6,-3
31013.0,2020-01-27,"(1079.25, 1307.0]",2,3,-1
31014.0,2020-01-27,"(318.029, 561.75]",16,20,-4
31014.0,2020-01-27,"(561.75, 804.5]",2,2,0
31014.0,2020-01-27,"(804.5, 1047.25]",3,10,-7
31014.0,2020-01-27,"(1047.25, 1290.0]",8,12,-4
31015.0,2020-01-27,"(302.055, 539.25]",12,13,-1
31015.0,2020-01-27,"(539.25, 775.5]",7,8,-1
31015.0,2020-01-27,"(775.5, 1011.75]",3,8,-5
31015.0,2020-01-27,"(1011.75, 1248.0]",3,7,-4
31016.0,2020-01-27,"(435.089, 663.75]",3,9,-6
31016.0,2020-01-27,"(663.75, 891.5]",2,3,-1
31016.0,2020-01-27,"(891.5, 1119.25]",6,10,-4
31017.0,2020-01-27,"(515.144, 730.0]",2,3,-1
31017.0,2020-01-27,"(730.0, 944.0]",2,5,-3
31017.0,2020-01-27,"(944.0, 1158.0]",4,6,-2
31018.0,2020-01-27,"(888.5, 1120.25]",2,4,-2
31018.0,2020-01-27,"(1120.25, 1352.0]",2,4,-2
31019.0,2020-01-27,"(655.25, 850.5]",1,1,0
31019.0,2020-01-27,"(1045.75, 1241.0]",1,2,-1
31020.0,2020-01-27,"(517.136, 734.0]",1,2,-1
31021.0,2020-01-27,"(699.25, 924.5]",1,3,-2
31021.0,2020-01-27,"(924.5, 1149.75]",3,1,2
31021.0,2020-01-27,"(1149.75, 1375.0]",1,6,-5
31022.0,2020-01-27,"(457.133, 674.75]",1,6,-5
31022.0,2020-01-27,"(674.75, 891.5]",1,3,-2
31022.0,2020-01-27,"(1108.25, 1325.0]",2,2,0
31023.0,2020-01-27,"(479.235, 671.25]",2,2,0
31023.0,2020-01-27,"(862.5, 1053.75]",3,4,-1
31024.0,2020-01-27,"(417.229, 610.75]",8,12,-4
31024.0,2020-01-27,"(610.75, 803.5]",2,3,-1
31024.0,2020-01-27,"(803.5, 996.25]",2,4,-2
31024.0,2020-01-27,"(996.25, 1189.0]",4,14,-10
31025.0,2020-01-27,"(780.5, 955.75]",1,1,0
31025.0,2020-01-27,"(955.75, 1131.0]",1,1,0
31026.0,2020-01-27,"(413.084, 643.0]",1,3,-2
31026.0,2020-01-27,"(872.0, 1101.0]",1,8,-7
31027.0,2020-01-27,"(727.5, 902.0]",1,1,0
31027.0,2020-01-27,"(1076.5, 1251.0]",1,1,0
31028.0,2020-01-27,"(458.079, 689.25]",2,2,0
31028.0,2020-01-27,"(919.5, 1149.75]",1,1,0
31028.0,2020-01-27,"(1149.75, 1380.0]",1,3,-2
31029.0,2020-01-27,"(698.0, 877.0]",2,6,-4
31029.0,2020-01-27,"(877.0, 1056.0]",1,3,-2
31029.0,2020-01-27,"(1056.0, 1235.0]",3,1,2
31030.0,2020-01-27,"(948.0, 1166.0]",3,10,-7
31030.0,2020-01-27,"(1166.0, 1384.0]",2,1,1
31031.0,2020-01-27,"(721.25, 943.5]",2,3,-1
31031.0,2020-01-27,"(943.5, 1165.75]",2,2,0
31031.0,2020-01-27,"(1165.75, 1388.0]",1,5,-4
31032.0,2020-01-27,"(1065.0, 1255.0]",3,1,2
31033.0,2020-01-27,"(1334.0, 1336.0]",1,1,0
31034.0,2020-01-27,"(497.122, 717.5]",1,2,-1
31034.0,2020-01-27,"(937.0, 1156.5]",2,1,1
31035.0,2020-01-27,"(678.25, 913.5]",3,3,0
31035.0,2020-01-27,"(913.5, 1148.75]",3,4,-1
31035.0,2020-01-27,"(1148.75, 1384.0]",1,4,-3
31036.0,2020-01-27,"(951.75, 1123.0]",3,3,0
31037.0,2020-01-27,"(419.092, 647.0]",14,16,-2
31037.0,2020-01-27,"(647.0, 874.0]",1,2,-1
31037.0,2020-01-27,"(874.0, 1101.0]",8,14,-6
31038.0,2020-01-27,"(517.314, 689.5]",1,2,-1
31038.0,2020-01-27,"(861.0, 1032.5]",1,2,-1
31038.0,2020-01-27,"(1032.5, 1204.0]",1,3,-2
31039.0,2020-01-27,"(470.151, 683.25]",2,4,-2
31039.0,2020-01-27,"(1107.75, 1320.0]",2,3,-1
31040.0,2020-01-27,"(432.061, 667.75]",2,2,0
31040.0,2020-01-27,"(667.75, 902.5]",1,2,-1
31040.0,2020-01-27,"(1137.25, 1372.0]",1,1,0
31041.0,2020-01-27,"(467.519, 588.25]",2,3,-1
31041.0,2020-01-27,"(708.5, 828.75]",1,1,0
31042.0,2020-01-27,"(437.269, 620.75]",7,10,-3
31042.0,2020-01-27,"(620.75, 803.5]",2,2,0
31042.0,2020-01-27,"(986.25, 1169.0]",2,1,1
31043.0,2020-01-27,"(416.144, 631.0]",2,3,-1
31043.0,2020-01-27,"(845.0, 1059.0]",1,1,0
31043.0,2020-01-27,"(1059.0, 1273.0]",2,2,0
31044.0,2020-01-27,"(472.196, 674.0]",3,5,-2
31044.0,2020-01-27,"(875.0, 1076.0]",2,4,-2
31044.0,2020-01-27,"(1076.0, 1277.0]",3,5,-2
31045.0,2020-01-27,"(858.0, 945.0]",1,2,-1
31045.0,2020-01-27,"(945.0, 1032.0]",1,4,-3
31046.0,2020-01-27,"(459.75, 524.5]",1,1,0
31047.0,2020-01-27,"(345.116, 567.0]",12,23,-11
31047.0,2020-01-27,"(567.0, 788.0]",5,5,0
31047.0,2020-01-27,"(788.0, 1009.0]",2,3,-1
31047.0,2020-01-27,"(1009.0, 1230.0]",5,20,-15
31048.0,2020-01-27,"(410.068, 644.0]",3,7,-4
31048.0,2020-01-27,"(644.0, 877.0]",3,4,-1
31048.0,2020-01-27,"(877.0, 1110.0]",2,4,-2
31048.0,2020-01-27,"(1110.0, 1343.0]",2,5,-3
31049.0,2020-01-27,"(541.21, 739.5]",2,4,-2
31049.0,2020-01-27,"(937.0, 1134.5]",1,2,-1
31049.0,2020-01-27,"(1134.5, 1332.0]",2,2,0
31050.0,2020-01-27,"(947.75, 1116.0]",1,4,-3
31051.0,2020-01-27,"(857.0, 1136.0]",6,4,2
31051.0,2020-01-27,"(1136.0, 1415.0]",1,2,-1
31052.0,2020-01-27,"(440.324, 610.0]",3,5,-2
31052.0,2020-01-27,"(948.0, 1117.0]",2,2,0
31053.0,2020-01-27,"(533.403, 683.25]",1,2,-1
31053.0,2020-01-27,"(981.75, 1131.0]",1,1,0
31054.0,2020-01-27,"(974.25, 1042.0]",2,1,1
31055.0,2020-01-27,"(334.25, 668.5]",1,1,0
31055.0,2020-01-27,"(1002.75, 1337.0]",2,1,1
31056.0,2020-01-27,"(931.0, 1177.0]",1,1,0
31056.0,2020-01-27,"(1177.0, 1423.0]",1,2,-1
31057.0,2020-01-27,"(961.956, 973.0]",1,3,-2
31057.0,2020-01-27,"(995.0, 1006.0]",1,1,0
31058.0,2020-01-27,"(785.722, 855.5]",1,2,-1
31058.0,2020-01-27,"(994.5, 1064.0]",1,1,0
31059.0,2020-01-27,"(644.5, 861.0]",2,2,0
31059.0,2020-01-27,"(861.0, 1077.5]",3,2,1
31059.0,2020-01-27,"(1077.5, 1294.0]",1,3,-2
31060.0,2020-01-27,"(941.75, 1098.5]",4,1,3
31061.0,2020-01-27,"(394.5, 526.0]",1,1,0
31062.0,2020-01-27,"(1001.819, 1047.25]",2,3,-1
31062.0,2020-01-27,"(1137.75, 1183.0]",1,2,-1
,,,,2.0,
31064.0,2020-01-27,"(620.59, 723.5]",1,2,-1
31064.0,2020-01-27,"(826.0, 928.5]",1,2,-1
31064.0,2020-01-27,"(928.5, 1031.0]",4,7,-3
31065.0,2020-01-27,"(426.178, 632.5]",1,2,-1
31065.0,2020-01-27,"(1043.5, 1249.0]",2,3,-1
31066.0,2020-01-27,"(780.75, 1041.0]",1,1,0
31067.0,2020-01-27,"(374.272, 557.0]",2,5,-3
31067.0,2020-01-27,"(921.0, 1103.0]",2,1,1
31068.0,2020-01-27,"(1145.0, 1349.0]",2,1,1
31069.0,2020-01-27,"(654.0, 881.0]",2,4,-2
31069.0,2020-01-27,"(881.0, 1108.0]",4,2,2
31069.0,2020-01-27,"(1108.0, 1335.0]",2,6,-4
31070.0,2020-01-27,"(912.5, 1082.75]",1,2,-1
31070.0,2020-01-27,"(1082.75, 1253.0]",3,2,1
31071.0,2020-01-27,"(815.5, 997.75]",2,4,-2
31071.0,2020-01-27,"(997.75, 1180.0]",8,1,7
31072.0,2020-01-27,"(1159.75, 1232.0]",1,1,0
31073.0,2020-01-27,"(500.459, 636.25]",1,1,0
31073.0,2020-01-27,"(771.5, 906.75]",1,1,0
31074.0,2020-01-27,"(484.355, 646.25]",1,3,-2
31074.0,2020-01-27,"(968.75, 1130.0]",4,1,3
31075.0,2020-01-27,"(747.633, 839.75]",1,2,-1
31075.0,2020-01-27,"(1023.25, 1115.0]",1,1,0
31076.0,2020-01-27,"(434.211, 632.25]",1,3,-2
31076.0,2020-01-27,"(632.25, 829.5]",1,1,0
31076.0,2020-01-27,"(829.5, 1026.75]",1,1,0
31076.0,2020-01-27,"(1026.75, 1224.0]",2,3,-1
31077.0,2020-01-27,"(415.069, 648.75]",1,4,-3
31077.0,2020-01-27,"(881.5, 1114.25]",2,1,1
31077.0,2020-01-27,"(1114.25, 1347.0]",2,2,0
31078.0,2020-01-27,"(479.409, 627.75]",4,5,-1
31078.0,2020-01-27,"(923.25, 1071.0]",2,1,1
31079.0,2020-01-27,"(686.5, 918.0]",2,5,-3
31079.0,2020-01-27,"(918.0, 1149.5]",2,2,0
31079.0,2020-01-27,"(1149.5, 1381.0]",5,3,2
31080.0,2020-01-27,"(903.5, 1154.75]",6,9,-3
31080.0,2020-01-27,"(1154.75, 1406.0]",4,8,-4
31081.0,2020-01-27,"(459.105, 683.75]",3,4,-1
31081.0,2020-01-27,"(907.5, 1131.25]",1,3,-2
31081.0,2020-01-27,"(1131.25, 1355.0]",1,3,-2
31082.0,2020-01-27,"(954.25, 1086.5]",1,1,0
31082.0,2020-01-27,"(1218.75, 1351.0]",1,1,0
31083.0,2020-01-27,"(573.25, 806.5]",1,2,-1
31083.0,2020-01-27,"(1039.75, 1273.0]",1,2,-1
31084.0,2020-01-27,"(566.227, 760.25]",5,5,0
31084.0,2020-01-27,"(760.25, 953.5]",2,3,-1
31085.0,2020-01-27,"(399.296, 576.0]",1,4,-3
31085.0,2020-01-27,"(928.0, 1104.0]",3,1,2
31086.0,2020-01-27,"(895.0, 1134.5]",2,1,1
31086.0,2020-01-27,"(1134.5, 1374.0]",1,5,-4
31087.0,2020-01-27,"(895.0, 1096.0]",2,2,0
31087.0,2020-01-27,"(1096.0, 1297.0]",2,2,0
31088.0,2020-01-27,"(135.831, 429.25]",1,2,-1
31088.0,2020-01-27,"(721.5, 1013.75]",1,2,-1
31088.0,2020-01-27,"(1013.75, 1306.0]",4,2,2
31089.0,2020-01-27,"(379.969, 638.75]",6,11,-5
31089.0,2020-01-27,"(638.75, 896.5]",3,5,-2
31089.0,2020-01-27,"(896.5, 1154.25]",7,25,-18
,,,,2.0,
31091.0,2020-01-27,"(838.0, 1054.0]",1,4,-3
31091.0,2020-01-27,"(1054.0, 1270.0]",5,1,4
31092.0,2020-01-27,"(964.75, 1132.0]",4,3,1
,,,,1.0,
,,,,1.0,
,,,,2.0,
,,,,2.0,
31094.0,2020-01-27,"(498.393, 650.75]",2,2,0
31095.0,2020-01-27,"(614.5, 740.0]",1,1,0
31095.0,2020-01-27,"(865.5, 991.0]",1,2,-1
31096.0,2020-01-27,"(706.5, 827.25]",1,1,0
31096.0,2020-01-27,"(827.25, 948.0]",1,2,-1
31097.0,2020-01-27,"(405.31, 578.5]",2,3,-1
31097.0,2020-01-27,"(578.5, 751.0]",2,2,0
31098.0,2020-01-27,"(429.138, 645.5]",5,11,-6
31098.0,2020-01-27,"(861.0, 1076.5]",8,2,6
31098.0,2020-01-27,"(1076.5, 1292.0]",2,14,-12
31099.0,2020-01-27,"(1000.732, 1068.0]",1,1,0
31100.0,2020-01-27,"(471.146, 685.5]",15,17,-2
31100.0,2020-01-27,"(685.5, 899.0]",6,11,-5
31101.0,2020-01-27,"(2.612, 351.0]",1,2,-1
31101.0,2020-01-27,"(351.0, 698.0]",7,42,-35
31101.0,2020-01-27,"(698.0, 1045.0]",22,33,-11
31101.0,2020-01-27,"(1045.0, 1392.0]",41,66,-25
31102.0,2020-01-27,"(382.062, 617.5]",1,22,-21
31102.0,2020-01-27,"(852.0, 1086.5]",1,2,-1
31102.0,2020-01-27,"(1086.5, 1321.0]",9,12,-3
31103.0,2020-01-27,"(334.998, 586.5]",2,22,-20
31103.0,2020-01-27,"(586.5, 837.0]",1,7,-6
31103.0,2020-01-27,"(837.0, 1087.5]",8,13,-5
31103.0,2020-01-27,"(1087.5, 1338.0]",5,11,-6
31104.0,2020-01-27,"(336.949, 600.75]",6,20,-14
31104.0,2020-01-27,"(600.75, 863.5]",4,13,-9
31104.0,2020-01-27,"(863.5, 1126.25]",21,30,-9
31104.0,2020-01-27,"(1126.25, 1389.0]",4,11,-7
31105.0,2020-01-27,"(362.0, 711.0]",1,1,0
31105.0,2020-01-27,"(711.0, 1060.0]",2,6,-4
31105.0,2020-01-27,"(1060.0, 1409.0]",5,9,-4
31106.0,2020-01-27,"(456.186, 660.5]",1,3,-2
31106.0,2020-01-27,"(864.0, 1067.5]",4,5,-1
31106.0,2020-01-27,"(1067.5, 1271.0]",4,4,0
31107.0,2020-01-27,"(345.952, 609.0]",3,30,-27
31107.0,2020-01-27,"(609.0, 871.0]",1,3,-2
31107.0,2020-01-27,"(871.0, 1133.0]",16,27,-11
31107.0,2020-01-27,"(1133.0, 1395.0]",7,11,-4
31108.0,2020-01-27,"(343.016, 590.0]",6,22,-16
31108.0,2020-01-27,"(590.0, 836.0]",7,12,-5
31108.0,2020-01-27,"(836.0, 1082.0]",16,23,-7
31108.0,2020-01-27,"(1082.0, 1328.0]",6,8,-2
31109.0,2020-01-27,"(70.643, 411.25]",1,1,0
31109.0,2020-01-27,"(411.25, 750.5]",6,20,-14
31109.0,2020-01-27,"(750.5, 1089.75]",21,32,-11
31109.0,2020-01-27,"(1089.75, 1429.0]",7,16,-9
31110.0,2020-01-27,"(314.989, 568.75]",11,29,-18
31110.0,2020-01-27,"(568.75, 821.5]",9,19,-10
31110.0,2020-01-27,"(821.5, 1074.25]",18,28,-10
31110.0,2020-01-27,"(1074.25, 1327.0]",11,19,-8
31111.0,2020-01-27,"(324.914, 597.5]",4,15,-11
31111.0,2020-01-27,"(597.5, 869.0]",2,3,-1
31111.0,2020-01-27,"(869.0, 1140.5]",13,18,-5
31111.0,2020-01-27,"(1140.5, 1412.0]",7,13,-6
31112.0,2020-01-27,"(360.186, 564.5]",1,3,-2
31112.0,2020-01-27,"(971.5, 1175.0]",4,1,3
31113.0,2020-01-27,"(565.0, 789.0]",3,12,-9
31113.0,2020-01-27,"(789.0, 1013.0]",1,9,-8
31113.0,2020-01-27,"(1013.0, 1237.0]",7,4,3
31114.0,2020-01-27,"(8.696, 336.0]",3,3,0
31114.0,2020-01-27,"(336.0, 662.0]",5,30,-25
31114.0,2020-01-27,"(662.0, 988.0]",2,4,-2
31114.0,2020-01-27,"(988.0, 1314.0]",21,29,-8
31115.0,2020-01-27,"(604.25, 857.5]",2,17,-15
31115.0,2020-01-27,"(857.5, 1110.75]",10,6,4
31115.0,2020-01-27,"(1110.75, 1364.0]",5,13,-8
31116.0,2020-01-27,"(166.769, 475.75]",2,6,-4
31116.0,2020-01-27,"(475.75, 783.5]",3,22,-19
31116.0,2020-01-27,"(783.5, 1091.25]",9,14,-5
31116.0,2020-01-27,"(1091.25, 1399.0]",20,31,-11
31117.0,2020-01-27,"(347.974, 605.5]",4,26,-22
31117.0,2020-01-27,"(605.5, 862.0]",2,6,-4
31117.0,2020-01-27,"(862.0, 1118.5]",8,20,-12
31117.0,2020-01-27,"(1118.5, 1375.0]",7,10,-3
31118.0,2020-01-27,"(334.917, 606.75]",1,11,-10
31118.0,2020-01-27,"(606.75, 877.5]",2,7,-5
31118.0,2020-01-27,"(877.5, 1148.25]",8,15,-7
31118.0,2020-01-27,"(1148.25, 1419.0]",3,4,-1
31119.0,2020-01-27,"(298.86, 585.0]",6,15,-9
31119.0,2020-01-27,"(585.0, 870.0]",10,16,-6
31119.0,2020-01-27,"(870.0, 1155.0]",15,24,-9
31119.0,2020-01-27,"(1155.0, 1440.0]",11,18,-7
31120.0,2020-01-27,"(587.25, 825.5]",6,13,-7
31120.0,2020-01-27,"(825.5, 1063.75]",6,9,-3
31120.0,2020-01-27,"(1063.75, 1302.0]",8,9,-1
31121.0,2020-01-27,"(352.027, 596.25]",13,17,-4
31121.0,2020-01-27,"(596.25, 839.5]",1,3,-2
31121.0,2020-01-27,"(839.5, 1082.75]",1,10,-9
31121.0,2020-01-27,"(1082.75, 1326.0]",3,10,-7
31122.0,2020-01-27,"(430.011, 678.25]",1,14,-13
31122.0,2020-01-27,"(678.25, 925.5]",2,4,-2
31122.0,2020-01-27,"(925.5, 1172.75]",5,10,-5
31122.0,2020-01-27,"(1172.75, 1420.0]",9,14,-5
31123.0,2020-01-27,"(343.125, 562.75]",1,24,-23
31123.0,2020-01-27,"(781.5, 1000.25]",1,1,0
31123.0,2020-01-27,"(1000.25, 1219.0]",7,4,3
31124.0,2020-01-27,"(319.964, 580.0]",17,35,-18
31124.0,2020-01-27,"(580.0, 839.0]",4,21,-17
31124.0,2020-01-27,"(839.0, 1098.0]",14,41,-27
31124.0,2020-01-27,"(1098.0, 1357.0]",9,28,-19
31125.0,2020-01-27,"(341.98, 598.0]",6,29,-23
31125.0,2020-01-27,"(598.0, 853.0]",2,4,-2
31125.0,2020-01-27,"(853.0, 1108.0]",18,26,-8
31125.0,2020-01-27,"(1108.0, 1363.0]",19,26,-7
31126.0,2020-01-27,"(13.662, 349.5]",2,4,-2
31126.0,2020-01-27,"(349.5, 684.0]",5,17,-12
31126.0,2020-01-27,"(684.0, 1018.5]",6,11,-5
31126.0,2020-01-27,"(1018.5, 1353.0]",21,25,-4
31127.0,2020-01-27,"(393.975, 651.25]",11,15,-4
31127.0,2020-01-27,"(651.25, 907.5]",7,12,-5
31127.0,2020-01-27,"(907.5, 1163.75]",8,24,-16
31127.0,2020-01-27,"(1163.75, 1420.0]",2,11,-9
31128.0,2020-01-27,"(347.971, 606.25]",15,22,-7
31128.0,2020-01-27,"(606.25, 863.5]",7,12,-5
31128.0,2020-01-27,"(863.5, 1120.75]",14,22,-8
31128.0,2020-01-27,"(1120.75, 1378.0]",8,16,-8
31129.0,2020-01-27,"(428.04, 669.0]",11,14,-3
31129.0,2020-01-27,"(669.0, 909.0]",9,14,-5
31129.0,2020-01-27,"(909.0, 1149.0]",8,12,-4
31129.0,2020-01-27,"(1149.0, 1389.0]",1,3,-2
31130.0,2020-01-27,"(24.666, 359.5]",1,2,-1
31130.0,2020-01-27,"(359.5, 693.0]",1,14,-13
31130.0,2020-01-27,"(693.0, 1026.5]",1,4,-3
31130.0,2020-01-27,"(1026.5, 1360.0]",14,18,-4
31131.0,2020-01-27,"(363.002, 613.5]",2,12,-10
31131.0,2020-01-27,"(863.0, 1112.5]",3,1,2
31131.0,2020-01-27,"(1112.5, 1362.0]",7,10,-3
31200.0,2020-01-27,"(23.631, 367.25]",1,3,-2
31200.0,2020-01-27,"(367.25, 709.5]",33,48,-15
31200.0,2020-01-27,"(709.5, 1051.75]",12,26,-14
31200.0,2020-01-27,"(1051.75, 1394.0]",18,42,-24
31201.0,2020-01-27,"(348.035, 590.25]",15,35,-20
31201.0,2020-01-27,"(590.25, 831.5]",18,32,-14
31201.0,2020-01-27,"(831.5, 1072.75]",5,12,-7
,,,,2.0,
31203.0,2020-01-27,"(172.81, 471.5]",2,8,-6
31203.0,2020-01-27,"(471.5, 769.0]",8,22,-14
31203.0,2020-01-27,"(769.0, 1066.5]",23,33,-10
31203.0,2020-01-27,"(1066.5, 1364.0]",29,46,-17
31204.0,2020-01-27,"(182.756, 495.0]",6,6,0
31204.0,2020-01-27,"(495.0, 806.0]",13,19,-6
31204.0,2020-01-27,"(806.0, 1117.0]",10,31,-21
31204.0,2020-01-27,"(1117.0, 1428.0]",7,12,-5
31205.0,2020-01-27,"(101.716, 424.0]",1,3,-2
31205.0,2020-01-27,"(424.0, 745.0]",38,43,-5
31205.0,2020-01-27,"(745.0, 1066.0]",29,43,-14
31205.0,2020-01-27,"(1066.0, 1387.0]",7,30,-23
31206.0,2020-01-27,"(470.064, 705.0]",6,6,0
31206.0,2020-01-27,"(705.0, 939.0]",4,7,-3
31206.0,2020-01-27,"(939.0, 1173.0]",1,8,-7
31206.0,2020-01-27,"(1173.0, 1407.0]",1,1,0
31207.0,2020-01-27,"(351.953, 614.75]",1,6,-5
31207.0,2020-01-27,"(614.75, 876.5]",1,2,-1
31207.0,2020-01-27,"(876.5, 1138.25]",3,7,-4
31207.0,2020-01-27,"(1138.25, 1400.0]",1,2,-1
31208.0,2020-01-27,"(417.163, 627.25]",11,13,-2
31208.0,2020-01-27,"(627.25, 836.5]",3,4,-1
31208.0,2020-01-27,"(836.5, 1045.75]",1,11,-10
31208.0,2020-01-27,"(1045.75, 1255.0]",2,3,-1
31209.0,2020-01-27,"(479.196, 681.0]",1,5,-4
31209.0,2020-01-27,"(681.0, 882.0]",1,2,-1
31209.0,2020-01-27,"(882.0, 1083.0]",3,3,0
31209.0,2020-01-27,"(1083.0, 1284.0]",4,5,-1
31211.0,2020-01-27,"(492.339, 658.25]",8,10,-2
31211.0,2020-01-27,"(658.25, 823.5]",1,4,-3
31211.0,2020-01-27,"(823.5, 988.75]",3,4,-1
31211.0,2020-01-27,"(988.75, 1154.0]",2,9,-7
31212.0,2020-01-27,"(360.004, 610.0]",35,50,-15
31212.0,2020-01-27,"(610.0, 859.0]",9,13,-4
31212.0,2020-01-27,"(859.0, 1108.0]",13,27,-14
31212.0,2020-01-27,"(1108.0, 1357.0]",6,16,-10
31213.0,2020-01-27,"(398.192, 601.0]",26,35,-9
31213.0,2020-01-27,"(601.0, 803.0]",5,12,-7
31213.0,2020-01-27,"(803.0, 1005.0]",5,13,-8
31213.0,2020-01-27,"(1005.0, 1207.0]",13,32,-19
31214.0,2020-01-27,"(353.0, 604.0]",10,36,-26
31214.0,2020-01-27,"(604.0, 854.0]",9,18,-9
31214.0,2020-01-27,"(854.0, 1104.0]",14,24,-10
31214.0,2020-01-27,"(1104.0, 1354.0]",28,40,-12
31215.0,2020-01-27,"(442.232, 635.0]",20,22,-2
31215.0,2020-01-27,"(635.0, 827.0]",3,6,-3
31215.0,2020-01-27,"(827.0, 1019.0]",3,3,0
31215.0,2020-01-27,"(1019.0, 1211.0]",3,11,-8
31216.0,2020-01-27,"(441.005, 690.75]",23,25,-2
31216.0,2020-01-27,"(690.75, 939.5]",7,15,-8
31216.0,2020-01-27,"(939.5, 1188.25]",5,21,-16
31217.0,2020-01-27,"(335.028, 579.0]",13,16,-3
31217.0,2020-01-27,"(579.0, 822.0]",2,2,0
31217.0,2020-01-27,"(822.0, 1065.0]",2,7,-5
31217.0,2020-01-27,"(1065.0, 1308.0]",1,4,-3
31218.0,2020-01-27,"(376.08, 607.0]",16,30,-14
31218.0,2020-01-27,"(607.0, 837.0]",1,3,-2
31218.0,2020-01-27,"(837.0, 1067.0]",7,14,-7
31218.0,2020-01-27,"(1067.0, 1297.0]",2,4,-2
31219.0,2020-01-27,"(366.237, 557.75]",11,11,0
31219.0,2020-01-27,"(557.75, 748.5]",6,6,0
31219.0,2020-01-27,"(748.5, 939.25]",3,7,-4
31219.0,2020-01-27,"(939.25, 1130.0]",1,14,-13
31220.0,2020-01-27,"(349.319, 520.25]",10,13,-3
31220.0,2020-01-27,"(520.25, 690.5]",6,7,-1
31220.0,2020-01-27,"(860.75, 1031.0]",3,2,1
31221.0,2020-01-27,"(452.109, 675.75]",31,32,-1
31221.0,2020-01-27,"(675.75, 898.5]",19,27,-8
31221.0,2020-01-27,"(898.5, 1121.25]",8,37,-29
31221.0,2020-01-27,"(1121.25, 1344.0]",2,4,-2
31222.0,2020-01-27,"(460.13, 678.5]",21,23,-2
31222.0,2020-01-27,"(678.5, 896.0]",2,2,0
31222.0,2020-01-27,"(896.0, 1113.5]",1,13,-12
31222.0,2020-01-27,"(1113.5, 1331.0]",2,2,0
31223.0,2020-01-27,"(4.641, 345.75]",1,3,-2
31223.0,2020-01-27,"(345.75, 685.5]",11,37,-26
31223.0,2020-01-27,"(685.5, 1025.25]",5,15,-10
31223.0,2020-01-27,"(1025.25, 1365.0]",14,24,-10
31224.0,2020-01-27,"(456.081, 686.75]",12,13,-1
31224.0,2020-01-27,"(686.75, 916.5]",3,8,-5
31224.0,2020-01-27,"(916.5, 1146.25]",6,21,-15
31224.0,2020-01-27,"(1146.25, 1376.0]",2,8,-6
31225.0,2020-01-27,"(418.067, 652.25]",10,16,-6
31225.0,2020-01-27,"(652.25, 885.5]",4,14,-10
31225.0,2020-01-27,"(885.5, 1118.75]",3,15,-12
31225.0,2020-01-27,"(1118.75, 1352.0]",7,9,-2
31226.0,2020-01-27,"(322.074, 554.5]",4,10,-6
31226.0,2020-01-27,"(554.5, 786.0]",1,5,-4
31226.0,2020-01-27,"(1017.5, 1249.0]",8,1,7
31227.0,2020-01-27,"(405.978, 662.5]",35,41,-6
31227.0,2020-01-27,"(662.5, 918.0]",7,13,-6
31227.0,2020-01-27,"(918.0, 1173.5]",3,20,-17
31227.0,2020-01-27,"(1173.5, 1429.0]",2,4,-2
31228.0,2020-01-27,"(366.991, 620.25]",14,26,-12
31228.0,2020-01-27,"(620.25, 872.5]",9,20,-11
31228.0,2020-01-27,"(872.5, 1124.75]",13,27,-14
31228.0,2020-01-27,"(1124.75, 1377.0]",4,15,-11
31229.0,2020-01-27,"(353.945, 618.75]",11,56,-45
31229.0,2020-01-27,"(618.75, 882.5]",9,25,-16
31229.0,2020-01-27,"(882.5, 1146.25]",33,50,-17
31229.0,2020-01-27,"(1146.25, 1410.0]",12,25,-13
31230.0,2020-01-27,"(358.089, 586.75]",53,61,-8
31230.0,2020-01-27,"(586.75, 814.5]",11,19,-8
31230.0,2020-01-27,"(814.5, 1042.25]",13,21,-8
31230.0,2020-01-27,"(1042.25, 1270.0]",6,34,-28
31231.0,2020-01-27,"(326.951, 590.25]",16,17,-1
31231.0,2020-01-27,"(590.25, 852.5]",11,16,-5
31231.0,2020-01-27,"(852.5, 1114.75]",10,23,-13
31231.0,2020-01-27,"(1114.75, 1377.0]",1,5,-4
31232.0,2020-01-27,"(323.94, 590.0]",17,21,-4
31232.0,2020-01-27,"(590.0, 855.0]",2,9,-7
31232.0,2020-01-27,"(855.0, 1120.0]",10,24,-14
31232.0,2020-01-27,"(1120.0, 1385.0]",4,8,-4
31233.0,2020-01-27,"(324.061, 559.75]",36,41,-5
31233.0,2020-01-27,"(559.75, 794.5]",14,18,-4
31233.0,2020-01-27,"(794.5, 1029.25]",13,19,-6
31233.0,2020-01-27,"(1029.25, 1264.0]",9,26,-17
31234.0,2020-01-27,"(338.0, 665.0]",15,1,14
31234.0,2020-01-27,"(665.0, 992.0]",15,36,-21
31234.0,2020-01-27,"(992.0, 1319.0]",16,23,-7
31235.0,2020-01-27,"(471.067, 705.25]",6,7,-1
31235.0,2020-01-27,"(938.5, 1171.75]",1,4,-3
31235.0,2020-01-27,"(1171.75, 1405.0]",3,6,-3
31236.0,2020-01-27,"(383.25, 700.5]",21,1,20
31236.0,2020-01-27,"(700.5, 1017.75]",12,26,-14
31236.0,2020-01-27,"(1017.75, 1335.0]",11,26,-15
31237.0,2020-01-27,"(105.668, 440.0]",2,3,-1
31237.0,2020-01-27,"(440.0, 773.0]",9,23,-14
31237.0,2020-01-27,"(773.0, 1106.0]",14,25,-11
31237.0,2020-01-27,"(1106.0, 1439.0]",8,14,-6
31238.0,2020-01-27,"(38.633, 381.75]",1,1,0
31238.0,2020-01-27,"(381.75, 723.5]",10,13,-3
31238.0,2020-01-27,"(723.5, 1065.25]",4,14,-10
31238.0,2020-01-27,"(1065.25, 1407.0]",6,21,-15
31239.0,2020-01-27,"(373.168, 582.0]",18,20,-2
31239.0,2020-01-27,"(582.0, 790.0]",1,3,-2
31239.0,2020-01-27,"(790.0, 998.0]",4,12,-8
31239.0,2020-01-27,"(998.0, 1206.0]",10,37,-27
31240.0,2020-01-27,"(649.624, 744.0]",4,6,-2
31240.0,2020-01-27,"(932.0, 1026.0]",2,5,-3
31241.0,2020-01-27,"(332.979, 589.25]",17,39,-22
31241.0,2020-01-27,"(589.25, 844.5]",12,22,-10
31241.0,2020-01-27,"(844.5, 1099.75]",17,32,-15
31241.0,2020-01-27,"(1099.75, 1355.0]",23,43,-20
31242.0,2020-01-27,"(295.15, 508.5]",12,13,-1
31242.0,2020-01-27,"(508.5, 721.0]",11,13,-2
31242.0,2020-01-27,"(721.0, 933.5]",4,9,-5
31243.0,2020-01-27,"(376.198, 577.5]",25,29,-4
31243.0,2020-01-27,"(577.5, 778.0]",1,2,-1
31243.0,2020-01-27,"(778.0, 978.5]",8,22,-14
31243.0,2020-01-27,"(978.5, 1179.0]",3,20,-17
31244.0,2020-01-27,"(30.625, 375.75]",1,1,0
31244.0,2020-01-27,"(375.75, 719.5]",12,18,-6
31244.0,2020-01-27,"(719.5, 1063.25]",6,18,-12
31244.0,2020-01-27,"(1063.25, 1407.0]",8,13,-5
31245.0,2020-01-27,"(332.897, 609.75]",6,16,-10
31245.0,2020-01-27,"(609.75, 885.5]",4,10,-6
31245.0,2020-01-27,"(885.5, 1161.25]",19,26,-7
31245.0,2020-01-27,"(1161.25, 1437.0]",2,6,-4
31246.0,2020-01-27,"(398.093, 625.75]",12,15,-3
31246.0,2020-01-27,"(625.75, 852.5]",11,17,-6
31246.0,2020-01-27,"(852.5, 1079.25]",9,17,-8
31246.0,2020-01-27,"(1079.25, 1306.0]",10,20,-10
31247.0,2020-01-27,"(425.51, 548.5]",4,7,-3
31247.0,2020-01-27,"(548.5, 671.0]",7,7,0
31247.0,2020-01-27,"(671.0, 793.5]",5,16,-11
31247.0,2020-01-27,"(793.5, 916.0]",3,5,-2
31248.0,2020-01-27,"(356.031, 599.25]",10,16,-6
31248.0,2020-01-27,"(599.25, 841.5]",12,18,-6
31248.0,2020-01-27,"(841.5, 1083.75]",11,24,-13
31248.0,2020-01-27,"(1083.75, 1326.0]",2,5,-3
31249.0,2020-01-27,"(418.26, 604.0]",4,8,-4
31249.0,2020-01-27,"(604.0, 789.0]",3,5,-2
31249.0,2020-01-27,"(789.0, 974.0]",5,11,-6
31249.0,2020-01-27,"(974.0, 1159.0]",4,8,-4
31250.0,2020-01-27,"(424.051, 662.25]",20,24,-4
31250.0,2020-01-27,"(662.25, 899.5]",2,6,-4
31250.0,2020-01-27,"(899.5, 1136.75]",6,21,-15
31250.0,2020-01-27,"(1136.75, 1374.0]",1,5,-4
31251.0,2020-01-27,"(52.661, 388.75]",2,3,-1
31251.0,2020-01-27,"(388.75, 723.5]",18,34,-16
31251.0,2020-01-27,"(723.5, 1058.25]",5,14,-9
31251.0,2020-01-27,"(1058.25, 1393.0]",12,20,-8
31252.0,2020-01-27,"(472.249, 660.75]",17,18,-1
31252.0,2020-01-27,"(660.75, 848.5]",2,6,-4
31252.0,2020-01-27,"(848.5, 1036.25]",4,13,-9
31252.0,2020-01-27,"(1036.25, 1224.0]",2,8,-6
31253.0,2020-01-27,"(383.233, 575.75]",20,23,-3
31253.0,2020-01-27,"(575.75, 767.5]",9,9,0
31253.0,2020-01-27,"(767.5, 959.25]",3,5,-2
31253.0,2020-01-27,"(959.25, 1151.0]",3,22,-19
31254.0,2020-01-27,"(62.749, 376.75]",1,3,-2
31254.0,2020-01-27,"(376.75, 689.5]",21,25,-4
31254.0,2020-01-27,"(689.5, 1002.25]",1,4,-3
31254.0,2020-01-27,"(1002.25, 1315.0]",3,25,-22
31255.0,2020-01-27,"(371.021, 616.75]",9,16,-7
31255.0,2020-01-27,"(616.75, 861.5]",3,4,-1
31255.0,2020-01-27,"(861.5, 1106.25]",6,16,-10
31255.0,2020-01-27,"(1106.25, 1351.0]",7,15,-8
31256.0,2020-01-27,"(262.898, 539.5]",9,10,-1
31256.0,2020-01-27,"(815.0, 1090.5]",4,1,3
31256.0,2020-01-27,"(1090.5, 1366.0]",5,14,-9
31257.0,2020-01-27,"(323.005, 572.75]",14,26,-12
31257.0,2020-01-27,"(572.75, 821.5]",8,16,-8
31257.0,2020-01-27,"(821.5, 1070.25]",11,23,-12
31257.0,2020-01-27,"(1070.25, 1319.0]",12,35,-23
31258.0,2020-01-27,"(393.139, 609.25]",5,11,-6
31258.0,2020-01-27,"(609.25, 824.5]",8,20,-12
31258.0,2020-01-27,"(824.5, 1039.75]",8,15,-7
31258.0,2020-01-27,"(1039.75, 1255.0]",4,8,-4
31259.0,2020-01-27,"(458.289, 636.75]",12,12,0
31259.0,2020-01-27,"(636.75, 814.5]",2,4,-2
31259.0,2020-01-27,"(814.5, 992.25]",2,4,-2
31259.0,2020-01-27,"(992.25, 1170.0]",1,13,-12
31260.0,2020-01-27,"(39.636, 382.0]",2,3,-1
31260.0,2020-01-27,"(382.0, 723.0]",16,22,-6
31260.0,2020-01-27,"(723.0, 1064.0]",1,12,-11
31260.0,2020-01-27,"(1064.0, 1405.0]",3,9,-6
31261.0,2020-01-27,"(390.329, 558.75]",9,9,0
31261.0,2020-01-27,"(558.75, 726.5]",2,2,0
31261.0,2020-01-27,"(726.5, 894.25]",2,3,-1
31261.0,2020-01-27,"(894.25, 1062.0]",4,16,-12
31262.0,2020-01-27,"(312.069, 545.75]",5,5,0
31262.0,2020-01-27,"(545.75, 778.5]",14,16,-2
31262.0,2020-01-27,"(778.5, 1011.25]",2,2,0
31263.0,2020-01-27,"(360.104, 585.0]",22,38,-16
31263.0,2020-01-27,"(585.0, 809.0]",9,18,-9
31263.0,2020-01-27,"(809.0, 1033.0]",8,19,-11
31263.0,2020-01-27,"(1033.0, 1257.0]",5,22,-17
31264.0,2020-01-27,"(353.087, 582.25]",8,12,-4
31264.0,2020-01-27,"(810.5, 1038.75]",3,2,1
31264.0,2020-01-27,"(1038.75, 1267.0]",4,7,-3
31265.0,2020-01-27,"(375.026, 619.5]",16,33,-17
31265.0,2020-01-27,"(619.5, 863.0]",8,13,-5
31265.0,2020-01-27,"(863.0, 1106.5]",23,45,-22
31265.0,2020-01-27,"(1106.5, 1350.0]",23,34,-11
31266.0,2020-01-27,"(313.895, 591.25]",5,24,-19
31266.0,2020-01-27,"(591.25, 867.5]",9,18,-9
31266.0,2020-01-27,"(867.5, 1143.75]",18,29,-11
31266.0,2020-01-27,"(1143.75, 1420.0]",11,20,-9
31267.0,2020-01-27,"(467.047, 706.25]",27,44,-17
31267.0,2020-01-27,"(706.25, 944.5]",7,17,-10
31267.0,2020-01-27,"(944.5, 1182.75]",18,29,-11
31267.0,2020-01-27,"(1182.75, 1421.0]",7,15,-8
31268.0,2020-01-27,"(334.973, 592.75]",11,30,-19
31268.0,2020-01-27,"(592.75, 849.5]",4,12,-8
31268.0,2020-01-27,"(849.5, 1106.25]",15,21,-6
31268.0,2020-01-27,"(1106.25, 1363.0]",15,23,-8
31269.0,2020-01-27,"(379.046, 618.5]",7,13,-6
31269.0,2020-01-27,"(618.5, 857.0]",2,6,-4
31269.0,2020-01-27,"(857.0, 1095.5]",6,19,-13
31269.0,2020-01-27,"(1095.5, 1334.0]",3,7,-4
31270.0,2020-01-27,"(15.723, 336.25]",1,1,0
31270.0,2020-01-27,"(336.25, 655.5]",17,26,-9
31270.0,2020-01-27,"(655.5, 974.75]",11,22,-11
31270.0,2020-01-27,"(974.75, 1294.0]",13,25,-12
31271.0,2020-01-27,"(380.151, 593.25]",17,24,-7
31271.0,2020-01-27,"(593.25, 805.5]",4,10,-6
31271.0,2020-01-27,"(805.5, 1017.75]",6,14,-8
31271.0,2020-01-27,"(1017.75, 1230.0]",10,31,-21
31272.0,2020-01-27,"(301.913, 574.75]",31,34,-3
31272.0,2020-01-27,"(574.75, 846.5]",4,5,-1
31272.0,2020-01-27,"(846.5, 1118.25]",5,22,-17
31272.0,2020-01-27,"(1118.25, 1390.0]",4,10,-6
31273.0,2020-01-27,"(798.5, 913.25]",1,2,-1
31273.0,2020-01-27,"(913.25, 1028.0]",2,1,1
31274.0,2020-01-27,"(352.986, 607.5]",11,14,-3
31274.0,2020-01-27,"(607.5, 861.0]",1,3,-2
31274.0,2020-01-27,"(861.0, 1114.5]",5,11,-6
31274.0,2020-01-27,"(1114.5, 1368.0]",6,13,-7
31275.0,2020-01-27,"(330.898, 607.5]",19,31,-12
31275.0,2020-01-27,"(607.5, 883.0]",7,11,-4
31275.0,2020-01-27,"(883.0, 1158.5]",10,22,-12
31275.0,2020-01-27,"(1158.5, 1434.0]",2,8,-6
31276.0,2020-01-27,"(408.004, 658.0]",16,17,-1
31276.0,2020-01-27,"(658.0, 907.0]",7,15,-8
31276.0,2020-01-27,"(907.0, 1156.0]",4,25,-21
31276.0,2020-01-27,"(1156.0, 1405.0]",1,3,-2
31277.0,2020-01-27,"(409.07, 642.5]",31,34,-3
31277.0,2020-01-27,"(642.5, 875.0]",12,20,-8
31277.0,2020-01-27,"(875.0, 1107.5]",4,24,-20
31277.0,2020-01-27,"(1107.5, 1340.0]",5,16,-11
31278.0,2020-01-27,"(7.579, 364.25]",1,1,0
31278.0,2020-01-27,"(364.25, 719.5]",11,37,-26
31278.0,2020-01-27,"(719.5, 1074.75]",11,19,-8
31278.0,2020-01-27,"(1074.75, 1430.0]",22,34,-12
31279.0,2020-01-27,"(435.177, 641.75]",22,24,-2
31279.0,2020-01-27,"(641.75, 847.5]",5,9,-4
31279.0,2020-01-27,"(847.5, 1053.25]",8,21,-13
31280.0,2020-01-27,"(97.778, 404.5]",1,2,-1
31280.0,2020-01-27,"(404.5, 710.0]",5,25,-20
31280.0,2020-01-27,"(710.0, 1015.5]",7,11,-4
31280.0,2020-01-27,"(1015.5, 1321.0]",17,22,-5
,,,,1.0,
,,,,1.0,
,,,,1.0,
31001.0,2020-01-28,"(421.427, 565.25]",1,1,0
31002.0,2020-01-28,"(454.422, 599.5]",1,3,-2
31002.0,2020-01-28,"(599.5, 744.0]",1,1,0
31002.0,2020-01-28,"(888.5, 1033.0]",1,3,-2
31003.0,2020-01-28,"(377.245, 566.75]",3,5,-2
31003.0,2020-01-28,"(755.5, 944.25]",2,2,0
31003.0,2020-01-28,"(944.25, 1133.0]",2,4,-2
31004.0,2020-01-28,"(975.25, 1149.0]",5,3,2
31005.0,2020-01-28,"(439.083, 669.25]",5,8,-3
31005.0,2020-01-28,"(898.5, 1127.75]",3,9,-6
31005.0,2020-01-28,"(1127.75, 1357.0]",1,2,-1
31006.0,2020-01-28,"(909.819, 955.25]",1,1,0
31006.0,2020-01-28,"(1045.75, 1091.0]",1,1,0
31007.0,2020-01-28,"(355.094, 582.5]",9,21,-12
31007.0,2020-01-28,"(582.5, 809.0]",4,8,-4
31007.0,2020-01-28,"(809.0, 1035.5]",5,11,-6
31007.0,2020-01-28,"(1035.5, 1262.0]",10,26,-16
31009.0,2020-01-28,"(460.357, 621.75]",3,3,0
31009.0,2020-01-28,"(943.25, 1104.0]",1,4,-3
31010.0,2020-01-28,"(509.143, 724.25]",1,1,0
31010.0,2020-01-28,"(724.25, 938.5]",3,5,-2
31010.0,2020-01-28,"(938.5, 1152.75]",1,1,0
31010.0,2020-01-28,"(1152.75, 1367.0]",2,4,-2
31011.0,2020-01-28,"(375.105, 599.75]",5,5,0
31011.0,2020-01-28,"(599.75, 823.5]",2,2,0
31011.0,2020-01-28,"(1047.25, 1271.0]",4,1,3
31012.0,2020-01-28,"(358.217, 554.75]",7,8,-1
31012.0,2020-01-28,"(750.5, 946.25]",1,1,0
31013.0,2020-01-28,"(615.75, 831.5]",1,4,-3
31013.0,2020-01-28,"(831.5, 1047.25]",2,2,0
31013.0,2020-01-28,"(1047.25, 1263.0]",5,4,1
31014.0,2020-01-28,"(389.082, 619.5]",15,18,-3
31014.0,2020-01-28,"(619.5, 849.0]",5,6,-1
31014.0,2020-01-28,"(849.0, 1078.5]",12,22,-10
31014.0,2020-01-28,"(1078.5, 1308.0]",11,18,-7
31015.0,2020-01-28,"(350.981, 606.75]",12,15,-3
31015.0,2020-01-28,"(606.75, 861.5]",3,3,0
31015.0,2020-01-28,"(861.5, 1116.25]",5,10,-5
31016.0,2020-01-28,"(375.969, 634.75]",8,14,-6
31016.0,2020-01-28,"(634.75, 892.5]",3,4,-1
31016.0,2020-01-28,"(892.5, 1150.25]",3,9,-6
31016.0,2020-01-28,"(1150.25, 1408.0]",2,3,-1
31017.0,2020-01-28,"(487.083, 717.25]",5,6,-1
31017.0,2020-01-28,"(946.5, 1175.75]",1,2,-1
31018.0,2020-01-28,"(776.0, 954.0]",1,7,-6
31018.0,2020-01-28,"(954.0, 1132.0]",4,2,2
31019.0,2020-01-28,"(423.09, 651.5]",1,2,-1
31019.0,2020-01-28,"(1106.5, 1334.0]",1,4,-3
31020.0,2020-01-28,"(413.078, 644.5]",2,3,-1
31020.0,2020-01-28,"(644.5, 875.0]",1,1,0
31020.0,2020-01-28,"(875.0, 1105.5]",1,2,-1
31020.0,2020-01-28,"(1105.5, 1336.0]",2,4,-2
31021.0,2020-01-28,"(432.105, 656.75]",1,6,-5
31021.0,2020-01-28,"(656.75, 880.5]",1,4,-3
31021.0,2020-01-28,"(880.5, 1104.25]",3,6,-3
31021.0,2020-01-28,"(1104.25, 1328.0]",1,4,-3
31022.0,2020-01-28,"(415.193, 617.75]",3,7,-4
31022.0,2020-01-28,"(617.75, 819.5]",1,2,-1
31022.0,2020-01-28,"(819.5, 1021.25]",1,2,-1
31022.0,2020-01-28,"(1021.25, 1223.0]",2,9,-7
31023.0,2020-01-28,"(447.172, 655.0]",1,1,0
31023.0,2020-01-28,"(655.0, 862.0]",1,2,-1
31023.0,2020-01-28,"(1069.0, 1276.0]",1,2,-1
31024.0,2020-01-28,"(375.047, 614.25]",10,13,-3
31024.0,2020-01-28,"(852.5, 1090.75]",3,9,-6
31024.0,2020-01-28,"(1090.75, 1329.0]",1,4,-3
31025.0,2020-01-28,"(509.334, 676.5]",2,3,-1
31025.0,2020-01-28,"(1009.5, 1176.0]",1,1,0
31026.0,2020-01-28,"(389.053, 626.75]",1,4,-3
31026.0,2020-01-28,"(626.75, 863.5]",2,2,0
31026.0,2020-01-28,"(863.5, 1100.25]",1,5,-4
31026.0,2020-01-28,"(1100.25, 1337.0]",2,3,-1
31027.0,2020-01-28,"(1215.25, 1431.0]",3,1,2
31028.0,2020-01-28,"(333.75, 666.5]",1,1,0
31028.0,2020-01-28,"(999.25, 1332.0]",2,1,1
31029.0,2020-01-28,"(102.933, 370.75]",1,2,-1
31029.0,2020-01-28,"(904.25, 1171.0]",2,4,-2
31030.0,2020-01-28,"(368.255, 555.25]",1,9,-8
31030.0,2020-01-28,"(555.25, 741.5]",1,7,-6
31030.0,2020-01-28,"(927.75, 1114.0]",6,7,-1
31031.0,2020-01-28,"(76.659, 413.25]",1,2,-1
31031.0,2020-01-28,"(748.5, 1083.75]",1,2,-1
31031.0,2020-01-28,"(1083.75, 1419.0]",3,2,1
31032.0,2020-01-28,"(959.25, 1141.0]",3,2,1
,,,,2.0,
31034.0,2020-01-28,"(393.986, 648.5]",3,6,-3
31034.0,2020-01-28,"(648.5, 902.0]",3,4,-1
31034.0,2020-01-28,"(902.0, 1155.5]",2,7,-5
31034.0,2020-01-28,"(1155.5, 1409.0]",1,3,-2
31035.0,2020-01-28,"(442.177, 648.75]",1,5,-4
31035.0,2020-01-28,"(854.5, 1060.25]",3,4,-1
31036.0,2020-01-28,"(664.5, 890.0]",1,3,-2
31036.0,2020-01-28,"(890.0, 1115.5]",2,2,0
31036.0,2020-01-28,"(1115.5, 1341.0]",3,2,1
31037.0,2020-01-28,"(418.145, 632.75]",11,14,-3
31037.0,2020-01-28,"(632.75, 846.5]",1,4,-3
31037.0,2020-01-28,"(846.5, 1060.25]",4,10,-6
31037.0,2020-01-28,"(1060.25, 1274.0]",1,14,-13
31038.0,2020-01-28,"(857.0, 1039.5]",1,3,-2
31038.0,2020-01-28,"(1039.5, 1222.0]",1,1,0
31039.0,2020-01-28,"(373.132, 591.0]",3,7,-4
31039.0,2020-01-28,"(808.0, 1025.0]",3,6,-3
31039.0,2020-01-28,"(1025.0, 1242.0]",4,6,-2
31040.0,2020-01-28,"(448.123, 668.25]",2,2,0
31040.0,2020-01-28,"(668.25, 887.5]",1,1,0
31041.0,2020-01-28,"(524.271, 707.25]",4,4,0
31041.0,2020-01-28,"(707.25, 889.5]",1,1,0
31041.0,2020-01-28,"(889.5, 1071.75]",1,2,-1
31041.0,2020-01-28,"(1071.75, 1254.0]",1,2,-1
31042.0,2020-01-28,"(437.27, 620.5]",4,5,-1
31042.0,2020-01-28,"(985.5, 1168.0]",2,1,1
31043.0,2020-01-28,"(413.161, 623.75]",3,5,-2
31043.0,2020-01-28,"(1043.25, 1253.0]",6,1,5
31044.0,2020-01-28,"(431.221, 626.75]",3,4,-1
31044.0,2020-01-28,"(1016.25, 1211.0]",2,2,0
31045.0,2020-01-28,"(523.142, 738.5]",1,4,-3
31045.0,2020-01-28,"(953.0, 1167.5]",4,1,3
31046.0,2020-01-28,"(592.5, 888.75]",2,1,1
31046.0,2020-01-28,"(888.75, 1185.0]",2,2,0
31047.0,2020-01-28,"(357.065, 591.75]",13,21,-8
31047.0,2020-01-28,"(591.75, 825.5]",3,4,-1
31047.0,2020-01-28,"(825.5, 1059.25]",8,17,-9
31047.0,2020-01-28,"(1059.25, 1293.0]",2,14,-12
31048.0,2020-01-28,"(498.311, 671.25]",2,4,-2
31048.0,2020-01-28,"(1015.75, 1188.0]",4,1,3
31049.0,2020-01-28,"(493.268, 677.0]",2,2,0
31049.0,2020-01-28,"(1043.0, 1226.0]",2,1,1
31050.0,2020-01-28,"(721.75, 804.0]",1,3,-2
31051.0,2020-01-28,"(425.123, 645.25]",1,8,-7
31051.0,2020-01-28,"(864.5, 1083.75]",4,4,0
31051.0,2020-01-28,"(1083.75, 1303.0]",3,3,0
31052.0,2020-01-28,"(309.25, 618.5]",2,1,1
31052.0,2020-01-28,"(927.75, 1237.0]",2,2,0
31053.0,2020-01-28,"(980.0, 1144.0]",1,1,0
,,,,2.0,
31055.0,2020-01-28,"(308.25, 411.0]",1,1,0
31056.0,2020-01-28,"(991.25, 998.0]",1,1,0
31057.0,2020-01-28,"(1395.997, 1396.75]",1,1,0
31058.0,2020-01-28,"(1346.964, 1356.0]",1,1,0
31059.0,2020-01-28,"(742.75, 865.5]",1,1,0
31059.0,2020-01-28,"(988.25, 1111.0]",2,1,1
31060.0,2020-01-28,"(612.464, 747.0]",2,2,0
31060.0,2020-01-28,"(881.0, 1015.0]",1,1,0
31060.0,2020-01-28,"(1015.0, 1149.0]",1,2,-1
31061.0,2020-01-28,"(527.135, 744.25]",1,1,0
31061.0,2020-01-28,"(1176.75, 1393.0]",1,2,-1
31062.0,2020-01-28,"(549.475, 681.25]",3,6,-3
31062.0,2020-01-28,"(681.25, 812.5]",1,4,-3
31062.0,2020-01-28,"(943.75, 1075.0]",2,3,-1
,,,,2.0,
31064.0,2020-01-28,"(510.499, 636.25]",1,2,-1
31064.0,2020-01-28,"(636.25, 761.5]",1,2,-1
31064.0,2020-01-28,"(761.5, 886.75]",5,9,-4
31064.0,2020-01-28,"(886.75, 1012.0]",3,6,-3
31065.0,2020-01-28,"(925.5, 1087.0]",1,2,-1
31066.0,2020-01-28,"(800.0, 931.5]",1,1,0
31066.0,2020-01-28,"(931.5, 1063.0]",2,1,1
31067.0,2020-01-28,"(147.765, 457.75]",1,2,-1
31067.0,2020-01-28,"(457.75, 766.5]",2,5,-3
31067.0,2020-01-28,"(766.5, 1075.25]",1,2,-1
31067.0,2020-01-28,"(1075.25, 1384.0]",2,2,0
31068.0,2020-01-28,"(672.318, 843.5]",2,4,-2
31068.0,2020-01-28,"(1014.0, 1184.5]",1,1,0
31068.0,2020-01-28,"(1184.5, 1355.0]",1,1,0
31069.0,2020-01-28,"(425.286, 604.5]",1,7,-6
31069.0,2020-01-28,"(783.0, 961.5]",2,3,-1
31069.0,2020-01-28,"(961.5, 1140.0]",3,3,0
31070.0,2020-01-28,"(413.28, 594.0]",1,4,-3
31070.0,2020-01-28,"(954.0, 1134.0]",4,4,0
31071.0,2020-01-28,"(425.265, 609.75]",2,4,-2
31071.0,2020-01-28,"(609.75, 793.5]",2,2,0
31071.0,2020-01-28,"(793.5, 977.25]",2,3,-1
31071.0,2020-01-28,"(977.25, 1161.0]",5,8,-3
,,,,1.0,
,,,,1.0,
31073.0,2020-01-28,"(491.472, 624.0]",2,3,-1
31073.0,2020-01-28,"(888.0, 1020.0]",3,1,2
31074.0,2020-01-28,"(421.31, 594.5]",1,3,-2
31074.0,2020-01-28,"(939.5, 1112.0]",3,5,-2
31075.0,2020-01-28,"(955.5, 1120.0]",1,1,0
31076.0,2020-01-28,"(410.25, 547.0]",1,1,0
31077.0,2020-01-28,"(26.976, 284.0]",1,1,0
31077.0,2020-01-28,"(540.0, 796.0]",3,1,2
31077.0,2020-01-28,"(796.0, 1052.0]",1,5,-4
31078.0,2020-01-28,"(479.409, 627.75]",5,5,0
31078.0,2020-01-28,"(627.75, 775.5]",1,1,0
31078.0,2020-01-28,"(923.25, 1071.0]",1,1,0
31079.0,2020-01-28,"(2.597, 354.75]",1,1,0
31079.0,2020-01-28,"(354.75, 705.5]",2,12,-10
31079.0,2020-01-28,"(705.5, 1056.25]",1,2,-1
31079.0,2020-01-28,"(1056.25, 1407.0]",7,10,-3
31080.0,2020-01-28,"(649.75, 894.5]",1,7,-6
31080.0,2020-01-28,"(894.5, 1139.25]",7,2,5
31080.0,2020-01-28,"(1139.25, 1384.0]",4,9,-5
31081.0,2020-01-28,"(418.133, 635.75]",3,3,0
31081.0,2020-01-28,"(635.75, 852.5]",1,1,0
31081.0,2020-01-28,"(852.5, 1069.25]",1,2,-1
,,,,1.0,
,,,,1.0,
,,,,1.0,
31083.0,2020-01-28,"(867.0, 1023.0]",2,3,-1
31084.0,2020-01-28,"(495.335, 662.25]",5,8,-3
31084.0,2020-01-28,"(662.25, 828.5]",5,6,-1
31085.0,2020-01-28,"(1033.25, 1221.0]",3,4,-1
,,,,1.0,
,,,,1.0,
,,,,1.0,
31087.0,2020-01-28,"(861.0, 1042.0]",1,2,-1
31087.0,2020-01-28,"(1042.0, 1223.0]",5,1,4
31088.0,2020-01-28,"(963.5, 1035.75]",1,2,-1
31088.0,2020-01-28,"(1035.75, 1108.0]",4,1,3
31089.0,2020-01-28,"(452.025, 696.75]",6,10,-4
31089.0,2020-01-28,"(696.75, 940.5]",2,6,-4
31089.0,2020-01-28,"(940.5, 1184.25]",4,20,-16
31089.0,2020-01-28,"(1184.25, 1428.0]",1,4,-3
31090.0,2020-01-28,"(417.677, 498.75]",1,1,0
31090.0,2020-01-28,"(579.5, 660.25]",1,1,0
31091.0,2020-01-28,"(866.5, 1081.25]",2,3,-1
31091.0,2020-01-28,"(1081.25, 1296.0]",3,2,1
31092.0,2020-01-28,"(859.0, 1051.0]",2,3,-1
31092.0,2020-01-28,"(1051.0, 1243.0]",2,3,-1
31093.0,2020-01-28,"(791.0, 928.5]",1,2,-1
,,,,2.0,
31095.0,2020-01-28,"(412.421, 557.75]",1,2,-1
31096.0,2020-01-28,"(871.25, 915.0]",1,1,0
31097.0,2020-01-28,"(551.402, 701.5]",1,1,0
31097.0,2020-01-28,"(1000.5, 1150.0]",2,2,0
31098.0,2020-01-28,"(431.046, 670.5]",5,11,-6
31098.0,2020-01-28,"(909.0, 1147.5]",9,14,-5
31098.0,2020-01-28,"(1147.5, 1386.0]",2,3,-1
31099.0,2020-01-28,"(1089.5, 1114.0]",1,1,0
31099.0,2020-01-28,"(1138.5, 1163.0]",1,1,0
31100.0,2020-01-28,"(366.956, 629.0]",14,16,-2
31100.0,2020-01-28,"(629.0, 890.0]",3,8,-5
31100.0,2020-01-28,"(890.0, 1151.0]",3,14,-11
31100.0,2020-01-28,"(1151.0, 1412.0]",3,8,-5
31101.0,2020-01-28,"(8.586, 363.5]",1,3,-2
31101.0,2020-01-28,"(363.5, 717.0]",7,41,-34
31101.0,2020-01-28,"(717.0, 1070.5]",29,37,-8
31101.0,2020-01-28,"(1070.5, 1424.0]",22,39,-17
31102.0,2020-01-28,"(27.712, 351.0]",1,1,0
31102.0,2020-01-28,"(351.0, 673.0]",1,21,-20
31102.0,2020-01-28,"(673.0, 995.0]",1,4,-3
31102.0,2020-01-28,"(995.0, 1317.0]",12,15,-3
31103.0,2020-01-28,"(9.601, 360.75]",1,1,0
31103.0,2020-01-28,"(360.75, 710.5]",1,42,-41
31103.0,2020-01-28,"(710.5, 1060.25]",3,10,-7
31103.0,2020-01-28,"(1060.25, 1410.0]",6,18,-12
31104.0,2020-01-28,"(350.75, 691.5]",5,3,2
31104.0,2020-01-28,"(691.5, 1032.25]",5,16,-11
31104.0,2020-01-28,"(1032.25, 1373.0]",22,16,6
31105.0,2020-01-28,"(920.5, 1179.75]",3,4,-1
31105.0,2020-01-28,"(1179.75, 1439.0]",3,1,2
31106.0,2020-01-28,"(690.25, 927.5]",2,7,-5
31106.0,2020-01-28,"(927.5, 1164.75]",1,3,-2
31106.0,2020-01-28,"(1164.75, 1402.0]",1,1,0
31107.0,2020-01-28,"(333.979, 590.25]",1,19,-18
31107.0,2020-01-28,"(590.25, 845.5]",4,8,-4
31107.0,2020-01-28,"(845.5, 1100.75]",11,18,-7
31107.0,2020-01-28,"(1100.75, 1356.0]",7,8,-1
31108.0,2020-01-28,"(344.075, 576.25]",4,26,-22
31108.0,2020-01-28,"(576.25, 807.5]",8,16,-8
31108.0,2020-01-28,"(807.5, 1038.75]",13,21,-8
31108.0,2020-01-28,"(1038.75, 1270.0]",14,19,-5
31109.0,2020-01-28,"(328.5, 655.0]",3,1,2
31109.0,2020-01-28,"(655.0, 981.5]",9,16,-7
31109.0,2020-01-28,"(981.5, 1308.0]",30,15,15
31110.0,2020-01-28,"(335.942, 601.5]",16,39,-23
31110.0,2020-01-28,"(601.5, 866.0]",6,11,-5
31110.0,2020-01-28,"(866.0, 1130.5]",16,32,-16
31110.0,2020-01-28,"(1130.5, 1395.0]",8,17,-9
31111.0,2020-01-28,"(349.959, 611.25]",8,21,-13
31111.0,2020-01-28,"(611.25, 871.5]",1,3,-2
31111.0,2020-01-28,"(871.5, 1131.75]",9,13,-4
31111.0,2020-01-28,"(1131.75, 1392.0]",8,13,-5
31112.0,2020-01-28,"(362.147, 576.25]",1,5,-4
31112.0,2020-01-28,"(789.5, 1002.75]",2,3,-1
31112.0,2020-01-28,"(1002.75, 1216.0]",5,6,-1
31113.0,2020-01-28,"(351.965, 611.75]",1,19,-18
31113.0,2020-01-28,"(611.75, 870.5]",1,8,-7
31113.0,2020-01-28,"(870.5, 1129.25]",4,7,-3
31113.0,2020-01-28,"(1129.25, 1388.0]",5,10,-5
31114.0,2020-01-28,"(13.606, 363.5]",2,3,-1
31114.0,2020-01-28,"(363.5, 712.0]",6,36,-30
31114.0,2020-01-28,"(712.0, 1060.5]",11,19,-8
31114.0,2020-01-28,"(1060.5, 1409.0]",19,31,-12
31115.0,2020-01-28,"(363.974, 621.5]",1,20,-19
31115.0,2020-01-28,"(621.5, 878.0]",1,4,-3
31115.0,2020-01-28,"(878.0, 1134.5]",7,11,-4
31115.0,2020-01-28,"(1134.5, 1391.0]",9,11,-2
31116.0,2020-01-28,"(40.643, 381.25]",4,5,-1
31116.0,2020-01-28,"(381.25, 720.5]",6,29,-23
31116.0,2020-01-28,"(720.5, 1059.75]",11,18,-7
31116.0,2020-01-28,"(1059.75, 1399.0]",22,33,-11
31117.0,2020-01-28,"(305.894, 583.5]",3,15,-12
31117.0,2020-01-28,"(583.5, 860.0]",5,9,-4
31117.0,2020-01-28,"(860.0, 1136.5]",7,17,-10
31117.0,2020-01-28,"(1136.5, 1413.0]",16,27,-11
31118.0,2020-01-28,"(3.6, 355.0]",1,1,0
31118.0,2020-01-28,"(355.0, 705.0]",2,11,-9
31118.0,2020-01-28,"(705.0, 1055.0]",7,9,-2
31118.0,2020-01-28,"(1055.0, 1405.0]",12,15,-3
31119.0,2020-01-28,"(253.945, 518.75]",2,17,-15
31119.0,2020-01-28,"(518.75, 782.5]",5,9,-4
31119.0,2020-01-28,"(782.5, 1046.25]",8,14,-6
31119.0,2020-01-28,"(1046.25, 1310.0]",19,28,-9
31120.0,2020-01-28,"(360.946, 625.5]",2,17,-15
31120.0,2020-01-28,"(625.5, 889.0]",1,4,-3
31120.0,2020-01-28,"(889.0, 1152.5]",8,11,-3
31120.0,2020-01-28,"(1152.5, 1416.0]",15,20,-5
31121.0,2020-01-28,"(351.987, 606.25]",15,21,-6
31121.0,2020-01-28,"(606.25, 859.5]",4,5,-1
31121.0,2020-01-28,"(859.5, 1112.75]",4,16,-12
31121.0,2020-01-28,"(1112.75, 1366.0]",7,11,-4
31122.0,2020-01-28,"(400.031, 643.25]",1,7,-6
31122.0,2020-01-28,"(643.25, 885.5]",2,2,0
31122.0,2020-01-28,"(885.5, 1127.75]",10,15,-5
31122.0,2020-01-28,"(1127.75, 1370.0]",9,14,-5
31123.0,2020-01-28,"(306.014, 553.5]",3,17,-14
31123.0,2020-01-28,"(553.5, 800.0]",3,10,-7
31123.0,2020-01-28,"(800.0, 1046.5]",2,4,-2
31123.0,2020-01-28,"(1046.5, 1293.0]",10,16,-6
31124.0,2020-01-28,"(2.571, 361.25]",2,2,0
31124.0,2020-01-28,"(361.25, 718.5]",21,60,-39
31124.0,2020-01-28,"(718.5, 1075.75]",16,39,-23
31124.0,2020-01-28,"(1075.75, 1433.0]",14,42,-28
31125.0,2020-01-28,"(364.971, 623.25]",5,24,-19
31125.0,2020-01-28,"(623.25, 880.5]",2,5,-3
31125.0,2020-01-28,"(880.5, 1137.75]",30,34,-4
31125.0,2020-01-28,"(1137.75, 1395.0]",6,9,-3
31126.0,2020-01-28,"(432.125, 651.75]",2,22,-20
31126.0,2020-01-28,"(651.75, 870.5]",5,7,-2
31126.0,2020-01-28,"(870.5, 1089.25]",9,18,-9
31126.0,2020-01-28,"(1089.25, 1308.0]",11,19,-8
31127.0,2020-01-28,"(343.938, 610.5]",8,11,-3
31127.0,2020-01-28,"(610.5, 876.0]",14,18,-4
31127.0,2020-01-28,"(876.0, 1141.5]",13,29,-16
31127.0,2020-01-28,"(1141.5, 1407.0]",2,15,-13
31128.0,2020-01-28,"(24.595, 377.25]",4,6,-2
31128.0,2020-01-28,"(377.25, 728.5]",28,40,-12
31128.0,2020-01-28,"(728.5, 1079.75]",16,28,-12
31128.0,2020-01-28,"(1079.75, 1431.0]",10,19,-9
31129.0,2020-01-28,"(408.073, 640.75]",11,17,-6
31129.0,2020-01-28,"(640.75, 872.5]",9,10,-1
31129.0,2020-01-28,"(872.5, 1104.25]",7,17,-10
31129.0,2020-01-28,"(1104.25, 1336.0]",4,6,-2
31130.0,2020-01-28,"(25.677, 357.75]",3,4,-1
31130.0,2020-01-28,"(357.75, 688.5]",5,17,-12
31130.0,2020-01-28,"(688.5, 1019.25]",3,7,-4
31130.0,2020-01-28,"(1019.25, 1350.0]",16,26,-10
31131.0,2020-01-28,"(446.142, 661.5]",1,15,-14
31131.0,2020-01-28,"(661.5, 876.0]",1,3,-2
31131.0,2020-01-28,"(876.0, 1090.5]",3,5,-2
31131.0,2020-01-28,"(1090.5, 1305.0]",6,8,-2
31200.0,2020-01-28,"(366.98, 623.0]",23,35,-12
31200.0,2020-01-28,"(623.0, 878.0]",7,14,-7
31200.0,2020-01-28,"(878.0, 1133.0]",20,43,-23
31200.0,2020-01-28,"(1133.0, 1388.0]",8,24,-16
31201.0,2020-01-28,"(754.361, 914.75]",8,20,-12
31201.0,2020-01-28,"(914.75, 1074.5]",8,15,-7
31201.0,2020-01-28,"(1234.25, 1394.0]",8,1,7
,,,,2.0,
31203.0,2020-01-28,"(359.5, 702.0]",23,5,18
31203.0,2020-01-28,"(702.0, 1044.5]",34,53,-19
31203.0,2020-01-28,"(1044.5, 1387.0]",40,52,-12
31204.0,2020-01-28,"(404.997, 656.75]",12,15,-3
31204.0,2020-01-28,"(656.75, 907.5]",4,8,-4
31204.0,2020-01-28,"(907.5, 1158.25]",5,21,-16
31204.0,2020-01-28,"(1158.25, 1409.0]",3,6,-3
31205.0,2020-01-28,"(51.621, 397.75]",1,2,-1
31205.0,2020-01-28,"(397.75, 742.5]",32,42,-10
31205.0,2020-01-28,"(742.5, 1087.25]",23,45,-22
31205.0,2020-01-28,"(1087.25, 1432.0]",4,26,-22
31206.0,2020-01-28,"(385.293, 562.75]",7,8,-1
31206.0,2020-01-28,"(562.75, 739.5]",2,3,-1
31206.0,2020-01-28,"(916.25, 1093.0]",2,1,1
31207.0,2020-01-28,"(468.094, 695.5]",3,11,-8
31207.0,2020-01-28,"(922.0, 1148.5]",1,1,0
31207.0,2020-01-28,"(1148.5, 1375.0]",6,3,3
31208.0,2020-01-28,"(385.071, 618.25]",10,12,-2
31208.0,2020-01-28,"(850.5, 1082.75]",4,1,3
31208.0,2020-01-28,"(1082.75, 1315.0]",3,16,-13
31209.0,2020-01-28,"(519.23, 712.5]",7,9,-2
31209.0,2020-01-28,"(905.0, 1097.5]",2,1,1
31209.0,2020-01-28,"(1097.5, 1290.0]",2,3,-1
31211.0,2020-01-28,"(450.207, 649.25]",14,15,-1
31211.0,2020-01-28,"(649.25, 847.5]",1,1,0
31211.0,2020-01-28,"(847.5, 1045.75]",1,3,-2
31211.0,2020-01-28,"(1045.75, 1244.0]",4,9,-5
31212.0,2020-01-28,"(362.995, 615.25]",33,51,-18
31212.0,2020-01-28,"(615.25, 866.5]",15,27,-12
31212.0,2020-01-28,"(866.5, 1117.75]",17,38,-21
31212.0,2020-01-28,"(1117.75, 1369.0]",7,17,-10
31213.0,2020-01-28,"(389.061, 624.75]",36,52,-16
31213.0,2020-01-28,"(624.75, 859.5]",1,4,-3
31213.0,2020-01-28,"(859.5, 1094.25]",17,27,-10
31213.0,2020-01-28,"(1094.25, 1329.0]",9,20,-11
31214.0,2020-01-28,"(301.914, 574.5]",10,34,-24
31214.0,2020-01-28,"(574.5, 846.0]",6,12,-6
31214.0,2020-01-28,"(846.0, 1117.5]",17,24,-7
31214.0,2020-01-28,"(1117.5, 1389.0]",21,26,-5
31215.0,2020-01-28,"(431.076, 663.0]",27,31,-4
31215.0,2020-01-28,"(663.0, 894.0]",7,12,-5
31215.0,2020-01-28,"(894.0, 1125.0]",7,13,-6
31216.0,2020-01-28,"(356.056, 593.0]",25,28,-3
31216.0,2020-01-28,"(593.0, 829.0]",3,8,-5
31216.0,2020-01-28,"(829.0, 1065.0]",6,16,-10
31216.0,2020-01-28,"(1065.0, 1301.0]",2,14,-12
31217.0,2020-01-28,"(323.238, 514.5]",7,8,-1
31217.0,2020-01-28,"(514.5, 705.0]",5,5,0
31217.0,2020-01-28,"(705.0, 895.5]",1,6,-5
31217.0,2020-01-28,"(895.5, 1086.0]",1,14,-13
31218.0,2020-01-28,"(334.176, 541.0]",13,30,-17
31218.0,2020-01-28,"(541.0, 747.0]",7,12,-5
31218.0,2020-01-28,"(747.0, 953.0]",4,5,-1
31218.0,2020-01-28,"(953.0, 1159.0]",8,16,-8
31219.0,2020-01-28,"(381.31, 554.5]",14,14,0
31219.0,2020-01-28,"(554.5, 727.0]",4,5,-1
31219.0,2020-01-28,"(727.0, 899.5]",2,4,-2
31220.0,2020-01-28,"(288.233, 480.75]",7,9,-2
31220.0,2020-01-28,"(480.75, 672.5]",10,10,0
31221.0,2020-01-28,"(384.039, 625.25]",32,40,-8
31221.0,2020-01-28,"(625.25, 865.5]",10,16,-6
31221.0,2020-01-28,"(865.5, 1105.75]",7,27,-20
31221.0,2020-01-28,"(1105.75, 1346.0]",6,17,-11
31222.0,2020-01-28,"(373.23, 566.5]",9,14,-5
31222.0,2020-01-28,"(566.5, 759.0]",17,24,-7
31222.0,2020-01-28,"(759.0, 951.5]",5,9,-4
31222.0,2020-01-28,"(951.5, 1144.0]",3,17,-14
31223.0,2020-01-28,"(47.648, 387.0]",1,2,-1
31223.0,2020-01-28,"(387.0, 725.0]",12,31,-19
31223.0,2020-01-28,"(725.0, 1063.0]",8,20,-12
31223.0,2020-01-28,"(1063.0, 1401.0]",13,23,-10
31224.0,2020-01-28,"(420.151, 633.25]",14,14,0
31224.0,2020-01-28,"(633.25, 845.5]",2,3,-1
31224.0,2020-01-28,"(845.5, 1057.75]",2,12,-10
31224.0,2020-01-28,"(1057.75, 1270.0]",3,9,-6
31225.0,2020-01-28,"(368.122, 588.5]",6,10,-4
31225.0,2020-01-28,"(588.5, 808.0]",2,4,-2
31225.0,2020-01-28,"(808.0, 1027.5]",4,11,-7
31225.0,2020-01-28,"(1027.5, 1247.0]",7,18,-11
31226.0,2020-01-28,"(345.969, 604.75]",3,8,-5
31226.0,2020-01-28,"(604.75, 862.5]",1,2,-1
31226.0,2020-01-28,"(862.5, 1120.25]",4,9,-5
31226.0,2020-01-28,"(1120.25, 1378.0]",3,4,-1
31227.0,2020-01-28,"(453.178, 659.5]",26,31,-5
31227.0,2020-01-28,"(659.5, 865.0]",9,14,-5
31227.0,2020-01-28,"(865.0, 1070.5]",4,15,-11
31227.0,2020-01-28,"(1070.5, 1276.0]",6,21,-15
31228.0,2020-01-28,"(365.952, 629.0]",27,37,-10
31228.0,2020-01-28,"(629.0, 891.0]",13,23,-10
31228.0,2020-01-28,"(891.0, 1153.0]",20,37,-17
31228.0,2020-01-28,"(1153.0, 1415.0]",8,22,-14
31229.0,2020-01-28,"(358.94, 625.0]",14,71,-57
31229.0,2020-01-28,"(625.0, 890.0]",9,16,-7
31229.0,2020-01-28,"(890.0, 1155.0]",35,55,-20
31229.0,2020-01-28,"(1155.0, 1420.0]",6,14,-8
31230.0,2020-01-28,"(330.984, 586.0]",55,61,-6
31230.0,2020-01-28,"(586.0, 840.0]",14,24,-10
31230.0,2020-01-28,"(840.0, 1094.0]",10,41,-31
31230.0,2020-01-28,"(1094.0, 1348.0]",4,18,-14
31231.0,2020-01-28,"(335.039, 576.25]",23,26,-3
31231.0,2020-01-28,"(576.25, 816.5]",5,10,-5
31231.0,2020-01-28,"(816.5, 1056.75]",8,19,-11
31232.0,2020-01-28,"(264.863, 550.25]",17,19,-2
31232.0,2020-01-28,"(550.25, 834.5]",13,18,-5
31232.0,2020-01-28,"(834.5, 1118.75]",14,32,-18
31232.0,2020-01-28,"(1118.75, 1403.0]",9,20,-11
31233.0,2020-01-28,"(319.979, 576.25]",32,36,-4
31233.0,2020-01-28,"(576.25, 831.5]",26,38,-12
31233.0,2020-01-28,"(831.5, 1086.75]",16,35,-19
31233.0,2020-01-28,"(1086.75, 1342.0]",5,21,-16
31234.0,2020-01-28,"(378.008, 627.0]",21,35,-14
31234.0,2020-01-28,"(627.0, 875.0]",4,13,-9
31234.0,2020-01-28,"(875.0, 1123.0]",23,36,-13
31234.0,2020-01-28,"(1123.0, 1371.0]",7,17,-10
31235.0,2020-01-28,"(497.429, 640.75]",8,8,0
31235.0,2020-01-28,"(783.5, 926.25]",5,2,3
31235.0,2020-01-28,"(926.25, 1069.0]",1,6,-5
31236.0,2020-01-28,"(385.75, 681.5]",20,1,19
31236.0,2020-01-28,"(681.5, 977.25]",12,25,-13
31236.0,2020-01-28,"(977.25, 1273.0]",3,21,-18
31237.0,2020-01-28,"(128.694, 456.5]",1,3,-2
31237.0,2020-01-28,"(456.5, 783.0]",13,30,-17
31237.0,2020-01-28,"(783.0, 1109.5]",16,27,-11
31237.0,2020-01-28,"(1109.5, 1436.0]",6,11,-5
31238.0,2020-01-28,"(53.676, 386.0]",1,1,0
31238.0,2020-01-28,"(386.0, 717.0]",15,16,-1
31238.0,2020-01-28,"(717.0, 1048.0]",6,14,-8
31238.0,2020-01-28,"(1048.0, 1379.0]",1,9,-8
31239.0,2020-01-28,"(424.35, 587.5]",28,29,-1
31239.0,2020-01-28,"(587.5, 750.0]",6,8,-2
31239.0,2020-01-28,"(750.0, 912.5]",3,8,-5
31239.0,2020-01-28,"(912.5, 1075.0]",2,22,-20
31240.0,2020-01-28,"(689.837, 730.75]",1,3,-2
31240.0,2020-01-28,"(812.25, 853.0]",3,2,1
31241.0,2020-01-28,"(277.95, 541.5]",15,36,-21
31241.0,2020-01-28,"(541.5, 804.0]",20,48,-28
31241.0,2020-01-28,"(804.0, 1066.5]",9,25,-16
31241.0,2020-01-28,"(1066.5, 1329.0]",16,35,-19
31242.0,2020-01-28,"(394.216, 591.0]",26,27,-1
31242.0,2020-01-28,"(591.0, 787.0]",4,6,-2
31242.0,2020-01-28,"(787.0, 983.0]",2,8,-6
31242.0,2020-01-28,"(983.0, 1179.0]",3,29,-26
31243.0,2020-01-28,"(376.018, 622.5]",23,26,-3
31243.0,2020-01-28,"(622.5, 868.0]",1,3,-2
31243.0,2020-01-28,"(868.0, 1113.5]",6,29,-23
31243.0,2020-01-28,"(1113.5, 1359.0]",1,3,-2
31244.0,2020-01-28,"(336.5, 669.0]",22,1,21
31244.0,2020-01-28,"(669.0, 1001.5]",3,30,-27
31244.0,2020-01-28,"(1001.5, 1334.0]",11,9,2
31245.0,2020-01-28,"(378.988, 633.0]",10,22,-12
31245.0,2020-01-28,"(633.0, 886.0]",10,16,-6
31245.0,2020-01-28,"(886.0, 1139.0]",9,26,-17
31245.0,2020-01-28,"(1139.0, 1392.0]",6,11,-5
31246.0,2020-01-28,"(409.034, 651.5]",10,16,-6
31246.0,2020-01-28,"(651.5, 893.0]",6,14,-8
31246.0,2020-01-28,"(893.0, 1134.5]",20,33,-13
31246.0,2020-01-28,"(1134.5, 1376.0]",7,12,-5
,,,,2.0,
31248.0,2020-01-28,"(356.18, 562.0]",12,18,-6
31248.0,2020-01-28,"(562.0, 767.0]",9,15,-6
31248.0,2020-01-28,"(767.0, 972.0]",10,19,-9
31248.0,2020-01-28,"(972.0, 1177.0]",9,21,-12
31249.0,2020-01-28,"(357.203, 557.25]",6,12,-6
31249.0,2020-01-28,"(557.25, 756.5]",3,6,-3
31249.0,2020-01-28,"(756.5, 955.75]",3,6,-3
31249.0,2020-01-28,"(955.75, 1155.0]",8,16,-8
31250.0,2020-01-28,"(458.076, 690.0]",18,23,-5
31250.0,2020-01-28,"(690.0, 921.0]",9,17,-8
31250.0,2020-01-28,"(921.0, 1152.0]",3,22,-19
31250.0,2020-01-28,"(1152.0, 1383.0]",2,5,-3
31251.0,2020-01-28,"(364.973, 622.75]",21,40,-19
31251.0,2020-01-28,"(622.75, 879.5]",6,11,-5
31251.0,2020-01-28,"(879.5, 1136.25]",8,27,-19
31251.0,2020-01-28,"(1136.25, 1393.0]",10,22,-12
31252.0,2020-01-28,"(461.213, 658.75]",20,23,-3
31252.0,2020-01-28,"(658.75, 855.5]",5,11,-6
31252.0,2020-01-28,"(855.5, 1052.25]",6,17,-11
31252.0,2020-01-28,"(1052.25, 1249.0]",1,12,-11
31253.0,2020-01-28,"(327.027, 571.25]",22,24,-2
31253.0,2020-01-28,"(571.25, 814.5]",5,9,-4
31253.0,2020-01-28,"(814.5, 1057.75]",9,21,-12
31253.0,2020-01-28,"(1057.75, 1301.0]",1,18,-17
31254.0,2020-01-28,"(409.097, 635.75]",25,28,-3
31254.0,2020-01-28,"(635.75, 861.5]",3,7,-4
31254.0,2020-01-28,"(861.5, 1087.25]",3,19,-16
31254.0,2020-01-28,"(1087.25, 1313.0]",1,10,-9
31255.0,2020-01-28,"(394.024, 639.0]",19,24,-5
31255.0,2020-01-28,"(639.0, 883.0]",1,3,-2
31255.0,2020-01-28,"(883.0, 1127.0]",5,16,-11
31255.0,2020-01-28,"(1127.0, 1371.0]",3,6,-3
31256.0,2020-01-28,"(266.898, 543.5]",8,9,-1
31256.0,2020-01-28,"(543.5, 819.0]",2,3,-1
31256.0,2020-01-28,"(819.0, 1094.5]",1,7,-6
31256.0,2020-01-28,"(1094.5, 1370.0]",6,13,-7
31257.0,2020-01-28,"(344.974, 602.5]",19,29,-10
31257.0,2020-01-28,"(602.5, 859.0]",16,27,-11
31257.0,2020-01-28,"(859.0, 1115.5]",18,32,-14
31257.0,2020-01-28,"(1115.5, 1372.0]",4,17,-13
31258.0,2020-01-28,"(434.291, 612.25]",6,14,-8
31258.0,2020-01-28,"(612.25, 789.5]",4,10,-6
31258.0,2020-01-28,"(789.5, 966.75]",7,11,-4
31258.0,2020-01-28,"(966.75, 1144.0]",2,6,-4
31259.0,2020-01-28,"(449.28, 630.0]",14,14,0
31259.0,2020-01-28,"(990.0, 1170.0]",1,2,-1
31260.0,2020-01-28,"(362.157, 573.75]",16,18,-2
31260.0,2020-01-28,"(573.75, 784.5]",4,5,-1
31260.0,2020-01-28,"(784.5, 995.25]",1,4,-3
31260.0,2020-01-28,"(995.25, 1206.0]",4,19,-15
31261.0,2020-01-28,"(390.327, 559.25]",8,8,0
31261.0,2020-01-28,"(559.25, 727.5]",1,2,-1
31261.0,2020-01-28,"(727.5, 895.75]",1,2,-1
31262.0,2020-01-28,"(327.923, 598.25]",9,10,-1
31262.0,2020-01-28,"(867.5, 1136.75]",3,1,2
31262.0,2020-01-28,"(1136.75, 1406.0]",3,11,-8
31263.0,2020-01-28,"(364.949, 628.75]",20,28,-8
31263.0,2020-01-28,"(628.75, 891.5]",4,12,-8
31263.0,2020-01-28,"(891.5, 1154.25]",8,23,-15
31263.0,2020-01-28,"(1154.25, 1417.0]",5,8,-3
31264.0,2020-01-28,"(329.016, 576.0]",11,15,-4
31264.0,2020-01-28,"(576.0, 822.0]",3,4,-1
31264.0,2020-01-28,"(822.0, 1068.0]",9,23,-14
31264.0,2020-01-28,"(1068.0, 1314.0]",1,8,-7
31265.0,2020-01-28,"(367.017, 613.75]",7,25,-18
31265.0,2020-01-28,"(613.75, 859.5]",5,12,-7
31265.0,2020-01-28,"(859.5, 1105.25]",20,34,-14
31265.0,2020-01-28,"(1105.25, 1351.0]",13,19,-6
31266.0,2020-01-28,"(12.661, 348.75]",1,2,-1
31266.0,2020-01-28,"(348.75, 683.5]",2,18,-16
31266.0,2020-01-28,"(683.5, 1018.25]",14,30,-16
31266.0,2020-01-28,"(1018.25, 1353.0]",21,31,-10
31267.0,2020-01-28,"(442.123, 662.25]",26,43,-17
31267.0,2020-01-28,"(662.25, 881.5]",3,17,-14
31267.0,2020-01-28,"(881.5, 1100.75]",14,26,-12
31267.0,2020-01-28,"(1100.75, 1320.0]",7,21,-14
31268.0,2020-01-28,"(362.952, 626.0]",11,38,-27
31268.0,2020-01-28,"(626.0, 888.0]",6,7,-1
31268.0,2020-01-28,"(888.0, 1150.0]",17,25,-8
31268.0,2020-01-28,"(1150.0, 1412.0]",15,21,-6
31269.0,2020-01-28,"(363.113, 585.75]",9,15,-6
31269.0,2020-01-28,"(585.75, 807.5]",5,10,-5
31269.0,2020-01-28,"(807.5, 1029.25]",4,10,-6
31269.0,2020-01-28,"(1029.25, 1251.0]",3,7,-4
31270.0,2020-01-28,"(378.125, 597.75]",15,24,-9
31270.0,2020-01-28,"(597.75, 816.5]",2,4,-2
31270.0,2020-01-28,"(816.5, 1035.25]",5,10,-5
31270.0,2020-01-28,"(1035.25, 1254.0]",8,14,-6
31271.0,2020-01-28,"(421.229, 614.75]",10,13,-3
31271.0,2020-01-28,"(614.75, 807.5]",12,18,-6
31271.0,2020-01-28,"(807.5, 1000.25]",10,20,-10
31271.0,2020-01-28,"(1000.25, 1193.0]",2,15,-13
31272.0,2020-01-28,"(304.033, 546.75]",24,26,-2
31272.0,2020-01-28,"(546.75, 788.5]",8,10,-2
31272.0,2020-01-28,"(788.5, 1030.25]",5,17,-12
31272.0,2020-01-28,"(1030.25, 1272.0]",2,8,-6
31273.0,2020-01-28,"(412.511, 535.25]",1,2,-1
31273.0,2020-01-28,"(779.75, 902.0]",1,1,0
31274.0,2020-01-28,"(394.987, 649.25]",18,23,-5
31274.0,2020-01-28,"(649.25, 902.5]",5,10,-5
31274.0,2020-01-28,"(902.5, 1155.75]",4,13,-9
31274.0,2020-01-28,"(1155.75, 1409.0]",2,8,-6
31275.0,2020-01-28,"(114.747, 429.25]",4,7,-3
31275.0,2020-01-28,"(429.25, 742.5]",20,34,-14
31275.0,2020-01-28,"(742.5, 1055.75]",8,19,-11
31275.0,2020-01-28,"(1055.75, 1369.0]",11,24,-13
31276.0,2020-01-28,"(430.173, 637.75]",18,22,-4
31276.0,2020-01-28,"(637.75, 844.5]",7,10,-3
31276.0,2020-01-28,"(844.5, 1051.25]",5,19,-14
31276.0,2020-01-28,"(1051.25, 1258.0]",2,16,-14
31277.0,2020-01-28,"(441.081, 671.75]",40,44,-4
31277.0,2020-01-28,"(671.75, 901.5]",8,13,-5
31277.0,2020-01-28,"(901.5, 1131.25]",7,33,-26
31277.0,2020-01-28,"(1131.25, 1361.0]",3,13,-10
31278.0,2020-01-28,"(369.041, 609.75]",7,28,-21
31278.0,2020-01-28,"(609.75, 849.5]",11,18,-7
31278.0,2020-01-28,"(849.5, 1089.25]",14,20,-6
31278.0,2020-01-28,"(1089.25, 1329.0]",3,5,-2
31279.0,2020-01-28,"(298.5, 593.0]",22,4,18
31279.0,2020-01-28,"(593.0, 887.5]",4,24,-20
31279.0,2020-01-28,"(887.5, 1182.0]",7,10,-3
31280.0,2020-01-28,"(354.975, 612.25]",7,28,-21
31280.0,2020-01-28,"(612.25, 868.5]",3,7,-4
31280.0,2020-01-28,"(868.5, 1124.75]",8,11,-3
31280.0,2020-01-28,"(1124.75, 1381.0]",7,9,-2
31000.0,2020-01-29,"(949.5, 1102.0]",2,1,1
31001.0,2020-01-29,"(1116.25, 1269.0]",1,1,0
31002.0,2020-01-29,"(445.215, 642.25]",2,5,-3
31002.0,2020-01-29,"(838.5, 1034.75]",2,3,-1
31002.0,2020-01-29,"(1034.75, 1231.0]",1,2,-1
31003.0,2020-01-29,"(3.836, 296.0]",1,1,0
31003.0,2020-01-29,"(296.0, 587.0]",3,5,-2
31003.0,2020-01-29,"(587.0, 878.0]",3,5,-2
31003.0,2020-01-29,"(878.0, 1169.0]",2,5,-3
31004.0,2020-01-29,"(942.5, 1096.0]",1,1,0
31005.0,2020-01-29,"(389.075, 621.25]",7,8,-1
31005.0,2020-01-29,"(621.25, 852.5]",1,1,0
31005.0,2020-01-29,"(852.5, 1083.75]",1,4,-3
31005.0,2020-01-29,"(1083.75, 1315.0]",1,6,-5
31006.0,2020-01-29,"(1051.0, 1089.0]",1,1,0
31006.0,2020-01-29,"(1089.0, 1127.0]",1,1,0
31007.0,2020-01-29,"(353.013, 600.75]",6,19,-13
31007.0,2020-01-29,"(600.75, 847.5]",5,8,-3
31007.0,2020-01-29,"(847.5, 1094.25]",14,28,-14
31007.0,2020-01-29,"(1094.25, 1341.0]",2,10,-8
31009.0,2020-01-29,"(507.424, 652.0]",5,5,0
31009.0,2020-01-29,"(940.0, 1084.0]",1,3,-2
31010.0,2020-01-29,"(712.0, 781.0]",2,1,1
31011.0,2020-01-29,"(442.272, 625.0]",5,7,-2
31011.0,2020-01-29,"(625.0, 807.0]",2,2,0
31011.0,2020-01-29,"(807.0, 989.0]",1,3,-2
31011.0,2020-01-29,"(989.0, 1171.0]",4,8,-4
31012.0,2020-01-29,"(357.085, 586.75]",5,5,0
31012.0,2020-01-29,"(586.75, 815.5]",2,3,-1
31012.0,2020-01-29,"(815.5, 1044.25]",1,7,-6
31012.0,2020-01-29,"(1044.25, 1273.0]",1,2,-1
31013.0,2020-01-29,"(397.015, 644.25]",1,3,-2
31013.0,2020-01-29,"(644.25, 890.5]",1,1,0
31013.0,2020-01-29,"(890.5, 1136.75]",2,3,-1
31013.0,2020-01-29,"(1136.75, 1383.0]",5,8,-3
31014.0,2020-01-29,"(114.686, 444.5]",3,4,-1
31014.0,2020-01-29,"(444.5, 773.0]",23,30,-7
31014.0,2020-01-29,"(773.0, 1101.5]",14,21,-7
31014.0,2020-01-29,"(1101.5, 1430.0]",8,13,-5
31015.0,2020-01-29,"(441.069, 674.75]",17,18,-1
31015.0,2020-01-29,"(674.75, 907.5]",1,3,-2
31015.0,2020-01-29,"(907.5, 1140.25]",6,10,-4
31016.0,2020-01-29,"(347.993, 600.75]",9,15,-6
31016.0,2020-01-29,"(600.75, 852.5]",2,5,-3
31016.0,2020-01-29,"(852.5, 1104.25]",7,13,-6
31016.0,2020-01-29,"(1104.25, 1356.0]",2,3,-1
31017.0,2020-01-29,"(456.243, 646.25]",4,7,-3
31017.0,2020-01-29,"(1024.75, 1214.0]",1,1,0
31018.0,2020-01-29,"(658.25, 883.5]",1,6,-5
31018.0,2020-01-29,"(883.5, 1108.75]",1,2,-1
31018.0,2020-01-29,"(1108.75, 1334.0]",2,1,1
31019.0,2020-01-29,"(693.293, 870.75]",1,2,-1
31020.0,2020-01-29,"(661.555, 773.25]",1,1,0
31020.0,2020-01-29,"(773.25, 884.5]",1,1,0
31021.0,2020-01-29,"(448.128, 667.0]",1,5,-4
31021.0,2020-01-29,"(667.0, 885.0]",2,3,-1
31021.0,2020-01-29,"(885.0, 1103.0]",4,9,-5
31021.0,2020-01-29,"(1103.0, 1321.0]",3,5,-2
31022.0,2020-01-29,"(364.25, 699.5]",2,1,1
31022.0,2020-01-29,"(699.5, 1034.75]",3,5,-2
31022.0,2020-01-29,"(1034.75, 1370.0]",2,4,-2
31023.0,2020-01-29,"(474.148, 688.0]",1,1,0
31023.0,2020-01-29,"(688.0, 901.0]",3,5,-2
31023.0,2020-01-29,"(901.0, 1114.0]",2,3,-1
31023.0,2020-01-29,"(1114.0, 1327.0]",1,3,-2
31024.0,2020-01-29,"(402.082, 632.5]",8,12,-4
31024.0,2020-01-29,"(862.0, 1091.5]",4,1,3
31024.0,2020-01-29,"(1091.5, 1321.0]",1,16,-15
31025.0,2020-01-29,"(775.0, 962.0]",1,2,-1
31025.0,2020-01-29,"(962.0, 1149.0]",2,4,-2
31026.0,2020-01-29,"(405.235, 597.25]",1,2,-1
31026.0,2020-01-29,"(597.25, 788.5]",1,2,-1
31026.0,2020-01-29,"(979.75, 1171.0]",4,1,3
31027.0,2020-01-29,"(1098.5, 1324.0]",1,2,-1
31028.0,2020-01-29,"(489.35, 652.5]",3,3,0
31029.0,2020-01-29,"(101.744, 417.0]",1,2,-1
31029.0,2020-01-29,"(417.0, 731.0]",1,9,-8
31029.0,2020-01-29,"(1045.0, 1359.0]",6,8,-2
31030.0,2020-01-29,"(342.034, 584.5]",1,8,-7
31030.0,2020-01-29,"(826.0, 1067.5]",2,4,-2
31030.0,2020-01-29,"(1067.5, 1309.0]",3,4,-1
31031.0,2020-01-29,"(425.061, 660.75]",3,10,-7
31031.0,2020-01-29,"(895.5, 1130.25]",3,4,-1
31031.0,2020-01-29,"(1130.25, 1365.0]",1,1,0
31032.0,2020-01-29,"(30.802, 331.5]",1,1,0
31032.0,2020-01-29,"(930.5, 1230.0]",1,2,-1
31033.0,2020-01-29,"(317.239, 508.25]",1,2,-1
31033.0,2020-01-29,"(888.75, 1079.0]",2,2,0
31034.0,2020-01-29,"(396.043, 636.25]",3,6,-3
31034.0,2020-01-29,"(636.25, 875.5]",1,1,0
31034.0,2020-01-29,"(875.5, 1114.75]",2,5,-3
31035.0,2020-01-29,"(829.5, 1016.25]",3,3,0
31035.0,2020-01-29,"(1016.25, 1203.0]",3,4,-1
31036.0,2020-01-29,"(591.0, 750.0]",1,4,-3
31036.0,2020-01-29,"(909.0, 1068.0]",3,2,1
31037.0,2020-01-29,"(413.193, 615.75]",13,17,-4
31037.0,2020-01-29,"(615.75, 817.5]",5,8,-3
31037.0,2020-01-29,"(817.5, 1019.25]",3,7,-4
31037.0,2020-01-29,"(1019.25, 1221.0]",3,13,-10
31038.0,2020-01-29,"(500.279, 681.25]",1,3,-2
31038.0,2020-01-29,"(681.25, 861.5]",3,4,-1
31038.0,2020-01-29,"(1041.75, 1222.0]",1,1,0
31039.0,2020-01-29,"(465.202, 665.5]",3,7,-4
31039.0,2020-01-29,"(865.0, 1064.5]",1,1,0
31039.0,2020-01-29,"(1064.5, 1264.0]",1,3,-2
31040.0,2020-01-29,"(443.124, 663.0]",4,4,0
31041.0,2020-01-29,"(453.369, 611.75]",2,3,-1
31041.0,2020-01-29,"(611.75, 769.5]",1,1,0
31041.0,2020-01-29,"(927.25, 1085.0]",2,1,1
31042.0,2020-01-29,"(446.363, 606.25]",11,13,-2
31042.0,2020-01-29,"(606.25, 765.5]",1,2,-1
31042.0,2020-01-29,"(765.5, 924.75]",4,4,0
31042.0,2020-01-29,"(924.75, 1084.0]",2,10,-8
31043.0,2020-01-29,"(401.135, 618.25]",1,2,-1
31043.0,2020-01-29,"(1050.75, 1267.0]",2,5,-3
31044.0,2020-01-29,"(414.013, 661.75]",3,5,-2
31044.0,2020-01-29,"(661.75, 908.5]",1,2,-1
31045.0,2020-01-29,"(709.25, 838.5]",1,2,-1
31045.0,2020-01-29,"(967.75, 1097.0]",1,1,0
31046.0,2020-01-29,"(730.5, 960.0]",1,1,0
31046.0,2020-01-29,"(960.0, 1189.5]",2,1,1
31046.0,2020-01-29,"(1189.5, 1419.0]",1,2,-1
31047.0,2020-01-29,"(345.985, 600.75]",16,25,-9
31047.0,2020-01-29,"(600.75, 854.5]",4,6,-2
31047.0,2020-01-29,"(854.5, 1108.25]",5,19,-14
31047.0,2020-01-29,"(1108.25, 1362.0]",2,6,-4
31048.0,2020-01-29,"(407.271, 590.25]",4,7,-3
31048.0,2020-01-29,"(954.75, 1137.0]",6,3,3
31049.0,2020-01-29,"(451.185, 655.75]",4,5,-1
31049.0,2020-01-29,"(1063.25, 1267.0]",1,1,0
,,,,1.0,
,,,,1.0,
31051.0,2020-01-29,"(613.5, 786.0]",1,6,-5
31051.0,2020-01-29,"(958.5, 1131.0]",6,2,4
31052.0,2020-01-29,"(519.273, 701.75]",3,4,-1
31052.0,2020-01-29,"(701.75, 883.5]",1,1,0
31052.0,2020-01-29,"(883.5, 1065.25]",1,3,-2
31052.0,2020-01-29,"(1065.25, 1247.0]",3,3,0
31053.0,2020-01-29,"(535.409, 683.75]",1,2,-1
31053.0,2020-01-29,"(979.25, 1127.0]",1,2,-1
31054.0,2020-01-29,"(946.0, 1014.0]",1,1,0
31055.0,2020-01-29,"(408.257, 594.75]",1,1,0
31055.0,2020-01-29,"(966.25, 1152.0]",3,5,-2
31056.0,2020-01-29,"(84.956, 347.0]",1,1,0
31056.0,2020-01-29,"(869.0, 1130.0]",1,2,-1
,,,,2.0,
31058.0,2020-01-29,"(1334.992, 1337.0]",1,1,0
31059.0,2020-01-29,"(314.259, 500.25]",1,3,-2
31059.0,2020-01-29,"(870.75, 1056.0]",2,2,0
31060.0,2020-01-29,"(320.75, 566.5]",1,1,0
31060.0,2020-01-29,"(566.5, 812.25]",1,1,0
31060.0,2020-01-29,"(812.25, 1058.0]",1,1,0
31061.0,2020-01-29,"(657.0, 876.0]",1,1,0
31062.0,2020-01-29,"(909.75, 1042.0]",3,1,2
31063.0,2020-01-29,"(746.881, 776.75]",1,1,0
31064.0,2020-01-29,"(585.413, 732.75]",1,2,-1
31064.0,2020-01-29,"(879.5, 1026.25]",4,7,-3
31064.0,2020-01-29,"(1026.25, 1173.0]",4,8,-4
31065.0,2020-01-29,"(577.0, 716.0]",1,1,0
31065.0,2020-01-29,"(855.0, 994.0]",1,1,0
31066.0,2020-01-29,"(853.5, 1057.0]",1,1,0
31067.0,2020-01-29,"(855.0, 1069.5]",2,2,0
31067.0,2020-01-29,"(1069.5, 1284.0]",3,3,0
31068.0,2020-01-29,"(767.25, 965.5]",1,1,0
31068.0,2020-01-29,"(1163.75, 1362.0]",1,1,0
31069.0,2020-01-29,"(783.0, 970.0]",1,5,-4
31069.0,2020-01-29,"(970.0, 1157.0]",3,1,2
31070.0,2020-01-29,"(998.0, 1175.0]",3,4,-1
31071.0,2020-01-29,"(302.026, 546.5]",2,5,-3
31071.0,2020-01-29,"(790.0, 1033.5]",2,1,1
31071.0,2020-01-29,"(1033.5, 1277.0]",10,2,8
31072.0,2020-01-29,"(738.0, 984.0]",2,1,1
31073.0,2020-01-29,"(528.534, 645.5]",1,3,-2
31073.0,2020-01-29,"(878.5, 995.0]",1,3,-2
31074.0,2020-01-29,"(928.0, 1128.5]",4,1,3
31074.0,2020-01-29,"(1128.5, 1329.0]",2,6,-4
31075.0,2020-01-29,"(966.5, 1124.0]",1,1,0
31076.0,2020-01-29,"(424.23, 617.5]",1,1,0
31076.0,2020-01-29,"(810.0, 1002.5]",1,1,0
31076.0,2020-01-29,"(1002.5, 1195.0]",1,2,-1
31077.0,2020-01-29,"(409.034, 651.5]",1,5,-4
31077.0,2020-01-29,"(893.0, 1134.5]",14,2,12
31077.0,2020-01-29,"(1134.5, 1376.0]",2,20,-18
31078.0,2020-01-29,"(476.403, 626.25]",7,8,-1
31078.0,2020-01-29,"(924.75, 1074.0]",1,4,-3
31079.0,2020-01-29,"(461.057, 697.75]",4,16,-12
31079.0,2020-01-29,"(933.5, 1169.25]",4,6,-2
31079.0,2020-01-29,"(1169.25, 1405.0]",5,7,-2
31080.0,2020-01-29,"(382.99, 636.5]",1,11,-10
31080.0,2020-01-29,"(889.0, 1141.5]",4,5,-1
31080.0,2020-01-29,"(1141.5, 1394.0]",3,3,0
31081.0,2020-01-29,"(466.234, 658.5]",2,2,0
31081.0,2020-01-29,"(1041.5, 1233.0]",1,1,0
31082.0,2020-01-29,"(1087.5, 1105.0]",1,1,0
31083.0,2020-01-29,"(946.5, 1126.0]",6,2,4
31084.0,2020-01-29,"(588.454, 725.5]",6,8,-2
31084.0,2020-01-29,"(725.5, 862.0]",1,1,0
31084.0,2020-01-29,"(998.5, 1135.0]",1,7,-6
31085.0,2020-01-29,"(1024.25, 1194.0]",1,1,0
31086.0,2020-01-29,"(605.25, 793.5]",1,1,0
31086.0,2020-01-29,"(981.75, 1170.0]",4,2,2
31087.0,2020-01-29,"(906.0, 1062.0]",6,3,3
31088.0,2020-01-29,"(927.25, 1105.0]",6,3,3
31089.0,2020-01-29,"(381.026, 625.5]",9,13,-4
31089.0,2020-01-29,"(625.5, 869.0]",5,11,-6
31089.0,2020-01-29,"(869.0, 1112.5]",5,21,-16
31089.0,2020-01-29,"(1112.5, 1356.0]",1,10,-9
,,,,1.0,
,,,,1.0,
31091.0,2020-01-29,"(105.717, 427.75]",1,1,0
31091.0,2020-01-29,"(748.5, 1069.25]",2,6,-4
31091.0,2020-01-29,"(1069.25, 1390.0]",4,4,0
31092.0,2020-01-29,"(968.75, 1133.0]",2,4,-2
31093.0,2020-01-29,"(1048.5, 1264.0]",1,3,-2
31094.0,2020-01-29,"(372.75, 497.0]",1,1,0
,,,,1.0,
,,,,1.0,
31096.0,2020-01-29,"(485.339, 651.25]",1,3,-2
31096.0,2020-01-29,"(816.5, 981.75]",1,3,-2
31096.0,2020-01-29,"(981.75, 1147.0]",3,3,0
31097.0,2020-01-29,"(471.385, 625.75]",1,2,-1
31097.0,2020-01-29,"(779.5, 933.25]",1,1,0
31097.0,2020-01-29,"(933.25, 1087.0]",1,2,-1
31098.0,2020-01-29,"(418.121, 638.75]",9,17,-8
31098.0,2020-01-29,"(638.75, 858.5]",1,1,0
31098.0,2020-01-29,"(858.5, 1078.25]",4,12,-8
31098.0,2020-01-29,"(1078.25, 1298.0]",1,4,-3
31099.0,2020-01-29,"(748.5, 898.25]",1,1,0
31099.0,2020-01-29,"(898.25, 1048.0]",3,1,2
31100.0,2020-01-29,"(438.186, 642.5]",12,13,-1
31100.0,2020-01-29,"(642.5, 846.0]",4,8,-4
31100.0,2020-01-29,"(846.0, 1049.5]",5,16,-11
31100.0,2020-01-29,"(1049.5, 1253.0]",9,24,-15
31101.0,2020-01-29,"(42.66, 379.0]",2,4,-2
31101.0,2020-01-29,"(379.0, 714.0]",20,64,-44
31101.0,2020-01-29,"(714.0, 1049.0]",22,33,-11
31101.0,2020-01-29,"(1049.0, 1384.0]",37,60,-23
31102.0,2020-01-29,"(356.75, 698.5]",2,1,1
31102.0,2020-01-29,"(698.5, 1040.25]",3,26,-23
31102.0,2020-01-29,"(1040.25, 1382.0]",16,6,10
31103.0,2020-01-29,"(353.985, 608.75]",2,23,-21
31103.0,2020-01-29,"(608.75, 862.5]",3,13,-10
31103.0,2020-01-29,"(862.5, 1116.25]",11,22,-11
31103.0,2020-01-29,"(1116.25, 1370.0]",10,23,-13
31104.0,2020-01-29,"(361.75, 720.5]",6,3,3
31104.0,2020-01-29,"(720.5, 1079.25]",18,22,-4
31104.0,2020-01-29,"(1079.25, 1438.0]",20,30,-10
31105.0,2020-01-29,"(48.624, 394.0]",1,2,-1
31105.0,2020-01-29,"(394.0, 738.0]",2,10,-8
31105.0,2020-01-29,"(738.0, 1082.0]",5,11,-6
31105.0,2020-01-29,"(1082.0, 1426.0]",5,8,-3
31106.0,2020-01-29,"(372.955, 635.25]",1,5,-4
31106.0,2020-01-29,"(896.5, 1157.75]",6,6,0
31106.0,2020-01-29,"(1157.75, 1419.0]",3,5,-2
31107.0,2020-01-29,"(415.072, 648.0]",2,31,-29
31107.0,2020-01-29,"(648.0, 880.0]",2,11,-9
31107.0,2020-01-29,"(880.0, 1112.0]",12,22,-10
31107.0,2020-01-29,"(1112.0, 1344.0]",5,12,-7
31108.0,2020-01-29,"(333.985, 588.75]",6,28,-22
31108.0,2020-01-29,"(588.75, 842.5]",6,10,-4
31108.0,2020-01-29,"(842.5, 1096.25]",29,38,-9
31108.0,2020-01-29,"(1096.25, 1350.0]",5,10,-5
31109.0,2020-01-29,"(339.014, 586.5]",4,19,-15
31109.0,2020-01-29,"(586.5, 833.0]",3,6,-3
31109.0,2020-01-29,"(833.0, 1079.5]",10,16,-6
31109.0,2020-01-29,"(1079.5, 1326.0]",12,20,-8
31110.0,2020-01-29,"(334.935, 602.25]",16,35,-19
31110.0,2020-01-29,"(602.25, 868.5]",6,14,-8
31110.0,2020-01-29,"(868.5, 1134.75]",22,34,-12
31110.0,2020-01-29,"(1134.75, 1401.0]",10,20,-10
31111.0,2020-01-29,"(385.011, 633.25]",6,13,-7
31111.0,2020-01-29,"(633.25, 880.5]",2,7,-5
31111.0,2020-01-29,"(880.5, 1127.75]",11,20,-9
31111.0,2020-01-29,"(1127.75, 1375.0]",9,16,-7
31112.0,2020-01-29,"(592.0, 801.0]",1,4,-3
31112.0,2020-01-29,"(1010.0, 1219.0]",5,2,3
31113.0,2020-01-29,"(356.25, 681.5]",1,2,-1
31113.0,2020-01-29,"(681.5, 1006.75]",1,9,-8
31113.0,2020-01-29,"(1006.75, 1332.0]",14,4,10
31114.0,2020-01-29,"(46.673, 379.75]",1,2,-1
31114.0,2020-01-29,"(379.75, 711.5]",2,25,-23
31114.0,2020-01-29,"(711.5, 1043.25]",6,9,-3
31114.0,2020-01-29,"(1043.25, 1375.0]",30,42,-12
31115.0,2020-01-29,"(849.0, 1102.5]",4,19,-15
31115.0,2020-01-29,"(1102.5, 1356.0]",8,3,5
31116.0,2020-01-29,"(43.667, 378.25]",6,10,-4
31116.0,2020-01-29,"(378.25, 711.5]",4,25,-21
31116.0,2020-01-29,"(711.5, 1044.75]",5,9,-4
31116.0,2020-01-29,"(1044.75, 1378.0]",28,40,-12
31117.0,2020-01-29,"(303.876, 586.0]",3,25,-22
31117.0,2020-01-29,"(586.0, 867.0]",2,10,-8
31117.0,2020-01-29,"(867.0, 1148.0]",8,19,-11
31117.0,2020-01-29,"(1148.0, 1429.0]",8,15,-7
31118.0,2020-01-29,"(317.93, 586.5]",3,19,-16
31118.0,2020-01-29,"(586.5, 854.0]",1,2,-1
31118.0,2020-01-29,"(854.0, 1121.5]",11,15,-4
31118.0,2020-01-29,"(1121.5, 1389.0]",8,9,-1
31119.0,2020-01-29,"(5.61, 354.5]",1,1,0
31119.0,2020-01-29,"(354.5, 702.0]",3,18,-15
31119.0,2020-01-29,"(702.0, 1049.5]",9,15,-6
31119.0,2020-01-29,"(1049.5, 1397.0]",15,23,-8
31120.0,2020-01-29,"(405.014, 652.5]",1,17,-16
31120.0,2020-01-29,"(652.5, 899.0]",2,4,-2
31120.0,2020-01-29,"(899.0, 1145.5]",8,10,-2
31120.0,2020-01-29,"(1145.5, 1392.0]",8,12,-4
31121.0,2020-01-29,"(320.974, 578.5]",18,26,-8
31121.0,2020-01-29,"(578.5, 835.0]",4,5,-1
31121.0,2020-01-29,"(835.0, 1091.5]",4,15,-11
31121.0,2020-01-29,"(1091.5, 1348.0]",6,10,-4
31122.0,2020-01-29,"(366.981, 622.75]",1,12,-11
31122.0,2020-01-29,"(877.5, 1132.25]",8,1,7
31122.0,2020-01-29,"(1132.25, 1387.0]",13,13,0
31123.0,2020-01-29,"(351.959, 613.25]",2,23,-21
31123.0,2020-01-29,"(873.5, 1133.75]",5,9,-4
31123.0,2020-01-29,"(1133.75, 1394.0]",3,6,-3
31124.0,2020-01-29,"(332.909, 606.75]",21,38,-17
31124.0,2020-01-29,"(606.75, 879.5]",3,24,-21
31124.0,2020-01-29,"(879.5, 1152.25]",15,40,-25
31124.0,2020-01-29,"(1152.25, 1425.0]",10,21,-11
31125.0,2020-01-29,"(365.973, 623.75]",3,24,-21
31125.0,2020-01-29,"(623.75, 880.5]",4,8,-4
31125.0,2020-01-29,"(880.5, 1137.25]",19,27,-8
31125.0,2020-01-29,"(1137.25, 1394.0]",13,20,-7
31126.0,2020-01-29,"(329.893, 607.75]",3,24,-21
31126.0,2020-01-29,"(607.75, 884.5]",4,6,-2
31126.0,2020-01-29,"(884.5, 1161.25]",13,22,-9
31126.0,2020-01-29,"(1161.25, 1438.0]",11,18,-7
31127.0,2020-01-29,"(10.586, 365.5]",2,5,-3
31127.0,2020-01-29,"(365.5, 719.0]",12,15,-3
31127.0,2020-01-29,"(719.0, 1072.5]",18,30,-12
31127.0,2020-01-29,"(1072.5, 1426.0]",6,26,-20
31128.0,2020-01-29,"(86.754, 399.5]",5,9,-4
31128.0,2020-01-29,"(399.5, 711.0]",24,32,-8
31128.0,2020-01-29,"(711.0, 1022.5]",19,37,-18
31128.0,2020-01-29,"(1022.5, 1334.0]",14,32,-18
31129.0,2020-01-29,"(428.14, 644.0]",11,12,-1
31129.0,2020-01-29,"(644.0, 859.0]",1,5,-4
31129.0,2020-01-29,"(859.0, 1074.0]",5,10,-5
31129.0,2020-01-29,"(1074.0, 1289.0]",3,7,-4
31130.0,2020-01-29,"(343.076, 575.0]",2,8,-6
31130.0,2020-01-29,"(575.0, 806.0]",1,4,-3
31130.0,2020-01-29,"(806.0, 1037.0]",2,4,-2
31130.0,2020-01-29,"(1037.0, 1268.0]",7,9,-2
31131.0,2020-01-29,"(40.657, 377.75]",1,2,-1
31131.0,2020-01-29,"(377.75, 713.5]",3,21,-18
31131.0,2020-01-29,"(713.5, 1049.25]",3,7,-4
31131.0,2020-01-29,"(1049.25, 1385.0]",8,10,-2
31200.0,2020-01-29,"(20.662, 356.5]",1,2,-1
31200.0,2020-01-29,"(356.5, 691.0]",28,47,-19
31200.0,2020-01-29,"(691.0, 1025.5]",13,26,-13
31200.0,2020-01-29,"(1025.5, 1360.0]",18,38,-20
31201.0,2020-01-29,"(500.081, 730.75]",7,29,-22
31201.0,2020-01-29,"(730.75, 960.5]",22,39,-17
31201.0,2020-01-29,"(960.5, 1190.25]",31,59,-28
31201.0,2020-01-29,"(1190.25, 1420.0]",16,27,-11
,,,,2.0,
31203.0,2020-01-29,"(383.5, 731.0]",19,2,17
31203.0,2020-01-29,"(731.0, 1078.5]",24,38,-14
31203.0,2020-01-29,"(1078.5, 1426.0]",21,39,-18
31204.0,2020-01-29,"(380.75, 733.5]",17,1,16
31204.0,2020-01-29,"(733.5, 1086.25]",11,23,-12
31204.0,2020-01-29,"(1086.25, 1439.0]",11,26,-15
31205.0,2020-01-29,"(90.664, 426.0]",1,1,0
31205.0,2020-01-29,"(426.0, 760.0]",30,35,-5
31205.0,2020-01-29,"(760.0, 1094.0]",19,37,-18
31205.0,2020-01-29,"(1094.0, 1428.0]",2,22,-20
31206.0,2020-01-29,"(415.107, 639.25]",6,7,-1
31206.0,2020-01-29,"(639.25, 862.5]",1,3,-2
31206.0,2020-01-29,"(862.5, 1085.75]",1,6,-5
31207.0,2020-01-29,"(590.75, 797.5]",1,4,-3
31207.0,2020-01-29,"(797.5, 1004.25]",2,2,0
31207.0,2020-01-29,"(1004.25, 1211.0]",5,3,2
31208.0,2020-01-29,"(349.129, 567.75]",12,14,-2
31208.0,2020-01-29,"(785.5, 1003.25]",2,2,0
31208.0,2020-01-29,"(1003.25, 1221.0]",5,11,-6
31209.0,2020-01-29,"(389.162, 599.5]",4,6,-2
31209.0,2020-01-29,"(599.5, 809.0]",4,5,-1
31209.0,2020-01-29,"(1018.5, 1228.0]",3,1,2
31211.0,2020-01-29,"(313.953, 576.75]",11,12,-1
31211.0,2020-01-29,"(576.75, 838.5]",1,4,-3
31211.0,2020-01-29,"(838.5, 1100.25]",4,7,-3
31211.0,2020-01-29,"(1100.25, 1362.0]",3,14,-11
31212.0,2020-01-29,"(368.99, 622.5]",28,43,-15
31212.0,2020-01-29,"(622.5, 875.0]",17,25,-8
31212.0,2020-01-29,"(875.0, 1127.5]",9,22,-13
31212.0,2020-01-29,"(1127.5, 1380.0]",7,14,-7
31213.0,2020-01-29,"(8.617, 355.75]",1,2,-1
31213.0,2020-01-29,"(355.75, 701.5]",35,53,-18
31213.0,2020-01-29,"(701.5, 1047.25]",11,27,-16
31213.0,2020-01-29,"(1047.25, 1393.0]",15,31,-16
31214.0,2020-01-29,"(299.902, 575.5]",8,31,-23
31214.0,2020-01-29,"(575.5, 850.0]",13,21,-8
31214.0,2020-01-29,"(850.0, 1124.5]",19,26,-7
31214.0,2020-01-29,"(1124.5, 1399.0]",22,34,-12
31215.0,2020-01-29,"(14.633, 357.75]",4,8,-4
31215.0,2020-01-29,"(357.75, 699.5]",25,27,-2
31215.0,2020-01-29,"(699.5, 1041.25]",4,7,-3
31215.0,2020-01-29,"(1041.25, 1383.0]",4,17,-13
31216.0,2020-01-29,"(452.164, 662.0]",23,24,-1
31216.0,2020-01-29,"(662.0, 871.0]",2,5,-3
31216.0,2020-01-29,"(871.0, 1080.0]",5,12,-7
31216.0,2020-01-29,"(1080.0, 1289.0]",1,12,-11
31217.0,2020-01-29,"(322.972, 581.0]",12,14,-2
31217.0,2020-01-29,"(581.0, 838.0]",4,7,-3
31217.0,2020-01-29,"(838.0, 1095.0]",3,15,-12
31217.0,2020-01-29,"(1095.0, 1352.0]",1,1,0
31218.0,2020-01-29,"(361.981, 617.75]",17,34,-17
31218.0,2020-01-29,"(617.75, 872.5]",4,9,-5
31218.0,2020-01-29,"(872.5, 1127.25]",10,20,-10
31218.0,2020-01-29,"(1127.25, 1382.0]",2,4,-2
31219.0,2020-01-29,"(467.167, 676.25]",11,11,0
31219.0,2020-01-29,"(676.25, 884.5]",6,7,-1
31219.0,2020-01-29,"(1092.75, 1301.0]",6,7,-1
31220.0,2020-01-29,"(286.19, 489.5]",8,13,-5
31220.0,2020-01-29,"(489.5, 692.0]",12,13,-1
31220.0,2020-01-29,"(692.0, 894.5]",7,13,-6
31220.0,2020-01-29,"(894.5, 1097.0]",2,18,-16
31221.0,2020-01-29,"(409.01, 657.5]",35,38,-3
31221.0,2020-01-29,"(657.5, 905.0]",15,21,-6
31221.0,2020-01-29,"(905.0, 1152.5]",9,37,-28
31221.0,2020-01-29,"(1152.5, 1400.0]",2,6,-4
31222.0,2020-01-29,"(396.961, 657.75]",18,21,-3
31222.0,2020-01-29,"(657.75, 917.5]",4,4,0
31222.0,2020-01-29,"(917.5, 1177.25]",12,29,-17
31222.0,2020-01-29,"(1177.25, 1437.0]",1,3,-2
31223.0,2020-01-29,"(51.638, 393.5]",2,3,-1
31223.0,2020-01-29,"(393.5, 734.0]",15,40,-25
31223.0,2020-01-29,"(734.0, 1074.5]",8,17,-9
31223.0,2020-01-29,"(1074.5, 1415.0]",8,20,-12
31224.0,2020-01-29,"(462.225, 656.75]",11,12,-1
31224.0,2020-01-29,"(656.75, 850.5]",1,2,-1
31224.0,2020-01-29,"(850.5, 1044.25]",1,8,-7
31224.0,2020-01-29,"(1044.25, 1238.0]",3,17,-14
31225.0,2020-01-29,"(428.134, 645.5]",4,10,-6
31225.0,2020-01-29,"(645.5, 862.0]",2,6,-4
31225.0,2020-01-29,"(862.0, 1078.5]",7,16,-9
31225.0,2020-01-29,"(1078.5, 1295.0]",5,8,-3
31226.0,2020-01-29,"(303.069, 536.75]",2,5,-3
31226.0,2020-01-29,"(536.75, 769.5]",1,5,-4
31226.0,2020-01-29,"(769.5, 1002.25]",4,6,-2
31226.0,2020-01-29,"(1002.25, 1235.0]",6,13,-7
31227.0,2020-01-29,"(16.726, 336.5]",1,2,-1
31227.0,2020-01-29,"(336.5, 655.0]",29,36,-7
31227.0,2020-01-29,"(655.0, 973.5]",12,17,-5
31227.0,2020-01-29,"(973.5, 1292.0]",6,27,-21
31228.0,2020-01-29,"(353.25, 703.5]",23,2,21
31228.0,2020-01-29,"(703.5, 1053.75]",15,37,-22
31228.0,2020-01-29,"(1053.75, 1404.0]",15,28,-13
31229.0,2020-01-29,"(13.584, 369.0]",1,4,-3
31229.0,2020-01-29,"(369.0, 723.0]",12,67,-55
31229.0,2020-01-29,"(723.0, 1077.0]",36,59,-23
31229.0,2020-01-29,"(1077.0, 1431.0]",21,42,-21
31230.0,2020-01-29,"(361.106, 585.5]",50,63,-13
31230.0,2020-01-29,"(585.5, 809.0]",7,11,-4
31230.0,2020-01-29,"(809.0, 1032.5]",11,20,-9
31230.0,2020-01-29,"(1032.5, 1256.0]",9,35,-26
31231.0,2020-01-29,"(391.179, 597.25]",26,30,-4
31231.0,2020-01-29,"(597.25, 802.5]",4,9,-5
31231.0,2020-01-29,"(802.5, 1007.75]",4,10,-6
31231.0,2020-01-29,"(1007.75, 1213.0]",5,20,-15
31232.0,2020-01-29,"(296.913, 569.75]",14,27,-13
31232.0,2020-01-29,"(569.75, 841.5]",13,20,-7
31232.0,2020-01-29,"(841.5, 1113.25]",19,33,-14
31232.0,2020-01-29,"(1113.25, 1385.0]",10,26,-16
31233.0,2020-01-29,"(408.052, 646.0]",36,41,-5
31233.0,2020-01-29,"(646.0, 883.0]",8,16,-8
31233.0,2020-01-29,"(883.0, 1120.0]",13,33,-20
31233.0,2020-01-29,"(1120.0, 1357.0]",1,7,-6
31234.0,2020-01-29,"(384.06, 620.0]",16,27,-11
31234.0,2020-01-29,"(620.0, 855.0]",8,14,-6
31234.0,2020-01-29,"(855.0, 1090.0]",17,26,-9
31234.0,2020-01-29,"(1090.0, 1325.0]",12,26,-14
31235.0,2020-01-29,"(384.187, 588.25]",4,5,-1
31235.0,2020-01-29,"(588.25, 791.5]",4,6,-2
31235.0,2020-01-29,"(791.5, 994.75]",6,9,-3
31235.0,2020-01-29,"(994.75, 1198.0]",3,7,-4
31236.0,2020-01-29,"(461.151, 674.25]",20,25,-5
31236.0,2020-01-29,"(674.25, 886.5]",10,19,-9
31236.0,2020-01-29,"(886.5, 1098.75]",12,33,-21
31236.0,2020-01-29,"(1098.75, 1311.0]",4,15,-11
31237.0,2020-01-29,"(404.978, 661.5]",8,17,-9
31237.0,2020-01-29,"(661.5, 917.0]",9,19,-10
31237.0,2020-01-29,"(917.0, 1172.5]",11,22,-11
31237.0,2020-01-29,"(1172.5, 1428.0]",4,6,-2
31238.0,2020-01-29,"(57.732, 376.0]",1,1,0
31238.0,2020-01-29,"(376.0, 693.0]",16,18,-2
31238.0,2020-01-29,"(693.0, 1010.0]",4,9,-5
31238.0,2020-01-29,"(1010.0, 1327.0]",7,28,-21
31239.0,2020-01-29,"(327.949, 591.75]",24,27,-3
31239.0,2020-01-29,"(591.75, 854.5]",6,13,-7
31239.0,2020-01-29,"(854.5, 1117.25]",10,28,-18
31239.0,2020-01-29,"(1117.25, 1380.0]",6,13,-7
31240.0,2020-01-29,"(690.669, 773.75]",3,3,0
31241.0,2020-01-29,"(275.931, 544.25]",10,26,-16
31241.0,2020-01-29,"(544.25, 811.5]",15,28,-13
31241.0,2020-01-29,"(811.5, 1078.75]",10,21,-11
31241.0,2020-01-29,"(1078.75, 1346.0]",14,33,-19
31242.0,2020-01-29,"(400.259, 586.25]",26,27,-1
31242.0,2020-01-29,"(586.25, 771.5]",4,6,-2
31242.0,2020-01-29,"(771.5, 956.75]",3,13,-10
31242.0,2020-01-29,"(956.75, 1142.0]",4,27,-23
31243.0,2020-01-29,"(385.067, 619.25]",28,35,-7
31243.0,2020-01-29,"(619.25, 852.5]",9,11,-2
31243.0,2020-01-29,"(852.5, 1085.75]",6,23,-17
31243.0,2020-01-29,"(1085.75, 1319.0]",2,10,-8
31244.0,2020-01-29,"(60.624, 406.0]",1,3,-2
31244.0,2020-01-29,"(406.0, 750.0]",19,36,-17
31244.0,2020-01-29,"(750.0, 1094.0]",8,21,-13
31244.0,2020-01-29,"(1094.0, 1438.0]",4,9,-5
31245.0,2020-01-29,"(336.975, 594.25]",10,20,-10
31245.0,2020-01-29,"(594.25, 850.5]",2,7,-5
31245.0,2020-01-29,"(850.5, 1106.75]",7,14,-7
31245.0,2020-01-29,"(1106.75, 1363.0]",4,8,-4
31246.0,2020-01-29,"(351.034, 593.5]",8,15,-7
31246.0,2020-01-29,"(593.5, 835.0]",7,11,-4
31246.0,2020-01-29,"(835.0, 1076.5]",4,11,-7
31246.0,2020-01-29,"(1076.5, 1318.0]",13,19,-6
31247.0,2020-01-29,"(419.087, 648.25]",7,15,-8
31247.0,2020-01-29,"(648.25, 876.5]",4,9,-5
31247.0,2020-01-29,"(876.5, 1104.75]",3,9,-6
31248.0,2020-01-29,"(357.002, 607.5]",13,22,-9
31248.0,2020-01-29,"(607.5, 857.0]",5,14,-9
31248.0,2020-01-29,"(857.0, 1106.5]",16,28,-12
31248.0,2020-01-29,"(1106.5, 1356.0]",6,11,-5
31249.0,2020-01-29,"(416.017, 662.75]",6,11,-5
31249.0,2020-01-29,"(662.75, 908.5]",2,3,-1
31249.0,2020-01-29,"(908.5, 1154.25]",13,26,-13
31249.0,2020-01-29,"(1154.25, 1400.0]",2,3,-1
31250.0,2020-01-29,"(12.581, 368.75]",1,1,0
31250.0,2020-01-29,"(368.75, 723.5]",22,29,-7
31250.0,2020-01-29,"(723.5, 1078.25]",11,24,-13
31250.0,2020-01-29,"(1078.25, 1433.0]",2,17,-15
31251.0,2020-01-29,"(399.062, 634.5]",22,40,-18
31251.0,2020-01-29,"(634.5, 869.0]",9,17,-8
31251.0,2020-01-29,"(869.0, 1103.5]",15,30,-15
31251.0,2020-01-29,"(1103.5, 1338.0]",11,22,-11
31252.0,2020-01-29,"(472.119, 693.25]",19,20,-1
31252.0,2020-01-29,"(693.25, 913.5]",2,4,-2
31252.0,2020-01-29,"(913.5, 1133.75]",3,16,-13
31252.0,2020-01-29,"(1133.75, 1354.0]",1,4,-3
31253.0,2020-01-29,"(356.053, 593.75]",22,23,-1
31253.0,2020-01-29,"(593.75, 830.5]",4,8,-4
31253.0,2020-01-29,"(830.5, 1067.25]",8,21,-13
31253.0,2020-01-29,"(1067.25, 1304.0]",1,10,-9
31254.0,2020-01-29,"(399.083, 629.25]",26,29,-3
31254.0,2020-01-29,"(629.25, 858.5]",2,3,-1
31254.0,2020-01-29,"(858.5, 1087.75]",3,29,-26
31254.0,2020-01-29,"(1087.75, 1317.0]",2,5,-3
31255.0,2020-01-29,"(386.119, 607.25]",12,19,-7
31255.0,2020-01-29,"(607.25, 827.5]",2,2,0
31255.0,2020-01-29,"(827.5, 1047.75]",2,14,-12
31255.0,2020-01-29,"(1047.75, 1268.0]",5,13,-8
31256.0,2020-01-29,"(269.894, 547.5]",14,15,-1
31256.0,2020-01-29,"(547.5, 824.0]",4,9,-5
31256.0,2020-01-29,"(824.0, 1100.5]",8,21,-13
31256.0,2020-01-29,"(1100.5, 1377.0]",2,4,-2
31257.0,2020-01-29,"(342.913, 615.75]",27,41,-14
31257.0,2020-01-29,"(615.75, 887.5]",11,20,-9
31257.0,2020-01-29,"(887.5, 1159.25]",16,44,-28
31257.0,2020-01-29,"(1159.25, 1431.0]",3,7,-4
31258.0,2020-01-29,"(79.805, 379.75]",7,11,-4
31258.0,2020-01-29,"(379.75, 678.5]",12,28,-16
31258.0,2020-01-29,"(678.5, 977.25]",4,14,-10
31258.0,2020-01-29,"(977.25, 1276.0]",12,19,-7
31259.0,2020-01-29,"(337.75, 624.5]",10,1,9
31259.0,2020-01-29,"(624.5, 911.25]",1,11,-10
31259.0,2020-01-29,"(911.25, 1198.0]",3,4,-1
31260.0,2020-01-29,"(389.055, 626.25]",17,20,-3
31260.0,2020-01-29,"(626.25, 862.5]",1,7,-6
31260.0,2020-01-29,"(862.5, 1098.75]",2,17,-15
31260.0,2020-01-29,"(1098.75, 1335.0]",4,9,-5
31261.0,2020-01-29,"(403.163, 613.25]",9,9,0
31261.0,2020-01-29,"(822.5, 1031.75]",4,10,-6
31262.0,2020-01-29,"(401.06, 637.0]",11,12,-1
31262.0,2020-01-29,"(637.0, 872.0]",1,3,-2
31262.0,2020-01-29,"(872.0, 1107.0]",4,7,-3
31262.0,2020-01-29,"(1107.0, 1342.0]",3,8,-5
31263.0,2020-01-29,"(342.924, 613.0]",24,38,-14
31263.0,2020-01-29,"(613.0, 882.0]",6,13,-7
31263.0,2020-01-29,"(882.0, 1151.0]",9,28,-19
31263.0,2020-01-29,"(1151.0, 1420.0]",5,10,-5
31264.0,2020-01-29,"(355.962, 616.5]",11,16,-5
31264.0,2020-01-29,"(616.5, 876.0]",9,14,-5
31264.0,2020-01-29,"(876.0, 1135.5]",6,18,-12
31264.0,2020-01-29,"(1135.5, 1395.0]",4,9,-5
31265.0,2020-01-29,"(394.009, 642.75]",16,38,-22
31265.0,2020-01-29,"(642.75, 890.5]",9,16,-7
31265.0,2020-01-29,"(890.5, 1138.25]",21,36,-15
31265.0,2020-01-29,"(1138.25, 1386.0]",13,23,-10
31266.0,2020-01-29,"(291.923, 562.25]",6,28,-22
31266.0,2020-01-29,"(562.25, 831.5]",5,9,-4
31266.0,2020-01-29,"(831.5, 1100.75]",7,22,-15
31266.0,2020-01-29,"(1100.75, 1370.0]",17,23,-6
31267.0,2020-01-29,"(478.135, 695.25]",25,39,-14
31267.0,2020-01-29,"(695.25, 911.5]",7,15,-8
31267.0,2020-01-29,"(911.5, 1127.75]",18,29,-11
31267.0,2020-01-29,"(1127.75, 1344.0]",6,16,-10
31268.0,2020-01-29,"(404.021, 649.75]",9,38,-29
31268.0,2020-01-29,"(649.75, 894.5]",6,12,-6
31268.0,2020-01-29,"(894.5, 1139.25]",21,28,-7
31268.0,2020-01-29,"(1139.25, 1384.0]",18,26,-8
31269.0,2020-01-29,"(379.067, 613.25]",8,11,-3
31269.0,2020-01-29,"(613.25, 846.5]",2,10,-8
31269.0,2020-01-29,"(846.5, 1079.75]",6,9,-3
31269.0,2020-01-29,"(1079.75, 1313.0]",7,9,-2
31270.0,2020-01-29,"(406.156, 618.0]",13,24,-11
31270.0,2020-01-29,"(829.0, 1040.0]",3,6,-3
31270.0,2020-01-29,"(1040.0, 1251.0]",4,13,-9
31271.0,2020-01-29,"(391.179, 597.25]",16,20,-4
31271.0,2020-01-29,"(597.25, 802.5]",3,5,-2
31271.0,2020-01-29,"(802.5, 1007.75]",5,11,-6
31271.0,2020-01-29,"(1007.75, 1213.0]",4,11,-7
31272.0,2020-01-29,"(307.07, 540.5]",21,22,-1
31272.0,2020-01-29,"(540.5, 773.0]",14,17,-3
31272.0,2020-01-29,"(773.0, 1005.5]",7,14,-7
31272.0,2020-01-29,"(1005.5, 1238.0]",3,16,-13
31273.0,2020-01-29,"(619.5, 724.0]",1,2,-1
31273.0,2020-01-29,"(724.0, 828.5]",2,2,0
31273.0,2020-01-29,"(828.5, 933.0]",7,10,-3
31274.0,2020-01-29,"(401.974, 659.5]",17,20,-3
31274.0,2020-01-29,"(659.5, 916.0]",1,4,-3
31274.0,2020-01-29,"(916.0, 1172.5]",5,17,-12
31274.0,2020-01-29,"(1172.5, 1429.0]",3,7,-4
31275.0,2020-01-29,"(4.619, 351.25]",2,2,0
31275.0,2020-01-29,"(351.25, 696.5]",14,27,-13
31275.0,2020-01-29,"(696.5, 1041.75]",14,30,-16
31275.0,2020-01-29,"(1041.75, 1387.0]",17,37,-20
31276.0,2020-01-29,"(408.198, 609.5]",25,29,-4
31276.0,2020-01-29,"(609.5, 810.0]",3,4,-1
31276.0,2020-01-29,"(1010.5, 1211.0]",4,12,-8
31277.0,2020-01-29,"(348.982, 604.5]",40,45,-5
31277.0,2020-01-29,"(859.0, 1113.5]",13,2,11
31277.0,2020-01-29,"(1113.5, 1368.0]",4,46,-42
31278.0,2020-01-29,"(312.978, 569.5]",6,27,-21
31278.0,2020-01-29,"(569.5, 825.0]",8,12,-4
31278.0,2020-01-29,"(825.0, 1080.5]",13,25,-12
31278.0,2020-01-29,"(1080.5, 1336.0]",19,26,-7
31279.0,2020-01-29,"(425.027, 669.25]",26,32,-6
31279.0,2020-01-29,"(669.25, 912.5]",10,19,-9
31279.0,2020-01-29,"(912.5, 1155.75]",10,32,-22
31280.0,2020-01-29,"(399.07, 632.5]",6,20,-14
31280.0,2020-01-29,"(632.5, 865.0]",3,3,0
31280.0,2020-01-29,"(865.0, 1097.5]",11,17,-6
31280.0,2020-01-29,"(1097.5, 1330.0]",11,19,-8
,,,,2.0,
31001.0,2020-01-30,"(708.508, 832.0]",1,1,0
31001.0,2020-01-30,"(1078.0, 1201.0]",2,4,-2
31002.0,2020-01-30,"(457.185, 661.75]",2,4,-2
31002.0,2020-01-30,"(661.75, 865.5]",1,2,-1
31002.0,2020-01-30,"(865.5, 1069.25]",3,5,-2
31002.0,2020-01-30,"(1069.25, 1273.0]",2,2,0
31003.0,2020-01-30,"(585.75, 762.5]",3,2,1
31003.0,2020-01-30,"(762.5, 939.25]",2,5,-3
31003.0,2020-01-30,"(939.25, 1116.0]",2,3,-1
31004.0,2020-01-30,"(988.0, 1149.0]",1,1,0
31005.0,2020-01-30,"(424.247, 613.25]",5,7,-2
31005.0,2020-01-30,"(613.25, 801.5]",3,3,0
31005.0,2020-01-30,"(989.75, 1178.0]",2,8,-6
31006.0,2020-01-30,"(722.75, 885.5]",1,1,0
31006.0,2020-01-30,"(1048.25, 1211.0]",4,1,3
31007.0,2020-01-30,"(354.025, 598.75]",8,16,-8
31007.0,2020-01-30,"(598.75, 842.5]",2,6,-4
31007.0,2020-01-30,"(842.5, 1086.25]",8,17,-9
31007.0,2020-01-30,"(1086.25, 1330.0]",7,14,-7
31009.0,2020-01-30,"(517.488, 646.0]",3,3,0
31010.0,2020-01-30,"(446.457, 582.75]",1,2,-1
31011.0,2020-01-30,"(332.011, 580.25]",7,8,-1
31011.0,2020-01-30,"(580.25, 827.5]",3,5,-2
31011.0,2020-01-30,"(827.5, 1074.75]",3,4,-1
31012.0,2020-01-30,"(358.235, 550.25]",2,2,0
31012.0,2020-01-30,"(550.25, 741.5]",1,2,-1
31012.0,2020-01-30,"(932.75, 1124.0]",1,5,-4
31013.0,2020-01-30,"(620.25, 857.5]",1,3,-2
31013.0,2020-01-30,"(857.5, 1094.75]",3,3,0
31013.0,2020-01-30,"(1094.75, 1332.0]",3,4,-1
31014.0,2020-01-30,"(374.974, 632.5]",15,29,-14
31014.0,2020-01-30,"(632.5, 889.0]",6,9,-3
31014.0,2020-01-30,"(889.0, 1145.5]",15,22,-7
31014.0,2020-01-30,"(1145.5, 1402.0]",4,5,-1
31015.0,2020-01-30,"(306.163, 516.25]",9,13,-4
31015.0,2020-01-30,"(516.25, 725.5]",4,9,-5
31015.0,2020-01-30,"(934.75, 1144.0]",9,1,8
31016.0,2020-01-30,"(429.001, 679.75]",9,18,-9
31016.0,2020-01-30,"(679.75, 929.5]",1,2,-1
31016.0,2020-01-30,"(929.5, 1179.25]",2,4,-2
31016.0,2020-01-30,"(1179.25, 1429.0]",3,4,-1
31017.0,2020-01-30,"(272.25, 544.5]",3,1,2
31017.0,2020-01-30,"(544.5, 816.75]",3,4,-1
31018.0,2020-01-30,"(625.75, 817.5]",3,2,1
31018.0,2020-01-30,"(1009.25, 1201.0]",3,3,0
31019.0,2020-01-30,"(423.083, 653.25]",2,3,-1
31019.0,2020-01-30,"(653.25, 882.5]",1,1,0
31019.0,2020-01-30,"(882.5, 1111.75]",1,2,-1
31019.0,2020-01-30,"(1111.75, 1341.0]",1,6,-5
31020.0,2020-01-30,"(544.107, 768.25]",1,3,-2
31020.0,2020-01-30,"(1214.75, 1438.0]",1,5,-4
31021.0,2020-01-30,"(371.989, 625.75]",1,5,-4
31021.0,2020-01-30,"(878.5, 1131.25]",1,1,0
31021.0,2020-01-30,"(1131.25, 1384.0]",3,2,1
31022.0,2020-01-30,"(490.134, 707.5]",2,6,-4
31022.0,2020-01-30,"(707.5, 924.0]",1,2,-1
31022.0,2020-01-30,"(1140.5, 1357.0]",1,2,-1
31023.0,2020-01-30,"(758.417, 904.75]",1,1,0
31023.0,2020-01-30,"(1050.5, 1196.25]",1,1,0
31023.0,2020-01-30,"(1196.25, 1342.0]",1,1,0
31024.0,2020-01-30,"(423.084, 653.0]",9,13,-4
31024.0,2020-01-30,"(653.0, 882.0]",2,4,-2
31024.0,2020-01-30,"(882.0, 1111.0]",4,14,-10
31024.0,2020-01-30,"(1111.0, 1340.0]",3,6,-3
31025.0,2020-01-30,"(593.247, 782.25]",2,4,-2
31025.0,2020-01-30,"(970.5, 1158.75]",2,1,1
31025.0,2020-01-30,"(1158.75, 1347.0]",1,3,-2
31026.0,2020-01-30,"(398.118, 619.5]",1,2,-1
31026.0,2020-01-30,"(619.5, 840.0]",1,2,-1
31026.0,2020-01-30,"(1060.5, 1281.0]",4,1,3
31027.0,2020-01-30,"(583.5, 795.0]",1,4,-3
31027.0,2020-01-30,"(1006.5, 1218.0]",3,2,1
31028.0,2020-01-30,"(490.103, 715.25]",2,2,0
31028.0,2020-01-30,"(939.5, 1163.75]",1,1,0
31028.0,2020-01-30,"(1163.75, 1388.0]",1,4,-3
31029.0,2020-01-30,"(796.5, 973.75]",3,6,-3
31029.0,2020-01-30,"(973.75, 1151.0]",3,3,0
31030.0,2020-01-30,"(920.75, 1070.0]",3,9,-6
31031.0,2020-01-30,"(909.5, 1140.25]",2,2,0
31031.0,2020-01-30,"(1140.25, 1371.0]",1,4,-3
31032.0,2020-01-30,"(974.25, 1141.0]",1,2,-1
,,,,1.0,
,,,,1.0,
31034.0,2020-01-30,"(392.033, 634.75]",5,9,-4
31034.0,2020-01-30,"(876.5, 1118.25]",1,3,-2
31034.0,2020-01-30,"(1118.25, 1360.0]",2,5,-3
31035.0,2020-01-30,"(462.386, 616.5]",1,2,-1
31035.0,2020-01-30,"(770.0, 923.5]",1,2,-1
31035.0,2020-01-30,"(923.5, 1077.0]",2,3,-1
31036.0,2020-01-30,"(509.44, 650.0]",1,3,-2
31036.0,2020-01-30,"(930.0, 1070.0]",4,1,3
31037.0,2020-01-30,"(139.883, 420.25]",2,3,-1
31037.0,2020-01-30,"(420.25, 699.5]",8,12,-4
31037.0,2020-01-30,"(699.5, 978.75]",3,5,-2
31037.0,2020-01-30,"(978.75, 1258.0]",4,15,-11
31038.0,2020-01-30,"(851.25, 1119.0]",1,1,0
31039.0,2020-01-30,"(474.232, 667.0]",1,4,-3
31039.0,2020-01-30,"(667.0, 859.0]",2,5,-3
31039.0,2020-01-30,"(859.0, 1051.0]",4,7,-3
31039.0,2020-01-30,"(1051.0, 1243.0]",2,4,-2
31040.0,2020-01-30,"(448.411, 596.25]",2,2,0
31040.0,2020-01-30,"(743.5, 890.75]",1,1,0
31041.0,2020-01-30,"(977.726, 1046.5]",1,1,0
31041.0,2020-01-30,"(1183.5, 1252.0]",2,1,1
31042.0,2020-01-30,"(440.142, 655.5]",10,11,-1
31042.0,2020-01-30,"(655.5, 870.0]",2,2,0
31042.0,2020-01-30,"(870.0, 1084.5]",2,11,-9
31042.0,2020-01-30,"(1084.5, 1299.0]",4,7,-3
31043.0,2020-01-30,"(395.296, 572.0]",1,3,-2
31043.0,2020-01-30,"(924.0, 1100.0]",2,1,1
31044.0,2020-01-30,"(423.256, 610.0]",3,6,-3
31044.0,2020-01-30,"(796.0, 982.0]",2,1,1
31044.0,2020-01-30,"(982.0, 1168.0]",2,2,0
31045.0,2020-01-30,"(985.5, 1115.0]",3,1,2
31046.0,2020-01-30,"(436.194, 638.5]",1,2,-1
31046.0,2020-01-30,"(1041.5, 1243.0]",2,2,0
31047.0,2020-01-30,"(346.957, 608.75]",9,17,-8
31047.0,2020-01-30,"(608.75, 869.5]",1,1,0
31047.0,2020-01-30,"(869.5, 1130.25]",11,23,-12
31048.0,2020-01-30,"(511.272, 694.0]",2,8,-6
31048.0,2020-01-30,"(694.0, 876.0]",1,3,-2
31048.0,2020-01-30,"(876.0, 1058.0]",4,5,-1
31048.0,2020-01-30,"(1058.0, 1240.0]",1,6,-5
31049.0,2020-01-30,"(427.301, 602.75]",3,4,-1
31049.0,2020-01-30,"(952.25, 1127.0]",1,1,0
,,,,2.0,
31051.0,2020-01-30,"(714.5, 920.25]",1,4,-3
31051.0,2020-01-30,"(920.25, 1126.0]",7,2,5
31052.0,2020-01-30,"(448.256, 635.0]",1,3,-2
31052.0,2020-01-30,"(821.0, 1007.0]",1,1,0
31052.0,2020-01-30,"(1007.0, 1193.0]",2,1,1
,,,,1.0,
,,,,2.0,
31054.0,2020-01-30,"(777.5, 942.25]",1,1,0
31054.0,2020-01-30,"(942.25, 1107.0]",1,1,0
31055.0,2020-01-30,"(395.467, 529.25]",1,1,0
31055.0,2020-01-30,"(795.75, 929.0]",1,2,-1
31056.0,2020-01-30,"(702.75, 937.0]",1,1,0
31057.0,2020-01-30,"(814.974, 821.5]",1,1,0
31057.0,2020-01-30,"(834.5, 841.0]",1,1,0
,,,,2.0,
31059.0,2020-01-30,"(804.75, 1073.0]",2,1,1
31060.0,2020-01-30,"(469.416, 616.0]",1,1,0
31060.0,2020-01-30,"(616.0, 762.0]",1,1,0
31061.0,2020-01-30,"(737.807, 786.25]",1,1,0
31062.0,2020-01-30,"(733.966, 742.5]",1,1,0
31062.0,2020-01-30,"(759.5, 768.0]",1,1,0
31063.0,2020-01-30,"(86.073, 318.75]",1,2,-1
31063.0,2020-01-30,"(318.75, 550.5]",1,1,0
31063.0,2020-01-30,"(782.25, 1014.0]",1,1,0
31064.0,2020-01-30,"(469.376, 626.0]",1,3,-2
31064.0,2020-01-30,"(782.0, 938.0]",2,4,-2
31064.0,2020-01-30,"(938.0, 1094.0]",2,3,-1
31065.0,2020-01-30,"(691.5, 853.25]",1,2,-1
31066.0,2020-01-30,"(755.803, 805.25]",1,1,0
31066.0,2020-01-30,"(903.75, 953.0]",2,4,-2
31067.0,2020-01-30,"(357.03, 600.5]",2,4,-2
31067.0,2020-01-30,"(843.0, 1085.5]",2,3,-1
31067.0,2020-01-30,"(1085.5, 1328.0]",2,2,0
31068.0,2020-01-30,"(570.317, 741.75]",1,2,-1
31068.0,2020-01-30,"(741.75, 912.5]",1,3,-2
31069.0,2020-01-30,"(418.211, 616.25]",1,8,-7
31069.0,2020-01-30,"(616.25, 813.5]",2,3,-1
31069.0,2020-01-30,"(813.5, 1010.75]",2,5,-3
31069.0,2020-01-30,"(1010.75, 1208.0]",3,3,0
31070.0,2020-01-30,"(966.0, 1166.5]",1,1,0
31070.0,2020-01-30,"(1166.5, 1367.0]",3,1,2
31071.0,2020-01-30,"(326.061, 561.75]",1,3,-2
31071.0,2020-01-30,"(796.5, 1031.25]",3,2,1
31071.0,2020-01-30,"(1031.25, 1266.0]",5,7,-2
,,,,2.0,
31073.0,2020-01-30,"(477.456, 614.0]",3,5,-2
31073.0,2020-01-30,"(886.0, 1022.0]",1,1,0
31074.0,2020-01-30,"(834.0, 1008.5]",2,2,0
31074.0,2020-01-30,"(1008.5, 1183.0]",3,3,0
31075.0,2020-01-30,"(961.25, 1109.0]",1,1,0
,,,,2.0,
31077.0,2020-01-30,"(680.75, 853.5]",1,2,-1
31077.0,2020-01-30,"(1026.25, 1199.0]",2,2,0
31078.0,2020-01-30,"(479.404, 629.0]",4,4,0
31078.0,2020-01-30,"(629.0, 778.0]",1,3,-2
31078.0,2020-01-30,"(927.0, 1076.0]",1,1,0
31079.0,2020-01-30,"(2.604, 353.0]",1,1,0
31079.0,2020-01-30,"(353.0, 702.0]",1,10,-9
31079.0,2020-01-30,"(1051.0, 1400.0]",9,3,6
31080.0,2020-01-30,"(948.539, 1064.25]",1,2,-1
31080.0,2020-01-30,"(1064.25, 1179.5]",4,6,-2
31080.0,2020-01-30,"(1294.75, 1410.0]",3,3,0
31081.0,2020-01-30,"(475.264, 660.0]",3,4,-1
31081.0,2020-01-30,"(660.0, 844.0]",1,1,0
31081.0,2020-01-30,"(1028.0, 1212.0]",1,1,0
31082.0,2020-01-30,"(769.572, 877.0]",1,1,0
31082.0,2020-01-30,"(1091.0, 1198.0]",3,2,1
31083.0,2020-01-30,"(867.0, 1054.0]",1,1,0
31083.0,2020-01-30,"(1054.0, 1241.0]",3,1,2
31084.0,2020-01-30,"(567.389, 720.75]",6,6,0
31084.0,2020-01-30,"(720.75, 873.5]",2,3,-1
31085.0,2020-01-30,"(810.0, 991.0]",1,2,-1
31085.0,2020-01-30,"(991.0, 1172.0]",1,2,-1
31086.0,2020-01-30,"(834.5, 990.25]",2,1,1
31086.0,2020-01-30,"(990.25, 1146.0]",2,2,0
31087.0,2020-01-30,"(989.25, 1161.0]",1,1,0
31088.0,2020-01-30,"(438.107, 662.25]",1,3,-2
31088.0,2020-01-30,"(885.5, 1108.75]",3,4,-1
31088.0,2020-01-30,"(1108.75, 1332.0]",3,4,-1
31089.0,2020-01-30,"(446.129, 664.75]",9,13,-4
31089.0,2020-01-30,"(664.75, 882.5]",3,6,-3
31089.0,2020-01-30,"(882.5, 1100.25]",2,10,-8
31090.0,2020-01-30,"(324.0, 432.0]",1,1,0
31091.0,2020-01-30,"(41.9, 318.0]",1,1,0
31091.0,2020-01-30,"(868.0, 1143.0]",2,5,-3
31092.0,2020-01-30,"(1048.5, 1242.0]",2,2,0
31093.0,2020-01-30,"(1019.25, 1204.0]",1,3,-2
31094.0,2020-01-30,"(649.5, 866.0]",1,1,0
31095.0,2020-01-30,"(886.5, 1032.0]",1,3,-2
31096.0,2020-01-30,"(954.5, 1154.0]",2,2,0
31097.0,2020-01-30,"(541.147, 755.25]",2,2,0
31097.0,2020-01-30,"(968.5, 1181.75]",1,3,-2
31097.0,2020-01-30,"(1181.75, 1395.0]",1,2,-1
31098.0,2020-01-30,"(347.149, 560.75]",7,14,-7
31098.0,2020-01-30,"(560.75, 773.5]",3,4,-1
31098.0,2020-01-30,"(986.25, 1199.0]",11,20,-9
31099.0,2020-01-30,"(958.0, 1119.0]",3,1,2
31100.0,2020-01-30,"(442.276, 624.0]",15,16,-1
31100.0,2020-01-30,"(805.0, 986.0]",3,1,2
31101.0,2020-01-30,"(309.929, 578.75]",8,35,-27
31101.0,2020-01-30,"(578.75, 846.5]",10,24,-14
31101.0,2020-01-30,"(846.5, 1114.25]",26,34,-8
31101.0,2020-01-30,"(1114.25, 1382.0]",20,32,-12
31102.0,2020-01-30,"(-1.374, 343.5]",2,5,-3
31102.0,2020-01-30,"(343.5, 687.0]",3,21,-18
31102.0,2020-01-30,"(687.0, 1030.5]",1,5,-4
31102.0,2020-01-30,"(1030.5, 1374.0]",9,19,-10
31103.0,2020-01-30,"(163.815, 461.25]",1,4,-3
31103.0,2020-01-30,"(757.5, 1053.75]",4,21,-17
31103.0,2020-01-30,"(1053.75, 1350.0]",8,11,-3
31104.0,2020-01-30,"(362.0, 718.0]",10,3,7
31104.0,2020-01-30,"(718.0, 1074.0]",12,24,-12
31104.0,2020-01-30,"(1074.0, 1430.0]",16,23,-7
31105.0,2020-01-30,"(475.098, 701.5]",1,7,-6
31105.0,2020-01-30,"(701.5, 927.0]",1,6,-5
31105.0,2020-01-30,"(927.0, 1152.5]",1,4,-3
31106.0,2020-01-30,"(919.5, 1150.75]",5,7,-2
31106.0,2020-01-30,"(1150.75, 1382.0]",3,6,-3
31107.0,2020-01-30,"(345.923, 616.25]",4,24,-20
31107.0,2020-01-30,"(616.25, 885.5]",7,16,-9
31107.0,2020-01-30,"(885.5, 1154.75]",17,32,-15
31107.0,2020-01-30,"(1154.75, 1424.0]",6,16,-10
31108.0,2020-01-30,"(347.944, 613.0]",4,31,-27
31108.0,2020-01-30,"(613.0, 877.0]",6,12,-6
31108.0,2020-01-30,"(877.0, 1141.0]",22,33,-11
31108.0,2020-01-30,"(1141.0, 1405.0]",11,13,-2
31109.0,2020-01-30,"(388.986, 643.5]",4,14,-10
31109.0,2020-01-30,"(643.5, 897.0]",3,11,-8
31109.0,2020-01-30,"(897.0, 1150.5]",17,23,-6
31109.0,2020-01-30,"(1150.5, 1404.0]",9,17,-8
31110.0,2020-01-30,"(58.648, 398.0]",3,5,-2
31110.0,2020-01-30,"(398.0, 736.0]",15,41,-26
31110.0,2020-01-30,"(736.0, 1074.0]",10,19,-9
31110.0,2020-01-30,"(1074.0, 1412.0]",18,25,-7
31111.0,2020-01-30,"(62.624, 408.0]",4,5,-1
31111.0,2020-01-30,"(408.0, 752.0]",5,23,-18
31111.0,2020-01-30,"(752.0, 1096.0]",9,14,-5
31111.0,2020-01-30,"(1096.0, 1440.0]",12,23,-11
31112.0,2020-01-30,"(930.0, 1138.0]",3,3,0
31112.0,2020-01-30,"(1138.0, 1346.0]",1,5,-4
31113.0,2020-01-30,"(580.0, 847.0]",2,27,-25
31113.0,2020-01-30,"(847.0, 1114.0]",5,14,-9
31113.0,2020-01-30,"(1114.0, 1381.0]",5,11,-6
31114.0,2020-01-30,"(348.945, 613.75]",6,30,-24
31114.0,2020-01-30,"(613.75, 877.5]",3,6,-3
31114.0,2020-01-30,"(877.5, 1141.25]",18,25,-7
31114.0,2020-01-30,"(1141.25, 1405.0]",14,24,-10
31115.0,2020-01-30,"(146.801, 447.75]",2,10,-8
31115.0,2020-01-30,"(447.75, 747.5]",2,13,-11
31115.0,2020-01-30,"(747.5, 1047.25]",2,6,-4
31115.0,2020-01-30,"(1047.25, 1347.0]",12,17,-5
31116.0,2020-01-30,"(303.048, 542.0]",3,21,-18
31116.0,2020-01-30,"(542.0, 780.0]",3,8,-5
31116.0,2020-01-30,"(780.0, 1018.0]",8,11,-3
31116.0,2020-01-30,"(1018.0, 1256.0]",20,27,-7
31117.0,2020-01-30,"(377.095, 604.25]",1,17,-16
31117.0,2020-01-30,"(604.25, 830.5]",2,8,-6
31117.0,2020-01-30,"(830.5, 1056.75]",5,15,-10
31117.0,2020-01-30,"(1056.75, 1283.0]",11,24,-13
31118.0,2020-01-30,"(314.037, 555.75]",2,13,-11
31118.0,2020-01-30,"(555.75, 796.5]",2,7,-5
31118.0,2020-01-30,"(796.5, 1037.25]",6,9,-3
31118.0,2020-01-30,"(1037.25, 1278.0]",9,9,0
31119.0,2020-01-30,"(1.697, 328.75]",2,2,0
31119.0,2020-01-30,"(328.75, 654.5]",9,31,-22
31119.0,2020-01-30,"(654.5, 980.25]",9,16,-7
31119.0,2020-01-30,"(980.25, 1306.0]",24,39,-15
31120.0,2020-01-30,"(646.0, 898.0]",1,13,-12
31120.0,2020-01-30,"(898.0, 1150.0]",7,2,5
31120.0,2020-01-30,"(1150.0, 1402.0]",5,10,-5
31121.0,2020-01-30,"(421.041, 661.75]",17,23,-6
31121.0,2020-01-30,"(661.75, 901.5]",4,8,-4
31121.0,2020-01-30,"(901.5, 1141.25]",2,15,-13
31121.0,2020-01-30,"(1141.25, 1381.0]",6,11,-5
31122.0,2020-01-30,"(457.124, 677.0]",1,12,-11
31122.0,2020-01-30,"(677.0, 896.0]",3,7,-4
31122.0,2020-01-30,"(896.0, 1115.0]",5,8,-3
31122.0,2020-01-30,"(1115.0, 1334.0]",10,14,-4
31123.0,2020-01-30,"(310.998, 562.5]",2,21,-19
31123.0,2020-01-30,"(562.5, 813.0]",2,6,-4
31123.0,2020-01-30,"(813.0, 1063.5]",5,8,-3
31123.0,2020-01-30,"(1063.5, 1314.0]",5,8,-3
31124.0,2020-01-30,"(55.624, 401.0]",1,1,0
31124.0,2020-01-30,"(401.0, 745.0]",19,42,-23
31124.0,2020-01-30,"(745.0, 1089.0]",14,42,-28
31124.0,2020-01-30,"(1089.0, 1433.0]",15,42,-27
31125.0,2020-01-30,"(256.878, 538.5]",3,22,-19
31125.0,2020-01-30,"(538.5, 819.0]",4,8,-4
31125.0,2020-01-30,"(819.0, 1099.5]",17,28,-11
31125.0,2020-01-30,"(1099.5, 1380.0]",25,32,-7
31126.0,2020-01-30,"(418.99, 672.5]",2,23,-21
31126.0,2020-01-30,"(925.0, 1177.5]",17,1,16
31126.0,2020-01-30,"(1177.5, 1430.0]",8,29,-21
31127.0,2020-01-30,"(379.947, 644.25]",18,22,-4
31127.0,2020-01-30,"(644.25, 907.5]",5,10,-5
31127.0,2020-01-30,"(907.5, 1170.75]",12,26,-14
31127.0,2020-01-30,"(1170.75, 1434.0]",5,19,-14
31128.0,2020-01-30,"(102.808, 402.0]",2,3,-1
31128.0,2020-01-30,"(402.0, 700.0]",29,49,-20
31128.0,2020-01-30,"(700.0, 998.0]",18,37,-19
31128.0,2020-01-30,"(998.0, 1296.0]",25,44,-19
31129.0,2020-01-30,"(316.25, 595.5]",9,2,7
31129.0,2020-01-30,"(595.5, 874.75]",5,11,-6
31129.0,2020-01-30,"(874.75, 1154.0]",7,9,-2
31130.0,2020-01-30,"(322.996, 575.0]",1,10,-9
31130.0,2020-01-30,"(575.0, 826.0]",2,5,-3
31130.0,2020-01-30,"(826.0, 1077.0]",5,9,-4
31130.0,2020-01-30,"(1077.0, 1328.0]",6,10,-4
31131.0,2020-01-30,"(368.25, 682.5]",1,2,-1
31131.0,2020-01-30,"(682.5, 996.75]",2,17,-15
31131.0,2020-01-30,"(996.75, 1311.0]",4,5,-1
31200.0,2020-01-30,"(336.918, 608.5]",20,35,-15
31200.0,2020-01-30,"(608.5, 879.0]",8,16,-8
31200.0,2020-01-30,"(879.0, 1149.5]",16,33,-17
31200.0,2020-01-30,"(1149.5, 1420.0]",8,23,-15
31201.0,2020-01-30,"(259.843, 550.25]",20,41,-21
31201.0,2020-01-30,"(550.25, 839.5]",19,34,-15
31201.0,2020-01-30,"(839.5, 1128.75]",23,47,-24
31201.0,2020-01-30,"(1128.75, 1418.0]",20,49,-29
,,,,2.0,
31203.0,2020-01-30,"(302.875, 585.25]",12,29,-17
31203.0,2020-01-30,"(585.25, 866.5]",13,22,-9
31203.0,2020-01-30,"(866.5, 1147.75]",29,40,-11
31203.0,2020-01-30,"(1147.75, 1429.0]",6,8,-2
31204.0,2020-01-30,"(431.014, 678.5]",14,15,-1
31204.0,2020-01-30,"(678.5, 925.0]",2,13,-11
31204.0,2020-01-30,"(925.0, 1171.5]",6,19,-13
31204.0,2020-01-30,"(1171.5, 1418.0]",5,10,-5
31205.0,2020-01-30,"(416.024, 661.0]",23,24,-1
31205.0,2020-01-30,"(661.0, 905.0]",12,17,-5
31205.0,2020-01-30,"(905.0, 1149.0]",17,34,-17
31205.0,2020-01-30,"(1149.0, 1393.0]",3,19,-16
31206.0,2020-01-30,"(399.307, 573.25]",9,10,-1
31206.0,2020-01-30,"(573.25, 746.5]",1,1,0
31206.0,2020-01-30,"(919.75, 1093.0]",3,3,0
31207.0,2020-01-30,"(347.099, 573.25]",1,4,-3
31207.0,2020-01-30,"(573.25, 798.5]",4,7,-3
31207.0,2020-01-30,"(798.5, 1023.75]",1,5,-4
31207.0,2020-01-30,"(1023.75, 1249.0]",4,8,-4
31208.0,2020-01-30,"(386.257, 572.75]",14,16,-2
31208.0,2020-01-30,"(758.5, 944.25]",1,2,-1
31208.0,2020-01-30,"(944.25, 1130.0]",4,13,-9
31209.0,2020-01-30,"(454.157, 665.75]",4,5,-1
31209.0,2020-01-30,"(665.75, 876.5]",2,4,-2
31209.0,2020-01-30,"(876.5, 1087.25]",1,2,-1
31211.0,2020-01-30,"(498.214, 695.5]",8,8,0
31211.0,2020-01-30,"(695.5, 892.0]",1,2,-1
31211.0,2020-01-30,"(892.0, 1088.5]",6,13,-7
31211.0,2020-01-30,"(1088.5, 1285.0]",5,14,-9
31212.0,2020-01-30,"(345.939, 612.25]",38,50,-12
31212.0,2020-01-30,"(612.25, 877.5]",14,23,-9
31212.0,2020-01-30,"(877.5, 1142.75]",14,28,-14
31212.0,2020-01-30,"(1142.75, 1408.0]",10,13,-3
31213.0,2020-01-30,"(5.615, 353.25]",2,2,0
31213.0,2020-01-30,"(353.25, 699.5]",26,41,-15
31213.0,2020-01-30,"(699.5, 1045.75]",13,26,-13
31213.0,2020-01-30,"(1045.75, 1392.0]",13,33,-20
31214.0,2020-01-30,"(298.904, 574.0]",8,34,-26
31214.0,2020-01-30,"(574.0, 848.0]",3,6,-3
31214.0,2020-01-30,"(848.0, 1122.0]",26,34,-8
31214.0,2020-01-30,"(1122.0, 1396.0]",12,19,-7
31215.0,2020-01-30,"(464.165, 673.75]",19,19,0
31215.0,2020-01-30,"(673.75, 882.5]",3,7,-4
31215.0,2020-01-30,"(882.5, 1091.25]",3,12,-9
31215.0,2020-01-30,"(1091.25, 1300.0]",2,4,-2
31216.0,2020-01-30,"(320.902, 596.5]",22,25,-3
31216.0,2020-01-30,"(596.5, 871.0]",7,11,-4
31216.0,2020-01-30,"(871.0, 1145.5]",3,16,-13
31216.0,2020-01-30,"(1145.5, 1420.0]",4,9,-5
31217.0,2020-01-30,"(323.159, 534.25]",10,11,-1
31217.0,2020-01-30,"(534.25, 744.5]",4,6,-2
31217.0,2020-01-30,"(744.5, 954.75]",4,7,-3
31217.0,2020-01-30,"(954.75, 1165.0]",3,12,-9
31218.0,2020-01-30,"(337.057, 573.75]",16,34,-18
31218.0,2020-01-30,"(573.75, 809.5]",4,7,-3
31218.0,2020-01-30,"(809.5, 1045.25]",8,16,-8
31218.0,2020-01-30,"(1045.25, 1281.0]",6,14,-8
31219.0,2020-01-30,"(361.251, 549.25]",6,6,0
31219.0,2020-01-30,"(549.25, 736.5]",8,8,0
31219.0,2020-01-30,"(923.75, 1111.0]",6,4,2
31220.0,2020-01-30,"(288.231, 481.25]",5,8,-3
31220.0,2020-01-30,"(481.25, 673.5]",10,11,-1
31220.0,2020-01-30,"(673.5, 865.75]",4,8,-4
31220.0,2020-01-30,"(865.75, 1058.0]",3,17,-14
31221.0,2020-01-30,"(438.013, 685.75]",35,37,-2
31221.0,2020-01-30,"(685.75, 932.5]",11,21,-10
31221.0,2020-01-30,"(932.5, 1179.25]",12,37,-25
31221.0,2020-01-30,"(1179.25, 1426.0]",2,9,-7
31222.0,2020-01-30,"(380.09, 608.5]",12,14,-2
31222.0,2020-01-30,"(608.5, 836.0]",5,6,-1
31222.0,2020-01-30,"(836.0, 1063.5]",6,17,-11
31223.0,2020-01-30,"(4.693, 332.75]",3,5,-2
31223.0,2020-01-30,"(332.75, 659.5]",16,35,-19
31223.0,2020-01-30,"(659.5, 986.25]",8,17,-9
31223.0,2020-01-30,"(986.25, 1313.0]",19,33,-14
31224.0,2020-01-30,"(425.085, 654.75]",19,22,-3
31224.0,2020-01-30,"(654.75, 883.5]",5,11,-6
31224.0,2020-01-30,"(883.5, 1112.25]",4,21,-17
31224.0,2020-01-30,"(1112.25, 1341.0]",2,3,-1
31225.0,2020-01-30,"(418.016, 665.0]",14,21,-7
31225.0,2020-01-30,"(665.0, 911.0]",2,5,-3
31225.0,2020-01-30,"(911.0, 1157.0]",7,19,-12
31225.0,2020-01-30,"(1157.0, 1403.0]",8,13,-5
31226.0,2020-01-30,"(193.807, 493.25]",1,3,-2
31226.0,2020-01-30,"(493.25, 791.5]",3,9,-6
31226.0,2020-01-30,"(791.5, 1089.75]",6,14,-8
31226.0,2020-01-30,"(1089.75, 1388.0]",7,11,-4
31227.0,2020-01-30,"(413.108, 637.0]",33,38,-5
31227.0,2020-01-30,"(637.0, 860.0]",10,13,-3
31227.0,2020-01-30,"(860.0, 1083.0]",5,19,-14
31227.0,2020-01-30,"(1083.0, 1306.0]",8,17,-9
31228.0,2020-01-30,"(6.57, 365.5]",1,1,0
31228.0,2020-01-30,"(365.5, 723.0]",23,32,-9
31228.0,2020-01-30,"(723.0, 1080.5]",28,51,-23
31228.0,2020-01-30,"(1080.5, 1438.0]",9,17,-8
31229.0,2020-01-30,"(70.637, 412.75]",3,14,-11
31229.0,2020-01-30,"(412.75, 753.5]",17,70,-53
31229.0,2020-01-30,"(753.5, 1094.25]",33,54,-21
31229.0,2020-01-30,"(1094.25, 1435.0]",19,40,-21
31230.0,2020-01-30,"(369.981, 625.75]",43,49,-6
31230.0,2020-01-30,"(625.75, 880.5]",7,12,-5
31230.0,2020-01-30,"(880.5, 1135.25]",10,32,-22
31230.0,2020-01-30,"(1135.25, 1390.0]",2,11,-9
31231.0,2020-01-30,"(324.897, 601.75]",20,22,-2
31231.0,2020-01-30,"(601.75, 877.5]",9,14,-5
31231.0,2020-01-30,"(877.5, 1153.25]",10,28,-18
31232.0,2020-01-30,"(31.595, 384.25]",3,6,-3
31232.0,2020-01-30,"(384.25, 735.5]",17,27,-10
31232.0,2020-01-30,"(735.5, 1086.75]",15,34,-19
31232.0,2020-01-30,"(1086.75, 1438.0]",14,29,-15
31233.0,2020-01-30,"(374.988, 629.0]",33,36,-3
31233.0,2020-01-30,"(629.0, 882.0]",8,13,-5
31233.0,2020-01-30,"(882.0, 1135.0]",21,45,-24
31233.0,2020-01-30,"(1135.0, 1388.0]",4,9,-5
31234.0,2020-01-30,"(386.991, 640.25]",22,38,-16
31234.0,2020-01-30,"(640.25, 892.5]",8,15,-7
31234.0,2020-01-30,"(892.5, 1144.75]",17,30,-13
31234.0,2020-01-30,"(1144.75, 1397.0]",9,18,-9
31235.0,2020-01-30,"(468.359, 629.25]",4,4,0
31235.0,2020-01-30,"(629.25, 789.5]",1,3,-2
31235.0,2020-01-30,"(789.5, 949.75]",2,2,0
31236.0,2020-01-30,"(6.598, 358.5]",1,1,0
31236.0,2020-01-30,"(358.5, 709.0]",26,34,-8
31236.0,2020-01-30,"(709.0, 1059.5]",13,31,-18
31236.0,2020-01-30,"(1059.5, 1410.0]",11,31,-20
31237.0,2020-01-30,"(336.987, 591.25]",4,13,-9
31237.0,2020-01-30,"(591.25, 844.5]",6,14,-8
31237.0,2020-01-30,"(844.5, 1097.75]",14,20,-6
31237.0,2020-01-30,"(1097.75, 1351.0]",3,6,-3
31238.0,2020-01-30,"(2.645, 342.75]",1,3,-2
31238.0,2020-01-30,"(342.75, 681.5]",17,20,-3
31238.0,2020-01-30,"(681.5, 1020.25]",6,17,-11
31238.0,2020-01-30,"(1020.25, 1359.0]",7,24,-17
31239.0,2020-01-30,"(382.018, 628.5]",20,24,-4
31239.0,2020-01-30,"(628.5, 874.0]",3,8,-5
31239.0,2020-01-30,"(874.0, 1119.5]",9,22,-13
31239.0,2020-01-30,"(1119.5, 1365.0]",1,14,-13
31240.0,2020-01-30,"(689.617, 785.75]",1,3,-2
31240.0,2020-01-30,"(785.75, 881.5]",2,4,-2
31240.0,2020-01-30,"(881.5, 977.25]",5,15,-10
31240.0,2020-01-30,"(977.25, 1073.0]",8,10,-2
31241.0,2020-01-30,"(44.638, 386.5]",1,2,-1
31241.0,2020-01-30,"(386.5, 727.0]",32,59,-27
31241.0,2020-01-30,"(727.0, 1067.5]",18,37,-19
31241.0,2020-01-30,"(1067.5, 1408.0]",18,39,-21
31242.0,2020-01-30,"(418.122, 638.5]",25,25,0
31242.0,2020-01-30,"(638.5, 858.0]",5,12,-7
31242.0,2020-01-30,"(858.0, 1077.5]",5,20,-15
31242.0,2020-01-30,"(1077.5, 1297.0]",3,18,-15
31243.0,2020-01-30,"(375.076, 607.0]",21,24,-3
31243.0,2020-01-30,"(838.0, 1069.0]",6,8,-2
31243.0,2020-01-30,"(1069.0, 1300.0]",1,23,-22
31244.0,2020-01-30,"(426.095, 653.25]",16,26,-10
31244.0,2020-01-30,"(653.25, 879.5]",3,5,-2
31244.0,2020-01-30,"(879.5, 1105.75]",5,19,-14
31244.0,2020-01-30,"(1105.75, 1332.0]",7,10,-3
31245.0,2020-01-30,"(419.073, 651.75]",9,17,-8
31245.0,2020-01-30,"(651.75, 883.5]",1,1,0
31245.0,2020-01-30,"(883.5, 1115.25]",7,13,-6
31245.0,2020-01-30,"(1115.25, 1347.0]",4,10,-6
31246.0,2020-01-30,"(406.107, 630.25]",11,15,-4
31246.0,2020-01-30,"(630.25, 853.5]",9,14,-5
31246.0,2020-01-30,"(853.5, 1076.75]",7,16,-9
31246.0,2020-01-30,"(1076.75, 1300.0]",12,22,-10
31247.0,2020-01-30,"(428.14, 644.0]",11,14,-3
31247.0,2020-01-30,"(644.0, 859.0]",10,21,-11
31247.0,2020-01-30,"(859.0, 1074.0]",9,18,-9
31247.0,2020-01-30,"(1074.0, 1289.0]",2,5,-3
31248.0,2020-01-30,"(355.264, 540.0]",6,11,-5
31248.0,2020-01-30,"(724.0, 908.0]",10,2,8
31248.0,2020-01-30,"(908.0, 1092.0]",13,15,-2
31249.0,2020-01-30,"(351.024, 596.0]",8,15,-7
31249.0,2020-01-30,"(596.0, 840.0]",6,13,-7
31249.0,2020-01-30,"(840.0, 1084.0]",5,9,-4
31249.0,2020-01-30,"(1084.0, 1328.0]",1,2,-1
31250.0,2020-01-30,"(396.996, 649.0]",18,19,-1
31250.0,2020-01-30,"(649.0, 900.0]",4,8,-4
31250.0,2020-01-30,"(900.0, 1151.0]",2,19,-17
31250.0,2020-01-30,"(1151.0, 1402.0]",1,6,-5
31251.0,2020-01-30,"(239.804, 540.0]",10,19,-9
31251.0,2020-01-30,"(540.0, 839.0]",16,28,-12
31251.0,2020-01-30,"(839.0, 1138.0]",16,40,-24
31251.0,2020-01-30,"(1138.0, 1437.0]",8,8,0
31252.0,2020-01-30,"(469.314, 641.5]",18,18,0
31252.0,2020-01-30,"(641.5, 813.0]",2,4,-2
31252.0,2020-01-30,"(984.5, 1156.0]",2,3,-1
31253.0,2020-01-30,"(359.079, 590.25]",22,25,-3
31253.0,2020-01-30,"(590.25, 820.5]",7,12,-5
31253.0,2020-01-30,"(820.5, 1050.75]",5,15,-10
31253.0,2020-01-30,"(1050.75, 1281.0]",2,13,-11
31254.0,2020-01-30,"(409.092, 637.0]",22,26,-4
31254.0,2020-01-30,"(637.0, 864.0]",6,8,-2
31254.0,2020-01-30,"(864.0, 1091.0]",3,25,-22
31255.0,2020-01-30,"(366.969, 625.75]",15,22,-7
31255.0,2020-01-30,"(625.75, 883.5]",2,3,-1
31255.0,2020-01-30,"(883.5, 1141.25]",8,23,-15
31255.0,2020-01-30,"(1141.25, 1399.0]",1,4,-3
31256.0,2020-01-30,"(136.5, 273.0]",1,1,0
31256.0,2020-01-30,"(409.5, 546.0]",6,1,5
31257.0,2020-01-30,"(341.969, 600.75]",16,29,-13
31257.0,2020-01-30,"(600.75, 858.5]",13,24,-11
31257.0,2020-01-30,"(858.5, 1116.25]",21,35,-14
31257.0,2020-01-30,"(1116.25, 1374.0]",9,25,-16
31258.0,2020-01-30,"(16.595, 369.25]",1,2,-1
31258.0,2020-01-30,"(369.25, 720.5]",9,18,-9
31258.0,2020-01-30,"(720.5, 1071.75]",13,29,-16
31258.0,2020-01-30,"(1071.75, 1423.0]",4,5,-1
31259.0,2020-01-30,"(450.378, 606.5]",13,16,-3
31259.0,2020-01-30,"(606.5, 762.0]",1,3,-2
31259.0,2020-01-30,"(762.0, 917.5]",2,3,-1
31259.0,2020-01-30,"(917.5, 1073.0]",1,14,-13
31260.0,2020-01-30,"(404.153, 616.75]",20,22,-2
31260.0,2020-01-30,"(616.75, 828.5]",4,11,-7
31260.0,2020-01-30,"(1040.25, 1252.0]",7,8,-1
31261.0,2020-01-30,"(388.326, 557.5]",4,4,0
31261.0,2020-01-30,"(894.5, 1063.0]",1,1,0
31262.0,2020-01-30,"(419.068, 653.0]",8,10,-2
31262.0,2020-01-30,"(653.0, 886.0]",5,9,-4
31262.0,2020-01-30,"(886.0, 1119.0]",5,14,-9
31262.0,2020-01-30,"(1119.0, 1352.0]",2,4,-2
31263.0,2020-01-30,"(348.994, 601.5]",26,34,-8
31263.0,2020-01-30,"(601.5, 853.0]",9,18,-9
31263.0,2020-01-30,"(853.0, 1104.5]",13,27,-14
31263.0,2020-01-30,"(1104.5, 1356.0]",5,13,-8
31264.0,2020-01-30,"(437.192, 640.0]",11,15,-4
31264.0,2020-01-30,"(640.0, 842.0]",3,6,-3
31264.0,2020-01-30,"(842.0, 1044.0]",5,12,-7
31264.0,2020-01-30,"(1044.0, 1246.0]",3,8,-5
31265.0,2020-01-30,"(408.058, 644.5]",12,33,-21
31265.0,2020-01-30,"(644.5, 880.0]",8,11,-3
31265.0,2020-01-30,"(880.0, 1115.5]",17,29,-12
31265.0,2020-01-30,"(1115.5, 1351.0]",12,23,-11
31266.0,2020-01-30,"(293.928, 563.0]",3,22,-19
31266.0,2020-01-30,"(563.0, 831.0]",10,21,-11
31266.0,2020-01-30,"(831.0, 1099.0]",17,28,-11
31266.0,2020-01-30,"(1099.0, 1367.0]",11,20,-9
31267.0,2020-01-30,"(0.597, 352.75]",1,1,0
31267.0,2020-01-30,"(352.75, 703.5]",22,44,-22
31267.0,2020-01-30,"(703.5, 1054.25]",12,21,-9
31267.0,2020-01-30,"(1054.25, 1405.0]",15,32,-17
31268.0,2020-01-30,"(78.691, 407.25]",7,10,-3
31268.0,2020-01-30,"(407.25, 734.5]",12,43,-31
31268.0,2020-01-30,"(734.5, 1061.75]",14,20,-6
31268.0,2020-01-30,"(1061.75, 1389.0]",21,32,-11
31269.0,2020-01-30,"(383.043, 623.25]",8,14,-6
31269.0,2020-01-30,"(623.25, 862.5]",5,13,-8
31269.0,2020-01-30,"(862.5, 1101.75]",5,13,-8
31269.0,2020-01-30,"(1101.75, 1341.0]",3,9,-6
31270.0,2020-01-30,"(338.125, 557.75]",9,13,-4
31270.0,2020-01-30,"(557.75, 776.5]",8,10,-2
31270.0,2020-01-30,"(776.5, 995.25]",5,9,-4
31270.0,2020-01-30,"(995.25, 1214.0]",4,13,-9
31271.0,2020-01-30,"(460.059, 696.25]",11,15,-4
31271.0,2020-01-30,"(696.25, 931.5]",4,8,-4
31271.0,2020-01-30,"(931.5, 1166.75]",5,25,-20
31272.0,2020-01-30,"(295.965, 555.75]",24,25,-1
31272.0,2020-01-30,"(555.75, 814.5]",9,15,-6
31272.0,2020-01-30,"(814.5, 1073.25]",5,16,-11
31272.0,2020-01-30,"(1073.25, 1332.0]",4,7,-3
31273.0,2020-01-30,"(915.59, 1018.5]",1,1,0
31273.0,2020-01-30,"(1121.0, 1223.5]",2,2,0
31274.0,2020-01-30,"(415.055, 652.25]",20,22,-2
31274.0,2020-01-30,"(652.25, 888.5]",3,7,-4
31274.0,2020-01-30,"(888.5, 1124.75]",5,15,-10
31274.0,2020-01-30,"(1124.75, 1361.0]",2,4,-2
31275.0,2020-01-30,"(14.63, 358.5]",2,4,-2
31275.0,2020-01-30,"(358.5, 701.0]",21,36,-15
31275.0,2020-01-30,"(701.0, 1043.5]",9,17,-8
31275.0,2020-01-30,"(1043.5, 1386.0]",15,28,-13
31276.0,2020-01-30,"(430.125, 649.75]",27,31,-4
31276.0,2020-01-30,"(649.75, 868.5]",4,9,-5
31276.0,2020-01-30,"(868.5, 1087.25]",5,24,-19
31276.0,2020-01-30,"(1087.25, 1306.0]",2,11,-9
31277.0,2020-01-30,"(351.095, 578.25]",32,37,-5
31277.0,2020-01-30,"(578.25, 804.5]",13,17,-4
31277.0,2020-01-30,"(804.5, 1030.75]",6,22,-16
31277.0,2020-01-30,"(1030.75, 1257.0]",4,22,-18
31278.0,2020-01-30,"(353.94, 620.0]",13,32,-19
31278.0,2020-01-30,"(620.0, 885.0]",5,9,-4
31278.0,2020-01-30,"(885.0, 1150.0]",16,26,-10
31278.0,2020-01-30,"(1150.0, 1415.0]",7,13,-6
31279.0,2020-01-30,"(423.253, 610.75]",20,21,-1
31279.0,2020-01-30,"(610.75, 797.5]",4,10,-6
31279.0,2020-01-30,"(797.5, 984.25]",6,16,-10
31279.0,2020-01-30,"(984.25, 1171.0]",5,25,-20
31280.0,2020-01-30,"(339.907, 614.25]",9,28,-19
31280.0,2020-01-30,"(614.25, 887.5]",5,9,-4
31280.0,2020-01-30,"(887.5, 1160.75]",15,18,-3
31280.0,2020-01-30,"(1160.75, 1434.0]",6,6,0
,,,,1.0,
,,,,1.0,
31001.0,2020-01-31,"(1048.0, 1130.5]",1,1,0
31001.0,2020-01-31,"(1130.5, 1213.0]",1,1,0
31002.0,2020-01-31,"(447.415, 594.25]",2,4,-2
31002.0,2020-01-31,"(594.25, 740.5]",1,1,0
31002.0,2020-01-31,"(740.5, 886.75]",1,1,0
31002.0,2020-01-31,"(886.75, 1033.0]",1,4,-3
31003.0,2020-01-31,"(473.216, 670.0]",4,9,-5
31003.0,2020-01-31,"(670.0, 866.0]",3,4,-1
31003.0,2020-01-31,"(1062.0, 1258.0]",2,1,1
31004.0,2020-01-31,"(883.0, 1075.0]",1,3,-2
31004.0,2020-01-31,"(1075.0, 1267.0]",2,1,1
31005.0,2020-01-31,"(437.127, 656.25]",5,5,0
31005.0,2020-01-31,"(656.25, 874.5]",1,1,0
31005.0,2020-01-31,"(874.5, 1092.75]",3,7,-4
31005.0,2020-01-31,"(1092.75, 1311.0]",2,9,-7
31006.0,2020-01-31,"(619.41, 767.5]",1,1,0
31006.0,2020-01-31,"(1062.5, 1210.0]",2,1,1
31007.0,2020-01-31,"(390.105, 614.75]",5,12,-7
31007.0,2020-01-31,"(614.75, 838.5]",2,4,-2
31007.0,2020-01-31,"(838.5, 1062.25]",4,10,-6
31007.0,2020-01-31,"(1062.25, 1286.0]",5,12,-7
31009.0,2020-01-31,"(525.561, 635.75]",3,5,-2
31010.0,2020-01-31,"(741.307, 915.25]",1,3,-2
31010.0,2020-01-31,"(915.25, 1088.5]",1,1,0
31010.0,2020-01-31,"(1261.75, 1435.0]",2,1,1
31011.0,2020-01-31,"(469.178, 675.5]",3,5,-2
31011.0,2020-01-31,"(675.5, 881.0]",1,2,-1
31011.0,2020-01-31,"(881.0, 1086.5]",1,4,-3
31011.0,2020-01-31,"(1086.5, 1292.0]",1,1,0
31012.0,2020-01-31,"(393.004, 643.0]",3,3,0
31013.0,2020-01-31,"(370.253, 557.75]",1,2,-1
31013.0,2020-01-31,"(744.5, 931.25]",2,1,1
31013.0,2020-01-31,"(931.25, 1118.0]",3,3,0
31014.0,2020-01-31,"(320.917, 592.75]",15,21,-6
31014.0,2020-01-31,"(592.75, 863.5]",5,6,-1
31014.0,2020-01-31,"(863.5, 1134.25]",10,19,-9
31014.0,2020-01-31,"(1134.25, 1405.0]",10,15,-5
31015.0,2020-01-31,"(305.072, 538.0]",11,11,0
31015.0,2020-01-31,"(538.0, 770.0]",7,7,0
31015.0,2020-01-31,"(770.0, 1002.0]",2,5,-3
31015.0,2020-01-31,"(1002.0, 1234.0]",7,11,-4
31016.0,2020-01-31,"(344.125, 563.75]",5,9,-4
31016.0,2020-01-31,"(782.5, 1001.25]",3,5,-2
31017.0,2020-01-31,"(506.189, 709.75]",3,3,0
31017.0,2020-01-31,"(709.75, 912.5]",2,3,-1
31017.0,2020-01-31,"(912.5, 1115.25]",2,7,-5
31018.0,2020-01-31,"(456.311, 629.25]",1,6,-5
31018.0,2020-01-31,"(629.25, 801.5]",1,1,0
31018.0,2020-01-31,"(973.75, 1146.0]",3,1,2
31019.0,2020-01-31,"(667.25, 881.5]",1,1,0
31019.0,2020-01-31,"(881.5, 1095.75]",1,1,0
31019.0,2020-01-31,"(1095.75, 1310.0]",2,5,-3
31020.0,2020-01-31,"(1021.0, 1073.0]",1,1,0
31021.0,2020-01-31,"(937.0, 1183.0]",2,2,0
31021.0,2020-01-31,"(1183.0, 1429.0]",3,1,2
31022.0,2020-01-31,"(329.106, 553.5]",1,5,-4
31022.0,2020-01-31,"(553.5, 777.0]",1,1,0
31022.0,2020-01-31,"(777.0, 1000.5]",3,4,-1
31022.0,2020-01-31,"(1000.5, 1224.0]",1,4,-3
31023.0,2020-01-31,"(472.075, 704.25]",2,2,0
31023.0,2020-01-31,"(704.25, 935.5]",1,2,-1
31023.0,2020-01-31,"(935.5, 1166.75]",1,2,-1
31024.0,2020-01-31,"(463.03, 706.5]",7,8,-1
31024.0,2020-01-31,"(949.0, 1191.5]",5,8,-3
31025.0,2020-01-31,"(499.333, 666.75]",1,1,0
31025.0,2020-01-31,"(666.75, 833.5]",1,1,0
31025.0,2020-01-31,"(1000.25, 1167.0]",1,2,-1
31026.0,2020-01-31,"(406.204, 606.0]",2,3,-1
31026.0,2020-01-31,"(1004.0, 1203.0]",5,1,4
31027.0,2020-01-31,"(749.5, 964.0]",2,1,1
31028.0,2020-01-31,"(944.25, 1071.5]",1,1,0
31028.0,2020-01-31,"(1071.5, 1198.75]",1,3,-2
31028.0,2020-01-31,"(1198.75, 1326.0]",1,1,0
31029.0,2020-01-31,"(93.774, 401.5]",1,1,0
31029.0,2020-01-31,"(708.0, 1014.5]",3,6,-3
31029.0,2020-01-31,"(1014.5, 1321.0]",3,3,0
31030.0,2020-01-31,"(-0.405, 352.25]",1,2,-1
31030.0,2020-01-31,"(703.5, 1054.75]",4,6,-2
31030.0,2020-01-31,"(1054.75, 1406.0]",3,5,-2
31031.0,2020-01-31,"(638.5, 838.0]",1,5,-4
31031.0,2020-01-31,"(1037.5, 1237.0]",1,1,0
31032.0,2020-01-31,"(333.165, 542.75]",1,3,-2
31032.0,2020-01-31,"(960.25, 1169.0]",3,1,2
,,,,2.0,
31034.0,2020-01-31,"(496.124, 716.0]",3,6,-3
31034.0,2020-01-31,"(935.0, 1154.0]",1,3,-2
31035.0,2020-01-31,"(484.045, 723.75]",2,5,-3
31035.0,2020-01-31,"(723.75, 962.5]",1,3,-2
31035.0,2020-01-31,"(962.5, 1201.25]",1,2,-1
31035.0,2020-01-31,"(1201.25, 1440.0]",2,2,0
31036.0,2020-01-31,"(694.25, 899.5]",1,4,-3
31036.0,2020-01-31,"(899.5, 1104.75]",1,1,0
31036.0,2020-01-31,"(1104.75, 1310.0]",2,3,-1
31037.0,2020-01-31,"(420.09, 648.5]",9,12,-3
31037.0,2020-01-31,"(648.5, 876.0]",7,11,-4
31037.0,2020-01-31,"(876.0, 1103.5]",3,9,-6
31037.0,2020-01-31,"(1103.5, 1331.0]",4,11,-7
,,,,1.0,
,,,,1.0,
,,,,2.0,
31039.0,2020-01-31,"(1149.25, 1376.0]",2,3,-1
31040.0,2020-01-31,"(450.082, 680.5]",2,3,-1
31040.0,2020-01-31,"(680.5, 910.0]",1,3,-2
31041.0,2020-01-31,"(936.627, 1030.25]",1,1,0
31042.0,2020-01-31,"(458.098, 684.5]",10,12,-2
31042.0,2020-01-31,"(684.5, 910.0]",2,4,-2
31042.0,2020-01-31,"(910.0, 1135.5]",1,5,-4
31042.0,2020-01-31,"(1135.5, 1361.0]",3,4,-1
31043.0,2020-01-31,"(511.302, 686.5]",1,1,0
31043.0,2020-01-31,"(1035.5, 1210.0]",2,1,1
31044.0,2020-01-31,"(830.5, 1052.25]",1,2,-1
31044.0,2020-01-31,"(1052.25, 1274.0]",2,1,1
31045.0,2020-01-31,"(577.184, 782.0]",4,6,-2
31045.0,2020-01-31,"(1190.0, 1394.0]",1,2,-1
31046.0,2020-01-31,"(1031.973, 1038.75]",1,1,0
31047.0,2020-01-31,"(347.1, 573.0]",8,12,-4
31047.0,2020-01-31,"(573.0, 798.0]",5,12,-7
31047.0,2020-01-31,"(798.0, 1023.0]",2,4,-2
31047.0,2020-01-31,"(1023.0, 1248.0]",3,10,-7
31048.0,2020-01-31,"(682.517, 803.75]",1,2,-1
31048.0,2020-01-31,"(924.5, 1045.25]",1,1,0
31049.0,2020-01-31,"(522.258, 708.5]",2,2,0
31049.0,2020-01-31,"(1079.5, 1265.0]",2,1,1
31050.0,2020-01-31,"(712.0, 791.0]",1,2,-1
31051.0,2020-01-31,"(531.25, 759.5]",2,4,-2
31051.0,2020-01-31,"(759.5, 987.75]",1,3,-2
31051.0,2020-01-31,"(987.75, 1216.0]",7,2,5
31052.0,2020-01-31,"(538.469, 671.75]",2,4,-2
31052.0,2020-01-31,"(671.75, 804.5]",1,1,0
31052.0,2020-01-31,"(937.25, 1070.0]",1,2,-1
31053.0,2020-01-31,"(1078.645, 1167.75]",1,1,0
31053.0,2020-01-31,"(1345.25, 1434.0]",1,2,-1
31054.0,2020-01-31,"(929.0, 1004.0]",1,1,0
31055.0,2020-01-31,"(382.303, 557.25]",1,2,-1
31055.0,2020-01-31,"(557.25, 731.5]",1,1,0
31055.0,2020-01-31,"(905.75, 1080.0]",1,1,0
,,,,1.0,
,,,,2.0,
,,,,1.0,
,,,,1.0,
31058.0,2020-01-31,"(104.465, 238.75]",1,2,-1
31058.0,2020-01-31,"(506.25, 640.0]",1,1,0
31059.0,2020-01-31,"(971.75, 1097.0]",3,1,2
31060.0,2020-01-31,"(591.596, 693.0]",1,1,0
31060.0,2020-01-31,"(693.0, 794.0]",1,1,0
,,,,2.0,
31062.0,2020-01-31,"(883.829, 926.75]",1,3,-2
31062.0,2020-01-31,"(926.75, 969.5]",2,2,0
31062.0,2020-01-31,"(1012.25, 1055.0]",1,1,0
,,,,2.0,
31064.0,2020-01-31,"(647.5, 847.25]",1,1,0
31064.0,2020-01-31,"(847.25, 1047.0]",3,2,1
31065.0,2020-01-31,"(707.0, 795.0]",1,1,0
31066.0,2020-01-31,"(837.75, 943.0]",1,1,0
31067.0,2020-01-31,"(108.939, 375.25]",1,2,-1
31067.0,2020-01-31,"(375.25, 640.5]",1,4,-3
31067.0,2020-01-31,"(905.75, 1171.0]",2,2,0
31068.0,2020-01-31,"(619.288, 798.0]",3,5,-2
31068.0,2020-01-31,"(1154.0, 1332.0]",1,1,0
31069.0,2020-01-31,"(890.0, 1135.5]",2,7,-5
31069.0,2020-01-31,"(1135.5, 1381.0]",2,1,1
31070.0,2020-01-31,"(946.0, 1131.5]",1,2,-1
31070.0,2020-01-31,"(1131.5, 1317.0]",1,3,-2
31071.0,2020-01-31,"(451.169, 659.75]",2,5,-3
31071.0,2020-01-31,"(659.75, 867.5]",1,3,-2
31071.0,2020-01-31,"(867.5, 1075.25]",6,7,-1
31071.0,2020-01-31,"(1075.25, 1283.0]",3,5,-2
,,,,2.0,
31073.0,2020-01-31,"(491.467, 625.25]",2,4,-2
31073.0,2020-01-31,"(758.5, 891.75]",1,2,-1
31073.0,2020-01-31,"(891.75, 1025.0]",1,1,0
31074.0,2020-01-31,"(484.471, 617.25]",1,2,-1
31075.0,2020-01-31,"(954.0, 1104.0]",1,1,0
31076.0,2020-01-31,"(540.0, 810.0]",1,1,0
31076.0,2020-01-31,"(810.0, 1080.0]",1,1,0
31077.0,2020-01-31,"(525.171, 733.25]",1,4,-3
31077.0,2020-01-31,"(940.5, 1147.75]",1,1,0
31077.0,2020-01-31,"(1147.75, 1355.0]",3,2,1
31078.0,2020-01-31,"(479.527, 598.25]",5,5,0
31079.0,2020-01-31,"(954.0, 1187.0]",1,5,-4
31079.0,2020-01-31,"(1187.0, 1420.0]",2,3,-1
31080.0,2020-01-31,"(902.0, 1124.5]",3,8,-5
31080.0,2020-01-31,"(1124.5, 1347.0]",3,3,0
31081.0,2020-01-31,"(413.247, 602.25]",1,1,0
31081.0,2020-01-31,"(978.75, 1167.0]",1,1,0
31082.0,2020-01-31,"(767.68, 848.0]",1,1,0
31082.0,2020-01-31,"(928.0, 1008.0]",1,1,0
31082.0,2020-01-31,"(1008.0, 1088.0]",1,2,-1
31083.0,2020-01-31,"(633.25, 730.0]",1,2,-1
31084.0,2020-01-31,"(604.334, 771.5]",3,3,0
31085.0,2020-01-31,"(822.5, 968.25]",2,2,0
31085.0,2020-01-31,"(968.25, 1114.0]",1,2,-1
31086.0,2020-01-31,"(776.5, 908.75]",1,1,0
31086.0,2020-01-31,"(908.75, 1041.0]",1,1,0
31087.0,2020-01-31,"(931.25, 1071.0]",2,1,1
31088.0,2020-01-31,"(403.015, 650.25]",1,4,-3
31088.0,2020-01-31,"(896.5, 1142.75]",3,4,-1
31088.0,2020-01-31,"(1142.75, 1389.0]",1,2,-1
31089.0,2020-01-31,"(380.95, 644.5]",6,11,-5
31089.0,2020-01-31,"(644.5, 907.0]",1,5,-4
31089.0,2020-01-31,"(907.0, 1169.5]",4,13,-9
31089.0,2020-01-31,"(1169.5, 1432.0]",4,7,-3
31090.0,2020-01-31,"(875.75, 1030.0]",1,2,-1
31091.0,2020-01-31,"(883.0, 1107.0]",2,2,0
31091.0,2020-01-31,"(1107.0, 1331.0]",3,2,1
31092.0,2020-01-31,"(907.5, 1053.0]",1,2,-1
31093.0,2020-01-31,"(906.75, 1080.0]",1,2,-1
31094.0,2020-01-31,"(1164.5, 1374.0]",2,1,1
31095.0,2020-01-31,"(890.0, 998.0]",1,1,0
31096.0,2020-01-31,"(528.0, 704.0]",1,1,0
31097.0,2020-01-31,"(532.274, 714.5]",2,2,0
31097.0,2020-01-31,"(714.5, 896.0]",2,4,-2
31097.0,2020-01-31,"(1077.5, 1259.0]",1,1,0
31098.0,2020-01-31,"(390.022, 635.5]",3,8,-5
31098.0,2020-01-31,"(880.0, 1124.5]",2,1,1
31098.0,2020-01-31,"(1124.5, 1369.0]",2,5,-3
31099.0,2020-01-31,"(1078.25, 1262.0]",1,1,0
31100.0,2020-01-31,"(440.155, 652.25]",13,13,0
31100.0,2020-01-31,"(652.25, 863.5]",2,5,-3
31100.0,2020-01-31,"(863.5, 1074.75]",4,11,-7
31100.0,2020-01-31,"(1074.75, 1286.0]",1,9,-8
31101.0,2020-01-31,"(409.004, 659.0]",12,52,-40
31101.0,2020-01-31,"(659.0, 908.0]",18,31,-13
31101.0,2020-01-31,"(908.0, 1157.0]",33,44,-11
31101.0,2020-01-31,"(1157.0, 1406.0]",21,35,-14
31102.0,2020-01-31,"(12.691, 341.25]",1,3,-2
31102.0,2020-01-31,"(341.25, 668.5]",3,21,-18
31102.0,2020-01-31,"(668.5, 995.75]",3,10,-7
31102.0,2020-01-31,"(995.75, 1323.0]",11,24,-13
31103.0,2020-01-31,"(342.926, 612.5]",4,34,-30
31103.0,2020-01-31,"(612.5, 881.0]",7,22,-15
31103.0,2020-01-31,"(881.0, 1149.5]",8,25,-17
31103.0,2020-01-31,"(1149.5, 1418.0]",9,15,-6
31104.0,2020-01-31,"(2.632, 346.0]",1,3,-2
31104.0,2020-01-31,"(346.0, 688.0]",6,26,-20
31104.0,2020-01-31,"(688.0, 1030.0]",18,29,-11
31104.0,2020-01-31,"(1030.0, 1372.0]",13,23,-10
31105.0,2020-01-31,"(483.212, 681.0]",2,9,-7
31105.0,2020-01-31,"(681.0, 878.0]",2,6,-4
31105.0,2020-01-31,"(878.0, 1075.0]",3,7,-4
31105.0,2020-01-31,"(1075.0, 1272.0]",1,4,-3
31106.0,2020-01-31,"(880.25, 1099.0]",2,1,1
31107.0,2020-01-31,"(382.02, 628.0]",1,14,-13
31107.0,2020-01-31,"(628.0, 873.0]",4,12,-8
31107.0,2020-01-31,"(873.0, 1118.0]",10,24,-14
31107.0,2020-01-31,"(1118.0, 1363.0]",7,14,-7
31108.0,2020-01-31,"(342.975, 600.25]",6,27,-21
31108.0,2020-01-31,"(600.25, 856.5]",10,21,-11
31108.0,2020-01-31,"(856.5, 1112.75]",19,26,-7
31108.0,2020-01-31,"(1112.75, 1369.0]",9,12,-3
31109.0,2020-01-31,"(138.773, 446.75]",1,2,-1
31109.0,2020-01-31,"(446.75, 753.5]",7,21,-14
31109.0,2020-01-31,"(753.5, 1060.25]",7,17,-10
31109.0,2020-01-31,"(1060.25, 1367.0]",22,32,-10
31110.0,2020-01-31,"(332.957, 594.75]",12,34,-22
31110.0,2020-01-31,"(594.75, 855.5]",7,13,-6
31110.0,2020-01-31,"(855.5, 1116.25]",17,33,-16
31110.0,2020-01-31,"(1116.25, 1377.0]",11,17,-6
31111.0,2020-01-31,"(258.836, 551.0]",6,17,-11
31111.0,2020-01-31,"(551.0, 842.0]",4,9,-5
31111.0,2020-01-31,"(842.0, 1133.0]",16,19,-3
31111.0,2020-01-31,"(1133.0, 1424.0]",8,15,-7
31112.0,2020-01-31,"(396.011, 644.25]",1,6,-5
31112.0,2020-01-31,"(644.25, 891.5]",2,2,0
31112.0,2020-01-31,"(891.5, 1138.75]",5,8,-3
31112.0,2020-01-31,"(1138.75, 1386.0]",1,2,-1
31113.0,2020-01-31,"(389.0, 718.0]",3,5,-2
31113.0,2020-01-31,"(718.0, 1047.0]",3,26,-23
31113.0,2020-01-31,"(1047.0, 1376.0]",12,13,-1
31114.0,2020-01-31,"(52.708, 377.0]",1,1,0
31114.0,2020-01-31,"(700.0, 1023.0]",8,23,-15
31114.0,2020-01-31,"(1023.0, 1346.0]",13,14,-1
31115.0,2020-01-31,"(8.625, 353.75]",2,5,-3
31115.0,2020-01-31,"(353.75, 697.5]",4,22,-18
31115.0,2020-01-31,"(697.5, 1041.25]",2,6,-4
31115.0,2020-01-31,"(1041.25, 1385.0]",9,16,-7
31116.0,2020-01-31,"(369.972, 628.0]",3,21,-18
31116.0,2020-01-31,"(628.0, 885.0]",8,15,-7
31116.0,2020-01-31,"(885.0, 1142.0]",16,24,-8
31116.0,2020-01-31,"(1142.0, 1399.0]",11,15,-4
31117.0,2020-01-31,"(370.968, 630.0]",5,29,-24
31117.0,2020-01-31,"(630.0, 888.0]",4,10,-6
31117.0,2020-01-31,"(888.0, 1146.0]",8,26,-18
31117.0,2020-01-31,"(1146.0, 1404.0]",8,12,-4
31118.0,2020-01-31,"(317.9, 594.0]",3,16,-13
31118.0,2020-01-31,"(594.0, 869.0]",2,8,-6
31118.0,2020-01-31,"(869.0, 1144.0]",10,13,-3
31118.0,2020-01-31,"(1144.0, 1419.0]",7,9,-2
31119.0,2020-01-31,"(181.755, 494.25]",4,14,-10
31119.0,2020-01-31,"(494.25, 805.5]",3,10,-7
31119.0,2020-01-31,"(805.5, 1116.75]",14,22,-8
31119.0,2020-01-31,"(1116.75, 1428.0]",13,23,-10
31120.0,2020-01-31,"(183.755, 496.25]",1,4,-3
31120.0,2020-01-31,"(496.25, 807.5]",9,25,-16
31120.0,2020-01-31,"(807.5, 1118.75]",4,11,-7
31120.0,2020-01-31,"(1118.75, 1430.0]",12,17,-5
31121.0,2020-01-31,"(361.982, 617.5]",16,22,-6
31121.0,2020-01-31,"(617.5, 872.0]",4,8,-4
31121.0,2020-01-31,"(872.0, 1126.5]",5,14,-9
31121.0,2020-01-31,"(1126.5, 1381.0]",4,12,-8
31122.0,2020-01-31,"(316.75, 633.5]",2,1,1
31122.0,2020-01-31,"(633.5, 950.25]",1,15,-14
31122.0,2020-01-31,"(950.25, 1267.0]",8,2,6
31123.0,2020-01-31,"(26.673, 359.75]",1,3,-2
31123.0,2020-01-31,"(359.75, 691.5]",1,17,-16
31123.0,2020-01-31,"(691.5, 1023.25]",1,1,0
31123.0,2020-01-31,"(1023.25, 1355.0]",8,12,-4
31124.0,2020-01-31,"(49.617, 396.75]",3,4,-1
31124.0,2020-01-31,"(396.75, 742.5]",13,30,-17
31124.0,2020-01-31,"(742.5, 1088.25]",13,48,-35
31124.0,2020-01-31,"(1088.25, 1434.0]",13,43,-30
31125.0,2020-01-31,"(76.701, 402.75]",2,7,-5
31125.0,2020-01-31,"(402.75, 727.5]",7,28,-21
31125.0,2020-01-31,"(727.5, 1052.25]",11,17,-6
31125.0,2020-01-31,"(1052.25, 1377.0]",19,30,-11
31126.0,2020-01-31,"(0.621, 346.75]",1,2,-1
31126.0,2020-01-31,"(346.75, 691.5]",3,22,-19
31126.0,2020-01-31,"(691.5, 1036.25]",12,21,-9
31126.0,2020-01-31,"(1036.25, 1381.0]",23,32,-9
31127.0,2020-01-31,"(355.923, 626.25]",18,26,-8
31127.0,2020-01-31,"(626.25, 895.5]",7,13,-6
31127.0,2020-01-31,"(895.5, 1164.75]",10,20,-10
31127.0,2020-01-31,"(1164.75, 1434.0]",3,9,-6
31128.0,2020-01-31,"(0.737, 317.75]",1,2,-1
31128.0,2020-01-31,"(317.75, 633.5]",21,29,-8
31128.0,2020-01-31,"(633.5, 949.25]",15,28,-13
31128.0,2020-01-31,"(949.25, 1265.0]",21,34,-13
31129.0,2020-01-31,"(530.366, 689.5]",10,12,-2
31129.0,2020-01-31,"(689.5, 848.0]",1,2,-1
31129.0,2020-01-31,"(848.0, 1006.5]",5,7,-2
31129.0,2020-01-31,"(1006.5, 1165.0]",4,7,-3
31130.0,2020-01-31,"(372.937, 639.75]",3,12,-9
31130.0,2020-01-31,"(639.75, 905.5]",3,3,0
31130.0,2020-01-31,"(905.5, 1171.25]",4,9,-5
31130.0,2020-01-31,"(1171.25, 1437.0]",6,7,-1
31131.0,2020-01-31,"(54.697, 381.75]",2,4,-2
31131.0,2020-01-31,"(707.5, 1033.25]",2,12,-10
31131.0,2020-01-31,"(1033.25, 1359.0]",3,7,-4
31200.0,2020-01-31,"(32.611, 381.25]",1,4,-3
31200.0,2020-01-31,"(381.25, 728.5]",27,43,-16
31200.0,2020-01-31,"(728.5, 1075.75]",13,28,-15
31200.0,2020-01-31,"(1075.75, 1423.0]",10,21,-11
31201.0,2020-01-31,"(332.941, 598.75]",21,42,-21
31201.0,2020-01-31,"(598.75, 863.5]",20,37,-17
31201.0,2020-01-31,"(863.5, 1128.25]",32,56,-24
31201.0,2020-01-31,"(1128.25, 1393.0]",13,28,-15
,,,,2.0,
31203.0,2020-01-31,"(9.599, 361.25]",1,4,-3
31203.0,2020-01-31,"(361.25, 711.5]",15,32,-17
31203.0,2020-01-31,"(711.5, 1061.75]",21,34,-13
31203.0,2020-01-31,"(1061.75, 1412.0]",25,38,-13
31204.0,2020-01-31,"(429.994, 682.5]",10,16,-6
31204.0,2020-01-31,"(682.5, 934.0]",5,11,-6
31204.0,2020-01-31,"(934.0, 1185.5]",12,30,-18
31204.0,2020-01-31,"(1185.5, 1437.0]",10,12,-2
31205.0,2020-01-31,"(370.5, 697.0]",26,1,25
31205.0,2020-01-31,"(697.0, 1023.5]",16,31,-15
31205.0,2020-01-31,"(1023.5, 1350.0]",4,30,-26
31206.0,2020-01-31,"(385.272, 568.0]",6,6,0
31206.0,2020-01-31,"(568.0, 750.0]",1,1,0
31206.0,2020-01-31,"(932.0, 1114.0]",1,4,-3
31207.0,2020-01-31,"(362.999, 614.25]",1,9,-8
31207.0,2020-01-31,"(614.25, 864.5]",1,1,0
31207.0,2020-01-31,"(864.5, 1114.75]",3,3,0
31207.0,2020-01-31,"(1114.75, 1365.0]",1,4,-3
31208.0,2020-01-31,"(381.953, 644.75]",7,9,-2
31208.0,2020-01-31,"(644.75, 906.5]",2,6,-4
31208.0,2020-01-31,"(906.5, 1168.25]",2,12,-10
31208.0,2020-01-31,"(1168.25, 1430.0]",2,7,-5
31209.0,2020-01-31,"(443.0, 740.0]",2,1,1
31209.0,2020-01-31,"(740.0, 1037.0]",4,4,0
31209.0,2020-01-31,"(1037.0, 1334.0]",3,7,-4
31211.0,2020-01-31,"(313.967, 573.25]",7,10,-3
31211.0,2020-01-31,"(573.25, 831.5]",4,8,-4
31211.0,2020-01-31,"(831.5, 1089.75]",8,15,-7
31211.0,2020-01-31,"(1089.75, 1348.0]",9,15,-6
31212.0,2020-01-31,"(7.69, 336.5]",1,1,0
31212.0,2020-01-31,"(336.5, 664.0]",30,41,-11
31212.0,2020-01-31,"(664.0, 991.5]",12,18,-6
31212.0,2020-01-31,"(991.5, 1319.0]",6,24,-18
31213.0,2020-01-31,"(243.967, 503.25]",21,28,-7
31213.0,2020-01-31,"(503.25, 761.5]",9,16,-7
31213.0,2020-01-31,"(761.5, 1019.75]",3,7,-4
31213.0,2020-01-31,"(1019.75, 1278.0]",11,21,-10
31214.0,2020-01-31,"(36.615, 384.25]",1,4,-3
31214.0,2020-01-31,"(384.25, 730.5]",13,30,-17
31214.0,2020-01-31,"(730.5, 1076.75]",25,38,-13
31214.0,2020-01-31,"(1076.75, 1423.0]",15,30,-15
31215.0,2020-01-31,"(416.19, 619.5]",18,21,-3
31215.0,2020-01-31,"(619.5, 822.0]",3,3,0
31215.0,2020-01-31,"(822.0, 1024.5]",3,8,-5
31215.0,2020-01-31,"(1024.5, 1227.0]",5,10,-5
31216.0,2020-01-31,"(466.149, 679.75]",27,31,-4
31216.0,2020-01-31,"(679.75, 892.5]",6,13,-7
31216.0,2020-01-31,"(892.5, 1105.25]",3,13,-10
31216.0,2020-01-31,"(1105.25, 1318.0]",6,14,-8
31217.0,2020-01-31,"(377.256, 564.0]",4,4,0
31217.0,2020-01-31,"(564.0, 750.0]",2,4,-2
31217.0,2020-01-31,"(750.0, 936.0]",2,4,-2
31217.0,2020-01-31,"(936.0, 1122.0]",1,8,-7
31218.0,2020-01-31,"(373.224, 568.0]",10,25,-15
31218.0,2020-01-31,"(568.0, 762.0]",3,3,0
31218.0,2020-01-31,"(762.0, 956.0]",8,10,-2
31218.0,2020-01-31,"(956.0, 1150.0]",2,7,-5
31219.0,2020-01-31,"(376.982, 632.5]",10,11,-1
31219.0,2020-01-31,"(632.5, 887.0]",5,13,-8
31219.0,2020-01-31,"(887.0, 1141.5]",4,12,-8
31220.0,2020-01-31,"(301.238, 492.5]",8,9,-1
31220.0,2020-01-31,"(492.5, 683.0]",7,7,0
31220.0,2020-01-31,"(683.0, 873.5]",1,5,-4
31220.0,2020-01-31,"(873.5, 1064.0]",4,15,-11
31221.0,2020-01-31,"(66.773, 374.75]",2,2,0
31221.0,2020-01-31,"(374.75, 681.5]",36,41,-5
31221.0,2020-01-31,"(681.5, 988.25]",15,26,-11
31221.0,2020-01-31,"(988.25, 1295.0]",11,32,-21
31222.0,2020-01-31,"(296.089, 524.75]",3,4,-1
31222.0,2020-01-31,"(524.75, 752.5]",16,18,-2
31222.0,2020-01-31,"(752.5, 980.25]",5,6,-1
31222.0,2020-01-31,"(980.25, 1208.0]",2,9,-7
31223.0,2020-01-31,"(48.643, 389.25]",1,2,-1
31223.0,2020-01-31,"(389.25, 728.5]",13,29,-16
31223.0,2020-01-31,"(728.5, 1067.75]",14,22,-8
31223.0,2020-01-31,"(1067.75, 1407.0]",9,22,-13
31224.0,2020-01-31,"(463.153, 675.75]",5,5,0
31224.0,2020-01-31,"(675.75, 887.5]",6,11,-5
31224.0,2020-01-31,"(887.5, 1099.25]",3,13,-10
31224.0,2020-01-31,"(1099.25, 1311.0]",1,5,-4
31225.0,2020-01-31,"(452.056, 689.0]",9,19,-10
31225.0,2020-01-31,"(689.0, 925.0]",3,4,-1
31225.0,2020-01-31,"(925.0, 1161.0]",10,21,-11
31225.0,2020-01-31,"(1161.0, 1397.0]",3,6,-3
31226.0,2020-01-31,"(311.884, 592.0]",5,10,-5
31226.0,2020-01-31,"(871.0, 1150.0]",3,1,2
31226.0,2020-01-31,"(1150.0, 1429.0]",2,8,-6
31227.0,2020-01-31,"(98.78, 405.0]",1,1,0
31227.0,2020-01-31,"(405.0, 710.0]",39,47,-8
31227.0,2020-01-31,"(710.0, 1015.0]",6,18,-12
31227.0,2020-01-31,"(1015.0, 1320.0]",5,15,-10
31228.0,2020-01-31,"(93.661, 429.75]",2,3,-1
31228.0,2020-01-31,"(429.75, 764.5]",16,25,-9
31228.0,2020-01-31,"(764.5, 1099.25]",13,24,-11
31228.0,2020-01-31,"(1099.25, 1434.0]",8,22,-14
31229.0,2020-01-31,"(15.601, 366.75]",3,4,-1
31229.0,2020-01-31,"(366.75, 716.5]",17,67,-50
31229.0,2020-01-31,"(716.5, 1066.25]",33,51,-18
31229.0,2020-01-31,"(1066.25, 1416.0]",17,35,-18
31230.0,2020-01-31,"(356.982, 612.5]",49,60,-11
31230.0,2020-01-31,"(612.5, 867.0]",11,15,-4
31230.0,2020-01-31,"(867.0, 1121.5]",12,27,-15
31230.0,2020-01-31,"(1121.5, 1376.0]",6,19,-13
31231.0,2020-01-31,"(325.244, 515.0]",12,13,-1
31231.0,2020-01-31,"(515.0, 704.0]",13,17,-4
31231.0,2020-01-31,"(704.0, 893.0]",7,15,-8
31231.0,2020-01-31,"(893.0, 1082.0]",5,19,-14
31232.0,2020-01-31,"(235.81, 534.5]",9,12,-3
31232.0,2020-01-31,"(534.5, 832.0]",15,25,-10
31232.0,2020-01-31,"(832.0, 1129.5]",21,33,-12
31232.0,2020-01-31,"(1129.5, 1427.0]",4,12,-8
31233.0,2020-01-31,"(410.11, 633.5]",38,41,-3
31233.0,2020-01-31,"(633.5, 856.0]",11,23,-12
31233.0,2020-01-31,"(856.0, 1078.5]",15,27,-12
31233.0,2020-01-31,"(1078.5, 1301.0]",4,12,-8
31234.0,2020-01-31,"(362.973, 620.75]",20,39,-19
31234.0,2020-01-31,"(620.75, 877.5]",12,21,-9
31234.0,2020-01-31,"(877.5, 1134.25]",17,27,-10
31234.0,2020-01-31,"(1134.25, 1391.0]",9,19,-10
31235.0,2020-01-31,"(473.142, 688.5]",3,3,0
31235.0,2020-01-31,"(903.0, 1117.5]",2,2,0
31235.0,2020-01-31,"(1117.5, 1332.0]",1,3,-2
31236.0,2020-01-31,"(419.5, 758.0]",23,1,22
31236.0,2020-01-31,"(758.0, 1096.5]",5,26,-21
31236.0,2020-01-31,"(1096.5, 1435.0]",7,21,-14
31237.0,2020-01-31,"(11.593, 364.75]",1,2,-1
31237.0,2020-01-31,"(364.75, 716.5]",6,19,-13
31237.0,2020-01-31,"(716.5, 1068.25]",12,25,-13
31237.0,2020-01-31,"(1068.25, 1420.0]",16,30,-14
31238.0,2020-01-31,"(55.798, 357.5]",2,2,0
31238.0,2020-01-31,"(357.5, 658.0]",18,22,-4
31238.0,2020-01-31,"(658.0, 958.5]",6,12,-6
31238.0,2020-01-31,"(958.5, 1259.0]",4,24,-20
31239.0,2020-01-31,"(382.077, 613.75]",23,27,-4
31239.0,2020-01-31,"(613.75, 844.5]",5,13,-8
31239.0,2020-01-31,"(844.5, 1075.25]",8,23,-15
31239.0,2020-01-31,"(1075.25, 1306.0]",4,15,-11
31240.0,2020-01-31,"(405.0, 540.0]",1,1,0
31241.0,2020-01-31,"(37.713, 360.75]",1,4,-3
31241.0,2020-01-31,"(360.75, 682.5]",18,43,-25
31241.0,2020-01-31,"(682.5, 1004.25]",7,15,-8
31241.0,2020-01-31,"(1004.25, 1326.0]",21,43,-22
31242.0,2020-01-31,"(337.75, 627.5]",20,1,19
31242.0,2020-01-31,"(627.5, 917.25]",13,22,-9
31242.0,2020-01-31,"(917.25, 1207.0]",3,20,-17
31243.0,2020-01-31,"(375.153, 587.75]",19,22,-3
31243.0,2020-01-31,"(587.75, 799.5]",3,6,-3
31243.0,2020-01-31,"(799.5, 1011.25]",3,13,-10
31243.0,2020-01-31,"(1011.25, 1223.0]",1,8,-7
31244.0,2020-01-31,"(415.039, 656.25]",11,21,-10
31244.0,2020-01-31,"(656.25, 896.5]",4,9,-5
31244.0,2020-01-31,"(896.5, 1136.75]",3,10,-7
31244.0,2020-01-31,"(1136.75, 1377.0]",2,4,-2
31245.0,2020-01-31,"(379.979, 636.25]",6,11,-5
31245.0,2020-01-31,"(636.25, 891.5]",3,7,-4
31245.0,2020-01-31,"(891.5, 1146.75]",7,15,-8
31245.0,2020-01-31,"(1146.75, 1402.0]",3,5,-2
31246.0,2020-01-31,"(42.604, 393.0]",1,1,0
31246.0,2020-01-31,"(393.0, 742.0]",14,23,-9
31246.0,2020-01-31,"(742.0, 1091.0]",9,22,-13
31246.0,2020-01-31,"(1091.0, 1440.0]",9,14,-5
31247.0,2020-01-31,"(426.148, 640.0]",10,15,-5
31247.0,2020-01-31,"(640.0, 853.0]",6,13,-7
31247.0,2020-01-31,"(853.0, 1066.0]",4,9,-5
31248.0,2020-01-31,"(355.084, 585.0]",8,12,-4
31248.0,2020-01-31,"(585.0, 814.0]",11,17,-6
31248.0,2020-01-31,"(814.0, 1043.0]",7,19,-12
31248.0,2020-01-31,"(1043.0, 1272.0]",6,12,-6
31249.0,2020-01-31,"(259.141, 474.75]",3,5,-2
31249.0,2020-01-31,"(474.75, 689.5]",4,7,-3
31249.0,2020-01-31,"(689.5, 904.25]",2,4,-2
31249.0,2020-01-31,"(904.25, 1119.0]",3,7,-4
31250.0,2020-01-31,"(410.216, 607.0]",20,24,-4
31250.0,2020-01-31,"(607.0, 803.0]",4,8,-4
31250.0,2020-01-31,"(803.0, 999.0]",6,11,-5
31250.0,2020-01-31,"(999.0, 1195.0]",5,20,-15
31251.0,2020-01-31,"(99.661, 435.75]",1,2,-1
31251.0,2020-01-31,"(435.75, 770.5]",11,20,-9
31251.0,2020-01-31,"(770.5, 1105.25]",7,23,-16
31251.0,2020-01-31,"(1105.25, 1440.0]",10,17,-7
31252.0,2020-01-31,"(449.103, 674.25]",21,23,-2
31252.0,2020-01-31,"(674.25, 898.5]",6,14,-8
31252.0,2020-01-31,"(898.5, 1122.75]",4,14,-10
31252.0,2020-01-31,"(1122.75, 1347.0]",1,5,-4
31253.0,2020-01-31,"(419.125, 638.75]",20,27,-7
31253.0,2020-01-31,"(638.75, 857.5]",8,16,-8
31253.0,2020-01-31,"(857.5, 1076.25]",4,9,-5
31253.0,2020-01-31,"(1076.25, 1295.0]",1,6,-5
31254.0,2020-01-31,"(439.191, 642.25]",21,24,-3
31254.0,2020-01-31,"(642.25, 844.5]",8,12,-4
31254.0,2020-01-31,"(844.5, 1046.75]",4,21,-17
31254.0,2020-01-31,"(1046.75, 1249.0]",3,10,-7
31255.0,2020-01-31,"(363.972, 622.0]",16,21,-5
31255.0,2020-01-31,"(622.0, 879.0]",5,9,-4
31255.0,2020-01-31,"(879.0, 1136.0]",9,19,-10
31255.0,2020-01-31,"(1136.0, 1393.0]",2,5,-3
31256.0,2020-01-31,"(831.45, 969.5]",1,2,-1
31256.0,2020-01-31,"(969.5, 1107.0]",4,14,-10
31256.0,2020-01-31,"(1107.0, 1244.5]",2,7,-5
31256.0,2020-01-31,"(1244.5, 1382.0]",3,4,-1
31257.0,2020-01-31,"(336.976, 594.0]",19,33,-14
31257.0,2020-01-31,"(594.0, 850.0]",10,16,-6
31257.0,2020-01-31,"(850.0, 1106.0]",14,28,-14
31257.0,2020-01-31,"(1106.0, 1362.0]",2,11,-9
31258.0,2020-01-31,"(394.973, 652.75]",5,11,-6
31258.0,2020-01-31,"(652.75, 909.5]",6,11,-5
31258.0,2020-01-31,"(909.5, 1166.25]",2,4,-2
31258.0,2020-01-31,"(1166.25, 1423.0]",4,7,-3
31259.0,2020-01-31,"(444.338, 610.5]",12,12,0
31259.0,2020-01-31,"(610.5, 776.0]",1,1,0
31260.0,2020-01-31,"(449.138, 665.5]",14,18,-4
31260.0,2020-01-31,"(665.5, 881.0]",1,8,-7
31260.0,2020-01-31,"(881.0, 1096.5]",2,14,-12
31260.0,2020-01-31,"(1096.5, 1312.0]",1,4,-3
31261.0,2020-01-31,"(390.299, 566.25]",8,8,0
31262.0,2020-01-31,"(51.703, 377.25]",2,3,-1
31262.0,2020-01-31,"(377.25, 701.5]",11,11,0
31262.0,2020-01-31,"(701.5, 1025.75]",5,12,-7
31262.0,2020-01-31,"(1025.75, 1350.0]",6,11,-5
31263.0,2020-01-31,"(404.979, 661.25]",28,41,-13
31263.0,2020-01-31,"(661.25, 916.5]",7,17,-10
31263.0,2020-01-31,"(916.5, 1171.75]",8,21,-13
31263.0,2020-01-31,"(1171.75, 1427.0]",5,11,-6
31264.0,2020-01-31,"(415.027, 659.25]",9,13,-4
31264.0,2020-01-31,"(659.25, 902.5]",2,4,-2
31264.0,2020-01-31,"(902.5, 1145.75]",1,6,-5
31265.0,2020-01-31,"(377.5, 724.0]",12,2,10
31265.0,2020-01-31,"(724.0, 1070.5]",21,39,-18
31265.0,2020-01-31,"(1070.5, 1417.0]",16,35,-19
31266.0,2020-01-31,"(54.658, 391.5]",1,5,-4
31266.0,2020-01-31,"(391.5, 727.0]",7,30,-23
31266.0,2020-01-31,"(727.0, 1062.5]",8,16,-8
31266.0,2020-01-31,"(1062.5, 1398.0]",23,40,-17
31267.0,2020-01-31,"(412.986, 667.5]",20,36,-16
31267.0,2020-01-31,"(667.5, 921.0]",7,14,-7
31267.0,2020-01-31,"(921.0, 1174.5]",13,31,-18
31267.0,2020-01-31,"(1174.5, 1428.0]",5,10,-5
31268.0,2020-01-31,"(175.741, 491.75]",5,10,-5
31268.0,2020-01-31,"(491.75, 806.5]",17,39,-22
31268.0,2020-01-31,"(806.5, 1121.25]",19,31,-12
31268.0,2020-01-31,"(1121.25, 1436.0]",14,26,-12
31269.0,2020-01-31,"(378.969, 637.75]",5,10,-5
31269.0,2020-01-31,"(637.75, 895.5]",8,17,-9
31269.0,2020-01-31,"(895.5, 1153.25]",8,13,-5
31269.0,2020-01-31,"(1153.25, 1411.0]",7,17,-10
31270.0,2020-01-31,"(353.925, 623.75]",12,16,-4
31270.0,2020-01-31,"(623.75, 892.5]",6,12,-6
31270.0,2020-01-31,"(892.5, 1161.25]",9,17,-8
31270.0,2020-01-31,"(1161.25, 1430.0]",3,5,-2
31271.0,2020-01-31,"(407.04, 648.0]",16,19,-3
31271.0,2020-01-31,"(648.0, 888.0]",4,11,-7
31271.0,2020-01-31,"(888.0, 1128.0]",18,32,-14
31271.0,2020-01-31,"(1128.0, 1368.0]",2,3,-1
31272.0,2020-01-31,"(312.967, 572.25]",13,17,-4
31272.0,2020-01-31,"(572.25, 830.5]",8,12,-4
31272.0,2020-01-31,"(830.5, 1088.75]",3,11,-8
31272.0,2020-01-31,"(1088.75, 1347.0]",3,5,-2
31273.0,2020-01-31,"(723.5, 830.25]",1,1,0
31273.0,2020-01-31,"(830.25, 937.0]",2,1,1
31274.0,2020-01-31,"(456.149, 669.75]",24,26,-2
31274.0,2020-01-31,"(669.75, 882.5]",3,6,-3
31274.0,2020-01-31,"(882.5, 1095.25]",8,16,-8
31274.0,2020-01-31,"(1095.25, 1308.0]",1,3,-2
31275.0,2020-01-31,"(50.679, 382.25]",1,4,-3
31275.0,2020-01-31,"(382.25, 712.5]",16,26,-10
31275.0,2020-01-31,"(712.5, 1042.75]",8,20,-12
31275.0,2020-01-31,"(1042.75, 1373.0]",8,22,-14
31276.0,2020-01-31,"(84.745, 399.75]",1,2,-1
31276.0,2020-01-31,"(399.75, 713.5]",29,38,-9
31276.0,2020-01-31,"(713.5, 1027.25]",4,10,-6
31276.0,2020-01-31,"(1027.25, 1341.0]",4,23,-19
31277.0,2020-01-31,"(309.118, 530.5]",22,27,-5
31277.0,2020-01-31,"(530.5, 751.0]",15,21,-6
31277.0,2020-01-31,"(751.0, 971.5]",8,18,-10
31277.0,2020-01-31,"(971.5, 1192.0]",5,27,-22
31278.0,2020-01-31,"(345.915, 618.25]",3,24,-21
31278.0,2020-01-31,"(618.25, 889.5]",11,15,-4
31278.0,2020-01-31,"(889.5, 1160.75]",14,21,-7
31278.0,2020-01-31,"(1160.75, 1432.0]",6,9,-3
31279.0,2020-01-31,"(353.125, 572.75]",19,19,0
31279.0,2020-01-31,"(572.75, 791.5]",8,13,-5
31279.0,2020-01-31,"(791.5, 1010.25]",4,13,-9
31279.0,2020-01-31,"(1010.25, 1229.0]",4,16,-12
31280.0,2020-01-31,"(344.91, 618.5]",8,31,-23
31280.0,2020-01-31,"(618.5, 891.0]",7,13,-6
31280.0,2020-01-31,"(891.0, 1163.5]",17,25,-8
31280.0,2020-01-31,"(1163.5, 1436.0]",10,13,-3
31000.0,2020-02-01,"(760.5, 1014.0]",1,1,0
31001.0,2020-02-01,"(660.75, 757.5]",1,1,0
31001.0,2020-02-01,"(757.5, 854.25]",1,2,-1
31001.0,2020-02-01,"(854.25, 951.0]",2,2,0
31002.0,2020-02-01,"(753.798, 804.5]",1,3,-2
31002.0,2020-02-01,"(804.5, 855.0]",2,2,0
31002.0,2020-02-01,"(905.5, 956.0]",3,3,0
31003.0,2020-02-01,"(472.478, 603.5]",1,1,0
31003.0,2020-02-01,"(734.0, 864.5]",1,1,0
31004.0,2020-02-01,"(736.5, 937.0]",1,1,0
31004.0,2020-02-01,"(937.0, 1137.5]",2,1,1
31004.0,2020-02-01,"(1137.5, 1338.0]",1,4,-3
31005.0,2020-02-01,"(537.202, 737.5]",3,4,-1
31005.0,2020-02-01,"(737.5, 937.0]",3,7,-4
31005.0,2020-02-01,"(937.0, 1136.5]",1,3,-2
31006.0,2020-02-01,"(558.161, 768.75]",2,3,-1
31006.0,2020-02-01,"(768.75, 978.5]",2,5,-3
31006.0,2020-02-01,"(978.5, 1188.25]",1,3,-2
31006.0,2020-02-01,"(1188.25, 1398.0]",1,1,0
31007.0,2020-02-01,"(444.423, 589.25]",2,2,0
31007.0,2020-02-01,"(733.5, 877.75]",2,4,-2
31007.0,2020-02-01,"(877.75, 1022.0]",1,5,-4
31009.0,2020-02-01,"(644.618, 740.5]",1,2,-1
31009.0,2020-02-01,"(740.5, 836.0]",1,1,0
31009.0,2020-02-01,"(931.5, 1027.0]",1,1,0
31010.0,2020-02-01,"(665.481, 795.75]",3,5,-2
31010.0,2020-02-01,"(795.75, 925.5]",1,1,0
31010.0,2020-02-01,"(1055.25, 1185.0]",1,1,0
31011.0,2020-02-01,"(431.251, 619.25]",2,4,-2
31011.0,2020-02-01,"(619.25, 806.5]",1,2,-1
31011.0,2020-02-01,"(993.75, 1181.0]",3,5,-2
,,,,2.0,
31013.0,2020-02-01,"(771.5, 874.75]",2,1,1
31013.0,2020-02-01,"(874.75, 978.0]",2,1,1
31014.0,2020-02-01,"(47.864, 333.0]",1,2,-1
31014.0,2020-02-01,"(333.0, 617.0]",4,5,-1
31014.0,2020-02-01,"(617.0, 901.0]",8,15,-7
31014.0,2020-02-01,"(901.0, 1185.0]",2,7,-5
31015.0,2020-02-01,"(240.849, 529.75]",1,1,0
31015.0,2020-02-01,"(529.75, 817.5]",4,4,0
31015.0,2020-02-01,"(817.5, 1105.25]",2,4,-2
31015.0,2020-02-01,"(1105.25, 1393.0]",1,2,-1
31016.0,2020-02-01,"(831.461, 966.75]",2,4,-2
31016.0,2020-02-01,"(966.75, 1101.5]",2,3,-1
31016.0,2020-02-01,"(1236.25, 1371.0]",1,1,0
31017.0,2020-02-01,"(667.562, 777.5]",1,3,-2
31017.0,2020-02-01,"(996.5, 1106.0]",2,5,-3
31018.0,2020-02-01,"(24.091, 252.25]",2,2,0
31018.0,2020-02-01,"(479.5, 706.75]",1,2,-1
31018.0,2020-02-01,"(706.75, 934.0]",1,3,-2
31019.0,2020-02-01,"(691.353, 853.75]",1,2,-1
31019.0,2020-02-01,"(853.75, 1015.5]",2,2,0
31019.0,2020-02-01,"(1177.25, 1339.0]",1,2,-1
31020.0,2020-02-01,"(541.542, 656.5]",1,1,0
31020.0,2020-02-01,"(771.0, 885.5]",2,1,1
31020.0,2020-02-01,"(885.5, 1000.0]",3,4,-1
31021.0,2020-02-01,"(565.184, 770.0]",2,5,-3
31021.0,2020-02-01,"(770.0, 974.0]",3,5,-2
31021.0,2020-02-01,"(974.0, 1178.0]",1,3,-2
31022.0,2020-02-01,"(431.203, 631.25]",3,4,-1
31022.0,2020-02-01,"(631.25, 830.5]",3,6,-3
31022.0,2020-02-01,"(830.5, 1029.75]",6,11,-5
31022.0,2020-02-01,"(1029.75, 1229.0]",2,4,-2
31023.0,2020-02-01,"(333.25, 640.5]",4,1,3
31023.0,2020-02-01,"(640.5, 947.75]",3,4,-1
31023.0,2020-02-01,"(947.75, 1255.0]",2,5,-3
31024.0,2020-02-01,"(33.872, 317.0]",1,1,0
31024.0,2020-02-01,"(317.0, 599.0]",1,1,0
31024.0,2020-02-01,"(599.0, 881.0]",4,8,-4
31024.0,2020-02-01,"(881.0, 1163.0]",3,8,-5
31025.0,2020-02-01,"(552.512, 675.0]",2,3,-1
31025.0,2020-02-01,"(675.0, 797.0]",3,6,-3
31025.0,2020-02-01,"(797.0, 919.0]",1,2,-1
31025.0,2020-02-01,"(919.0, 1041.0]",1,1,0
31026.0,2020-02-01,"(452.75, 694.5]",2,1,1
31027.0,2020-02-01,"(7.929, 276.75]",1,1,0
31027.0,2020-02-01,"(544.5, 812.25]",3,1,2
31027.0,2020-02-01,"(812.25, 1080.0]",1,4,-3
31028.0,2020-02-01,"(500.542, 615.5]",1,1,0
31028.0,2020-02-01,"(615.5, 730.0]",1,1,0
31028.0,2020-02-01,"(844.5, 959.0]",1,2,-1
31029.0,2020-02-01,"(135.111, 358.25]",1,1,0
31029.0,2020-02-01,"(580.5, 802.75]",1,1,0
31029.0,2020-02-01,"(802.75, 1025.0]",7,5,2
31030.0,2020-02-01,"(877.0, 989.5]",1,3,-2
31030.0,2020-02-01,"(989.5, 1102.0]",2,1,1
,,,,2.0,
,,,,1.0,
,,,,1.0,
,,,,1.0,
31032.0,2020-02-01,"(948.0, 1054.0]",1,2,-1
31032.0,2020-02-01,"(1054.0, 1160.0]",2,1,1
31033.0,2020-02-01,"(611.625, 705.75]",1,2,-1
31033.0,2020-02-01,"(893.25, 987.0]",2,4,-2
31034.0,2020-02-01,"(28.872, 312.0]",1,1,0
31034.0,2020-02-01,"(594.0, 876.0]",2,1,1
31034.0,2020-02-01,"(876.0, 1158.0]",1,4,-3
31035.0,2020-02-01,"(525.112, 748.0]",1,2,-1
31035.0,2020-02-01,"(748.0, 970.0]",1,3,-2
31035.0,2020-02-01,"(970.0, 1192.0]",1,1,0
31035.0,2020-02-01,"(1192.0, 1414.0]",1,1,0
31036.0,2020-02-01,"(755.5, 881.75]",1,2,-1
31036.0,2020-02-01,"(881.75, 1008.0]",1,1,0
31037.0,2020-02-01,"(417.388, 571.0]",1,3,-2
31037.0,2020-02-01,"(571.0, 724.0]",3,5,-2
31037.0,2020-02-01,"(724.0, 877.0]",3,7,-4
31037.0,2020-02-01,"(877.0, 1030.0]",2,7,-5
31038.0,2020-02-01,"(580.526, 699.5]",1,2,-1
31039.0,2020-02-01,"(819.5, 925.25]",1,2,-1
31039.0,2020-02-01,"(925.25, 1031.0]",1,1,0
31040.0,2020-02-01,"(515.551, 628.25]",1,1,0
31040.0,2020-02-01,"(740.5, 852.75]",1,3,-2
31041.0,2020-02-01,"(593.619, 689.25]",1,2,-1
31041.0,2020-02-01,"(689.25, 784.5]",4,6,-2
31041.0,2020-02-01,"(784.5, 879.75]",1,1,0
31041.0,2020-02-01,"(879.75, 975.0]",4,8,-4
31042.0,2020-02-01,"(600.551, 713.25]",3,4,-1
31042.0,2020-02-01,"(713.25, 825.5]",1,3,-2
31042.0,2020-02-01,"(825.5, 937.75]",2,2,0
31042.0,2020-02-01,"(937.75, 1050.0]",2,6,-4
31043.0,2020-02-01,"(624.987, 628.25]",1,1,0
31044.0,2020-02-01,"(550.58, 656.0]",2,4,-2
31044.0,2020-02-01,"(761.0, 866.0]",1,2,-1
31044.0,2020-02-01,"(866.0, 971.0]",3,4,-1
31045.0,2020-02-01,"(598.176, 805.0]",1,4,-3
31045.0,2020-02-01,"(1217.0, 1423.0]",1,1,0
31046.0,2020-02-01,"(947.75, 978.5]",1,1,0
31047.0,2020-02-01,"(469.122, 689.5]",2,5,-3
31047.0,2020-02-01,"(689.5, 909.0]",1,4,-3
31047.0,2020-02-01,"(909.0, 1128.5]",2,4,-2
31048.0,2020-02-01,"(600.561, 710.75]",1,2,-1
31048.0,2020-02-01,"(710.75, 820.5]",1,1,0
31048.0,2020-02-01,"(930.25, 1040.0]",3,1,2
31049.0,2020-02-01,"(758.81, 806.5]",1,2,-1
31049.0,2020-02-01,"(806.5, 854.0]",1,2,-1
31049.0,2020-02-01,"(901.5, 949.0]",1,1,0
31050.0,2020-02-01,"(698.75, 757.5]",1,2,-1
31051.0,2020-02-01,"(26.64, 368.0]",1,1,0
31051.0,2020-02-01,"(708.0, 1048.0]",4,3,1
31051.0,2020-02-01,"(1048.0, 1388.0]",1,6,-5
31052.0,2020-02-01,"(620.0, 775.0]",1,2,-1
31052.0,2020-02-01,"(930.0, 1085.0]",1,1,0
31053.0,2020-02-01,"(558.0, 744.0]",1,1,0
,,,,2.0,
31055.0,2020-02-01,"(540.45, 678.5]",1,2,-1
31055.0,2020-02-01,"(953.5, 1091.0]",1,1,0
31056.0,2020-02-01,"(900.25, 1034.0]",1,1,0
31057.0,2020-02-01,"(979.999, 980.25]",1,1,0
31058.0,2020-02-01,"(204.25, 223.0]",1,1,0
31059.0,2020-02-01,"(794.736, 861.0]",1,3,-2
31059.0,2020-02-01,"(927.0, 993.0]",1,2,-1
31059.0,2020-02-01,"(993.0, 1059.0]",1,1,0
31060.0,2020-02-01,"(509.22, 705.0]",2,2,0
31060.0,2020-02-01,"(900.0, 1095.0]",3,1,2
31061.0,2020-02-01,"(394.5, 526.0]",1,1,0
31062.0,2020-02-01,"(487.454, 624.5]",9,19,-10
31062.0,2020-02-01,"(624.5, 761.0]",2,4,-2
31062.0,2020-02-01,"(761.0, 897.5]",5,13,-8
31062.0,2020-02-01,"(897.5, 1034.0]",12,19,-7
,,,,2.0,
31064.0,2020-02-01,"(604.587, 708.25]",1,1,0
31064.0,2020-02-01,"(708.25, 811.5]",2,4,-2
31064.0,2020-02-01,"(811.5, 914.75]",16,33,-17
31064.0,2020-02-01,"(914.75, 1018.0]",14,29,-15
31065.0,2020-02-01,"(666.75, 889.0]",1,1,0
31066.0,2020-02-01,"(603.75, 805.0]",3,1,2
31067.0,2020-02-01,"(151.203, 351.25]",1,2,-1
31067.0,2020-02-01,"(550.5, 749.75]",2,2,0
31067.0,2020-02-01,"(749.75, 949.0]",1,3,-2
31068.0,2020-02-01,"(729.723, 799.25]",1,2,-1
31068.0,2020-02-01,"(799.25, 868.5]",2,2,0
31068.0,2020-02-01,"(868.5, 937.75]",2,4,-2
31068.0,2020-02-01,"(937.75, 1007.0]",1,2,-1
31069.0,2020-02-01,"(221.047, 460.25]",1,2,-1
31069.0,2020-02-01,"(936.75, 1175.0]",3,2,1
31070.0,2020-02-01,"(552.371, 710.25]",1,2,-1
31070.0,2020-02-01,"(710.25, 867.5]",2,2,0
31070.0,2020-02-01,"(1024.75, 1182.0]",2,1,1
31071.0,2020-02-01,"(425.075, 657.25]",2,5,-3
31071.0,2020-02-01,"(657.25, 888.5]",7,13,-6
31071.0,2020-02-01,"(888.5, 1119.75]",2,5,-3
31071.0,2020-02-01,"(1119.75, 1351.0]",1,3,-2
,,,,2.0,
,,,,2.0,
31074.0,2020-02-01,"(606.5, 774.0]",1,1,0
31074.0,2020-02-01,"(941.5, 1109.0]",3,2,1
31075.0,2020-02-01,"(758.25, 1011.0]",1,1,0
31076.0,2020-02-01,"(527.25, 703.0]",2,1,1
31077.0,2020-02-01,"(584.408, 733.0]",1,3,-2
31077.0,2020-02-01,"(733.0, 881.0]",2,3,-1
31077.0,2020-02-01,"(881.0, 1029.0]",7,9,-2
,,,,2.0,
31079.0,2020-02-01,"(697.5, 833.0]",2,2,0
31079.0,2020-02-01,"(833.0, 968.5]",1,3,-2
31079.0,2020-02-01,"(968.5, 1104.0]",2,5,-3
31080.0,2020-02-01,"(850.0, 1020.0]",1,1,0
31080.0,2020-02-01,"(1190.0, 1360.0]",2,1,1
31081.0,2020-02-01,"(728.576, 835.0]",4,8,-4
31081.0,2020-02-01,"(835.0, 941.0]",1,1,0
31081.0,2020-02-01,"(1047.0, 1153.0]",1,2,-1
31082.0,2020-02-01,"(593.437, 734.75]",1,2,-1
31082.0,2020-02-01,"(734.75, 875.5]",1,1,0
31082.0,2020-02-01,"(875.5, 1016.25]",2,3,-1
31082.0,2020-02-01,"(1016.25, 1157.0]",1,1,0
31083.0,2020-02-01,"(767.5, 791.0]",1,1,0
31084.0,2020-02-01,"(589.172, 797.0]",2,3,-1
31084.0,2020-02-01,"(797.0, 1004.0]",1,1,0
31084.0,2020-02-01,"(1004.0, 1211.0]",1,2,-1
31085.0,2020-02-01,"(874.0, 922.0]",1,2,-1
31086.0,2020-02-01,"(486.469, 619.75]",1,1,0
31086.0,2020-02-01,"(885.25, 1018.0]",1,1,0
31087.0,2020-02-01,"(892.538, 1008.5]",2,3,-1
31087.0,2020-02-01,"(1239.5, 1355.0]",1,1,0
31088.0,2020-02-01,"(1001.75, 1037.0]",1,1,0
31089.0,2020-02-01,"(553.0, 818.5]",4,3,1
31089.0,2020-02-01,"(818.5, 1084.0]",5,7,-2
31090.0,2020-02-01,"(747.842, 787.5]",1,1,0
31091.0,2020-02-01,"(98.705, 423.75]",1,1,0
31091.0,2020-02-01,"(747.5, 1071.25]",2,1,1
31092.0,2020-02-01,"(632.891, 660.25]",1,2,-1
31092.0,2020-02-01,"(714.75, 742.0]",1,1,0
31093.0,2020-02-01,"(878.0, 932.0]",1,1,0
31094.0,2020-02-01,"(885.75, 936.0]",2,2,0
,,,,1.0,
,,,,1.0,
,,,,2.0,
31097.0,2020-02-01,"(591.179, 797.25]",1,3,-2
31097.0,2020-02-01,"(797.25, 1002.5]",1,4,-3
31097.0,2020-02-01,"(1207.75, 1413.0]",1,2,-1
31098.0,2020-02-01,"(572.747, 636.25]",2,3,-1
31098.0,2020-02-01,"(762.75, 826.0]",1,1,0
,,,,1.0,
,,,,2.0,
,,,,1.0,
31100.0,2020-02-01,"(278.5, 552.0]",1,2,-1
31100.0,2020-02-01,"(825.5, 1099.0]",1,1,0
31101.0,2020-02-01,"(2.565, 362.75]",3,7,-4
31101.0,2020-02-01,"(362.75, 721.5]",35,49,-14
31101.0,2020-02-01,"(721.5, 1080.25]",47,77,-30
31101.0,2020-02-01,"(1080.25, 1439.0]",10,17,-7
31102.0,2020-02-01,"(385.0, 733.0]",5,1,4
31102.0,2020-02-01,"(733.0, 1081.0]",7,16,-9
31102.0,2020-02-01,"(1081.0, 1429.0]",4,19,-15
31103.0,2020-02-01,"(7.802, 308.5]",1,3,-2
31103.0,2020-02-01,"(308.5, 608.0]",5,15,-10
31103.0,2020-02-01,"(608.0, 907.5]",9,31,-22
31103.0,2020-02-01,"(907.5, 1207.0]",7,23,-16
31104.0,2020-02-01,"(46.641, 387.75]",2,5,-3
31104.0,2020-02-01,"(387.75, 727.5]",15,33,-18
31104.0,2020-02-01,"(727.5, 1067.25]",20,40,-20
31104.0,2020-02-01,"(1067.25, 1407.0]",6,12,-6
31105.0,2020-02-01,"(133.772, 442.0]",2,2,0
31105.0,2020-02-01,"(442.0, 749.0]",7,17,-10
31105.0,2020-02-01,"(749.0, 1056.0]",3,8,-5
31106.0,2020-02-01,"(796.0, 927.0]",1,2,-1
31106.0,2020-02-01,"(927.0, 1058.0]",1,2,-1
31107.0,2020-02-01,"(159.728, 479.0]",2,6,-4
31107.0,2020-02-01,"(479.0, 797.0]",11,26,-15
31107.0,2020-02-01,"(797.0, 1115.0]",11,21,-10
31107.0,2020-02-01,"(1115.0, 1433.0]",1,6,-5
31108.0,2020-02-01,"(451.248, 640.0]",7,14,-7
31108.0,2020-02-01,"(640.0, 828.0]",2,7,-5
31108.0,2020-02-01,"(828.0, 1016.0]",11,25,-14
31108.0,2020-02-01,"(1016.0, 1204.0]",8,10,-2
31109.0,2020-02-01,"(114.769, 423.75]",2,8,-6
31109.0,2020-02-01,"(423.75, 731.5]",10,14,-4
31109.0,2020-02-01,"(731.5, 1039.25]",21,44,-23
31109.0,2020-02-01,"(1039.25, 1347.0]",8,14,-6
31110.0,2020-02-01,"(371.15, 584.5]",7,10,-3
31110.0,2020-02-01,"(584.5, 797.0]",14,32,-18
31110.0,2020-02-01,"(797.0, 1009.5]",13,25,-12
31110.0,2020-02-01,"(1009.5, 1222.0]",4,12,-8
31111.0,2020-02-01,"(27.59, 381.5]",1,9,-8
31111.0,2020-02-01,"(381.5, 734.0]",1,4,-3
31111.0,2020-02-01,"(734.0, 1086.5]",15,25,-10
31111.0,2020-02-01,"(1086.5, 1439.0]",8,18,-10
31112.0,2020-02-01,"(627.65, 715.5]",3,5,-2
31112.0,2020-02-01,"(890.5, 978.0]",3,1,2
31113.0,2020-02-01,"(11.576, 369.0]",3,5,-2
31113.0,2020-02-01,"(369.0, 725.0]",8,16,-8
31113.0,2020-02-01,"(725.0, 1081.0]",8,26,-18
31113.0,2020-02-01,"(1081.0, 1437.0]",2,5,-3
31114.0,2020-02-01,"(81.661, 417.75]",1,3,-2
31114.0,2020-02-01,"(417.75, 752.5]",3,13,-10
31114.0,2020-02-01,"(752.5, 1087.25]",9,26,-17
31114.0,2020-02-01,"(1087.25, 1422.0]",13,22,-9
31115.0,2020-02-01,"(618.5, 889.0]",6,10,-4
31115.0,2020-02-01,"(889.0, 1159.5]",6,16,-10
31115.0,2020-02-01,"(1159.5, 1430.0]",1,16,-15
31116.0,2020-02-01,"(70.678, 402.5]",1,1,0
31116.0,2020-02-01,"(402.5, 733.0]",14,34,-20
31116.0,2020-02-01,"(733.0, 1063.5]",24,36,-12
31116.0,2020-02-01,"(1063.5, 1394.0]",5,8,-3
31117.0,2020-02-01,"(35.678, 367.5]",6,7,-1
31117.0,2020-02-01,"(367.5, 698.0]",10,34,-24
31117.0,2020-02-01,"(698.0, 1028.5]",6,14,-8
31117.0,2020-02-01,"(1028.5, 1359.0]",2,9,-7
31118.0,2020-02-01,"(5.613, 353.75]",1,2,-1
31118.0,2020-02-01,"(353.75, 700.5]",5,11,-6
31118.0,2020-02-01,"(700.5, 1047.25]",11,20,-9
31118.0,2020-02-01,"(1047.25, 1394.0]",1,3,-2
31119.0,2020-02-01,"(3.625, 348.75]",3,4,-1
31119.0,2020-02-01,"(348.75, 692.5]",6,19,-13
31119.0,2020-02-01,"(692.5, 1036.25]",18,41,-23
31119.0,2020-02-01,"(1036.25, 1380.0]",10,17,-7
31120.0,2020-02-01,"(45.609, 394.75]",3,4,-1
31120.0,2020-02-01,"(394.75, 742.5]",6,15,-9
31120.0,2020-02-01,"(742.5, 1090.25]",6,21,-15
31120.0,2020-02-01,"(1090.25, 1438.0]",6,7,-1
31121.0,2020-02-01,"(164.797, 466.75]",2,3,-1
31121.0,2020-02-01,"(466.75, 767.5]",10,16,-6
31121.0,2020-02-01,"(767.5, 1068.25]",7,13,-6
31121.0,2020-02-01,"(1068.25, 1369.0]",2,3,-1
31122.0,2020-02-01,"(156.798, 458.5]",1,2,-1
31122.0,2020-02-01,"(458.5, 759.0]",10,16,-6
31122.0,2020-02-01,"(759.0, 1059.5]",3,6,-3
31123.0,2020-02-01,"(197.774, 505.5]",1,5,-4
31123.0,2020-02-01,"(505.5, 812.0]",4,16,-12
31123.0,2020-02-01,"(812.0, 1118.5]",1,11,-10
31123.0,2020-02-01,"(1118.5, 1425.0]",2,5,-3
31124.0,2020-02-01,"(8.577, 365.75]",3,6,-3
31124.0,2020-02-01,"(365.75, 721.5]",19,44,-25
31124.0,2020-02-01,"(721.5, 1077.25]",26,64,-38
31124.0,2020-02-01,"(1077.25, 1433.0]",7,18,-11
31125.0,2020-02-01,"(6.61, 355.5]",2,4,-2
31125.0,2020-02-01,"(355.5, 703.0]",11,26,-15
31125.0,2020-02-01,"(703.0, 1050.5]",16,30,-14
31125.0,2020-02-01,"(1050.5, 1398.0]",4,9,-5
31126.0,2020-02-01,"(46.64, 388.0]",1,3,-2
31126.0,2020-02-01,"(388.0, 728.0]",5,23,-18
31126.0,2020-02-01,"(728.0, 1068.0]",5,25,-20
31126.0,2020-02-01,"(1068.0, 1408.0]",5,7,-2
31127.0,2020-02-01,"(339.5, 640.0]",6,2,4
31127.0,2020-02-01,"(640.0, 940.5]",8,10,-2
31127.0,2020-02-01,"(940.5, 1241.0]",9,19,-10
31128.0,2020-02-01,"(54.618, 401.5]",2,4,-2
31128.0,2020-02-01,"(401.5, 747.0]",17,26,-9
31128.0,2020-02-01,"(747.0, 1092.5]",17,36,-19
31128.0,2020-02-01,"(1092.5, 1438.0]",4,5,-1
31129.0,2020-02-01,"(530.126, 749.5]",7,12,-5
31129.0,2020-02-01,"(749.5, 968.0]",18,30,-12
31129.0,2020-02-01,"(968.0, 1186.5]",4,4,0
31129.0,2020-02-01,"(1186.5, 1405.0]",2,6,-4
31130.0,2020-02-01,"(382.5, 709.0]",2,2,0
31130.0,2020-02-01,"(709.0, 1035.5]",1,10,-9
31130.0,2020-02-01,"(1035.5, 1362.0]",9,4,5
31131.0,2020-02-01,"(31.596, 384.0]",2,4,-2
31131.0,2020-02-01,"(735.0, 1086.0]",10,8,2
31131.0,2020-02-01,"(1086.0, 1437.0]",1,14,-13
31200.0,2020-02-01,"(72.708, 397.0]",2,5,-3
31200.0,2020-02-01,"(397.0, 720.0]",11,18,-7
31200.0,2020-02-01,"(720.0, 1043.0]",19,40,-21
31200.0,2020-02-01,"(1043.0, 1366.0]",3,6,-3
31201.0,2020-02-01,"(13.655, 351.25]",1,3,-2
31201.0,2020-02-01,"(351.25, 687.5]",26,47,-21
31201.0,2020-02-01,"(687.5, 1023.75]",48,95,-47
31201.0,2020-02-01,"(1023.75, 1360.0]",20,35,-15
,,,,2.0,
31203.0,2020-02-01,"(34.607, 384.25]",1,3,-2
31203.0,2020-02-01,"(384.25, 732.5]",21,32,-11
31203.0,2020-02-01,"(732.5, 1080.75]",29,59,-30
31203.0,2020-02-01,"(1080.75, 1429.0]",19,26,-7
31204.0,2020-02-01,"(761.5, 968.0]",7,6,1
31204.0,2020-02-01,"(968.0, 1174.5]",2,16,-14
31204.0,2020-02-01,"(1174.5, 1381.0]",3,7,-4
31205.0,2020-02-01,"(16.873, 299.75]",1,4,-3
31205.0,2020-02-01,"(299.75, 581.5]",4,5,-1
31205.0,2020-02-01,"(581.5, 863.25]",11,23,-12
31205.0,2020-02-01,"(863.25, 1145.0]",6,20,-14
31206.0,2020-02-01,"(752.25, 1003.0]",3,1,2
31207.0,2020-02-01,"(537.489, 665.75]",3,4,-1
31207.0,2020-02-01,"(921.25, 1049.0]",6,2,4
31208.0,2020-02-01,"(517.437, 658.75]",2,5,-3
31208.0,2020-02-01,"(658.75, 799.5]",3,4,-1
31208.0,2020-02-01,"(799.5, 940.25]",7,8,-1
31208.0,2020-02-01,"(940.25, 1081.0]",5,6,-1
31209.0,2020-02-01,"(534.21, 732.5]",1,4,-3
31209.0,2020-02-01,"(732.5, 930.0]",7,8,-1
31209.0,2020-02-01,"(930.0, 1127.5]",1,4,-3
31209.0,2020-02-01,"(1127.5, 1325.0]",3,3,0
31211.0,2020-02-01,"(499.142, 714.5]",2,6,-4
31211.0,2020-02-01,"(714.5, 929.0]",9,13,-4
31211.0,2020-02-01,"(929.0, 1143.5]",11,15,-4
31212.0,2020-02-01,"(5.583, 361.25]",3,3,0
31212.0,2020-02-01,"(361.25, 715.5]",6,11,-5
31212.0,2020-02-01,"(715.5, 1069.75]",9,18,-9
31212.0,2020-02-01,"(1069.75, 1424.0]",4,5,-1
31213.0,2020-02-01,"(630.23, 823.5]",2,4,-2
31213.0,2020-02-01,"(823.5, 1016.0]",4,8,-4
31214.0,2020-02-01,"(19.672, 353.0]",1,1,0
31214.0,2020-02-01,"(353.0, 685.0]",6,23,-17
31214.0,2020-02-01,"(685.0, 1017.0]",27,45,-18
31214.0,2020-02-01,"(1017.0, 1349.0]",7,12,-5
31215.0,2020-02-01,"(393.322, 563.5]",1,1,0
31215.0,2020-02-01,"(563.5, 733.0]",4,5,-1
31215.0,2020-02-01,"(733.0, 902.5]",9,10,-1
31215.0,2020-02-01,"(902.5, 1072.0]",10,18,-8
31216.0,2020-02-01,"(601.496, 728.0]",2,2,0
31216.0,2020-02-01,"(728.0, 854.0]",3,4,-1
31216.0,2020-02-01,"(854.0, 980.0]",2,5,-3
31216.0,2020-02-01,"(980.0, 1106.0]",4,5,-1
31217.0,2020-02-01,"(651.0, 784.0]",3,2,1
31217.0,2020-02-01,"(784.0, 917.0]",2,6,-4
31217.0,2020-02-01,"(917.0, 1050.0]",1,3,-2
31218.0,2020-02-01,"(502.201, 702.75]",3,7,-4
31218.0,2020-02-01,"(702.75, 902.5]",6,10,-4
31218.0,2020-02-01,"(902.5, 1102.25]",4,10,-6
31218.0,2020-02-01,"(1102.25, 1302.0]",1,10,-9
31219.0,2020-02-01,"(506.433, 648.75]",3,6,-3
31219.0,2020-02-01,"(648.75, 790.5]",12,13,-1
31219.0,2020-02-01,"(790.5, 932.25]",9,16,-7
31219.0,2020-02-01,"(932.25, 1074.0]",4,9,-5
31220.0,2020-02-01,"(63.087, 292.25]",2,2,0
31221.0,2020-02-01,"(340.088, 569.0]",2,2,0
31221.0,2020-02-01,"(569.0, 797.0]",8,9,-1
31221.0,2020-02-01,"(797.0, 1025.0]",4,10,-6
31221.0,2020-02-01,"(1025.0, 1253.0]",4,5,-1
31222.0,2020-02-01,"(574.252, 762.0]",1,4,-3
31222.0,2020-02-01,"(762.0, 949.0]",4,4,0
31222.0,2020-02-01,"(949.0, 1136.0]",10,11,-1
31223.0,2020-02-01,"(3.572, 362.0]",1,4,-3
31223.0,2020-02-01,"(362.0, 719.0]",5,8,-3
31223.0,2020-02-01,"(719.0, 1076.0]",14,25,-11
31223.0,2020-02-01,"(1076.0, 1433.0]",5,10,-5
31224.0,2020-02-01,"(632.507, 756.25]",4,4,0
31224.0,2020-02-01,"(756.25, 879.5]",3,6,-3
31224.0,2020-02-01,"(879.5, 1002.75]",1,5,-4
31224.0,2020-02-01,"(1002.75, 1126.0]",3,4,-1
31225.0,2020-02-01,"(5.613, 353.75]",1,1,0
31225.0,2020-02-01,"(353.75, 700.5]",9,12,-3
31225.0,2020-02-01,"(700.5, 1047.25]",17,27,-10
31225.0,2020-02-01,"(1047.25, 1394.0]",2,6,-4
31226.0,2020-02-01,"(355.218, 551.5]",1,3,-2
31226.0,2020-02-01,"(551.5, 747.0]",3,4,-1
31226.0,2020-02-01,"(747.0, 942.5]",4,8,-4
31226.0,2020-02-01,"(942.5, 1138.0]",5,10,-5
31227.0,2020-02-01,"(11.843, 302.25]",2,3,-1
31227.0,2020-02-01,"(302.25, 591.5]",3,4,-1
31227.0,2020-02-01,"(591.5, 880.75]",5,11,-6
31227.0,2020-02-01,"(880.75, 1170.0]",12,21,-9
31228.0,2020-02-01,"(417.25, 753.5]",16,1,15
31228.0,2020-02-01,"(753.5, 1089.75]",27,21,6
31228.0,2020-02-01,"(1089.75, 1426.0]",6,45,-39
31229.0,2020-02-01,"(12.577, 369.75]",5,10,-5
31229.0,2020-02-01,"(369.75, 725.5]",24,53,-29
31229.0,2020-02-01,"(725.5, 1081.25]",41,85,-44
31229.0,2020-02-01,"(1081.25, 1437.0]",15,29,-14
31230.0,2020-02-01,"(393.129, 611.75]",6,9,-3
31230.0,2020-02-01,"(611.75, 829.5]",7,10,-3
31230.0,2020-02-01,"(829.5, 1047.25]",13,24,-11
31230.0,2020-02-01,"(1047.25, 1265.0]",2,6,-4
31231.0,2020-02-01,"(824.779, 880.25]",7,7,0
31231.0,2020-02-01,"(935.5, 990.75]",3,2,1
31231.0,2020-02-01,"(990.75, 1046.0]",4,3,1
31232.0,2020-02-01,"(4.584, 360.0]",1,2,-1
31232.0,2020-02-01,"(360.0, 714.0]",10,16,-6
31232.0,2020-02-01,"(714.0, 1068.0]",23,37,-14
31232.0,2020-02-01,"(1068.0, 1422.0]",6,10,-4
31233.0,2020-02-01,"(306.001, 556.75]",8,9,-1
31233.0,2020-02-01,"(556.75, 806.5]",9,13,-4
31233.0,2020-02-01,"(806.5, 1056.25]",5,9,-4
31233.0,2020-02-01,"(1056.25, 1306.0]",1,5,-4
31234.0,2020-02-01,"(388.986, 643.5]",3,5,-2
31234.0,2020-02-01,"(643.5, 897.0]",17,26,-9
31234.0,2020-02-01,"(897.0, 1150.5]",14,23,-9
31234.0,2020-02-01,"(1150.5, 1404.0]",3,5,-2
31235.0,2020-02-01,"(575.488, 704.0]",1,4,-3
31235.0,2020-02-01,"(832.0, 960.0]",1,5,-4
31235.0,2020-02-01,"(960.0, 1088.0]",12,16,-4
31236.0,2020-02-01,"(463.75, 744.5]",6,1,5
31236.0,2020-02-01,"(744.5, 1025.25]",6,11,-5
31236.0,2020-02-01,"(1025.25, 1306.0]",4,19,-15
31237.0,2020-02-01,"(107.908, 382.0]",2,3,-1
31237.0,2020-02-01,"(382.0, 655.0]",4,5,-1
31237.0,2020-02-01,"(655.0, 928.0]",7,15,-8
31237.0,2020-02-01,"(928.0, 1201.0]",11,19,-8
31238.0,2020-02-01,"(55.849, 344.75]",1,2,-1
31238.0,2020-02-01,"(344.75, 632.5]",4,6,-2
31238.0,2020-02-01,"(632.5, 920.25]",4,12,-8
31238.0,2020-02-01,"(920.25, 1208.0]",15,24,-9
31239.0,2020-02-01,"(22.672, 356.0]",1,4,-3
31239.0,2020-02-01,"(356.0, 688.0]",9,12,-3
31239.0,2020-02-01,"(688.0, 1020.0]",10,22,-12
31239.0,2020-02-01,"(1020.0, 1352.0]",4,6,-2
31240.0,2020-02-01,"(748.659, 834.25]",4,8,-4
31240.0,2020-02-01,"(834.25, 919.5]",4,10,-6
31240.0,2020-02-01,"(919.5, 1004.75]",5,11,-6
31240.0,2020-02-01,"(1004.75, 1090.0]",4,5,-1
31241.0,2020-02-01,"(25.69, 354.5]",2,5,-3
31241.0,2020-02-01,"(354.5, 682.0]",11,25,-14
31241.0,2020-02-01,"(682.0, 1009.5]",13,33,-20
31241.0,2020-02-01,"(1009.5, 1337.0]",3,9,-6
31242.0,2020-02-01,"(523.235, 715.25]",2,2,0
31242.0,2020-02-01,"(715.25, 906.5]",2,5,-3
31242.0,2020-02-01,"(906.5, 1097.75]",5,5,0
31243.0,2020-02-01,"(541.386, 695.5]",2,3,-1
31243.0,2020-02-01,"(695.5, 849.0]",1,4,-3
31243.0,2020-02-01,"(849.0, 1002.5]",7,12,-5
31243.0,2020-02-01,"(1002.5, 1156.0]",2,3,-1
31244.0,2020-02-01,"(-0.406, 352.5]",1,2,-1
31244.0,2020-02-01,"(352.5, 704.0]",2,6,-4
31244.0,2020-02-01,"(704.0, 1055.5]",3,7,-4
31244.0,2020-02-01,"(1055.5, 1407.0]",5,6,-1
31245.0,2020-02-01,"(426.25, 732.5]",6,1,5
31245.0,2020-02-01,"(732.5, 1038.75]",19,11,8
31245.0,2020-02-01,"(1038.75, 1345.0]",3,29,-26
31246.0,2020-02-01,"(84.736, 402.0]",1,2,-1
31246.0,2020-02-01,"(402.0, 718.0]",16,26,-10
31246.0,2020-02-01,"(718.0, 1034.0]",25,42,-17
31246.0,2020-02-01,"(1034.0, 1350.0]",4,7,-3
31247.0,2020-02-01,"(570.447, 709.25]",7,10,-3
31247.0,2020-02-01,"(709.25, 847.5]",13,17,-4
31247.0,2020-02-01,"(847.5, 985.75]",7,22,-15
31247.0,2020-02-01,"(985.75, 1124.0]",14,25,-11
31248.0,2020-02-01,"(509.339, 675.25]",2,8,-6
31248.0,2020-02-01,"(675.25, 840.5]",11,24,-13
31248.0,2020-02-01,"(840.5, 1005.75]",24,61,-37
31248.0,2020-02-01,"(1005.75, 1171.0]",6,12,-6
31249.0,2020-02-01,"(425.377, 581.75]",1,2,-1
31249.0,2020-02-01,"(581.75, 737.5]",2,8,-6
31249.0,2020-02-01,"(737.5, 893.25]",22,39,-17
31249.0,2020-02-01,"(893.25, 1049.0]",12,29,-17
31250.0,2020-02-01,"(606.468, 740.0]",4,4,0
31250.0,2020-02-01,"(740.0, 873.0]",2,4,-2
31250.0,2020-02-01,"(873.0, 1006.0]",5,8,-3
31250.0,2020-02-01,"(1006.0, 1139.0]",1,3,-2
31251.0,2020-02-01,"(472.041, 712.75]",4,11,-7
31251.0,2020-02-01,"(712.75, 952.5]",8,18,-10
31251.0,2020-02-01,"(952.5, 1192.25]",8,11,-3
31251.0,2020-02-01,"(1192.25, 1432.0]",3,4,-1
31252.0,2020-02-01,"(668.365, 827.75]",1,4,-3
31252.0,2020-02-01,"(827.75, 986.5]",2,4,-2
31252.0,2020-02-01,"(986.5, 1145.25]",2,4,-2
31253.0,2020-02-01,"(327.218, 523.5]",1,1,0
31253.0,2020-02-01,"(523.5, 719.0]",3,3,0
31253.0,2020-02-01,"(719.0, 914.5]",7,9,-2
31253.0,2020-02-01,"(914.5, 1110.0]",4,9,-5
31254.0,2020-02-01,"(635.75, 888.5]",1,1,0
31254.0,2020-02-01,"(888.5, 1141.25]",2,5,-3
31254.0,2020-02-01,"(1141.25, 1394.0]",1,4,-3
31255.0,2020-02-01,"(513.331, 681.25]",2,6,-4
31255.0,2020-02-01,"(681.25, 848.5]",2,4,-2
31255.0,2020-02-01,"(848.5, 1015.75]",5,6,-1
31255.0,2020-02-01,"(1015.75, 1183.0]",2,4,-2
31256.0,2020-02-01,"(499.222, 694.5]",5,5,0
31256.0,2020-02-01,"(694.5, 889.0]",8,13,-5
31256.0,2020-02-01,"(889.0, 1083.5]",11,16,-5
31256.0,2020-02-01,"(1083.5, 1278.0]",1,2,-1
31257.0,2020-02-01,"(5.622, 351.5]",1,2,-1
31257.0,2020-02-01,"(351.5, 696.0]",9,13,-4
31257.0,2020-02-01,"(696.0, 1040.5]",19,40,-21
31257.0,2020-02-01,"(1040.5, 1385.0]",9,13,-4
31258.0,2020-02-01,"(-0.152, 289.0]",3,4,-1
31258.0,2020-02-01,"(577.0, 865.0]",24,2,22
31258.0,2020-02-01,"(865.0, 1153.0]",48,57,-9
,,,,1.0,
,,,,1.0,
31260.0,2020-02-01,"(575.388, 729.0]",1,2,-1
31260.0,2020-02-01,"(1035.0, 1188.0]",2,2,0
31261.0,2020-02-01,"(916.5, 1026.25]",2,2,0
31262.0,2020-02-01,"(306.25, 581.5]",1,1,0
31262.0,2020-02-01,"(581.5, 856.75]",5,1,4
31262.0,2020-02-01,"(856.75, 1132.0]",6,9,-3
31263.0,2020-02-01,"(431.112, 654.0]",5,9,-4
31263.0,2020-02-01,"(654.0, 876.0]",11,21,-10
31263.0,2020-02-01,"(876.0, 1098.0]",14,21,-7
31263.0,2020-02-01,"(1098.0, 1320.0]",2,3,-1
31264.0,2020-02-01,"(717.334, 884.5]",5,7,-2
31264.0,2020-02-01,"(884.5, 1051.0]",4,8,-4
31264.0,2020-02-01,"(1051.0, 1217.5]",2,2,0
31265.0,2020-02-01,"(86.704, 412.0]",1,2,-1
31265.0,2020-02-01,"(412.0, 736.0]",11,25,-14
31265.0,2020-02-01,"(736.0, 1060.0]",18,31,-13
31265.0,2020-02-01,"(1060.0, 1384.0]",2,5,-3
31266.0,2020-02-01,"(-1.275, 318.75]",4,6,-2
31266.0,2020-02-01,"(318.75, 637.5]",2,15,-13
31266.0,2020-02-01,"(637.5, 956.25]",17,35,-18
31266.0,2020-02-01,"(956.25, 1275.0]",9,21,-12
31267.0,2020-02-01,"(88.669, 422.75]",1,1,0
31267.0,2020-02-01,"(422.75, 755.5]",13,30,-17
31267.0,2020-02-01,"(755.5, 1088.25]",16,35,-19
31267.0,2020-02-01,"(1088.25, 1421.0]",6,11,-5
31268.0,2020-02-01,"(309.0, 614.0]",6,2,4
31268.0,2020-02-01,"(614.0, 919.0]",21,10,11
31268.0,2020-02-01,"(919.0, 1224.0]",3,35,-32
31269.0,2020-02-01,"(361.75, 696.5]",4,1,3
31269.0,2020-02-01,"(696.5, 1031.25]",13,7,6
31269.0,2020-02-01,"(1031.25, 1366.0]",6,26,-20
31270.0,2020-02-01,"(555.385, 709.75]",5,7,-2
31270.0,2020-02-01,"(709.75, 863.5]",5,12,-7
31270.0,2020-02-01,"(863.5, 1017.25]",5,8,-3
31270.0,2020-02-01,"(1017.25, 1171.0]",7,8,-1
31271.0,2020-02-01,"(504.363, 664.25]",5,8,-3
31271.0,2020-02-01,"(823.5, 982.75]",18,9,9
31271.0,2020-02-01,"(982.75, 1142.0]",5,28,-23
31272.0,2020-02-01,"(539.327, 708.25]",11,16,-5
31272.0,2020-02-01,"(708.25, 876.5]",2,6,-4
31272.0,2020-02-01,"(876.5, 1044.75]",3,9,-6
31272.0,2020-02-01,"(1044.75, 1213.0]",3,4,-1
31273.0,2020-02-01,"(544.487, 673.25]",2,4,-2
31273.0,2020-02-01,"(673.25, 801.5]",3,4,-1
31273.0,2020-02-01,"(801.5, 929.75]",1,4,-3
31273.0,2020-02-01,"(929.75, 1058.0]",4,7,-3
31274.0,2020-02-01,"(615.188, 819.0]",6,8,-2
31274.0,2020-02-01,"(819.0, 1022.0]",6,10,-4
31274.0,2020-02-01,"(1022.0, 1225.0]",6,6,0
31274.0,2020-02-01,"(1225.0, 1428.0]",1,1,0
31275.0,2020-02-01,"(54.678, 386.5]",2,4,-2
31275.0,2020-02-01,"(386.5, 717.0]",7,11,-4
31275.0,2020-02-01,"(717.0, 1047.5]",11,24,-13
31275.0,2020-02-01,"(1047.5, 1378.0]",7,9,-2
31276.0,2020-02-01,"(435.292, 613.0]",5,6,-1
31276.0,2020-02-01,"(613.0, 790.0]",4,4,0
31276.0,2020-02-01,"(790.0, 967.0]",1,4,-3
31276.0,2020-02-01,"(967.0, 1144.0]",4,7,-3
31277.0,2020-02-01,"(319.183, 524.25]",1,1,0
31277.0,2020-02-01,"(524.25, 728.5]",1,2,-1
31277.0,2020-02-01,"(728.5, 932.75]",8,15,-7
31277.0,2020-02-01,"(932.75, 1137.0]",14,26,-12
31278.0,2020-02-01,"(22.695, 350.25]",1,2,-1
31278.0,2020-02-01,"(350.25, 676.5]",8,18,-10
31278.0,2020-02-01,"(676.5, 1002.75]",17,35,-18
31278.0,2020-02-01,"(1002.75, 1329.0]",7,11,-4
31279.0,2020-02-01,"(577.483, 707.25]",1,1,0
31280.0,2020-02-01,"(367.25, 708.5]",10,3,7
31280.0,2020-02-01,"(708.5, 1049.75]",17,19,-2
31280.0,2020-02-01,"(1049.75, 1391.0]",7,42,-35
31000.0,2020-02-02,"(1038.0, 1081.0]",1,1,0
31000.0,2020-02-02,"(1081.0, 1124.0]",1,1,0
31001.0,2020-02-02,"(983.657, 1069.75]",1,2,-1
31001.0,2020-02-02,"(1069.75, 1155.5]",1,1,0
31002.0,2020-02-02,"(730.684, 810.0]",2,3,-1
31002.0,2020-02-02,"(968.0, 1047.0]",1,1,0
31003.0,2020-02-02,"(514.541, 629.75]",1,1,0
31003.0,2020-02-02,"(744.5, 859.25]",1,2,-1
31003.0,2020-02-02,"(859.25, 974.0]",1,2,-1
31004.0,2020-02-02,"(776.25, 830.0]",1,1,0
31005.0,2020-02-02,"(616.292, 794.0]",2,2,0
31005.0,2020-02-02,"(794.0, 971.0]",1,3,-2
31006.0,2020-02-02,"(305.75, 601.5]",2,1,1
31006.0,2020-02-02,"(601.5, 897.25]",2,4,-2
31006.0,2020-02-02,"(897.25, 1193.0]",3,4,-1
31007.0,2020-02-02,"(702.276, 884.0]",2,4,-2
31007.0,2020-02-02,"(1246.0, 1427.0]",2,4,-2
31009.0,2020-02-02,"(758.25, 1011.0]",3,1,2
31010.0,2020-02-02,"(747.5, 868.25]",1,1,0
31010.0,2020-02-02,"(868.25, 989.0]",3,2,1
31011.0,2020-02-02,"(428.376, 585.0]",1,2,-1
31011.0,2020-02-02,"(741.0, 897.0]",5,1,4
31011.0,2020-02-02,"(897.0, 1053.0]",3,8,-5
31012.0,2020-02-02,"(795.75, 801.0]",1,1,0
31013.0,2020-02-02,"(648.359, 809.25]",2,6,-4
31013.0,2020-02-02,"(969.5, 1129.75]",5,3,2
31013.0,2020-02-02,"(1129.75, 1290.0]",1,6,-5
31014.0,2020-02-02,"(345.923, 616.25]",3,5,-2
31014.0,2020-02-02,"(616.25, 885.5]",6,8,-2
31014.0,2020-02-02,"(885.5, 1154.75]",3,7,-4
31014.0,2020-02-02,"(1154.75, 1424.0]",2,2,0
31015.0,2020-02-02,"(65.727, 385.25]",1,2,-1
31015.0,2020-02-02,"(703.5, 1021.75]",2,2,0
31015.0,2020-02-02,"(1021.75, 1340.0]",6,4,2
31016.0,2020-02-02,"(708.346, 872.5]",2,4,-2
31016.0,2020-02-02,"(872.5, 1036.0]",3,6,-3
31016.0,2020-02-02,"(1036.0, 1199.5]",2,3,-1
31016.0,2020-02-02,"(1199.5, 1363.0]",2,3,-1
31017.0,2020-02-02,"(701.5, 1030.75]",1,1,0
31018.0,2020-02-02,"(819.743, 884.25]",1,1,0
31019.0,2020-02-02,"(416.75, 638.5]",1,1,0
31019.0,2020-02-02,"(638.5, 860.25]",3,2,1
31019.0,2020-02-02,"(860.25, 1082.0]",1,4,-3
31020.0,2020-02-02,"(178.907, 453.25]",2,4,-2
31020.0,2020-02-02,"(999.75, 1273.0]",4,7,-3
31021.0,2020-02-02,"(662.697, 738.75]",1,1,0
31021.0,2020-02-02,"(814.5, 890.25]",1,2,-1
31022.0,2020-02-02,"(483.382, 638.5]",2,2,0
31022.0,2020-02-02,"(638.5, 793.0]",3,5,-2
31022.0,2020-02-02,"(793.0, 947.5]",2,7,-5
31022.0,2020-02-02,"(947.5, 1102.0]",1,3,-2
31023.0,2020-02-02,"(522.162, 732.5]",2,5,-3
31023.0,2020-02-02,"(942.0, 1151.5]",2,4,-2
31023.0,2020-02-02,"(1151.5, 1361.0]",1,3,-2
31024.0,2020-02-02,"(377.5, 704.0]",2,1,1
31024.0,2020-02-02,"(704.0, 1030.5]",2,4,-2
31024.0,2020-02-02,"(1030.5, 1357.0]",1,2,-1
31025.0,2020-02-02,"(808.636, 900.0]",1,4,-3
31026.0,2020-02-02,"(610.238, 801.5]",1,1,0
31027.0,2020-02-02,"(845.5, 1023.0]",1,1,0
31027.0,2020-02-02,"(1023.0, 1200.5]",1,1,0
31027.0,2020-02-02,"(1200.5, 1378.0]",1,2,-1
31028.0,2020-02-02,"(585.503, 710.25]",2,5,-3
31028.0,2020-02-02,"(834.5, 958.75]",1,2,-1
31028.0,2020-02-02,"(958.75, 1083.0]",1,3,-2
31029.0,2020-02-02,"(132.026, 376.5]",1,1,0
31029.0,2020-02-02,"(620.0, 863.5]",2,2,0
31029.0,2020-02-02,"(863.5, 1107.0]",3,4,-1
31030.0,2020-02-02,"(197.805, 497.75]",1,1,0
31030.0,2020-02-02,"(497.75, 796.5]",2,3,-1
31030.0,2020-02-02,"(796.5, 1095.25]",4,6,-2
31030.0,2020-02-02,"(1095.25, 1394.0]",2,3,-1
31031.0,2020-02-02,"(638.208, 837.0]",1,2,-1
31031.0,2020-02-02,"(837.0, 1035.0]",1,3,-2
31031.0,2020-02-02,"(1035.0, 1233.0]",2,3,-1
31031.0,2020-02-02,"(1233.0, 1431.0]",2,3,-1
,,,,1.0,
,,,,1.0,
31033.0,2020-02-02,"(1051.75, 1063.0]",1,1,0
31034.0,2020-02-02,"(576.213, 773.75]",1,2,-1
31035.0,2020-02-02,"(696.0, 928.0]",1,1,0
31036.0,2020-02-02,"(854.624, 949.0]",1,1,0
31036.0,2020-02-02,"(949.0, 1043.0]",1,3,-2
31036.0,2020-02-02,"(1137.0, 1231.0]",1,1,0
31037.0,2020-02-02,"(524.0, 821.0]",4,1,3
31037.0,2020-02-02,"(821.0, 1118.0]",3,6,-3
31038.0,2020-02-02,"(582.537, 698.75]",3,4,-1
31038.0,2020-02-02,"(814.5, 930.25]",1,1,0
31039.0,2020-02-02,"(563.4, 714.0]",1,2,-1
31039.0,2020-02-02,"(714.0, 864.0]",1,3,-2
31039.0,2020-02-02,"(864.0, 1014.0]",3,7,-4
31039.0,2020-02-02,"(1014.0, 1164.0]",1,1,0
31040.0,2020-02-02,"(480.112, 703.0]",1,1,0
31040.0,2020-02-02,"(1147.0, 1369.0]",1,1,0
31041.0,2020-02-02,"(549.262, 734.5]",2,4,-2
31041.0,2020-02-02,"(734.5, 919.0]",4,7,-3
31041.0,2020-02-02,"(1103.5, 1288.0]",1,1,0
31042.0,2020-02-02,"(576.578, 682.5]",1,1,0
31042.0,2020-02-02,"(788.0, 893.5]",3,3,0
31042.0,2020-02-02,"(893.5, 999.0]",6,11,-5
31043.0,2020-02-02,"(637.608, 736.0]",1,1,0
31043.0,2020-02-02,"(834.0, 932.0]",1,2,-1
31043.0,2020-02-02,"(932.0, 1030.0]",1,3,-2
31044.0,2020-02-02,"(619.703, 694.25]",1,2,-1
31044.0,2020-02-02,"(694.25, 768.5]",1,1,0
31044.0,2020-02-02,"(842.75, 917.0]",1,1,0
31045.0,2020-02-02,"(849.0, 919.0]",1,1,0
31045.0,2020-02-02,"(989.0, 1059.0]",1,1,0
,,,,1.0,
,,,,1.0,
31047.0,2020-02-02,"(699.0, 830.0]",1,1,0
31048.0,2020-02-02,"(835.432, 978.0]",2,5,-3
31048.0,2020-02-02,"(978.0, 1120.0]",1,3,-2
31049.0,2020-02-02,"(560.514, 682.5]",1,3,-2
31049.0,2020-02-02,"(925.5, 1047.0]",1,1,0
,,,,2.0,
31051.0,2020-02-02,"(850.5, 969.75]",1,2,-1
31051.0,2020-02-02,"(969.75, 1089.0]",1,1,0
31052.0,2020-02-02,"(943.0, 1030.5]",1,2,-1
31053.0,2020-02-02,"(639.631, 732.25]",1,1,0
31054.0,2020-02-02,"(731.25, 780.5]",1,4,-3
31054.0,2020-02-02,"(829.75, 879.0]",1,1,0
31055.0,2020-02-02,"(806.25, 984.5]",1,1,0
31055.0,2020-02-02,"(984.5, 1162.75]",1,1,0
31055.0,2020-02-02,"(1162.75, 1341.0]",1,2,-1
31056.0,2020-02-02,"(730.0, 935.0]",2,1,1
31056.0,2020-02-02,"(935.0, 1140.0]",1,2,-1
31056.0,2020-02-02,"(1140.0, 1345.0]",1,2,-1
31057.0,2020-02-02,"(594.591, 697.25]",2,5,-3
31057.0,2020-02-02,"(901.75, 1004.0]",1,1,0
31058.0,2020-02-02,"(1158.821, 1203.75]",1,1,0
31059.0,2020-02-02,"(1087.0, 1092.0]",1,1,0
31060.0,2020-02-02,"(721.389, 874.75]",8,10,-2
31060.0,2020-02-02,"(874.75, 1027.5]",1,3,-2
31061.0,2020-02-02,"(480.0, 640.0]",2,1,1
31062.0,2020-02-02,"(660.617, 756.75]",2,4,-2
31062.0,2020-02-02,"(756.75, 852.5]",2,3,-1
31062.0,2020-02-02,"(852.5, 948.25]",4,7,-3
31062.0,2020-02-02,"(948.25, 1044.0]",7,14,-7
31063.0,2020-02-02,"(832.75, 848.0]",2,2,0
31064.0,2020-02-02,"(645.594, 747.5]",3,4,-1
31064.0,2020-02-02,"(747.5, 849.0]",6,13,-7
31064.0,2020-02-02,"(849.0, 950.5]",2,8,-6
31064.0,2020-02-02,"(950.5, 1052.0]",13,24,-11
,,,,2.0,
31066.0,2020-02-02,"(690.738, 756.5]",4,7,-3
31066.0,2020-02-02,"(887.5, 953.0]",1,1,0
,,,,1.0,
,,,,1.0,
31068.0,2020-02-02,"(965.573, 1072.75]",2,4,-2
31068.0,2020-02-02,"(1286.25, 1393.0]",1,1,0
31069.0,2020-02-02,"(900.0, 1073.5]",2,1,1
31069.0,2020-02-02,"(1073.5, 1247.0]",1,2,-1
31070.0,2020-02-02,"(593.5, 829.75]",1,1,0
31070.0,2020-02-02,"(829.75, 1066.0]",1,1,0
31071.0,2020-02-02,"(422.36, 583.0]",3,5,-2
31071.0,2020-02-02,"(583.0, 743.0]",2,4,-2
31071.0,2020-02-02,"(743.0, 903.0]",8,14,-6
31071.0,2020-02-02,"(903.0, 1063.0]",5,7,-2
,,,,1.0,
,,,,3.0,
31073.0,2020-02-02,"(635.558, 746.5]",1,3,-2
31073.0,2020-02-02,"(967.5, 1078.0]",1,1,0
31074.0,2020-02-02,"(559.5, 581.25]",1,1,0
31074.0,2020-02-02,"(581.25, 603.0]",1,1,0
,,,,1.0,
,,,,1.0,
,,,,2.0,
31077.0,2020-02-02,"(69.055, 306.25]",1,1,0
31077.0,2020-02-02,"(542.5, 778.75]",1,1,0
31077.0,2020-02-02,"(778.75, 1015.0]",7,14,-7
,,,,2.0,
31079.0,2020-02-02,"(46.655, 384.25]",1,1,0
31079.0,2020-02-02,"(384.25, 720.5]",1,5,-4
31079.0,2020-02-02,"(720.5, 1056.75]",3,7,-4
31079.0,2020-02-02,"(1056.75, 1393.0]",4,4,0
31080.0,2020-02-02,"(578.239, 769.25]",1,3,-2
31080.0,2020-02-02,"(769.25, 959.5]",3,5,-2
31080.0,2020-02-02,"(959.5, 1149.75]",1,3,-2
31080.0,2020-02-02,"(1149.75, 1340.0]",2,2,0
,,,,2.0,
31082.0,2020-02-02,"(785.408, 934.0]",1,2,-1
31082.0,2020-02-02,"(934.0, 1082.0]",1,1,0
31083.0,2020-02-02,"(744.602, 844.5]",3,5,-2
31083.0,2020-02-02,"(1043.5, 1143.0]",1,1,0
31084.0,2020-02-02,"(784.674, 866.5]",1,1,0
31084.0,2020-02-02,"(1029.5, 1111.0]",1,1,0
31085.0,2020-02-02,"(679.584, 784.0]",1,2,-1
31085.0,2020-02-02,"(784.0, 888.0]",1,1,0
31085.0,2020-02-02,"(888.0, 992.0]",1,2,-1
31085.0,2020-02-02,"(992.0, 1096.0]",1,1,0
31086.0,2020-02-02,"(752.617, 848.75]",3,7,-4
31087.0,2020-02-02,"(801.681, 881.75]",1,3,-2
31087.0,2020-02-02,"(881.75, 961.5]",1,1,0
31087.0,2020-02-02,"(1041.25, 1121.0]",1,1,0
31088.0,2020-02-02,"(686.292, 864.0]",2,6,-4
31088.0,2020-02-02,"(864.0, 1041.0]",2,2,0
31088.0,2020-02-02,"(1041.0, 1218.0]",1,1,0
31088.0,2020-02-02,"(1218.0, 1395.0]",1,1,0
31089.0,2020-02-02,"(568.181, 773.75]",3,7,-4
31089.0,2020-02-02,"(773.75, 978.5]",2,5,-3
31089.0,2020-02-02,"(978.5, 1183.25]",1,5,-4
31090.0,2020-02-02,"(713.766, 772.5]",2,2,0
31090.0,2020-02-02,"(772.5, 831.0]",2,3,-1
31090.0,2020-02-02,"(889.5, 948.0]",1,1,0
31091.0,2020-02-02,"(16.686, 346.5]",1,1,0
31091.0,2020-02-02,"(675.0, 1003.5]",1,4,-3
31091.0,2020-02-02,"(1003.5, 1332.0]",2,2,0
31092.0,2020-02-02,"(555.25, 636.5]",1,1,0
31092.0,2020-02-02,"(636.5, 717.75]",1,1,0
31092.0,2020-02-02,"(717.75, 799.0]",1,1,0
31093.0,2020-02-02,"(202.179, 408.25]",1,1,0
31093.0,2020-02-02,"(818.75, 1024.0]",1,3,-2
31094.0,2020-02-02,"(832.855, 869.25]",2,2,0
31094.0,2020-02-02,"(905.5, 941.75]",1,2,-1
31094.0,2020-02-02,"(941.75, 978.0]",1,1,0
31095.0,2020-02-02,"(83.25, 111.0]",1,1,0
,,,,2.0,
31097.0,2020-02-02,"(568.5, 758.0]",1,1,0
31098.0,2020-02-02,"(718.46, 854.0]",1,3,-2
31098.0,2020-02-02,"(854.0, 989.0]",1,3,-2
31099.0,2020-02-02,"(921.75, 967.0]",1,1,0
31100.0,2020-02-02,"(679.0, 970.5]",3,1,2
31101.0,2020-02-02,"(62.648, 402.0]",1,6,-5
31101.0,2020-02-02,"(402.0, 740.0]",28,40,-12
31101.0,2020-02-02,"(740.0, 1078.0]",37,66,-29
31101.0,2020-02-02,"(1078.0, 1416.0]",15,27,-12
31102.0,2020-02-02,"(40.646, 380.5]",1,7,-6
31102.0,2020-02-02,"(719.0, 1057.5]",11,5,6
31102.0,2020-02-02,"(1057.5, 1396.0]",4,25,-21
31103.0,2020-02-02,"(122.724, 443.0]",2,4,-2
31103.0,2020-02-02,"(443.0, 762.0]",9,26,-17
31103.0,2020-02-02,"(762.0, 1081.0]",13,39,-26
31103.0,2020-02-02,"(1081.0, 1400.0]",9,23,-14
31104.0,2020-02-02,"(14.63, 358.5]",3,11,-8
31104.0,2020-02-02,"(358.5, 701.0]",8,22,-14
31104.0,2020-02-02,"(701.0, 1043.5]",21,42,-21
31104.0,2020-02-02,"(1043.5, 1386.0]",16,32,-16
31105.0,2020-02-02,"(176.766, 486.5]",1,2,-1
31105.0,2020-02-02,"(486.5, 795.0]",3,7,-4
31105.0,2020-02-02,"(795.0, 1103.5]",2,8,-6
,,,,1.0,
,,,,1.0,
,,,,1.0,
31107.0,2020-02-02,"(6.615, 354.25]",3,6,-3
31107.0,2020-02-02,"(354.25, 700.5]",5,12,-7
31107.0,2020-02-02,"(700.5, 1046.75]",11,33,-22
31107.0,2020-02-02,"(1046.75, 1393.0]",8,11,-3
31108.0,2020-02-02,"(508.096, 735.0]",3,10,-7
31108.0,2020-02-02,"(735.0, 961.0]",7,10,-3
31108.0,2020-02-02,"(961.0, 1187.0]",9,19,-10
31108.0,2020-02-02,"(1187.0, 1413.0]",3,5,-2
31109.0,2020-02-02,"(17.609, 366.75]",1,4,-3
31109.0,2020-02-02,"(366.75, 714.5]",11,22,-11
31109.0,2020-02-02,"(714.5, 1062.25]",13,15,-2
31109.0,2020-02-02,"(1062.25, 1410.0]",4,11,-7
31110.0,2020-02-02,"(7.587, 362.25]",4,6,-2
31110.0,2020-02-02,"(362.25, 715.5]",14,27,-13
31110.0,2020-02-02,"(715.5, 1068.75]",19,35,-16
31110.0,2020-02-02,"(1068.75, 1422.0]",5,12,-7
31111.0,2020-02-02,"(27.625, 372.75]",3,4,-1
31111.0,2020-02-02,"(372.75, 716.5]",6,11,-5
31111.0,2020-02-02,"(716.5, 1060.25]",13,20,-7
31111.0,2020-02-02,"(1060.25, 1404.0]",14,27,-13
31112.0,2020-02-02,"(572.443, 712.25]",1,2,-1
31112.0,2020-02-02,"(712.25, 851.5]",1,1,0
31112.0,2020-02-02,"(851.5, 990.75]",5,12,-7
31113.0,2020-02-02,"(48.659, 385.25]",3,8,-5
31113.0,2020-02-02,"(385.25, 720.5]",2,8,-6
31113.0,2020-02-02,"(720.5, 1055.75]",7,26,-19
31113.0,2020-02-02,"(1055.75, 1391.0]",9,22,-13
31114.0,2020-02-02,"(3.618, 350.5]",3,3,0
31114.0,2020-02-02,"(350.5, 696.0]",5,17,-12
31114.0,2020-02-02,"(696.0, 1041.5]",8,22,-14
31114.0,2020-02-02,"(1041.5, 1387.0]",19,30,-11
31115.0,2020-02-02,"(22.631, 366.25]",4,6,-2
31115.0,2020-02-02,"(708.5, 1050.75]",7,8,-1
31115.0,2020-02-02,"(1050.75, 1393.0]",5,25,-20
31116.0,2020-02-02,"(15.631, 359.25]",2,5,-3
31116.0,2020-02-02,"(359.25, 701.5]",12,22,-10
31116.0,2020-02-02,"(701.5, 1043.75]",11,18,-7
31116.0,2020-02-02,"(1043.75, 1386.0]",10,22,-12
31117.0,2020-02-02,"(352.5, 703.0]",4,3,1
31117.0,2020-02-02,"(703.0, 1053.5]",7,14,-7
31117.0,2020-02-02,"(1053.5, 1404.0]",12,25,-13
31118.0,2020-02-02,"(58.634, 401.5]",2,3,-1
31118.0,2020-02-02,"(401.5, 743.0]",3,7,-4
31118.0,2020-02-02,"(743.0, 1084.5]",9,20,-11
31118.0,2020-02-02,"(1084.5, 1426.0]",6,10,-4
31119.0,2020-02-02,"(19.589, 373.75]",2,4,-2
31119.0,2020-02-02,"(373.75, 726.5]",11,22,-11
31119.0,2020-02-02,"(726.5, 1079.25]",17,33,-16
31119.0,2020-02-02,"(1079.25, 1432.0]",16,33,-17
31120.0,2020-02-02,"(3.631, 347.25]",3,5,-2
31120.0,2020-02-02,"(347.25, 689.5]",2,7,-5
31120.0,2020-02-02,"(689.5, 1031.75]",8,20,-12
31120.0,2020-02-02,"(1031.75, 1374.0]",5,6,-1
31121.0,2020-02-02,"(148.776, 456.0]",1,2,-1
31121.0,2020-02-02,"(456.0, 762.0]",4,8,-4
31121.0,2020-02-02,"(762.0, 1068.0]",7,12,-5
31121.0,2020-02-02,"(1068.0, 1374.0]",5,7,-2
31122.0,2020-02-02,"(26.654, 364.5]",3,3,0
31122.0,2020-02-02,"(364.5, 701.0]",2,8,-6
31122.0,2020-02-02,"(701.0, 1037.5]",5,16,-11
31122.0,2020-02-02,"(1037.5, 1374.0]",6,11,-5
31123.0,2020-02-02,"(26.6, 378.0]",2,2,0
31123.0,2020-02-02,"(378.0, 728.0]",1,13,-12
31123.0,2020-02-02,"(728.0, 1078.0]",9,26,-17
31123.0,2020-02-02,"(1078.0, 1428.0]",6,9,-3
31124.0,2020-02-02,"(23.658, 360.5]",1,1,0
31124.0,2020-02-02,"(360.5, 696.0]",5,14,-9
31124.0,2020-02-02,"(696.0, 1031.5]",16,55,-39
31124.0,2020-02-02,"(1031.5, 1367.0]",9,27,-18
31125.0,2020-02-02,"(12.62, 359.0]",1,3,-2
31125.0,2020-02-02,"(359.0, 704.0]",8,16,-8
31125.0,2020-02-02,"(704.0, 1049.0]",22,43,-21
31125.0,2020-02-02,"(1049.0, 1394.0]",12,20,-8
31126.0,2020-02-02,"(688.5, 1024.75]",7,1,6
31126.0,2020-02-02,"(1024.75, 1361.0]",12,3,9
31127.0,2020-02-02,"(37.79, 341.5]",2,2,0
31127.0,2020-02-02,"(341.5, 644.0]",5,6,-1
31127.0,2020-02-02,"(644.0, 946.5]",11,18,-7
31127.0,2020-02-02,"(946.5, 1249.0]",1,4,-3
31128.0,2020-02-02,"(0.665, 335.75]",4,7,-3
31128.0,2020-02-02,"(335.75, 669.5]",6,12,-6
31128.0,2020-02-02,"(669.5, 1003.25]",12,23,-11
31128.0,2020-02-02,"(1003.25, 1337.0]",16,27,-11
31129.0,2020-02-02,"(468.049, 706.75]",3,8,-5
31129.0,2020-02-02,"(706.75, 944.5]",6,6,0
31129.0,2020-02-02,"(944.5, 1182.25]",3,8,-5
31129.0,2020-02-02,"(1182.25, 1420.0]",1,4,-3
31130.0,2020-02-02,"(61.71, 385.5]",2,2,0
31130.0,2020-02-02,"(385.5, 708.0]",1,4,-3
31130.0,2020-02-02,"(708.0, 1030.5]",12,18,-6
31130.0,2020-02-02,"(1030.5, 1353.0]",6,12,-6
31131.0,2020-02-02,"(43.682, 374.5]",2,3,-1
31131.0,2020-02-02,"(374.5, 704.0]",1,7,-6
31131.0,2020-02-02,"(704.0, 1033.5]",2,12,-10
31131.0,2020-02-02,"(1033.5, 1363.0]",7,10,-3
31200.0,2020-02-02,"(4.623, 350.25]",1,2,-1
31200.0,2020-02-02,"(350.25, 694.5]",34,50,-16
31200.0,2020-02-02,"(694.5, 1038.75]",21,53,-32
31200.0,2020-02-02,"(1038.75, 1383.0]",11,19,-8
31201.0,2020-02-02,"(353.5, 686.0]",20,7,13
31201.0,2020-02-02,"(686.0, 1018.5]",57,37,20
31201.0,2020-02-02,"(1018.5, 1351.0]",21,112,-91
,,,,2.0,
31203.0,2020-02-02,"(49.622, 395.5]",2,6,-4
31203.0,2020-02-02,"(395.5, 740.0]",18,28,-10
31203.0,2020-02-02,"(740.0, 1084.5]",28,43,-15
31203.0,2020-02-02,"(1084.5, 1429.0]",18,32,-14
31204.0,2020-02-02,"(74.674, 407.5]",2,2,0
31204.0,2020-02-02,"(407.5, 739.0]",2,7,-5
31204.0,2020-02-02,"(739.0, 1070.5]",10,18,-8
31204.0,2020-02-02,"(1070.5, 1402.0]",7,15,-8
31205.0,2020-02-02,"(4.574, 362.5]",3,6,-3
31205.0,2020-02-02,"(362.5, 719.0]",9,11,-2
31205.0,2020-02-02,"(719.0, 1075.5]",6,11,-5
31205.0,2020-02-02,"(1075.5, 1432.0]",3,10,-7
31206.0,2020-02-02,"(963.999, 964.25]",1,1,0
31207.0,2020-02-02,"(615.226, 809.5]",2,4,-2
31207.0,2020-02-02,"(809.5, 1003.0]",3,5,-2
31207.0,2020-02-02,"(1196.5, 1390.0]",3,2,1
31208.0,2020-02-02,"(594.321, 764.75]",2,5,-3
31208.0,2020-02-02,"(764.75, 934.5]",2,2,0
31208.0,2020-02-02,"(934.5, 1104.25]",4,7,-3
31208.0,2020-02-02,"(1104.25, 1274.0]",3,5,-2
31209.0,2020-02-02,"(11.661, 347.75]",1,2,-1
31209.0,2020-02-02,"(347.75, 682.5]",5,7,-2
31209.0,2020-02-02,"(682.5, 1017.25]",2,5,-3
31209.0,2020-02-02,"(1017.25, 1352.0]",2,5,-3
31211.0,2020-02-02,"(682.39, 835.5]",3,4,-1
31211.0,2020-02-02,"(835.5, 988.0]",6,8,-2
31211.0,2020-02-02,"(988.0, 1140.5]",3,7,-4
31211.0,2020-02-02,"(1140.5, 1293.0]",3,6,-3
31212.0,2020-02-02,"(28.632, 372.0]",2,4,-2
31212.0,2020-02-02,"(372.0, 714.0]",11,17,-6
31212.0,2020-02-02,"(714.0, 1056.0]",12,24,-12
31212.0,2020-02-02,"(1056.0, 1398.0]",7,13,-6
31213.0,2020-02-02,"(108.723, 429.25]",1,2,-1
31213.0,2020-02-02,"(429.25, 748.5]",8,11,-3
31213.0,2020-02-02,"(748.5, 1067.75]",10,14,-4
31213.0,2020-02-02,"(1067.75, 1387.0]",1,3,-2
31214.0,2020-02-02,"(2.606, 352.5]",4,6,-2
31214.0,2020-02-02,"(352.5, 701.0]",4,22,-18
31214.0,2020-02-02,"(701.0, 1049.5]",30,58,-28
31214.0,2020-02-02,"(1049.5, 1398.0]",23,38,-15
31215.0,2020-02-02,"(765.634, 857.5]",4,6,-2
31215.0,2020-02-02,"(857.5, 949.0]",6,6,0
31215.0,2020-02-02,"(1040.5, 1132.0]",1,1,0
31216.0,2020-02-02,"(491.41, 639.5]",1,1,0
31216.0,2020-02-02,"(639.5, 787.0]",1,1,0
31216.0,2020-02-02,"(787.0, 934.5]",2,2,0
31216.0,2020-02-02,"(934.5, 1082.0]",1,3,-2
31217.0,2020-02-02,"(756.59, 859.5]",2,3,-1
31217.0,2020-02-02,"(859.5, 962.0]",1,5,-4
31217.0,2020-02-02,"(1064.5, 1167.0]",5,1,4
31218.0,2020-02-02,"(31.821, 327.75]",1,1,0
31218.0,2020-02-02,"(622.5, 917.25]",6,1,5
31218.0,2020-02-02,"(917.25, 1212.0]",6,9,-3
31219.0,2020-02-02,"(621.559, 732.25]",5,5,0
31219.0,2020-02-02,"(732.25, 842.5]",1,1,0
31219.0,2020-02-02,"(842.5, 952.75]",2,9,-7
31219.0,2020-02-02,"(952.75, 1063.0]",6,8,-2
31220.0,2020-02-02,"(223.2, 424.0]",1,1,0
31220.0,2020-02-02,"(824.0, 1024.0]",2,3,-1
31221.0,2020-02-02,"(22.899, 299.25]",1,5,-4
31221.0,2020-02-02,"(299.25, 574.5]",1,1,0
31221.0,2020-02-02,"(574.5, 849.75]",4,6,-2
31221.0,2020-02-02,"(849.75, 1125.0]",3,6,-3
31222.0,2020-02-02,"(604.323, 774.25]",3,4,-1
31222.0,2020-02-02,"(774.25, 943.5]",6,10,-4
31222.0,2020-02-02,"(943.5, 1112.75]",2,3,-1
31222.0,2020-02-02,"(1112.75, 1282.0]",1,2,-1
31223.0,2020-02-02,"(53.62, 400.0]",1,4,-3
31223.0,2020-02-02,"(400.0, 745.0]",11,18,-7
31223.0,2020-02-02,"(745.0, 1090.0]",6,12,-6
31223.0,2020-02-02,"(1090.0, 1435.0]",3,13,-10
31224.0,2020-02-02,"(470.081, 700.75]",3,4,-1
31224.0,2020-02-02,"(700.75, 930.5]",1,3,-2
31224.0,2020-02-02,"(930.5, 1160.25]",3,7,-4
31224.0,2020-02-02,"(1160.25, 1390.0]",1,4,-3
31225.0,2020-02-02,"(394.5, 707.0]",3,1,2
31225.0,2020-02-02,"(707.0, 1019.5]",13,6,7
31225.0,2020-02-02,"(1019.5, 1332.0]",5,19,-14
31226.0,2020-02-02,"(809.25, 985.5]",2,2,0
31226.0,2020-02-02,"(985.5, 1161.75]",2,2,0
31227.0,2020-02-02,"(20.669, 354.75]",1,1,0
31227.0,2020-02-02,"(354.75, 687.5]",2,2,0
31227.0,2020-02-02,"(687.5, 1020.25]",5,11,-6
31227.0,2020-02-02,"(1020.25, 1353.0]",7,11,-4
31228.0,2020-02-02,"(355.75, 702.5]",5,2,3
31228.0,2020-02-02,"(702.5, 1049.25]",16,7,9
31228.0,2020-02-02,"(1049.25, 1396.0]",13,30,-17
31229.0,2020-02-02,"(13.579, 370.25]",7,18,-11
31229.0,2020-02-02,"(370.25, 725.5]",15,38,-23
31229.0,2020-02-02,"(725.5, 1080.75]",52,99,-47
31229.0,2020-02-02,"(1080.75, 1436.0]",21,46,-25
31230.0,2020-02-02,"(352.75, 695.5]",5,1,4
31230.0,2020-02-02,"(695.5, 1038.25]",15,6,9
31230.0,2020-02-02,"(1038.25, 1381.0]",2,26,-24
31231.0,2020-02-02,"(935.25, 1021.0]",1,1,0
31232.0,2020-02-02,"(223.826, 518.5]",1,4,-3
31232.0,2020-02-02,"(518.5, 812.0]",16,27,-11
31232.0,2020-02-02,"(812.0, 1105.5]",19,30,-11
31232.0,2020-02-02,"(1105.5, 1399.0]",5,11,-6
31233.0,2020-02-02,"(370.75, 700.5]",2,4,-2
31233.0,2020-02-02,"(700.5, 1030.25]",4,3,1
31233.0,2020-02-02,"(1030.25, 1360.0]",1,6,-5
31234.0,2020-02-02,"(55.677, 387.75]",2,2,0
31234.0,2020-02-02,"(387.75, 718.5]",12,20,-8
31234.0,2020-02-02,"(718.5, 1049.25]",16,33,-17
31234.0,2020-02-02,"(1049.25, 1380.0]",12,18,-6
31235.0,2020-02-02,"(736.5, 829.0]",2,1,1
31235.0,2020-02-02,"(921.5, 1014.0]",2,4,-2
31236.0,2020-02-02,"(455.136, 672.0]",6,8,-2
31236.0,2020-02-02,"(672.0, 888.0]",8,13,-5
31236.0,2020-02-02,"(888.0, 1104.0]",9,21,-12
31236.0,2020-02-02,"(1104.0, 1320.0]",3,9,-6
31237.0,2020-02-02,"(173.892, 452.0]",1,4,-3
31237.0,2020-02-02,"(452.0, 729.0]",8,16,-8
31237.0,2020-02-02,"(729.0, 1006.0]",13,24,-11
31237.0,2020-02-02,"(1006.0, 1283.0]",6,14,-8
31238.0,2020-02-02,"(61.035, 303.25]",1,1,0
31238.0,2020-02-02,"(303.25, 544.5]",2,3,-1
31238.0,2020-02-02,"(544.5, 785.75]",5,10,-5
31238.0,2020-02-02,"(785.75, 1027.0]",4,5,-1
31239.0,2020-02-02,"(56.818, 353.5]",1,2,-1
31239.0,2020-02-02,"(353.5, 649.0]",1,1,0
31239.0,2020-02-02,"(649.0, 944.5]",12,16,-4
31239.0,2020-02-02,"(944.5, 1240.0]",12,23,-11
31240.0,2020-02-02,"(530.462, 665.5]",7,8,-1
31240.0,2020-02-02,"(665.5, 800.0]",2,5,-3
31240.0,2020-02-02,"(800.0, 934.5]",9,16,-7
31240.0,2020-02-02,"(934.5, 1069.0]",7,14,-7
31241.0,2020-02-02,"(450.25, 750.5]",8,3,5
31241.0,2020-02-02,"(750.5, 1050.75]",8,14,-6
31241.0,2020-02-02,"(1050.75, 1351.0]",11,24,-13
31242.0,2020-02-02,"(566.491, 694.25]",4,5,-1
31242.0,2020-02-02,"(821.5, 948.75]",2,2,0
31242.0,2020-02-02,"(948.75, 1076.0]",1,3,-2
31243.0,2020-02-02,"(456.146, 670.5]",5,5,0
31243.0,2020-02-02,"(670.5, 884.0]",8,10,-2
31243.0,2020-02-02,"(884.0, 1097.5]",9,16,-7
31243.0,2020-02-02,"(1097.5, 1311.0]",1,1,0
31244.0,2020-02-02,"(45.653, 383.75]",1,1,0
31244.0,2020-02-02,"(383.75, 720.5]",2,4,-2
31244.0,2020-02-02,"(720.5, 1057.25]",3,7,-4
31244.0,2020-02-02,"(1057.25, 1394.0]",7,10,-3
31245.0,2020-02-02,"(46.64, 388.0]",2,3,-1
31245.0,2020-02-02,"(388.0, 728.0]",5,9,-4
31245.0,2020-02-02,"(728.0, 1068.0]",15,24,-9
31245.0,2020-02-02,"(1068.0, 1408.0]",6,15,-9
31246.0,2020-02-02,"(159.758, 471.5]",4,8,-4
31246.0,2020-02-02,"(471.5, 782.0]",16,23,-7
31246.0,2020-02-02,"(782.0, 1092.5]",22,31,-9
31246.0,2020-02-02,"(1092.5, 1403.0]",2,7,-5
31247.0,2020-02-02,"(515.176, 722.0]",2,6,-4
31247.0,2020-02-02,"(722.0, 928.0]",23,43,-20
31247.0,2020-02-02,"(928.0, 1134.0]",5,15,-10
31247.0,2020-02-02,"(1134.0, 1340.0]",2,4,-2
31248.0,2020-02-02,"(448.053, 685.75]",12,15,-3
31248.0,2020-02-02,"(685.75, 922.5]",16,36,-20
31248.0,2020-02-02,"(922.5, 1159.25]",10,25,-15
31248.0,2020-02-02,"(1159.25, 1396.0]",2,5,-3
31249.0,2020-02-02,"(-0.386, 347.5]",2,2,0
31249.0,2020-02-02,"(347.5, 694.0]",2,4,-2
31249.0,2020-02-02,"(694.0, 1040.5]",28,53,-25
31249.0,2020-02-02,"(1040.5, 1387.0]",6,12,-6
31250.0,2020-02-02,"(119.008, 368.0]",2,2,0
31250.0,2020-02-02,"(368.0, 616.0]",1,3,-2
31250.0,2020-02-02,"(616.0, 864.0]",3,5,-2
31250.0,2020-02-02,"(864.0, 1112.0]",4,8,-4
31251.0,2020-02-02,"(12.599, 364.25]",1,1,0
31251.0,2020-02-02,"(364.25, 714.5]",1,2,-1
31251.0,2020-02-02,"(714.5, 1064.75]",9,24,-15
31251.0,2020-02-02,"(1064.75, 1415.0]",5,9,-4
31252.0,2020-02-02,"(521.0, 799.0]",2,1,1
31252.0,2020-02-02,"(799.0, 1077.0]",4,2,2
31252.0,2020-02-02,"(1077.0, 1355.0]",1,7,-6
31253.0,2020-02-02,"(318.966, 578.5]",2,2,0
31253.0,2020-02-02,"(578.5, 837.0]",2,3,-1
31253.0,2020-02-02,"(837.0, 1095.5]",3,3,0
31253.0,2020-02-02,"(1095.5, 1354.0]",2,5,-3
31254.0,2020-02-02,"(196.043, 436.25]",1,2,-1
31254.0,2020-02-02,"(675.5, 914.75]",2,1,1
31254.0,2020-02-02,"(914.75, 1154.0]",1,3,-2
31255.0,2020-02-02,"(475.121, 695.75]",4,9,-5
31255.0,2020-02-02,"(695.75, 915.5]",3,5,-2
31255.0,2020-02-02,"(915.5, 1135.25]",2,3,-1
31256.0,2020-02-02,"(400.0, 729.0]",2,2,0
31256.0,2020-02-02,"(729.0, 1058.0]",10,3,7
31256.0,2020-02-02,"(1058.0, 1387.0]",1,16,-15
31257.0,2020-02-02,"(76.718, 398.5]",1,3,-2
31257.0,2020-02-02,"(398.5, 719.0]",5,12,-7
31257.0,2020-02-02,"(719.0, 1039.5]",13,28,-15
31257.0,2020-02-02,"(1039.5, 1360.0]",10,20,-10
31258.0,2020-02-02,"(633.254, 820.5]",9,21,-12
31258.0,2020-02-02,"(820.5, 1007.0]",11,23,-12
31258.0,2020-02-02,"(1007.0, 1193.5]",4,13,-9
31258.0,2020-02-02,"(1193.5, 1380.0]",1,2,-1
,,,,1.0,
,,,,2.0,
31260.0,2020-02-02,"(974.5, 1169.25]",4,1,3
31260.0,2020-02-02,"(1169.25, 1364.0]",1,1,0
31261.0,2020-02-02,"(953.839, 994.25]",2,2,0
31261.0,2020-02-02,"(1074.75, 1115.0]",3,1,2
31262.0,2020-02-02,"(379.213, 576.75]",2,2,0
31262.0,2020-02-02,"(576.75, 773.5]",3,4,-1
31262.0,2020-02-02,"(773.5, 970.25]",4,5,-1
31262.0,2020-02-02,"(970.25, 1167.0]",2,6,-4
31263.0,2020-02-02,"(377.75, 731.5]",3,2,1
31263.0,2020-02-02,"(731.5, 1085.25]",15,11,4
31263.0,2020-02-02,"(1085.25, 1439.0]",2,26,-24
31264.0,2020-02-02,"(685.295, 862.25]",3,6,-3
31264.0,2020-02-02,"(862.25, 1038.5]",3,4,-1
31264.0,2020-02-02,"(1214.75, 1391.0]",1,1,0
31265.0,2020-02-02,"(62.683, 393.25]",2,3,-1
31265.0,2020-02-02,"(393.25, 722.5]",4,9,-5
31265.0,2020-02-02,"(722.5, 1051.75]",13,27,-14
31265.0,2020-02-02,"(1051.75, 1381.0]",7,15,-8
31266.0,2020-02-02,"(26.606, 376.5]",2,3,-1
31266.0,2020-02-02,"(376.5, 725.0]",7,20,-13
31266.0,2020-02-02,"(725.0, 1073.5]",15,40,-25
31266.0,2020-02-02,"(1073.5, 1422.0]",24,35,-11
31267.0,2020-02-02,"(523.133, 740.75]",3,12,-9
31267.0,2020-02-02,"(740.75, 957.5]",5,11,-6
31267.0,2020-02-02,"(957.5, 1174.25]",10,17,-7
31267.0,2020-02-02,"(1174.25, 1391.0]",6,9,-3
31268.0,2020-02-02,"(373.75, 726.5]",8,1,7
31268.0,2020-02-02,"(726.5, 1079.25]",18,9,9
31268.0,2020-02-02,"(1079.25, 1432.0]",5,31,-26
31269.0,2020-02-02,"(441.041, 681.75]",6,10,-4
31269.0,2020-02-02,"(681.75, 921.5]",11,18,-7
31269.0,2020-02-02,"(921.5, 1161.25]",7,12,-5
31269.0,2020-02-02,"(1161.25, 1401.0]",3,7,-4
31270.0,2020-02-02,"(70.726, 390.5]",1,2,-1
31270.0,2020-02-02,"(390.5, 709.0]",2,2,0
31270.0,2020-02-02,"(709.0, 1027.5]",5,10,-5
31271.0,2020-02-02,"(598.393, 750.75]",3,3,0
31271.0,2020-02-02,"(750.75, 902.5]",5,8,-3
31271.0,2020-02-02,"(902.5, 1054.25]",14,24,-10
31271.0,2020-02-02,"(1054.25, 1206.0]",2,5,-3
31272.0,2020-02-02,"(486.397, 637.75]",3,5,-2
31272.0,2020-02-02,"(637.75, 788.5]",5,8,-3
31272.0,2020-02-02,"(788.5, 939.25]",7,13,-6
31272.0,2020-02-02,"(939.25, 1090.0]",5,12,-7
31273.0,2020-02-02,"(594.188, 798.0]",5,9,-4
31273.0,2020-02-02,"(798.0, 1001.0]",3,6,-3
31274.0,2020-02-02,"(350.25, 698.5]",2,3,-1
31274.0,2020-02-02,"(698.5, 1046.75]",3,3,0
31274.0,2020-02-02,"(1046.75, 1395.0]",1,9,-8
31275.0,2020-02-02,"(31.615, 379.25]",2,3,-1
31275.0,2020-02-02,"(379.25, 725.5]",2,7,-5
31275.0,2020-02-02,"(725.5, 1071.75]",9,17,-8
31275.0,2020-02-02,"(1071.75, 1418.0]",9,15,-6
31276.0,2020-02-02,"(618.37, 776.5]",3,3,0
31276.0,2020-02-02,"(776.5, 934.0]",3,9,-6
31276.0,2020-02-02,"(934.0, 1091.5]",2,4,-2
31276.0,2020-02-02,"(1091.5, 1249.0]",1,2,-1
31277.0,2020-02-02,"(27.837, 319.75]",2,2,0
31277.0,2020-02-02,"(319.75, 610.5]",3,4,-1
31277.0,2020-02-02,"(610.5, 901.25]",5,22,-17
31277.0,2020-02-02,"(901.25, 1192.0]",8,14,-6
31278.0,2020-02-02,"(497.102, 722.5]",8,16,-8
31278.0,2020-02-02,"(722.5, 947.0]",9,17,-8
31278.0,2020-02-02,"(947.0, 1171.5]",9,18,-9
31278.0,2020-02-02,"(1171.5, 1396.0]",4,8,-4
31279.0,2020-02-02,"(564.417, 710.75]",1,5,-4
31279.0,2020-02-02,"(710.75, 856.5]",2,4,-2
31279.0,2020-02-02,"(856.5, 1002.25]",5,7,-2
31279.0,2020-02-02,"(1002.25, 1148.0]",1,2,-1
31280.0,2020-02-02,"(135.747, 450.25]",1,2,-1
31280.0,2020-02-02,"(450.25, 763.5]",3,9,-6
31280.0,2020-02-02,"(763.5, 1076.75]",14,26,-12
31280.0,2020-02-02,"(1076.75, 1390.0]",4,9,-5
31000.0,2020-02-03,"(661.0, 824.0]",1,2,-1
31000.0,2020-02-03,"(824.0, 987.0]",1,2,-1
31000.0,2020-02-03,"(987.0, 1150.0]",3,1,2
31001.0,2020-02-03,"(462.257, 648.75]",1,2,-1
31001.0,2020-02-03,"(834.5, 1020.25]",1,1,0
31001.0,2020-02-03,"(1020.25, 1206.0]",3,9,-6
31002.0,2020-02-03,"(310.107, 534.25]",2,3,-1
31002.0,2020-02-03,"(534.25, 757.5]",3,7,-4
31002.0,2020-02-03,"(980.75, 1204.0]",4,1,3
31003.0,2020-02-03,"(377.992, 631.0]",3,7,-4
31003.0,2020-02-03,"(631.0, 883.0]",1,2,-1
31003.0,2020-02-03,"(883.0, 1135.0]",4,8,-4
31004.0,2020-02-03,"(947.5, 1148.25]",3,1,2
31005.0,2020-02-03,"(431.074, 663.5]",6,7,-1
31005.0,2020-02-03,"(663.5, 895.0]",2,3,-1
31005.0,2020-02-03,"(895.0, 1126.5]",2,8,-6
31005.0,2020-02-03,"(1126.5, 1358.0]",2,10,-8
31006.0,2020-02-03,"(1080.705, 1154.75]",3,4,-1
31006.0,2020-02-03,"(1154.75, 1228.5]",1,1,0
31006.0,2020-02-03,"(1302.25, 1376.0]",2,1,1
31007.0,2020-02-03,"(363.11, 586.5]",4,14,-10
31007.0,2020-02-03,"(586.5, 809.0]",2,4,-2
31007.0,2020-02-03,"(809.0, 1031.5]",8,14,-6
31007.0,2020-02-03,"(1031.5, 1254.0]",10,21,-11
31009.0,2020-02-03,"(413.215, 610.25]",4,4,0
31009.0,2020-02-03,"(806.5, 1002.75]",1,5,-4
31009.0,2020-02-03,"(1002.75, 1199.0]",1,3,-2
31010.0,2020-02-03,"(450.014, 697.5]",2,5,-3
31010.0,2020-02-03,"(697.5, 944.0]",1,5,-4
31010.0,2020-02-03,"(944.0, 1190.5]",1,1,0
31010.0,2020-02-03,"(1190.5, 1437.0]",1,2,-1
31011.0,2020-02-03,"(415.14, 631.0]",4,5,-1
31011.0,2020-02-03,"(631.0, 846.0]",1,3,-2
31011.0,2020-02-03,"(846.0, 1061.0]",2,7,-5
31011.0,2020-02-03,"(1061.0, 1276.0]",6,10,-4
31012.0,2020-02-03,"(367.211, 565.25]",5,5,0
31012.0,2020-02-03,"(565.25, 762.5]",1,1,0
31013.0,2020-02-03,"(384.185, 588.75]",1,4,-3
31013.0,2020-02-03,"(588.75, 792.5]",2,2,0
31013.0,2020-02-03,"(792.5, 996.25]",2,2,0
31013.0,2020-02-03,"(996.25, 1200.0]",2,3,-1
31014.0,2020-02-03,"(318.979, 575.25]",20,27,-7
31014.0,2020-02-03,"(575.25, 830.5]",8,12,-4
31014.0,2020-02-03,"(830.5, 1085.75]",11,23,-12
31014.0,2020-02-03,"(1085.75, 1341.0]",8,13,-5
31015.0,2020-02-03,"(302.007, 551.25]",9,11,-2
31015.0,2020-02-03,"(551.25, 799.5]",1,2,-1
31015.0,2020-02-03,"(799.5, 1047.75]",10,19,-9
31015.0,2020-02-03,"(1047.75, 1296.0]",5,9,-4
31016.0,2020-02-03,"(431.358, 592.5]",5,14,-9
31016.0,2020-02-03,"(753.0, 913.5]",3,3,0
31016.0,2020-02-03,"(913.5, 1074.0]",3,6,-3
31017.0,2020-02-03,"(510.152, 723.0]",3,4,-1
31017.0,2020-02-03,"(723.0, 935.0]",2,3,-1
31017.0,2020-02-03,"(1147.0, 1359.0]",2,4,-2
31018.0,2020-02-03,"(646.25, 876.5]",2,2,0
31018.0,2020-02-03,"(876.5, 1106.75]",2,3,-1
31018.0,2020-02-03,"(1106.75, 1337.0]",2,3,-1
31019.0,2020-02-03,"(675.25, 890.5]",1,1,0
31019.0,2020-02-03,"(890.5, 1105.75]",4,3,1
31019.0,2020-02-03,"(1105.75, 1321.0]",1,7,-6
31020.0,2020-02-03,"(960.5, 1064.25]",2,2,0
31021.0,2020-02-03,"(425.143, 640.25]",1,4,-3
31021.0,2020-02-03,"(640.25, 854.5]",3,7,-4
31021.0,2020-02-03,"(854.5, 1068.75]",4,6,-2
31021.0,2020-02-03,"(1068.75, 1283.0]",5,8,-3
31022.0,2020-02-03,"(463.069, 696.75]",3,8,-5
31022.0,2020-02-03,"(696.75, 929.5]",4,5,-1
31022.0,2020-02-03,"(929.5, 1162.25]",3,8,-5
31022.0,2020-02-03,"(1162.25, 1395.0]",2,5,-3
31023.0,2020-02-03,"(638.25, 847.5]",2,1,1
31023.0,2020-02-03,"(847.5, 1056.75]",2,4,-2
31023.0,2020-02-03,"(1056.75, 1266.0]",2,4,-2
31024.0,2020-02-03,"(437.036, 679.0]",6,8,-2
31024.0,2020-02-03,"(679.0, 920.0]",4,7,-3
31024.0,2020-02-03,"(920.0, 1161.0]",9,19,-10
31025.0,2020-02-03,"(662.259, 848.25]",4,6,-2
31025.0,2020-02-03,"(848.25, 1033.5]",1,2,-1
31025.0,2020-02-03,"(1033.5, 1218.75]",2,4,-2
31025.0,2020-02-03,"(1218.75, 1404.0]",1,1,0
31026.0,2020-02-03,"(621.25, 844.5]",2,1,1
31026.0,2020-02-03,"(844.5, 1067.75]",2,4,-2
31026.0,2020-02-03,"(1067.75, 1291.0]",1,8,-7
31027.0,2020-02-03,"(495.288, 674.0]",1,4,-3
31027.0,2020-02-03,"(674.0, 852.0]",1,2,-1
31027.0,2020-02-03,"(1030.0, 1208.0]",3,4,-1
31028.0,2020-02-03,"(1009.0, 1109.5]",1,1,0
31028.0,2020-02-03,"(1109.5, 1210.0]",2,3,-1
31029.0,2020-02-03,"(833.5, 1034.25]",1,6,-5
31029.0,2020-02-03,"(1034.25, 1235.0]",9,3,6
31030.0,2020-02-03,"(457.049, 695.75]",1,7,-6
31030.0,2020-02-03,"(695.75, 933.5]",2,5,-3
31030.0,2020-02-03,"(933.5, 1171.25]",3,4,-1
31030.0,2020-02-03,"(1171.25, 1409.0]",2,2,0
31031.0,2020-02-03,"(90.926, 360.5]",1,2,-1
31031.0,2020-02-03,"(897.5, 1166.0]",2,3,-1
31032.0,2020-02-03,"(1166.75, 1398.0]",1,3,-2
31033.0,2020-02-03,"(538.481, 668.75]",1,1,0
31033.0,2020-02-03,"(928.25, 1058.0]",2,1,1
31034.0,2020-02-03,"(530.267, 714.25]",3,3,0
31034.0,2020-02-03,"(714.25, 897.5]",4,7,-3
31034.0,2020-02-03,"(1080.75, 1264.0]",1,4,-3
31035.0,2020-02-03,"(392.0, 705.0]",2,1,1
31035.0,2020-02-03,"(705.0, 1018.0]",4,8,-4
31035.0,2020-02-03,"(1018.0, 1331.0]",4,5,-1
31036.0,2020-02-03,"(441.266, 625.5]",1,4,-3
31036.0,2020-02-03,"(625.5, 809.0]",2,3,-1
31036.0,2020-02-03,"(809.0, 992.5]",3,5,-2
31036.0,2020-02-03,"(992.5, 1176.0]",5,6,-1
31037.0,2020-02-03,"(420.074, 652.5]",10,14,-4
31037.0,2020-02-03,"(652.5, 884.0]",5,10,-5
31037.0,2020-02-03,"(884.0, 1115.5]",8,22,-14
31037.0,2020-02-03,"(1115.5, 1347.0]",2,7,-5
31038.0,2020-02-03,"(714.75, 859.5]",1,1,0
31038.0,2020-02-03,"(859.5, 1004.25]",3,2,1
31039.0,2020-02-03,"(434.107, 658.25]",2,4,-2
31039.0,2020-02-03,"(658.25, 881.5]",2,6,-4
31039.0,2020-02-03,"(881.5, 1104.75]",2,5,-3
31040.0,2020-02-03,"(442.126, 661.5]",4,7,-3
31040.0,2020-02-03,"(661.5, 880.0]",1,2,-1
31040.0,2020-02-03,"(880.0, 1098.5]",2,5,-3
31041.0,2020-02-03,"(459.309, 632.75]",2,2,0
31041.0,2020-02-03,"(978.25, 1151.0]",2,1,1
31042.0,2020-02-03,"(440.063, 675.25]",5,7,-2
31042.0,2020-02-03,"(909.5, 1143.75]",1,1,0
31043.0,2020-02-03,"(447.366, 606.5]",2,2,0
31043.0,2020-02-03,"(606.5, 765.0]",2,3,-1
31043.0,2020-02-03,"(923.5, 1082.0]",2,1,1
31044.0,2020-02-03,"(557.419, 703.25]",3,4,-1
31044.0,2020-02-03,"(993.75, 1139.0]",3,4,-1
31045.0,2020-02-03,"(87.805, 387.75]",1,1,0
31045.0,2020-02-03,"(387.75, 686.5]",1,4,-3
31045.0,2020-02-03,"(985.25, 1284.0]",4,4,0
31046.0,2020-02-03,"(396.329, 564.75]",1,3,-2
31046.0,2020-02-03,"(564.75, 732.5]",1,2,-1
31046.0,2020-02-03,"(900.25, 1068.0]",2,1,1
31047.0,2020-02-03,"(440.056, 677.0]",11,18,-7
31047.0,2020-02-03,"(677.0, 913.0]",3,6,-3
31047.0,2020-02-03,"(913.0, 1149.0]",5,20,-15
31047.0,2020-02-03,"(1149.0, 1385.0]",2,6,-4
31048.0,2020-02-03,"(405.271, 588.25]",2,6,-4
31048.0,2020-02-03,"(952.75, 1135.0]",2,1,1
31049.0,2020-02-03,"(426.105, 650.75]",2,4,-2
31049.0,2020-02-03,"(650.75, 874.5]",1,2,-1
31049.0,2020-02-03,"(874.5, 1098.25]",1,3,-2
31049.0,2020-02-03,"(1098.25, 1322.0]",2,4,-2
31050.0,2020-02-03,"(696.5, 821.75]",1,5,-4
31051.0,2020-02-03,"(778.5, 1017.75]",2,4,-2
31051.0,2020-02-03,"(1017.75, 1257.0]",4,1,3
31052.0,2020-02-03,"(475.279, 656.25]",4,6,-2
31052.0,2020-02-03,"(656.25, 836.5]",1,1,0
31052.0,2020-02-03,"(836.5, 1016.75]",2,2,0
31052.0,2020-02-03,"(1016.75, 1197.0]",1,5,-4
31053.0,2020-02-03,"(537.412, 685.0]",1,3,-2
31053.0,2020-02-03,"(832.0, 979.0]",3,1,2
31053.0,2020-02-03,"(979.0, 1126.0]",1,3,-2
31054.0,2020-02-03,"(912.25, 1006.0]",1,1,0
31055.0,2020-02-03,"(395.108, 619.0]",1,1,0
31055.0,2020-02-03,"(1065.0, 1288.0]",1,2,-1
31056.0,2020-02-03,"(868.5, 1050.75]",1,2,-1
31056.0,2020-02-03,"(1050.75, 1233.0]",4,1,3
31057.0,2020-02-03,"(712.622, 807.5]",1,2,-1
31058.0,2020-02-03,"(11.981, 267.75]",1,2,-1
31058.0,2020-02-03,"(777.25, 1032.0]",1,2,-1
31059.0,2020-02-03,"(634.25, 853.5]",2,2,0
31059.0,2020-02-03,"(853.5, 1072.75]",1,2,-1
31059.0,2020-02-03,"(1072.75, 1292.0]",3,2,1
31060.0,2020-02-03,"(591.373, 748.75]",2,3,-1
31060.0,2020-02-03,"(748.75, 905.5]",1,3,-2
31060.0,2020-02-03,"(905.5, 1062.25]",4,8,-4
31060.0,2020-02-03,"(1062.25, 1219.0]",2,4,-2
,,,,2.0,
31062.0,2020-02-03,"(812.606, 911.5]",1,2,-1
31062.0,2020-02-03,"(911.5, 1010.0]",2,4,-2
31062.0,2020-02-03,"(1010.0, 1108.5]",2,5,-3
31062.0,2020-02-03,"(1108.5, 1207.0]",2,4,-2
31063.0,2020-02-03,"(728.687, 807.25]",2,2,0
31063.0,2020-02-03,"(807.25, 885.5]",1,2,-1
31063.0,2020-02-03,"(963.75, 1042.0]",1,1,0
31064.0,2020-02-03,"(434.275, 616.25]",2,4,-2
31064.0,2020-02-03,"(616.25, 797.5]",3,3,0
31064.0,2020-02-03,"(978.75, 1160.0]",10,1,9
31065.0,2020-02-03,"(435.142, 650.5]",1,4,-3
31065.0,2020-02-03,"(1079.5, 1294.0]",2,6,-4
31066.0,2020-02-03,"(949.0, 1096.0]",1,3,-2
31067.0,2020-02-03,"(15.914, 288.5]",1,2,-1
31067.0,2020-02-03,"(288.5, 560.0]",3,6,-3
31067.0,2020-02-03,"(831.5, 1103.0]",4,6,-2
31068.0,2020-02-03,"(541.229, 734.75]",1,4,-3
31068.0,2020-02-03,"(734.75, 927.5]",1,1,0
31068.0,2020-02-03,"(1120.25, 1313.0]",1,1,0
31069.0,2020-02-03,"(882.0, 1109.0]",3,4,-1
31069.0,2020-02-03,"(1109.0, 1336.0]",3,4,-1
31070.0,2020-02-03,"(728.5, 879.0]",1,2,-1
31070.0,2020-02-03,"(879.0, 1029.5]",1,2,-1
31070.0,2020-02-03,"(1029.5, 1180.0]",5,3,2
31071.0,2020-02-03,"(416.281, 596.75]",2,10,-8
31071.0,2020-02-03,"(776.5, 956.25]",1,1,0
31071.0,2020-02-03,"(956.25, 1136.0]",10,13,-3
,,,,2.0,
31073.0,2020-02-03,"(920.0, 1049.0]",1,1,0
31074.0,2020-02-03,"(659.25, 797.5]",1,2,-1
31074.0,2020-02-03,"(935.75, 1074.0]",3,2,1
31075.0,2020-02-03,"(1007.0, 1163.0]",1,1,0
31076.0,2020-02-03,"(421.337, 587.75]",1,2,-1
31076.0,2020-02-03,"(587.75, 753.5]",1,1,0
31076.0,2020-02-03,"(919.25, 1085.0]",3,4,-1
31077.0,2020-02-03,"(405.263, 590.25]",1,5,-4
31077.0,2020-02-03,"(590.25, 774.5]",9,18,-9
31077.0,2020-02-03,"(774.5, 958.75]",3,3,0
31077.0,2020-02-03,"(958.75, 1143.0]",9,14,-5
31078.0,2020-02-03,"(450.197, 651.75]",5,7,-2
31078.0,2020-02-03,"(1053.25, 1254.0]",2,7,-5
31079.0,2020-02-03,"(719.0, 952.0]",1,10,-9
31079.0,2020-02-03,"(952.0, 1185.0]",4,5,-1
31079.0,2020-02-03,"(1185.0, 1418.0]",6,6,0
31080.0,2020-02-03,"(646.5, 891.0]",2,9,-7
31080.0,2020-02-03,"(891.0, 1135.5]",3,3,0
31080.0,2020-02-03,"(1135.5, 1380.0]",4,7,-3
31081.0,2020-02-03,"(727.565, 836.75]",1,2,-1
31081.0,2020-02-03,"(1054.25, 1163.0]",1,1,0
31082.0,2020-02-03,"(692.64, 783.0]",1,2,-1
31083.0,2020-02-03,"(719.5, 895.0]",3,3,0
31083.0,2020-02-03,"(895.0, 1070.5]",2,3,-1
31083.0,2020-02-03,"(1070.5, 1246.0]",2,3,-1
31084.0,2020-02-03,"(383.75, 683.5]",5,1,4
31084.0,2020-02-03,"(683.5, 983.25]",1,6,-5
31085.0,2020-02-03,"(401.294, 578.5]",1,4,-3
31085.0,2020-02-03,"(578.5, 755.0]",2,3,-1
31085.0,2020-02-03,"(931.5, 1108.0]",2,2,0
31086.0,2020-02-03,"(800.0, 992.0]",2,2,0
31086.0,2020-02-03,"(992.0, 1184.0]",3,2,1
31087.0,2020-02-03,"(635.0, 830.0]",2,1,1
31087.0,2020-02-03,"(830.0, 1025.0]",2,2,0
31087.0,2020-02-03,"(1025.0, 1220.0]",4,4,0
31088.0,2020-02-03,"(753.5, 934.25]",1,2,-1
31088.0,2020-02-03,"(934.25, 1115.0]",6,2,4
31089.0,2020-02-03,"(382.978, 639.5]",9,12,-3
31089.0,2020-02-03,"(639.5, 895.0]",4,7,-3
31089.0,2020-02-03,"(895.0, 1150.5]",2,20,-18
31089.0,2020-02-03,"(1150.5, 1406.0]",2,11,-9
31090.0,2020-02-03,"(965.25, 1144.0]",2,1,1
31091.0,2020-02-03,"(894.0, 1136.5]",2,5,-3
31091.0,2020-02-03,"(1136.5, 1379.0]",3,2,1
31092.0,2020-02-03,"(669.5, 872.0]",2,3,-1
31092.0,2020-02-03,"(872.0, 1074.5]",2,2,0
31092.0,2020-02-03,"(1074.5, 1277.0]",2,3,-1
31093.0,2020-02-03,"(978.75, 1159.0]",2,4,-2
31094.0,2020-02-03,"(506.322, 676.5]",1,2,-1
31094.0,2020-02-03,"(846.0, 1015.5]",1,1,0
31094.0,2020-02-03,"(1015.5, 1185.0]",2,2,0
31095.0,2020-02-03,"(858.5, 1004.75]",2,1,1
31095.0,2020-02-03,"(1004.75, 1151.0]",2,2,0
31096.0,2020-02-03,"(734.5, 924.25]",1,1,0
31096.0,2020-02-03,"(924.25, 1114.0]",2,1,1
31097.0,2020-02-03,"(484.133, 701.75]",3,4,-1
31097.0,2020-02-03,"(701.75, 918.5]",1,3,-2
31097.0,2020-02-03,"(918.5, 1135.25]",2,5,-3
31098.0,2020-02-03,"(433.201, 633.75]",3,6,-3
31098.0,2020-02-03,"(633.75, 833.5]",1,1,0
31098.0,2020-02-03,"(833.5, 1033.25]",2,6,-4
31098.0,2020-02-03,"(1033.25, 1233.0]",6,9,-3
31099.0,2020-02-03,"(868.75, 1060.0]",1,1,0
31100.0,2020-02-03,"(432.264, 617.0]",13,13,0
31100.0,2020-02-03,"(617.0, 801.0]",1,2,-1
31100.0,2020-02-03,"(801.0, 985.0]",2,7,-5
31100.0,2020-02-03,"(985.0, 1169.0]",7,26,-19
31101.0,2020-02-03,"(0.585, 355.75]",2,5,-3
31101.0,2020-02-03,"(355.75, 709.5]",12,49,-37
31101.0,2020-02-03,"(709.5, 1063.25]",28,47,-19
31101.0,2020-02-03,"(1063.25, 1417.0]",34,51,-17
31102.0,2020-02-03,"(318.906, 593.5]",2,18,-16
31102.0,2020-02-03,"(867.0, 1140.5]",11,13,-2
31102.0,2020-02-03,"(1140.5, 1414.0]",8,14,-6
31103.0,2020-02-03,"(693.0, 1024.5]",6,1,5
31103.0,2020-02-03,"(1024.5, 1356.0]",9,27,-18
31104.0,2020-02-03,"(217.868, 502.0]",2,11,-9
31104.0,2020-02-03,"(502.0, 785.0]",2,3,-1
31104.0,2020-02-03,"(785.0, 1068.0]",10,19,-9
31104.0,2020-02-03,"(1068.0, 1351.0]",23,37,-14
31105.0,2020-02-03,"(437.03, 680.5]",4,10,-6
31105.0,2020-02-03,"(680.5, 923.0]",1,1,0
31105.0,2020-02-03,"(923.0, 1165.5]",5,9,-4
31105.0,2020-02-03,"(1165.5, 1408.0]",2,5,-3
31106.0,2020-02-03,"(514.098, 740.5]",1,2,-1
31106.0,2020-02-03,"(966.0, 1191.5]",2,2,0
31106.0,2020-02-03,"(1191.5, 1417.0]",3,5,-2
31107.0,2020-02-03,"(84.714, 407.5]",2,4,-2
31107.0,2020-02-03,"(407.5, 729.0]",4,21,-17
31107.0,2020-02-03,"(729.0, 1050.5]",12,21,-9
31107.0,2020-02-03,"(1050.5, 1372.0]",11,19,-8
31108.0,2020-02-03,"(343.027, 587.25]",14,41,-27
31108.0,2020-02-03,"(587.25, 830.5]",7,17,-10
31108.0,2020-02-03,"(830.5, 1073.75]",27,45,-18
31108.0,2020-02-03,"(1073.75, 1317.0]",21,28,-7
31109.0,2020-02-03,"(420.047, 659.25]",4,14,-10
31109.0,2020-02-03,"(659.25, 897.5]",5,10,-5
31109.0,2020-02-03,"(897.5, 1135.75]",13,19,-6
31109.0,2020-02-03,"(1135.75, 1374.0]",10,17,-7
31110.0,2020-02-03,"(332.988, 587.0]",15,36,-21
31110.0,2020-02-03,"(587.0, 840.0]",7,15,-8
31110.0,2020-02-03,"(840.0, 1093.0]",19,37,-18
31110.0,2020-02-03,"(1093.0, 1346.0]",18,30,-12
31111.0,2020-02-03,"(149.813, 447.75]",2,4,-2
31111.0,2020-02-03,"(447.75, 744.5]",1,15,-14
31111.0,2020-02-03,"(744.5, 1041.25]",3,5,-2
31111.0,2020-02-03,"(1041.25, 1338.0]",11,18,-7
31112.0,2020-02-03,"(644.75, 781.5]",1,5,-4
31112.0,2020-02-03,"(918.25, 1055.0]",4,1,3
31113.0,2020-02-03,"(418.134, 635.5]",2,21,-19
31113.0,2020-02-03,"(635.5, 852.0]",3,16,-13
31113.0,2020-02-03,"(852.0, 1068.5]",3,7,-4
31113.0,2020-02-03,"(1068.5, 1285.0]",8,11,-3
31114.0,2020-02-03,"(7.584, 363.0]",3,5,-2
31114.0,2020-02-03,"(363.0, 717.0]",4,28,-24
31114.0,2020-02-03,"(717.0, 1071.0]",15,29,-14
31114.0,2020-02-03,"(1071.0, 1425.0]",23,37,-14
31115.0,2020-02-03,"(3.602, 354.5]",1,4,-3
31115.0,2020-02-03,"(354.5, 704.0]",3,21,-18
31115.0,2020-02-03,"(704.0, 1053.5]",6,14,-8
31115.0,2020-02-03,"(1053.5, 1403.0]",19,31,-12
31116.0,2020-02-03,"(333.957, 595.75]",8,32,-24
31116.0,2020-02-03,"(595.75, 856.5]",8,13,-5
31116.0,2020-02-03,"(856.5, 1117.25]",13,18,-5
31116.0,2020-02-03,"(1117.25, 1378.0]",13,19,-6
31117.0,2020-02-03,"(365.044, 605.0]",8,19,-11
31117.0,2020-02-03,"(605.0, 844.0]",1,2,-1
31117.0,2020-02-03,"(844.0, 1083.0]",7,14,-7
31117.0,2020-02-03,"(1083.0, 1322.0]",11,22,-11
31118.0,2020-02-03,"(-0.284, 322.0]",1,1,0
31118.0,2020-02-03,"(322.0, 643.0]",3,20,-17
31118.0,2020-02-03,"(643.0, 964.0]",4,8,-4
31118.0,2020-02-03,"(964.0, 1285.0]",21,24,-3
31119.0,2020-02-03,"(3.698, 330.5]",2,3,-1
31119.0,2020-02-03,"(330.5, 656.0]",4,14,-10
31119.0,2020-02-03,"(656.0, 981.5]",6,10,-4
31119.0,2020-02-03,"(981.5, 1307.0]",23,35,-12
31120.0,2020-02-03,"(416.018, 662.5]",1,13,-12
31120.0,2020-02-03,"(662.5, 908.0]",4,6,-2
31120.0,2020-02-03,"(908.0, 1153.5]",7,9,-2
31120.0,2020-02-03,"(1153.5, 1399.0]",11,17,-6
31121.0,2020-02-03,"(51.722, 372.5]",1,2,-1
31121.0,2020-02-03,"(372.5, 692.0]",14,21,-7
31121.0,2020-02-03,"(692.0, 1011.5]",3,9,-6
31121.0,2020-02-03,"(1011.5, 1331.0]",12,28,-16
31122.0,2020-02-03,"(432.099, 658.25]",2,15,-13
31122.0,2020-02-03,"(658.25, 883.5]",4,7,-3
31122.0,2020-02-03,"(883.5, 1108.75]",4,7,-3
31122.0,2020-02-03,"(1108.75, 1334.0]",6,11,-5
31123.0,2020-02-03,"(382.08, 613.0]",1,16,-15
31123.0,2020-02-03,"(843.0, 1073.0]",4,14,-10
31123.0,2020-02-03,"(1073.0, 1303.0]",8,10,-2
31124.0,2020-02-03,"(345.922, 616.5]",15,52,-37
31124.0,2020-02-03,"(616.5, 886.0]",3,13,-10
31124.0,2020-02-03,"(886.0, 1155.5]",18,48,-30
31124.0,2020-02-03,"(1155.5, 1425.0]",9,22,-13
31125.0,2020-02-03,"(38.629, 382.75]",2,3,-1
31125.0,2020-02-03,"(382.75, 725.5]",6,28,-22
31125.0,2020-02-03,"(725.5, 1068.25]",22,31,-9
31125.0,2020-02-03,"(1068.25, 1411.0]",21,29,-8
31126.0,2020-02-03,"(333.913, 606.75]",3,13,-10
31126.0,2020-02-03,"(606.75, 878.5]",4,7,-3
31126.0,2020-02-03,"(878.5, 1150.25]",15,23,-8
31126.0,2020-02-03,"(1150.25, 1422.0]",12,19,-7
31127.0,2020-02-03,"(461.043, 701.25]",17,20,-3
31127.0,2020-02-03,"(701.25, 940.5]",6,14,-8
31127.0,2020-02-03,"(940.5, 1179.75]",13,29,-16
31127.0,2020-02-03,"(1179.75, 1419.0]",3,18,-15
31128.0,2020-02-03,"(18.65, 357.5]",1,2,-1
31128.0,2020-02-03,"(357.5, 695.0]",23,29,-6
31128.0,2020-02-03,"(695.0, 1032.5]",24,45,-21
31128.0,2020-02-03,"(1032.5, 1370.0]",19,34,-15
31129.0,2020-02-03,"(428.158, 639.5]",24,37,-13
31129.0,2020-02-03,"(639.5, 850.0]",6,12,-6
31129.0,2020-02-03,"(850.0, 1060.5]",16,27,-11
31129.0,2020-02-03,"(1060.5, 1271.0]",9,14,-5
31130.0,2020-02-03,"(441.02, 687.0]",5,21,-16
31130.0,2020-02-03,"(687.0, 932.0]",4,7,-3
31130.0,2020-02-03,"(932.0, 1177.0]",11,14,-3
31130.0,2020-02-03,"(1177.0, 1422.0]",2,4,-2
31131.0,2020-02-03,"(83.747, 398.25]",1,2,-1
31131.0,2020-02-03,"(398.25, 711.5]",2,13,-11
31131.0,2020-02-03,"(711.5, 1024.75]",2,9,-7
31131.0,2020-02-03,"(1024.75, 1338.0]",9,13,-4
31200.0,2020-02-03,"(351.977, 608.75]",23,33,-10
31200.0,2020-02-03,"(608.75, 864.5]",9,19,-10
31200.0,2020-02-03,"(864.5, 1120.25]",16,36,-20
31200.0,2020-02-03,"(1120.25, 1376.0]",10,30,-20
31201.0,2020-02-03,"(33.6, 385.0]",3,4,-1
31201.0,2020-02-03,"(385.0, 735.0]",23,52,-29
31201.0,2020-02-03,"(735.0, 1085.0]",43,72,-29
31201.0,2020-02-03,"(1085.0, 1435.0]",40,76,-36
,,,,2.0,
31203.0,2020-02-03,"(57.657, 394.75]",2,6,-4
31203.0,2020-02-03,"(394.75, 730.5]",13,37,-24
31203.0,2020-02-03,"(730.5, 1066.25]",22,41,-19
31203.0,2020-02-03,"(1066.25, 1402.0]",24,46,-22
31204.0,2020-02-03,"(409.084, 639.0]",16,21,-5
31204.0,2020-02-03,"(639.0, 868.0]",6,12,-6
31204.0,2020-02-03,"(868.0, 1097.0]",11,32,-21
31204.0,2020-02-03,"(1097.0, 1326.0]",6,14,-8
31205.0,2020-02-03,"(118.717, 440.75]",3,4,-1
31205.0,2020-02-03,"(440.75, 761.5]",26,30,-4
31205.0,2020-02-03,"(761.5, 1082.25]",19,29,-10
31205.0,2020-02-03,"(1082.25, 1403.0]",5,26,-21
31206.0,2020-02-03,"(465.362, 625.5]",8,9,-1
31206.0,2020-02-03,"(944.5, 1104.0]",1,1,0
31207.0,2020-02-03,"(688.75, 879.5]",1,7,-6
31207.0,2020-02-03,"(879.5, 1070.25]",2,1,1
31207.0,2020-02-03,"(1070.25, 1261.0]",4,4,0
31208.0,2020-02-03,"(338.059, 574.25]",9,11,-2
31208.0,2020-02-03,"(574.25, 809.5]",3,6,-3
31208.0,2020-02-03,"(1044.75, 1280.0]",7,8,-1
31209.0,2020-02-03,"(457.388, 611.0]",9,11,-2
31209.0,2020-02-03,"(611.0, 764.0]",1,1,0
31209.0,2020-02-03,"(917.0, 1070.0]",2,3,-1
31211.0,2020-02-03,"(434.139, 650.25]",8,10,-2
31211.0,2020-02-03,"(650.25, 865.5]",1,2,-1
31211.0,2020-02-03,"(865.5, 1080.75]",3,5,-2
31211.0,2020-02-03,"(1080.75, 1296.0]",2,5,-3
31212.0,2020-02-03,"(406.099, 632.25]",27,43,-16
31212.0,2020-02-03,"(632.25, 857.5]",2,8,-6
31212.0,2020-02-03,"(857.5, 1082.75]",12,32,-20
31212.0,2020-02-03,"(1082.75, 1308.0]",6,18,-12
31213.0,2020-02-03,"(251.868, 536.0]",24,33,-9
31213.0,2020-02-03,"(536.0, 819.0]",7,15,-8
31213.0,2020-02-03,"(819.0, 1102.0]",15,37,-22
31213.0,2020-02-03,"(1102.0, 1385.0]",5,15,-10
31214.0,2020-02-03,"(403.971, 662.25]",9,32,-23
31214.0,2020-02-03,"(662.25, 919.5]",6,14,-8
31214.0,2020-02-03,"(919.5, 1176.75]",31,46,-15
31214.0,2020-02-03,"(1176.75, 1434.0]",18,25,-7
31215.0,2020-02-03,"(390.078, 621.5]",27,32,-5
31215.0,2020-02-03,"(621.5, 852.0]",9,11,-2
31215.0,2020-02-03,"(852.0, 1082.5]",7,15,-8
31215.0,2020-02-03,"(1082.5, 1313.0]",3,11,-8
31216.0,2020-02-03,"(424.072, 657.0]",16,17,-1
31216.0,2020-02-03,"(657.0, 889.0]",6,12,-6
31216.0,2020-02-03,"(889.0, 1121.0]",8,32,-24
31216.0,2020-02-03,"(1121.0, 1353.0]",2,17,-15
31217.0,2020-02-03,"(328.145, 542.75]",9,11,-2
31217.0,2020-02-03,"(542.75, 756.5]",3,3,0
31217.0,2020-02-03,"(756.5, 970.25]",7,12,-5
31217.0,2020-02-03,"(970.25, 1184.0]",5,11,-6
31218.0,2020-02-03,"(373.109, 596.75]",17,39,-22
31218.0,2020-02-03,"(596.75, 819.5]",10,12,-2
31218.0,2020-02-03,"(819.5, 1042.25]",8,21,-13
31218.0,2020-02-03,"(1042.25, 1265.0]",8,11,-3
31219.0,2020-02-03,"(471.321, 641.75]",14,14,0
31219.0,2020-02-03,"(641.75, 811.5]",1,2,-1
31219.0,2020-02-03,"(811.5, 981.25]",2,5,-3
31219.0,2020-02-03,"(981.25, 1151.0]",3,11,-8
31220.0,2020-02-03,"(299.243, 489.25]",8,10,-2
31220.0,2020-02-03,"(489.25, 678.5]",6,6,0
31220.0,2020-02-03,"(678.5, 867.75]",8,13,-5
31220.0,2020-02-03,"(867.75, 1057.0]",2,13,-11
31221.0,2020-02-03,"(352.02, 598.0]",25,25,0
31221.0,2020-02-03,"(598.0, 843.0]",18,26,-8
31221.0,2020-02-03,"(843.0, 1088.0]",6,17,-11
31221.0,2020-02-03,"(1088.0, 1333.0]",9,24,-15
31222.0,2020-02-03,"(361.5, 715.0]",20,1,19
31222.0,2020-02-03,"(715.0, 1068.5]",6,22,-16
31222.0,2020-02-03,"(1068.5, 1422.0]",3,24,-21
31223.0,2020-02-03,"(16.61, 365.5]",1,3,-2
31223.0,2020-02-03,"(365.5, 713.0]",18,50,-32
31223.0,2020-02-03,"(713.0, 1060.5]",5,12,-7
31223.0,2020-02-03,"(1060.5, 1408.0]",19,30,-11
31224.0,2020-02-03,"(392.116, 614.0]",18,18,0
31224.0,2020-02-03,"(614.0, 835.0]",4,12,-8
31224.0,2020-02-03,"(835.0, 1056.0]",9,20,-11
31224.0,2020-02-03,"(1056.0, 1277.0]",2,6,-4
31225.0,2020-02-03,"(420.14, 636.0]",9,16,-7
31225.0,2020-02-03,"(636.0, 851.0]",4,7,-3
31225.0,2020-02-03,"(851.0, 1066.0]",4,11,-7
31225.0,2020-02-03,"(1066.0, 1281.0]",6,15,-9
31226.0,2020-02-03,"(263.935, 531.25]",5,10,-5
31226.0,2020-02-03,"(531.25, 797.5]",2,3,-1
31226.0,2020-02-03,"(797.5, 1063.75]",5,12,-7
31226.0,2020-02-03,"(1063.75, 1330.0]",9,14,-5
31227.0,2020-02-03,"(428.223, 623.25]",23,24,-1
31227.0,2020-02-03,"(623.25, 817.5]",7,12,-5
31227.0,2020-02-03,"(817.5, 1011.75]",13,21,-8
31227.0,2020-02-03,"(1011.75, 1206.0]",5,28,-23
31228.0,2020-02-03,"(352.94, 619.0]",24,36,-12
31228.0,2020-02-03,"(619.0, 884.0]",13,24,-11
31228.0,2020-02-03,"(884.0, 1149.0]",21,40,-19
31228.0,2020-02-03,"(1149.0, 1414.0]",13,36,-23
31229.0,2020-02-03,"(31.652, 370.0]",1,3,-2
31229.0,2020-02-03,"(370.0, 707.0]",9,40,-31
31229.0,2020-02-03,"(707.0, 1044.0]",30,57,-27
31229.0,2020-02-03,"(1044.0, 1381.0]",27,49,-22
31230.0,2020-02-03,"(358.055, 595.25]",54,61,-7
31230.0,2020-02-03,"(595.25, 831.5]",17,24,-7
31230.0,2020-02-03,"(831.5, 1067.75]",14,29,-15
31230.0,2020-02-03,"(1067.75, 1304.0]",10,40,-30
31231.0,2020-02-03,"(324.102, 549.5]",18,19,-1
31231.0,2020-02-03,"(549.5, 774.0]",7,14,-7
31231.0,2020-02-03,"(774.0, 998.5]",12,21,-9
31231.0,2020-02-03,"(998.5, 1223.0]",5,25,-20
31232.0,2020-02-03,"(243.865, 528.75]",10,15,-5
31232.0,2020-02-03,"(528.75, 812.5]",12,23,-11
31232.0,2020-02-03,"(812.5, 1096.25]",15,30,-15
31232.0,2020-02-03,"(1096.25, 1380.0]",8,29,-21
31233.0,2020-02-03,"(384.099, 610.25]",40,44,-4
31233.0,2020-02-03,"(610.25, 835.5]",11,14,-3
31233.0,2020-02-03,"(835.5, 1060.75]",14,32,-18
31233.0,2020-02-03,"(1060.75, 1286.0]",2,19,-17
31234.0,2020-02-03,"(362.5, 714.0]",31,2,29
31234.0,2020-02-03,"(714.0, 1065.5]",24,55,-31
31234.0,2020-02-03,"(1065.5, 1417.0]",16,34,-18
31235.0,2020-02-03,"(511.33, 679.5]",12,12,0
31235.0,2020-02-03,"(679.5, 847.0]",2,2,0
31235.0,2020-02-03,"(847.0, 1014.5]",1,3,-2
31235.0,2020-02-03,"(1014.5, 1182.0]",1,7,-6
31236.0,2020-02-03,"(441.01, 689.5]",23,28,-5
31236.0,2020-02-03,"(689.5, 937.0]",9,16,-7
31236.0,2020-02-03,"(937.0, 1184.5]",17,41,-24
31237.0,2020-02-03,"(121.812, 420.0]",1,1,0
31237.0,2020-02-03,"(420.0, 717.0]",12,23,-11
31237.0,2020-02-03,"(717.0, 1014.0]",7,15,-8
31237.0,2020-02-03,"(1014.0, 1311.0]",18,31,-13
31238.0,2020-02-03,"(56.643, 397.25]",1,1,0
31238.0,2020-02-03,"(397.25, 736.5]",12,19,-7
31238.0,2020-02-03,"(736.5, 1075.75]",6,29,-23
31238.0,2020-02-03,"(1075.75, 1415.0]",8,19,-11
31239.0,2020-02-03,"(337.0, 663.0]",22,1,21
31239.0,2020-02-03,"(663.0, 989.0]",12,28,-16
31239.0,2020-02-03,"(989.0, 1315.0]",14,22,-8
31240.0,2020-02-03,"(785.0, 942.0]",5,1,4
31240.0,2020-02-03,"(942.0, 1099.0]",6,6,0
31241.0,2020-02-03,"(-0.425, 357.25]",2,3,-1
31241.0,2020-02-03,"(357.25, 713.5]",22,46,-24
31241.0,2020-02-03,"(713.5, 1069.75]",16,37,-21
31241.0,2020-02-03,"(1069.75, 1426.0]",26,51,-25
31242.0,2020-02-03,"(290.053, 527.75]",7,7,0
31242.0,2020-02-03,"(527.75, 764.5]",6,13,-7
31242.0,2020-02-03,"(764.5, 1001.25]",16,37,-21
31242.0,2020-02-03,"(1001.25, 1238.0]",7,35,-28
31243.0,2020-02-03,"(27.709, 351.75]",1,1,0
31243.0,2020-02-03,"(351.75, 674.5]",13,17,-4
31243.0,2020-02-03,"(674.5, 997.25]",12,25,-13
31243.0,2020-02-03,"(997.25, 1320.0]",9,34,-25
31244.0,2020-02-03,"(346.935, 614.25]",16,26,-10
31244.0,2020-02-03,"(614.25, 880.5]",2,7,-5
31244.0,2020-02-03,"(880.5, 1146.75]",10,24,-14
31244.0,2020-02-03,"(1146.75, 1413.0]",9,12,-3
31245.0,2020-02-03,"(338.972, 597.0]",11,31,-20
31245.0,2020-02-03,"(597.0, 854.0]",5,9,-4
31245.0,2020-02-03,"(854.0, 1111.0]",14,22,-8
31245.0,2020-02-03,"(1111.0, 1368.0]",12,20,-8
31246.0,2020-02-03,"(392.958, 654.5]",11,19,-8
31246.0,2020-02-03,"(654.5, 915.0]",7,14,-7
31246.0,2020-02-03,"(915.0, 1175.5]",14,43,-29
31246.0,2020-02-03,"(1175.5, 1436.0]",8,11,-3
31247.0,2020-02-03,"(373.988, 628.0]",13,22,-9
31247.0,2020-02-03,"(628.0, 881.0]",23,33,-10
31247.0,2020-02-03,"(881.0, 1134.0]",9,19,-10
31247.0,2020-02-03,"(1134.0, 1387.0]",2,4,-2
31248.0,2020-02-03,"(388.972, 647.0]",9,15,-6
31248.0,2020-02-03,"(647.0, 904.0]",19,39,-20
31248.0,2020-02-03,"(904.0, 1161.0]",36,59,-23
31248.0,2020-02-03,"(1161.0, 1418.0]",3,6,-3
31249.0,2020-02-03,"(429.026, 673.5]",10,20,-10
31249.0,2020-02-03,"(673.5, 917.0]",1,10,-9
31249.0,2020-02-03,"(917.0, 1160.5]",20,41,-21
31249.0,2020-02-03,"(1160.5, 1404.0]",1,2,-1
31250.0,2020-02-03,"(417.009, 665.75]",22,27,-5
31250.0,2020-02-03,"(665.75, 913.5]",5,10,-5
31250.0,2020-02-03,"(913.5, 1161.25]",4,25,-21
31250.0,2020-02-03,"(1161.25, 1409.0]",4,7,-3
31251.0,2020-02-03,"(43.661, 379.75]",3,3,0
31251.0,2020-02-03,"(379.75, 714.5]",25,45,-20
31251.0,2020-02-03,"(714.5, 1049.25]",8,22,-14
31251.0,2020-02-03,"(1049.25, 1384.0]",21,46,-25
31252.0,2020-02-03,"(316.75, 617.5]",16,1,15
31252.0,2020-02-03,"(617.5, 918.25]",2,18,-16
31252.0,2020-02-03,"(918.25, 1219.0]",10,5,5
31253.0,2020-02-03,"(408.127, 627.25]",22,24,-2
31253.0,2020-02-03,"(627.25, 845.5]",2,4,-2
31253.0,2020-02-03,"(845.5, 1063.75]",4,11,-7
31253.0,2020-02-03,"(1063.75, 1282.0]",2,18,-16
31254.0,2020-02-03,"(342.022, 587.5]",26,28,-2
31254.0,2020-02-03,"(587.5, 832.0]",1,3,-2
31254.0,2020-02-03,"(832.0, 1076.5]",7,31,-24
31254.0,2020-02-03,"(1076.5, 1321.0]",4,16,-12
31255.0,2020-02-03,"(424.162, 634.5]",22,32,-10
31255.0,2020-02-03,"(634.5, 844.0]",5,10,-5
31255.0,2020-02-03,"(844.0, 1053.5]",3,21,-18
31255.0,2020-02-03,"(1053.5, 1263.0]",9,17,-8
31256.0,2020-02-03,"(45.71, 369.5]",2,2,0
31256.0,2020-02-03,"(369.5, 692.0]",10,11,-1
31256.0,2020-02-03,"(692.0, 1014.5]",6,17,-11
31256.0,2020-02-03,"(1014.5, 1337.0]",8,24,-16
31257.0,2020-02-03,"(339.95, 603.5]",23,40,-17
31257.0,2020-02-03,"(603.5, 866.0]",6,13,-7
31257.0,2020-02-03,"(866.0, 1128.5]",13,31,-18
31257.0,2020-02-03,"(1128.5, 1391.0]",9,22,-13
31258.0,2020-02-03,"(395.966, 655.5]",10,17,-7
31258.0,2020-02-03,"(655.5, 914.0]",17,42,-25
31258.0,2020-02-03,"(914.0, 1172.5]",19,45,-26
31258.0,2020-02-03,"(1172.5, 1431.0]",6,8,-2
31259.0,2020-02-03,"(454.178, 660.5]",15,15,0
31259.0,2020-02-03,"(660.5, 866.0]",2,4,-2
31259.0,2020-02-03,"(1071.5, 1277.0]",2,3,-1
31260.0,2020-02-03,"(360.972, 619.0]",19,24,-5
31260.0,2020-02-03,"(619.0, 876.0]",3,6,-3
31260.0,2020-02-03,"(876.0, 1133.0]",6,27,-21
31260.0,2020-02-03,"(1133.0, 1390.0]",1,4,-3
31261.0,2020-02-03,"(370.316, 542.0]",10,10,0
31261.0,2020-02-03,"(542.0, 713.0]",3,5,-2
31261.0,2020-02-03,"(713.0, 884.0]",3,7,-4
31261.0,2020-02-03,"(884.0, 1055.0]",1,9,-8
31262.0,2020-02-03,"(456.14, 672.0]",5,7,-2
31262.0,2020-02-03,"(672.0, 887.0]",2,5,-3
31262.0,2020-02-03,"(887.0, 1102.0]",5,14,-9
31262.0,2020-02-03,"(1102.0, 1317.0]",2,12,-10
31263.0,2020-02-03,"(359.926, 629.5]",20,36,-16
31263.0,2020-02-03,"(629.5, 898.0]",7,15,-8
31263.0,2020-02-03,"(898.0, 1166.5]",16,41,-25
31263.0,2020-02-03,"(1166.5, 1435.0]",3,13,-10
31264.0,2020-02-03,"(437.013, 684.75]",11,15,-4
31264.0,2020-02-03,"(684.75, 931.5]",4,7,-3
31264.0,2020-02-03,"(931.5, 1178.25]",7,19,-12
31264.0,2020-02-03,"(1178.25, 1425.0]",1,3,-2
31265.0,2020-02-03,"(377.5, 721.0]",20,1,19
31265.0,2020-02-03,"(721.0, 1064.5]",24,47,-23
31265.0,2020-02-03,"(1064.5, 1408.0]",23,42,-19
31266.0,2020-02-03,"(336.989, 590.75]",8,31,-23
31266.0,2020-02-03,"(590.75, 843.5]",6,12,-6
31266.0,2020-02-03,"(843.5, 1096.25]",23,35,-12
31266.0,2020-02-03,"(1096.25, 1349.0]",13,21,-8
31267.0,2020-02-03,"(23.602, 374.5]",2,2,0
31267.0,2020-02-03,"(374.5, 724.0]",27,48,-21
31267.0,2020-02-03,"(724.0, 1073.5]",22,44,-22
31267.0,2020-02-03,"(1073.5, 1423.0]",18,41,-23
31268.0,2020-02-03,"(339.948, 604.0]",11,45,-34
31268.0,2020-02-03,"(604.0, 867.0]",5,16,-11
31268.0,2020-02-03,"(867.0, 1130.0]",25,37,-12
31268.0,2020-02-03,"(1130.0, 1393.0]",23,29,-6
31269.0,2020-02-03,"(385.054, 622.5]",9,13,-4
31269.0,2020-02-03,"(622.5, 859.0]",2,8,-6
31269.0,2020-02-03,"(859.0, 1095.5]",8,20,-12
31269.0,2020-02-03,"(1095.5, 1332.0]",12,21,-9
31270.0,2020-02-03,"(266.892, 545.0]",16,24,-8
31270.0,2020-02-03,"(545.0, 822.0]",6,10,-4
31270.0,2020-02-03,"(822.0, 1099.0]",20,38,-18
31270.0,2020-02-03,"(1099.0, 1376.0]",2,9,-7
31271.0,2020-02-03,"(381.09, 609.5]",8,9,-1
31271.0,2020-02-03,"(609.5, 837.0]",3,12,-9
31271.0,2020-02-03,"(837.0, 1064.5]",6,22,-16
31271.0,2020-02-03,"(1064.5, 1292.0]",2,12,-10
31272.0,2020-02-03,"(296.02, 542.0]",18,21,-3
31272.0,2020-02-03,"(542.0, 787.0]",12,15,-3
31272.0,2020-02-03,"(787.0, 1032.0]",8,22,-14
31272.0,2020-02-03,"(1032.0, 1277.0]",5,11,-6
31273.0,2020-02-03,"(641.0, 796.0]",1,4,-3
31273.0,2020-02-03,"(796.0, 951.0]",8,2,6
31273.0,2020-02-03,"(951.0, 1106.0]",5,14,-9
31274.0,2020-02-03,"(393.13, 611.5]",20,22,-2
31274.0,2020-02-03,"(611.5, 829.0]",1,3,-2
31274.0,2020-02-03,"(829.0, 1046.5]",4,13,-9
31274.0,2020-02-03,"(1046.5, 1264.0]",5,14,-9
31275.0,2020-02-03,"(6.687, 336.25]",1,3,-2
31275.0,2020-02-03,"(336.25, 664.5]",26,38,-12
31275.0,2020-02-03,"(664.5, 992.75]",14,29,-15
31275.0,2020-02-03,"(992.75, 1321.0]",13,30,-17
31276.0,2020-02-03,"(404.141, 619.75]",26,29,-3
31276.0,2020-02-03,"(619.75, 834.5]",5,10,-5
31276.0,2020-02-03,"(834.5, 1049.25]",2,15,-13
31276.0,2020-02-03,"(1049.25, 1264.0]",1,14,-13
31277.0,2020-02-03,"(268.0, 402.0]",1,1,0
31277.0,2020-02-03,"(402.0, 536.0]",32,1,31
31278.0,2020-02-03,"(388.5, 710.0]",6,1,5
31278.0,2020-02-03,"(710.0, 1031.5]",8,27,-19
31278.0,2020-02-03,"(1031.5, 1353.0]",26,14,12
31279.0,2020-02-03,"(422.293, 599.75]",22,24,-2
31279.0,2020-02-03,"(599.75, 776.5]",12,18,-6
31279.0,2020-02-03,"(776.5, 953.25]",5,15,-10
31279.0,2020-02-03,"(953.25, 1130.0]",15,45,-30
31280.0,2020-02-03,"(354.943, 620.25]",6,20,-14
31280.0,2020-02-03,"(620.25, 884.5]",7,11,-4
31280.0,2020-02-03,"(884.5, 1148.75]",16,27,-11
31280.0,2020-02-03,"(1148.75, 1413.0]",9,14,-5
31000.0,2020-02-04,"(1094.75, 1228.0]",3,1,2
31001.0,2020-02-04,"(990.635, 1082.25]",1,5,-4
31001.0,2020-02-04,"(1173.5, 1264.75]",2,1,1
31001.0,2020-02-04,"(1264.75, 1356.0]",1,2,-1
31002.0,2020-02-04,"(450.31, 623.5]",2,4,-2
31002.0,2020-02-04,"(623.5, 796.0]",2,2,0
31002.0,2020-02-04,"(968.5, 1141.0]",4,8,-4
31003.0,2020-02-04,"(379.088, 608.0]",2,5,-3
31003.0,2020-02-04,"(608.0, 836.0]",3,6,-3
31003.0,2020-02-04,"(836.0, 1064.0]",2,6,-4
31003.0,2020-02-04,"(1064.0, 1292.0]",2,4,-2
31004.0,2020-02-04,"(806.55, 919.5]",1,2,-1
31004.0,2020-02-04,"(1032.0, 1144.5]",3,1,2
31004.0,2020-02-04,"(1144.5, 1257.0]",2,5,-3
31005.0,2020-02-04,"(440.259, 626.25]",3,3,0
31005.0,2020-02-04,"(626.25, 811.5]",1,3,-2
31005.0,2020-02-04,"(811.5, 996.75]",1,3,-2
31005.0,2020-02-04,"(996.75, 1182.0]",5,13,-8
31006.0,2020-02-04,"(556.348, 720.0]",2,3,-1
31006.0,2020-02-04,"(720.0, 883.0]",2,6,-4
31006.0,2020-02-04,"(883.0, 1046.0]",1,1,0
31006.0,2020-02-04,"(1046.0, 1209.0]",2,3,-1
31007.0,2020-02-04,"(472.176, 679.0]",3,11,-8
31007.0,2020-02-04,"(679.0, 885.0]",2,3,-1
31007.0,2020-02-04,"(885.0, 1091.0]",10,27,-17
31007.0,2020-02-04,"(1091.0, 1297.0]",5,14,-9
31009.0,2020-02-04,"(495.42, 641.0]",2,2,0
31009.0,2020-02-04,"(641.0, 786.0]",1,2,-1
31009.0,2020-02-04,"(931.0, 1076.0]",2,3,-1
31010.0,2020-02-04,"(451.096, 678.0]",1,2,-1
31010.0,2020-02-04,"(904.0, 1130.0]",2,4,-2
31010.0,2020-02-04,"(1130.0, 1356.0]",2,4,-2
31011.0,2020-02-04,"(335.233, 527.75]",3,3,0
31011.0,2020-02-04,"(527.75, 719.5]",1,2,-1
31011.0,2020-02-04,"(911.25, 1103.0]",5,4,1
31012.0,2020-02-04,"(384.289, 562.75]",3,3,0
31012.0,2020-02-04,"(740.5, 918.25]",1,1,0
31013.0,2020-02-04,"(398.164, 608.0]",1,3,-2
31013.0,2020-02-04,"(608.0, 817.0]",1,2,-1
31013.0,2020-02-04,"(817.0, 1026.0]",1,2,-1
31013.0,2020-02-04,"(1026.0, 1235.0]",5,7,-2
31014.0,2020-02-04,"(385.064, 620.0]",12,17,-5
31014.0,2020-02-04,"(620.0, 854.0]",6,11,-5
31014.0,2020-02-04,"(854.0, 1088.0]",12,20,-8
31014.0,2020-02-04,"(1088.0, 1322.0]",7,14,-7
31015.0,2020-02-04,"(301.024, 546.0]",8,9,-1
31015.0,2020-02-04,"(546.0, 790.0]",2,2,0
31015.0,2020-02-04,"(790.0, 1034.0]",3,9,-6
31015.0,2020-02-04,"(1034.0, 1278.0]",6,9,-3
31016.0,2020-02-04,"(220.92, 492.0]",5,6,-1
31016.0,2020-02-04,"(492.0, 762.0]",6,10,-4
31016.0,2020-02-04,"(762.0, 1032.0]",2,4,-2
31016.0,2020-02-04,"(1032.0, 1302.0]",7,11,-4
31017.0,2020-02-04,"(13.948, 278.0]",1,2,-1
31017.0,2020-02-04,"(278.0, 541.0]",1,1,0
31017.0,2020-02-04,"(541.0, 804.0]",3,5,-2
31017.0,2020-02-04,"(804.0, 1067.0]",1,10,-9
31018.0,2020-02-04,"(899.0, 1131.0]",3,5,-2
31018.0,2020-02-04,"(1131.0, 1363.0]",2,4,-2
31019.0,2020-02-04,"(26.702, 352.5]",2,4,-2
31019.0,2020-02-04,"(1001.5, 1326.0]",3,7,-4
31020.0,2020-02-04,"(1012.0, 1042.5]",1,1,0
31021.0,2020-02-04,"(567.246, 756.5]",1,2,-1
31021.0,2020-02-04,"(945.0, 1133.5]",1,1,0
31021.0,2020-02-04,"(1133.5, 1322.0]",4,9,-5
31022.0,2020-02-04,"(426.046, 665.5]",2,4,-2
31022.0,2020-02-04,"(665.5, 904.0]",5,7,-2
31022.0,2020-02-04,"(904.0, 1142.5]",4,14,-10
31022.0,2020-02-04,"(1142.5, 1381.0]",1,6,-5
31023.0,2020-02-04,"(700.5, 944.0]",3,1,2
31023.0,2020-02-04,"(944.0, 1187.5]",1,5,-4
31023.0,2020-02-04,"(1187.5, 1431.0]",1,3,-2
31024.0,2020-02-04,"(894.5, 1123.75]",9,4,5
31024.0,2020-02-04,"(1123.75, 1353.0]",3,1,2
31025.0,2020-02-04,"(889.604, 989.0]",1,1,0
31025.0,2020-02-04,"(989.0, 1088.0]",1,1,0
31025.0,2020-02-04,"(1088.0, 1187.0]",2,3,-1
31026.0,2020-02-04,"(940.0, 1146.0]",2,2,0
31027.0,2020-02-04,"(936.5, 1107.25]",1,1,0
31027.0,2020-02-04,"(1107.25, 1278.0]",2,2,0
31028.0,2020-02-04,"(998.886, 1027.5]",1,1,0
31028.0,2020-02-04,"(1027.5, 1056.0]",2,3,-1
31029.0,2020-02-04,"(874.0, 1085.5]",2,3,-1
31029.0,2020-02-04,"(1085.5, 1297.0]",3,1,2
31030.0,2020-02-04,"(9.702, 335.5]",1,2,-1
31030.0,2020-02-04,"(660.0, 984.5]",1,7,-6
31030.0,2020-02-04,"(984.5, 1309.0]",5,3,2
31031.0,2020-02-04,"(988.738, 1054.5]",3,4,-1
31031.0,2020-02-04,"(1054.5, 1120.0]",2,2,0
31031.0,2020-02-04,"(1185.5, 1251.0]",1,1,0
31032.0,2020-02-04,"(672.5, 886.0]",1,1,0
31032.0,2020-02-04,"(886.0, 1099.5]",1,2,-1
31032.0,2020-02-04,"(1099.5, 1313.0]",3,1,2
31033.0,2020-02-04,"(629.505, 753.75]",1,3,-2
31033.0,2020-02-04,"(1001.25, 1125.0]",2,3,-1
31034.0,2020-02-04,"(532.105, 756.75]",1,1,0
31034.0,2020-02-04,"(756.75, 980.5]",1,2,-1
31034.0,2020-02-04,"(980.5, 1204.25]",4,7,-3
31035.0,2020-02-04,"(850.0, 1049.5]",2,1,1
31035.0,2020-02-04,"(1049.5, 1249.0]",1,4,-3
31036.0,2020-02-04,"(896.5, 1120.25]",5,3,2
31036.0,2020-02-04,"(1120.25, 1344.0]",4,7,-3
31037.0,2020-02-04,"(414.159, 625.25]",7,10,-3
31037.0,2020-02-04,"(625.25, 835.5]",2,2,0
31037.0,2020-02-04,"(835.5, 1045.75]",4,11,-7
31037.0,2020-02-04,"(1045.75, 1256.0]",7,18,-11
31038.0,2020-02-04,"(782.5, 972.25]",1,1,0
31038.0,2020-02-04,"(972.25, 1162.0]",2,2,0
31039.0,2020-02-04,"(684.0, 877.0]",1,1,0
31039.0,2020-02-04,"(877.0, 1070.0]",2,6,-4
31039.0,2020-02-04,"(1070.0, 1263.0]",5,7,-2
31040.0,2020-02-04,"(457.159, 668.25]",4,4,0
31040.0,2020-02-04,"(1088.75, 1299.0]",1,4,-3
31041.0,2020-02-04,"(925.554, 1037.5]",2,4,-2
31041.0,2020-02-04,"(1037.5, 1149.0]",4,5,-1
31041.0,2020-02-04,"(1260.5, 1372.0]",4,4,0
31042.0,2020-02-04,"(440.162, 650.5]",5,7,-2
31042.0,2020-02-04,"(650.5, 860.0]",2,2,0
31042.0,2020-02-04,"(1069.5, 1279.0]",5,5,0
31043.0,2020-02-04,"(449.267, 633.25]",1,3,-2
31043.0,2020-02-04,"(816.5, 999.75]",3,1,2
31043.0,2020-02-04,"(999.75, 1183.0]",2,5,-3
31044.0,2020-02-04,"(572.0, 858.0]",2,1,1
31044.0,2020-02-04,"(858.0, 1144.0]",1,2,-1
31045.0,2020-02-04,"(550.175, 757.25]",1,4,-3
31045.0,2020-02-04,"(757.25, 963.5]",1,2,-1
31045.0,2020-02-04,"(963.5, 1169.75]",3,4,-1
31045.0,2020-02-04,"(1169.75, 1376.0]",1,1,0
31046.0,2020-02-04,"(907.75, 1037.0]",1,1,0
31047.0,2020-02-04,"(348.038, 589.5]",6,11,-5
31047.0,2020-02-04,"(589.5, 830.0]",3,6,-3
31047.0,2020-02-04,"(830.0, 1070.5]",8,24,-16
31047.0,2020-02-04,"(1070.5, 1311.0]",8,21,-13
31048.0,2020-02-04,"(534.297, 710.75]",1,4,-3
31048.0,2020-02-04,"(710.75, 886.5]",2,3,-1
31048.0,2020-02-04,"(886.5, 1062.25]",1,1,0
31048.0,2020-02-04,"(1062.25, 1238.0]",1,5,-4
31049.0,2020-02-04,"(1012.5, 1218.0]",1,1,0
31050.0,2020-02-04,"(749.597, 850.75]",3,4,-1
31050.0,2020-02-04,"(951.5, 1052.25]",2,2,0
31050.0,2020-02-04,"(1052.25, 1153.0]",2,3,-1
31051.0,2020-02-04,"(936.5, 1149.0]",6,4,2
31052.0,2020-02-04,"(258.136, 475.0]",1,2,-1
31052.0,2020-02-04,"(475.0, 691.0]",1,2,-1
31052.0,2020-02-04,"(691.0, 907.0]",1,1,0
31052.0,2020-02-04,"(907.0, 1123.0]",3,6,-3
31053.0,2020-02-04,"(927.5, 1056.75]",1,2,-1
31053.0,2020-02-04,"(1056.75, 1186.0]",1,1,0
31054.0,2020-02-04,"(747.0, 888.0]",2,1,1
31054.0,2020-02-04,"(888.0, 1029.0]",2,1,1
31055.0,2020-02-04,"(259.0, 518.0]",1,1,0
31055.0,2020-02-04,"(777.0, 1036.0]",3,1,2
31056.0,2020-02-04,"(948.5, 1100.0]",1,1,0
31057.0,2020-02-04,"(786.75, 1049.0]",1,1,0
31058.0,2020-02-04,"(786.75, 1049.0]",1,1,0
31059.0,2020-02-04,"(556.5, 834.75]",2,1,1
31059.0,2020-02-04,"(834.75, 1113.0]",3,2,1
31060.0,2020-02-04,"(518.383, 673.25]",1,1,0
31060.0,2020-02-04,"(673.25, 827.5]",1,2,-1
31060.0,2020-02-04,"(981.75, 1136.0]",3,7,-4
31061.0,2020-02-04,"(719.75, 753.0]",1,1,0
31062.0,2020-02-04,"(955.0, 1090.0]",3,1,2
31062.0,2020-02-04,"(1090.0, 1225.0]",2,6,-4
31063.0,2020-02-04,"(817.5, 1090.0]",2,1,1
31064.0,2020-02-04,"(731.518, 852.5]",2,3,-1
31064.0,2020-02-04,"(852.5, 973.0]",2,4,-2
31064.0,2020-02-04,"(973.0, 1093.5]",3,6,-3
31064.0,2020-02-04,"(1093.5, 1214.0]",4,8,-4
31065.0,2020-02-04,"(779.25, 1039.0]",3,1,2
31066.0,2020-02-04,"(836.5, 1017.75]",1,1,0
31066.0,2020-02-04,"(1017.75, 1199.0]",2,2,0
31067.0,2020-02-04,"(496.154, 708.5]",2,3,-1
31067.0,2020-02-04,"(920.0, 1131.5]",3,3,0
31067.0,2020-02-04,"(1131.5, 1343.0]",2,3,-1
31068.0,2020-02-04,"(1165.25, 1369.0]",2,1,1
31069.0,2020-02-04,"(792.5, 972.75]",2,2,0
31069.0,2020-02-04,"(972.75, 1153.0]",4,1,3
31070.0,2020-02-04,"(709.25, 936.5]",1,2,-1
31070.0,2020-02-04,"(936.5, 1163.75]",1,4,-3
31070.0,2020-02-04,"(1163.75, 1391.0]",2,2,0
31071.0,2020-02-04,"(329.16, 540.0]",1,5,-4
31071.0,2020-02-04,"(750.0, 960.0]",3,1,2
31071.0,2020-02-04,"(960.0, 1170.0]",8,5,3
,,,,2.0,
31073.0,2020-02-04,"(446.414, 593.5]",1,2,-1
31073.0,2020-02-04,"(593.5, 740.0]",1,2,-1
31073.0,2020-02-04,"(886.5, 1033.0]",1,1,0
31074.0,2020-02-04,"(777.5, 951.25]",2,3,-1
31074.0,2020-02-04,"(951.25, 1125.0]",2,2,0
31075.0,2020-02-04,"(834.75, 1113.0]",2,1,1
31076.0,2020-02-04,"(966.25, 1132.0]",1,1,0
31077.0,2020-02-04,"(20.626, 365.5]",1,1,0
31077.0,2020-02-04,"(365.5, 709.0]",1,3,-2
31077.0,2020-02-04,"(709.0, 1052.5]",6,13,-7
31077.0,2020-02-04,"(1052.5, 1396.0]",6,10,-4
31078.0,2020-02-04,"(470.397, 621.75]",3,3,0
31078.0,2020-02-04,"(923.25, 1074.0]",2,8,-6
31079.0,2020-02-04,"(760.5, 986.0]",1,5,-4
31079.0,2020-02-04,"(986.0, 1211.5]",2,4,-2
31079.0,2020-02-04,"(1211.5, 1437.0]",3,4,-1
31080.0,2020-02-04,"(679.75, 910.5]",1,6,-5
31080.0,2020-02-04,"(910.5, 1141.25]",5,1,4
31080.0,2020-02-04,"(1141.25, 1372.0]",3,7,-4
31081.0,2020-02-04,"(467.153, 679.75]",1,1,0
31081.0,2020-02-04,"(891.5, 1103.25]",1,3,-2
31081.0,2020-02-04,"(1103.25, 1315.0]",3,5,-2
,,,,1.0,
,,,,2.0,
31083.0,2020-02-04,"(816.0, 1026.0]",3,1,2
31083.0,2020-02-04,"(1026.0, 1236.0]",2,1,1
31084.0,2020-02-04,"(600.283, 780.25]",4,5,-1
31084.0,2020-02-04,"(780.25, 959.5]",1,2,-1
31084.0,2020-02-04,"(1138.75, 1318.0]",2,4,-2
31085.0,2020-02-04,"(853.0, 1007.0]",1,1,0
31085.0,2020-02-04,"(1007.0, 1161.0]",2,1,1
31086.0,2020-02-04,"(656.0, 856.0]",1,2,-1
31086.0,2020-02-04,"(856.0, 1056.0]",1,2,-1
31086.0,2020-02-04,"(1056.0, 1256.0]",3,2,1
31087.0,2020-02-04,"(868.5, 1038.75]",2,1,1
31087.0,2020-02-04,"(1038.75, 1209.0]",5,3,2
31088.0,2020-02-04,"(999.75, 1185.0]",8,1,7
31089.0,2020-02-04,"(382.022, 627.5]",4,6,-2
31089.0,2020-02-04,"(627.5, 872.0]",2,6,-4
31089.0,2020-02-04,"(872.0, 1116.5]",3,18,-15
31089.0,2020-02-04,"(1116.5, 1361.0]",4,11,-7
31090.0,2020-02-04,"(763.0, 936.5]",1,2,-1
31090.0,2020-02-04,"(936.5, 1110.0]",2,1,1
31091.0,2020-02-04,"(76.856, 364.0]",1,1,0
31091.0,2020-02-04,"(936.0, 1222.0]",5,2,3
31092.0,2020-02-04,"(850.5, 1042.75]",2,3,-1
31092.0,2020-02-04,"(1042.75, 1235.0]",4,1,3
31093.0,2020-02-04,"(961.75, 1144.0]",1,5,-4
31094.0,2020-02-04,"(605.638, 696.5]",1,1,0
31094.0,2020-02-04,"(877.5, 968.0]",1,2,-1
31095.0,2020-02-04,"(716.75, 874.5]",1,1,0
31095.0,2020-02-04,"(874.5, 1032.25]",1,1,0
31095.0,2020-02-04,"(1032.25, 1190.0]",2,1,1
31096.0,2020-02-04,"(1014.0, 1099.0]",1,1,0
31096.0,2020-02-04,"(1184.0, 1269.0]",1,2,-1
31097.0,2020-02-04,"(472.165, 681.75]",2,2,0
31097.0,2020-02-04,"(681.75, 890.5]",1,2,-1
31097.0,2020-02-04,"(890.5, 1099.25]",1,4,-3
31097.0,2020-02-04,"(1099.25, 1308.0]",2,6,-4
31098.0,2020-02-04,"(434.168, 643.0]",2,4,-2
31098.0,2020-02-04,"(643.0, 851.0]",1,1,0
31098.0,2020-02-04,"(851.0, 1059.0]",4,10,-6
31098.0,2020-02-04,"(1059.0, 1267.0]",3,10,-7
31099.0,2020-02-04,"(844.719, 915.25]",1,1,0
31099.0,2020-02-04,"(1055.75, 1126.0]",1,3,-2
31100.0,2020-02-04,"(434.3, 610.0]",15,17,-2
31100.0,2020-02-04,"(610.0, 785.0]",2,4,-2
31100.0,2020-02-04,"(785.0, 960.0]",4,9,-5
31101.0,2020-02-04,"(-1.429, 357.25]",3,5,-2
31101.0,2020-02-04,"(357.25, 714.5]",14,37,-23
31101.0,2020-02-04,"(714.5, 1071.75]",34,61,-27
31101.0,2020-02-04,"(1071.75, 1429.0]",38,62,-24
31102.0,2020-02-04,"(371.969, 630.75]",1,18,-17
31102.0,2020-02-04,"(630.75, 888.5]",1,5,-4
31102.0,2020-02-04,"(888.5, 1146.25]",10,16,-6
31102.0,2020-02-04,"(1146.25, 1404.0]",11,13,-2
31103.0,2020-02-04,"(347.936, 615.0]",1,20,-19
31103.0,2020-02-04,"(881.0, 1147.0]",11,11,0
31103.0,2020-02-04,"(1147.0, 1413.0]",6,20,-14
31104.0,2020-02-04,"(362.0, 716.0]",3,3,0
31104.0,2020-02-04,"(716.0, 1070.0]",12,19,-7
31104.0,2020-02-04,"(1070.0, 1424.0]",8,24,-16
31105.0,2020-02-04,"(458.116, 680.0]",1,7,-6
31105.0,2020-02-04,"(1122.0, 1343.0]",2,1,1
31106.0,2020-02-04,"(434.017, 680.75]",1,5,-4
31106.0,2020-02-04,"(680.75, 926.5]",1,1,0
31106.0,2020-02-04,"(926.5, 1172.25]",4,8,-4
31106.0,2020-02-04,"(1172.25, 1418.0]",1,2,-1
31107.0,2020-02-04,"(209.801, 510.75]",1,13,-12
31107.0,2020-02-04,"(510.75, 810.5]",4,15,-11
31107.0,2020-02-04,"(810.5, 1110.25]",17,35,-18
31107.0,2020-02-04,"(1110.25, 1410.0]",15,23,-8
31108.0,2020-02-04,"(333.019, 579.25]",4,22,-18
31108.0,2020-02-04,"(579.25, 824.5]",7,10,-3
31108.0,2020-02-04,"(824.5, 1069.75]",19,32,-13
31108.0,2020-02-04,"(1069.75, 1315.0]",20,28,-8
31109.0,2020-02-04,"(45.616, 393.0]",2,2,0
31109.0,2020-02-04,"(393.0, 739.0]",4,18,-14
31109.0,2020-02-04,"(739.0, 1085.0]",21,31,-10
31109.0,2020-02-04,"(1085.0, 1431.0]",14,32,-18
31110.0,2020-02-04,"(328.01, 576.5]",8,23,-15
31110.0,2020-02-04,"(576.5, 824.0]",5,10,-5
31110.0,2020-02-04,"(824.0, 1071.5]",12,25,-13
31110.0,2020-02-04,"(1071.5, 1319.0]",22,34,-12
31111.0,2020-02-04,"(119.778, 426.5]",4,5,-1
31111.0,2020-02-04,"(426.5, 732.0]",9,19,-10
31111.0,2020-02-04,"(732.0, 1037.5]",5,10,-5
31111.0,2020-02-04,"(1037.5, 1343.0]",15,24,-9
31112.0,2020-02-04,"(692.5, 879.0]",1,3,-2
31112.0,2020-02-04,"(879.0, 1065.5]",2,1,1
31112.0,2020-02-04,"(1065.5, 1252.0]",2,2,0
31113.0,2020-02-04,"(393.999, 645.25]",2,23,-21
31113.0,2020-02-04,"(645.25, 895.5]",3,9,-6
31113.0,2020-02-04,"(895.5, 1145.75]",5,15,-10
31113.0,2020-02-04,"(1145.75, 1396.0]",8,11,-3
31114.0,2020-02-04,"(10.628, 355.0]",2,3,-1
31114.0,2020-02-04,"(355.0, 698.0]",1,24,-23
31114.0,2020-02-04,"(698.0, 1041.0]",11,20,-9
31114.0,2020-02-04,"(1041.0, 1384.0]",33,53,-20
31115.0,2020-02-04,"(7.59, 361.5]",1,4,-3
31115.0,2020-02-04,"(361.5, 714.0]",2,16,-14
31115.0,2020-02-04,"(714.0, 1066.5]",5,9,-4
31115.0,2020-02-04,"(1066.5, 1419.0]",19,29,-10
31116.0,2020-02-04,"(366.992, 620.0]",1,13,-12
31116.0,2020-02-04,"(620.0, 872.0]",3,9,-6
31116.0,2020-02-04,"(872.0, 1124.0]",13,20,-7
31116.0,2020-02-04,"(1124.0, 1376.0]",10,15,-5
31117.0,2020-02-04,"(311.873, 594.75]",1,17,-16
31117.0,2020-02-04,"(594.75, 876.5]",1,10,-9
31117.0,2020-02-04,"(876.5, 1158.25]",12,21,-9
31117.0,2020-02-04,"(1158.25, 1440.0]",12,21,-9
31118.0,2020-02-04,"(491.0, 738.0]",1,6,-5
31118.0,2020-02-04,"(738.0, 985.0]",2,6,-4
31118.0,2020-02-04,"(985.0, 1232.0]",13,3,10
31119.0,2020-02-04,"(322.0, 573.0]",4,21,-17
31119.0,2020-02-04,"(573.0, 823.0]",2,4,-2
31119.0,2020-02-04,"(823.0, 1073.0]",10,12,-2
31119.0,2020-02-04,"(1073.0, 1323.0]",20,34,-14
31120.0,2020-02-04,"(349.96, 611.0]",3,10,-7
31120.0,2020-02-04,"(611.0, 871.0]",2,4,-2
31120.0,2020-02-04,"(871.0, 1131.0]",8,15,-7
31120.0,2020-02-04,"(1131.0, 1391.0]",11,14,-3
31121.0,2020-02-04,"(350.993, 603.75]",8,9,-1
31121.0,2020-02-04,"(603.75, 855.5]",3,8,-5
31121.0,2020-02-04,"(855.5, 1107.25]",7,21,-14
31121.0,2020-02-04,"(1107.25, 1359.0]",13,20,-7
31122.0,2020-02-04,"(412.005, 661.75]",1,4,-3
31122.0,2020-02-04,"(661.75, 910.5]",1,3,-2
31122.0,2020-02-04,"(910.5, 1159.25]",6,16,-10
31122.0,2020-02-04,"(1159.25, 1408.0]",8,18,-10
31123.0,2020-02-04,"(367.937, 634.75]",2,17,-15
31123.0,2020-02-04,"(900.5, 1166.25]",9,2,7
31123.0,2020-02-04,"(1166.25, 1432.0]",6,16,-10
31124.0,2020-02-04,"(346.922, 617.5]",18,36,-18
31124.0,2020-02-04,"(617.5, 887.0]",8,20,-12
31124.0,2020-02-04,"(887.0, 1156.5]",23,57,-34
31124.0,2020-02-04,"(1156.5, 1426.0]",14,32,-18
31125.0,2020-02-04,"(76.682, 407.5]",2,5,-3
31125.0,2020-02-04,"(407.5, 737.0]",6,26,-20
31125.0,2020-02-04,"(737.0, 1066.5]",21,30,-9
31125.0,2020-02-04,"(1066.5, 1396.0]",28,42,-14
31126.0,2020-02-04,"(5.67, 339.5]",2,3,-1
31126.0,2020-02-04,"(339.5, 672.0]",2,18,-16
31126.0,2020-02-04,"(672.0, 1004.5]",5,6,-1
31126.0,2020-02-04,"(1004.5, 1337.0]",25,35,-10
31127.0,2020-02-04,"(376.027, 620.25]",12,19,-7
31127.0,2020-02-04,"(620.25, 863.5]",9,14,-5
31127.0,2020-02-04,"(863.5, 1106.75]",11,27,-16
31127.0,2020-02-04,"(1106.75, 1350.0]",7,18,-11
31128.0,2020-02-04,"(307.938, 574.5]",21,29,-8
31128.0,2020-02-04,"(574.5, 840.0]",17,30,-13
31128.0,2020-02-04,"(840.0, 1105.5]",9,23,-14
31128.0,2020-02-04,"(1105.5, 1371.0]",8,17,-9
31129.0,2020-02-04,"(422.18, 628.0]",6,7,-1
31129.0,2020-02-04,"(628.0, 833.0]",4,7,-3
31129.0,2020-02-04,"(833.0, 1038.0]",6,15,-9
31129.0,2020-02-04,"(1038.0, 1243.0]",10,23,-13
31130.0,2020-02-04,"(357.958, 619.5]",3,13,-10
31130.0,2020-02-04,"(619.5, 880.0]",2,7,-5
31130.0,2020-02-04,"(880.0, 1140.5]",8,10,-2
31130.0,2020-02-04,"(1140.5, 1401.0]",8,10,-2
31131.0,2020-02-04,"(665.5, 942.75]",1,2,-1
31131.0,2020-02-04,"(942.75, 1220.0]",6,11,-5
31200.0,2020-02-04,"(335.94, 602.0]",16,26,-10
31200.0,2020-02-04,"(602.0, 867.0]",12,20,-8
31200.0,2020-02-04,"(867.0, 1132.0]",31,57,-26
31200.0,2020-02-04,"(1132.0, 1397.0]",10,33,-23
31201.0,2020-02-04,"(7.624, 353.0]",1,2,-1
31201.0,2020-02-04,"(353.0, 697.0]",24,50,-26
31201.0,2020-02-04,"(697.0, 1041.0]",28,54,-26
31201.0,2020-02-04,"(1041.0, 1385.0]",48,88,-40
,,,,2.0,
31203.0,2020-02-04,"(2.636, 345.0]",1,3,-2
31203.0,2020-02-04,"(345.0, 686.0]",13,29,-16
31203.0,2020-02-04,"(686.0, 1027.0]",24,39,-15
31203.0,2020-02-04,"(1027.0, 1368.0]",33,52,-19
31204.0,2020-02-04,"(482.217, 678.75]",7,7,0
31204.0,2020-02-04,"(678.75, 874.5]",2,6,-4
31204.0,2020-02-04,"(874.5, 1070.25]",7,22,-15
31204.0,2020-02-04,"(1070.25, 1266.0]",2,3,-1
31205.0,2020-02-04,"(125.864, 411.0]",1,3,-2
31205.0,2020-02-04,"(411.0, 695.0]",25,29,-4
31205.0,2020-02-04,"(695.0, 979.0]",12,18,-6
31205.0,2020-02-04,"(979.0, 1263.0]",7,35,-28
31206.0,2020-02-04,"(450.379, 606.25]",6,7,-1
31206.0,2020-02-04,"(761.5, 916.75]",1,2,-1
31206.0,2020-02-04,"(916.75, 1072.0]",5,2,3
31207.0,2020-02-04,"(368.008, 617.0]",1,8,-7
31207.0,2020-02-04,"(865.0, 1113.0]",4,1,3
31207.0,2020-02-04,"(1113.0, 1361.0]",5,4,1
31208.0,2020-02-04,"(362.026, 606.5]",11,14,-3
31208.0,2020-02-04,"(606.5, 850.0]",1,3,-2
31208.0,2020-02-04,"(850.0, 1093.5]",8,26,-18
31208.0,2020-02-04,"(1093.5, 1337.0]",10,15,-5
31209.0,2020-02-04,"(454.176, 661.0]",5,7,-2
31209.0,2020-02-04,"(661.0, 867.0]",1,2,-1
31209.0,2020-02-04,"(867.0, 1073.0]",3,4,-1
31209.0,2020-02-04,"(1073.0, 1279.0]",9,10,-1
31211.0,2020-02-04,"(530.253, 717.75]",6,6,0
31211.0,2020-02-04,"(904.5, 1091.25]",6,10,-4
31211.0,2020-02-04,"(1091.25, 1278.0]",1,4,-3
31212.0,2020-02-04,"(-1.429, 357.25]",2,3,-1
31212.0,2020-02-04,"(357.25, 714.5]",28,39,-11
31212.0,2020-02-04,"(714.5, 1071.75]",13,28,-15
31212.0,2020-02-04,"(1071.75, 1429.0]",6,28,-22
31213.0,2020-02-04,"(260.852, 549.0]",24,29,-5
31213.0,2020-02-04,"(549.0, 836.0]",9,19,-10
31213.0,2020-02-04,"(836.0, 1123.0]",19,37,-18
31213.0,2020-02-04,"(1123.0, 1410.0]",7,17,-10
31214.0,2020-02-04,"(38.695, 366.25]",1,4,-3
31214.0,2020-02-04,"(366.25, 692.5]",12,38,-26
31214.0,2020-02-04,"(692.5, 1018.75]",24,41,-17
31214.0,2020-02-04,"(1018.75, 1345.0]",45,69,-24
31215.0,2020-02-04,"(444.31, 617.5]",9,9,0
31215.0,2020-02-04,"(617.5, 790.0]",4,6,-2
31215.0,2020-02-04,"(790.0, 962.5]",5,8,-3
31215.0,2020-02-04,"(962.5, 1135.0]",9,20,-11
31216.0,2020-02-04,"(375.044, 615.0]",12,15,-3
31216.0,2020-02-04,"(615.0, 854.0]",9,14,-5
31216.0,2020-02-04,"(854.0, 1093.0]",8,25,-17
31216.0,2020-02-04,"(1093.0, 1332.0]",4,16,-12
31217.0,2020-02-04,"(325.036, 567.0]",11,12,-1
31217.0,2020-02-04,"(567.0, 808.0]",3,6,-3
31217.0,2020-02-04,"(808.0, 1049.0]",2,14,-12
31217.0,2020-02-04,"(1049.0, 1290.0]",2,6,-4
31218.0,2020-02-04,"(373.969, 632.75]",9,28,-19
31218.0,2020-02-04,"(632.75, 890.5]",5,6,-1
31218.0,2020-02-04,"(890.5, 1148.25]",16,33,-17
31218.0,2020-02-04,"(1148.25, 1406.0]",5,10,-5
31219.0,2020-02-04,"(383.017, 629.75]",8,9,-1
31219.0,2020-02-04,"(629.75, 875.5]",6,10,-4
31219.0,2020-02-04,"(875.5, 1121.25]",3,16,-13
31219.0,2020-02-04,"(1121.25, 1367.0]",2,6,-4
31220.0,2020-02-04,"(299.96, 561.0]",13,19,-6
31220.0,2020-02-04,"(561.0, 821.0]",1,5,-4
31220.0,2020-02-04,"(821.0, 1081.0]",1,21,-20
31220.0,2020-02-04,"(1081.0, 1341.0]",3,5,-2
31221.0,2020-02-04,"(345.5, 655.0]",21,3,18
31221.0,2020-02-04,"(655.0, 964.5]",9,23,-14
31221.0,2020-02-04,"(964.5, 1274.0]",14,18,-4
31222.0,2020-02-04,"(424.093, 651.75]",9,13,-4
31222.0,2020-02-04,"(651.75, 878.5]",2,3,-1
31222.0,2020-02-04,"(878.5, 1105.25]",4,15,-11
31222.0,2020-02-04,"(1105.25, 1332.0]",3,7,-4
31223.0,2020-02-04,"(-1.364, 341.0]",2,5,-3
31223.0,2020-02-04,"(341.0, 682.0]",13,25,-12
31223.0,2020-02-04,"(682.0, 1023.0]",5,10,-5
31223.0,2020-02-04,"(1023.0, 1364.0]",25,45,-20
31224.0,2020-02-04,"(455.105, 679.75]",13,16,-3
31224.0,2020-02-04,"(679.75, 903.5]",11,16,-5
31224.0,2020-02-04,"(903.5, 1127.25]",3,17,-14
31224.0,2020-02-04,"(1127.25, 1351.0]",5,16,-11
31225.0,2020-02-04,"(326.036, 568.0]",3,8,-5
31225.0,2020-02-04,"(568.0, 809.0]",8,12,-4
31225.0,2020-02-04,"(809.0, 1050.0]",6,9,-3
31225.0,2020-02-04,"(1050.0, 1291.0]",9,27,-18
31226.0,2020-02-04,"(313.984, 569.0]",2,4,-2
31226.0,2020-02-04,"(569.0, 823.0]",2,5,-3
31226.0,2020-02-04,"(1077.0, 1331.0]",9,3,6
31227.0,2020-02-04,"(432.245, 621.75]",23,25,-2
31227.0,2020-02-04,"(621.75, 810.5]",7,12,-5
31227.0,2020-02-04,"(810.5, 999.25]",2,5,-3
31227.0,2020-02-04,"(999.25, 1188.0]",3,28,-25
31228.0,2020-02-04,"(344.925, 614.75]",20,23,-3
31228.0,2020-02-04,"(614.75, 883.5]",11,21,-10
31228.0,2020-02-04,"(883.5, 1152.25]",35,54,-19
31228.0,2020-02-04,"(1152.25, 1421.0]",7,27,-20
31229.0,2020-02-04,"(348.939, 615.25]",15,56,-41
31229.0,2020-02-04,"(615.25, 880.5]",7,13,-6
31229.0,2020-02-04,"(880.5, 1145.75]",38,60,-22
31229.0,2020-02-04,"(1145.75, 1411.0]",14,27,-13
31230.0,2020-02-04,"(330.005, 579.75]",39,46,-7
31230.0,2020-02-04,"(579.75, 828.5]",5,6,-1
31230.0,2020-02-04,"(828.5, 1077.25]",8,26,-18
31230.0,2020-02-04,"(1077.25, 1326.0]",12,30,-18
31231.0,2020-02-04,"(329.202, 529.5]",11,12,-1
31231.0,2020-02-04,"(529.5, 729.0]",8,14,-6
31231.0,2020-02-04,"(729.0, 928.5]",21,43,-22
31231.0,2020-02-04,"(928.5, 1128.0]",5,27,-22
31232.0,2020-02-04,"(251.895, 529.25]",16,19,-3
31232.0,2020-02-04,"(529.25, 805.5]",4,11,-7
31232.0,2020-02-04,"(805.5, 1081.75]",20,35,-15
31232.0,2020-02-04,"(1081.75, 1358.0]",19,45,-26
31233.0,2020-02-04,"(375.5, 712.0]",33,1,32
31233.0,2020-02-04,"(712.0, 1048.5]",19,36,-17
31233.0,2020-02-04,"(1048.5, 1385.0]",17,36,-19
31234.0,2020-02-04,"(-0.395, 349.75]",1,2,-1
31234.0,2020-02-04,"(349.75, 698.5]",14,31,-17
31234.0,2020-02-04,"(698.5, 1047.25]",19,31,-12
31234.0,2020-02-04,"(1047.25, 1396.0]",22,47,-25
31235.0,2020-02-04,"(453.043, 693.25]",6,7,-1
31235.0,2020-02-04,"(693.25, 932.5]",2,6,-4
31235.0,2020-02-04,"(932.5, 1171.75]",1,6,-5
31236.0,2020-02-04,"(449.025, 693.75]",23,24,-1
31236.0,2020-02-04,"(693.75, 937.5]",5,18,-13
31236.0,2020-02-04,"(937.5, 1181.25]",7,30,-23
31236.0,2020-02-04,"(1181.25, 1425.0]",3,13,-10
31237.0,2020-02-04,"(7.593, 360.75]",3,5,-2
31237.0,2020-02-04,"(360.75, 712.5]",5,15,-10
31237.0,2020-02-04,"(712.5, 1064.25]",12,19,-7
31237.0,2020-02-04,"(1064.25, 1416.0]",26,51,-25
31238.0,2020-02-04,"(60.685, 390.75]",2,4,-2
31238.0,2020-02-04,"(390.75, 719.5]",18,21,-3
31238.0,2020-02-04,"(719.5, 1048.25]",8,33,-25
31238.0,2020-02-04,"(1048.25, 1377.0]",9,25,-16
31239.0,2020-02-04,"(327.978, 584.5]",22,25,-3
31239.0,2020-02-04,"(584.5, 840.0]",6,11,-5
31239.0,2020-02-04,"(840.0, 1095.5]",6,12,-6
31239.0,2020-02-04,"(1095.5, 1351.0]",5,25,-20
31240.0,2020-02-04,"(518.415, 665.25]",1,3,-2
31240.0,2020-02-04,"(957.75, 1104.0]",2,2,0
31241.0,2020-02-04,"(13.6, 365.0]",1,4,-3
31241.0,2020-02-04,"(365.0, 715.0]",28,50,-22
31241.0,2020-02-04,"(715.0, 1065.0]",12,31,-19
31241.0,2020-02-04,"(1065.0, 1415.0]",19,43,-24
31242.0,2020-02-04,"(275.934, 543.5]",17,17,0
31242.0,2020-02-04,"(543.5, 810.0]",15,21,-6
31242.0,2020-02-04,"(810.0, 1076.5]",5,27,-22
31243.0,2020-02-04,"(16.588, 371.0]",2,2,0
31243.0,2020-02-04,"(371.0, 724.0]",19,25,-6
31243.0,2020-02-04,"(724.0, 1077.0]",10,29,-19
31243.0,2020-02-04,"(1077.0, 1430.0]",8,21,-13
31244.0,2020-02-04,"(344.0, 686.0]",12,2,10
31244.0,2020-02-04,"(686.0, 1028.0]",11,26,-15
31244.0,2020-02-04,"(1028.0, 1370.0]",15,19,-4
31245.0,2020-02-04,"(102.675, 435.25]",2,4,-2
31245.0,2020-02-04,"(435.25, 766.5]",11,25,-14
31245.0,2020-02-04,"(766.5, 1097.75]",9,19,-10
31245.0,2020-02-04,"(1097.75, 1429.0]",12,23,-11
31246.0,2020-02-04,"(407.026, 651.5]",12,17,-5
31246.0,2020-02-04,"(651.5, 895.0]",10,14,-4
31246.0,2020-02-04,"(895.0, 1138.5]",20,36,-16
31246.0,2020-02-04,"(1138.5, 1382.0]",8,17,-9
31247.0,2020-02-04,"(478.172, 686.0]",1,2,-1
31247.0,2020-02-04,"(686.0, 893.0]",6,13,-7
31247.0,2020-02-04,"(893.0, 1100.0]",11,27,-16
31247.0,2020-02-04,"(1100.0, 1307.0]",9,15,-6
31248.0,2020-02-04,"(173.885, 453.75]",3,3,0
31248.0,2020-02-04,"(453.75, 732.5]",16,30,-14
31248.0,2020-02-04,"(732.5, 1011.25]",25,45,-20
31248.0,2020-02-04,"(1011.25, 1290.0]",11,22,-11
31249.0,2020-02-04,"(436.19, 639.5]",6,11,-5
31249.0,2020-02-04,"(639.5, 842.0]",5,10,-5
31249.0,2020-02-04,"(842.0, 1044.5]",3,9,-6
31249.0,2020-02-04,"(1044.5, 1247.0]",8,20,-12
31250.0,2020-02-04,"(503.09, 731.5]",15,20,-5
31250.0,2020-02-04,"(731.5, 959.0]",2,9,-7
31250.0,2020-02-04,"(959.0, 1186.5]",3,18,-15
31250.0,2020-02-04,"(1186.5, 1414.0]",2,3,-1
31251.0,2020-02-04,"(42.641, 383.75]",1,3,-2
31251.0,2020-02-04,"(383.75, 723.5]",13,28,-15
31251.0,2020-02-04,"(723.5, 1063.25]",11,29,-18
31251.0,2020-02-04,"(1063.25, 1403.0]",28,46,-18
31252.0,2020-02-04,"(395.24, 586.0]",12,13,-1
31252.0,2020-02-04,"(586.0, 776.0]",4,9,-5
31252.0,2020-02-04,"(776.0, 966.0]",3,10,-7
31252.0,2020-02-04,"(966.0, 1156.0]",8,30,-22
31253.0,2020-02-04,"(23.716, 346.0]",1,2,-1
31253.0,2020-02-04,"(346.0, 667.0]",19,22,-3
31253.0,2020-02-04,"(667.0, 988.0]",8,17,-9
31253.0,2020-02-04,"(988.0, 1309.0]",6,32,-26
31254.0,2020-02-04,"(410.054, 647.5]",16,21,-5
31254.0,2020-02-04,"(647.5, 884.0]",7,12,-5
31254.0,2020-02-04,"(884.0, 1120.5]",5,24,-19
31254.0,2020-02-04,"(1120.5, 1357.0]",4,10,-6
31255.0,2020-02-04,"(392.14, 608.0]",17,22,-5
31255.0,2020-02-04,"(608.0, 823.0]",4,9,-5
31255.0,2020-02-04,"(823.0, 1038.0]",7,19,-12
31255.0,2020-02-04,"(1038.0, 1253.0]",6,17,-11
31256.0,2020-02-04,"(266.918, 538.5]",7,8,-1
31256.0,2020-02-04,"(538.5, 809.0]",11,15,-4
31256.0,2020-02-04,"(809.0, 1079.5]",4,12,-8
31256.0,2020-02-04,"(1079.5, 1350.0]",9,17,-8
31257.0,2020-02-04,"(335.973, 593.75]",15,26,-11
31257.0,2020-02-04,"(593.75, 850.5]",13,21,-8
31257.0,2020-02-04,"(850.5, 1107.25]",14,37,-23
31257.0,2020-02-04,"(1107.25, 1364.0]",5,11,-6
31258.0,2020-02-04,"(50.858, 337.5]",1,4,-3
31258.0,2020-02-04,"(337.5, 623.0]",5,12,-7
31258.0,2020-02-04,"(623.0, 908.5]",21,39,-18
31258.0,2020-02-04,"(908.5, 1194.0]",23,46,-23
31259.0,2020-02-04,"(453.296, 630.0]",6,6,0
31259.0,2020-02-04,"(806.0, 982.0]",3,1,2
31259.0,2020-02-04,"(982.0, 1158.0]",3,5,-2
31260.0,2020-02-04,"(395.059, 631.25]",17,18,-1
31260.0,2020-02-04,"(631.25, 866.5]",4,8,-4
31260.0,2020-02-04,"(866.5, 1101.75]",1,19,-18
31260.0,2020-02-04,"(1101.75, 1337.0]",6,11,-5
31261.0,2020-02-04,"(387.99, 641.5]",8,8,0
31261.0,2020-02-04,"(894.0, 1146.5]",2,1,1
31261.0,2020-02-04,"(1146.5, 1399.0]",3,14,-11
31262.0,2020-02-04,"(324.065, 558.75]",6,7,-1
31262.0,2020-02-04,"(558.75, 792.5]",6,7,-1
31262.0,2020-02-04,"(792.5, 1026.25]",5,10,-5
31262.0,2020-02-04,"(1026.25, 1260.0]",3,16,-13
31263.0,2020-02-04,"(346.095, 573.25]",11,15,-4
31263.0,2020-02-04,"(573.25, 799.5]",8,15,-7
31263.0,2020-02-04,"(799.5, 1025.75]",12,21,-9
31263.0,2020-02-04,"(1025.75, 1252.0]",8,27,-19
31264.0,2020-02-04,"(353.75, 663.5]",10,1,9
31264.0,2020-02-04,"(663.5, 973.25]",7,16,-9
31264.0,2020-02-04,"(973.25, 1283.0]",8,13,-5
31265.0,2020-02-04,"(46.626, 391.5]",1,1,0
31265.0,2020-02-04,"(391.5, 735.0]",8,30,-22
31265.0,2020-02-04,"(735.0, 1078.5]",22,35,-13
31265.0,2020-02-04,"(1078.5, 1422.0]",20,36,-16
31266.0,2020-02-04,"(115.694, 443.5]",1,11,-10
31266.0,2020-02-04,"(443.5, 770.0]",8,32,-24
31266.0,2020-02-04,"(770.0, 1096.5]",18,32,-14
31266.0,2020-02-04,"(1096.5, 1423.0]",15,24,-9
31267.0,2020-02-04,"(5.579, 362.25]",1,1,0
31267.0,2020-02-04,"(362.25, 717.5]",19,33,-14
31267.0,2020-02-04,"(717.5, 1072.75]",19,35,-16
31267.0,2020-02-04,"(1072.75, 1428.0]",22,49,-27
31268.0,2020-02-04,"(333.929, 602.75]",16,36,-20
31268.0,2020-02-04,"(602.75, 870.5]",10,14,-4
31268.0,2020-02-04,"(870.5, 1138.25]",20,31,-11
31268.0,2020-02-04,"(1138.25, 1406.0]",18,26,-8
31269.0,2020-02-04,"(406.027, 650.25]",6,9,-3
31269.0,2020-02-04,"(650.25, 893.5]",5,11,-6
31269.0,2020-02-04,"(893.5, 1136.75]",8,15,-7
31269.0,2020-02-04,"(1136.75, 1380.0]",7,15,-8
31270.0,2020-02-04,"(262.993, 515.75]",7,9,-2
31270.0,2020-02-04,"(515.75, 767.5]",7,14,-7
31270.0,2020-02-04,"(767.5, 1019.25]",11,24,-13
31270.0,2020-02-04,"(1019.25, 1271.0]",7,17,-10
31271.0,2020-02-04,"(388.964, 649.0]",12,15,-3
31271.0,2020-02-04,"(649.0, 908.0]",7,11,-4
31271.0,2020-02-04,"(908.0, 1167.0]",8,28,-20
31271.0,2020-02-04,"(1167.0, 1426.0]",3,7,-4
31272.0,2020-02-04,"(23.687, 353.25]",1,2,-1
31272.0,2020-02-04,"(353.25, 681.5]",20,21,-1
31272.0,2020-02-04,"(681.5, 1009.75]",11,24,-13
31272.0,2020-02-04,"(1009.75, 1338.0]",9,24,-15
31273.0,2020-02-04,"(909.5, 1054.0]",5,2,3
31274.0,2020-02-04,"(393.999, 645.25]",7,7,0
31274.0,2020-02-04,"(645.25, 895.5]",6,9,-3
31274.0,2020-02-04,"(895.5, 1145.75]",5,25,-20
31274.0,2020-02-04,"(1145.75, 1396.0]",5,16,-11
31275.0,2020-02-04,"(104.728, 424.0]",6,7,-1
31275.0,2020-02-04,"(424.0, 742.0]",13,29,-16
31275.0,2020-02-04,"(742.0, 1060.0]",20,26,-6
31275.0,2020-02-04,"(1060.0, 1378.0]",7,28,-21
31276.0,2020-02-04,"(398.108, 622.0]",15,20,-5
31276.0,2020-02-04,"(622.0, 845.0]",6,15,-9
31276.0,2020-02-04,"(845.0, 1068.0]",7,26,-19
31276.0,2020-02-04,"(1068.0, 1291.0]",3,20,-17
31277.0,2020-02-04,"(560.167, 769.25]",14,17,-3
31277.0,2020-02-04,"(769.25, 977.5]",15,25,-10
31277.0,2020-02-04,"(977.5, 1185.75]",6,42,-36
31277.0,2020-02-04,"(1185.75, 1394.0]",1,8,-7
31278.0,2020-02-04,"(5.668, 340.0]",1,2,-1
31278.0,2020-02-04,"(340.0, 673.0]",10,31,-21
31278.0,2020-02-04,"(673.0, 1006.0]",8,16,-8
31278.0,2020-02-04,"(1006.0, 1339.0]",26,40,-14
31279.0,2020-02-04,"(433.011, 681.25]",23,24,-1
31279.0,2020-02-04,"(681.25, 928.5]",3,10,-7
31279.0,2020-02-04,"(928.5, 1175.75]",12,40,-28
31279.0,2020-02-04,"(1175.75, 1423.0]",2,5,-3
31280.0,2020-02-04,"(360.941, 626.75]",5,20,-15
31280.0,2020-02-04,"(626.75, 891.5]",4,5,-1
31280.0,2020-02-04,"(891.5, 1156.25]",10,19,-9
31280.0,2020-02-04,"(1156.25, 1421.0]",8,9,-1
31000.0,2020-02-05,"(875.25, 998.0]",1,1,0
31001.0,2020-02-05,"(1087.25, 1188.0]",1,1,0
31002.0,2020-02-05,"(458.195, 660.25]",4,8,-4
31002.0,2020-02-05,"(861.5, 1062.75]",3,5,-2
31003.0,2020-02-05,"(378.202, 578.5]",2,6,-4
31003.0,2020-02-05,"(778.0, 977.5]",1,1,0
31003.0,2020-02-05,"(977.5, 1177.0]",3,4,-1
31004.0,2020-02-05,"(912.0, 1050.0]",2,1,1
31005.0,2020-02-05,"(444.217, 640.75]",4,5,-1
31005.0,2020-02-05,"(640.75, 836.5]",1,1,0
31005.0,2020-02-05,"(1032.25, 1228.0]",1,1,0
31006.0,2020-02-05,"(954.0, 1140.0]",4,2,2
31007.0,2020-02-05,"(373.02, 619.0]",8,16,-8
31007.0,2020-02-05,"(619.0, 864.0]",3,4,-1
31007.0,2020-02-05,"(864.0, 1109.0]",4,9,-5
31007.0,2020-02-05,"(1109.0, 1354.0]",1,6,-5
31009.0,2020-02-05,"(377.019, 623.25]",4,4,0
31009.0,2020-02-05,"(868.5, 1113.75]",1,2,-1
31009.0,2020-02-05,"(1113.75, 1359.0]",2,4,-2
31010.0,2020-02-05,"(446.031, 689.25]",2,3,-1
31010.0,2020-02-05,"(931.5, 1173.75]",2,4,-2
31010.0,2020-02-05,"(1173.75, 1416.0]",2,4,-2
31011.0,2020-02-05,"(419.149, 632.75]",4,6,-2
31011.0,2020-02-05,"(845.5, 1058.25]",2,1,1
31011.0,2020-02-05,"(1058.25, 1271.0]",2,4,-2
31012.0,2020-02-05,"(382.319, 553.25]",5,5,0
31012.0,2020-02-05,"(553.25, 723.5]",1,1,0
31012.0,2020-02-05,"(723.5, 893.75]",1,2,-1
31013.0,2020-02-05,"(955.25, 1143.0]",3,1,2
31014.0,2020-02-05,"(395.126, 614.5]",16,23,-7
31014.0,2020-02-05,"(614.5, 833.0]",5,6,-1
31014.0,2020-02-05,"(833.0, 1051.5]",6,10,-4
31014.0,2020-02-05,"(1051.5, 1270.0]",9,16,-7
31015.0,2020-02-05,"(360.235, 552.25]",10,14,-4
31015.0,2020-02-05,"(552.25, 743.5]",3,4,-1
31015.0,2020-02-05,"(743.5, 934.75]",2,4,-2
31015.0,2020-02-05,"(934.75, 1126.0]",5,9,-4
31016.0,2020-02-05,"(427.129, 645.75]",5,9,-4
31016.0,2020-02-05,"(645.75, 863.5]",1,1,0
31016.0,2020-02-05,"(863.5, 1081.25]",4,7,-3
31016.0,2020-02-05,"(1081.25, 1299.0]",1,3,-2
31017.0,2020-02-05,"(489.419, 635.25]",5,6,-1
31018.0,2020-02-05,"(958.25, 1130.0]",2,4,-2
31019.0,2020-02-05,"(863.25, 934.0]",1,1,0
31020.0,2020-02-05,"(486.151, 699.25]",3,3,0
31021.0,2020-02-05,"(363.132, 581.0]",3,7,-4
31021.0,2020-02-05,"(581.0, 798.0]",1,3,-2
31021.0,2020-02-05,"(798.0, 1015.0]",2,2,0
31021.0,2020-02-05,"(1015.0, 1232.0]",1,7,-6
31022.0,2020-02-05,"(301.018, 547.5]",3,5,-2
31022.0,2020-02-05,"(547.5, 793.0]",2,2,0
31022.0,2020-02-05,"(1038.5, 1284.0]",3,2,1
31023.0,2020-02-05,"(680.25, 897.5]",1,2,-1
31023.0,2020-02-05,"(897.5, 1114.75]",1,1,0
31023.0,2020-02-05,"(1114.75, 1332.0]",1,3,-2
31024.0,2020-02-05,"(391.074, 623.5]",6,11,-5
31024.0,2020-02-05,"(623.5, 855.0]",1,3,-2
31024.0,2020-02-05,"(855.0, 1086.5]",3,10,-7
31024.0,2020-02-05,"(1086.5, 1318.0]",1,1,0
31025.0,2020-02-05,"(840.0, 1048.0]",4,1,3
31025.0,2020-02-05,"(1048.0, 1256.0]",1,1,0
31026.0,2020-02-05,"(418.25, 716.5]",1,2,-1
31026.0,2020-02-05,"(716.5, 1014.75]",1,3,-2
31026.0,2020-02-05,"(1014.75, 1313.0]",5,3,2
31027.0,2020-02-05,"(1120.0, 1307.0]",1,2,-1
31028.0,2020-02-05,"(396.221, 591.75]",1,1,0
31028.0,2020-02-05,"(786.5, 981.25]",1,1,0
31029.0,2020-02-05,"(995.25, 1177.0]",5,7,-2
31030.0,2020-02-05,"(419.144, 634.0]",1,7,-6
31030.0,2020-02-05,"(634.0, 848.0]",1,2,-1
31030.0,2020-02-05,"(848.0, 1062.0]",1,3,-2
31030.0,2020-02-05,"(1062.0, 1276.0]",4,5,-1
31031.0,2020-02-05,"(68.933, 336.75]",1,2,-1
31031.0,2020-02-05,"(603.5, 870.25]",1,2,-1
31031.0,2020-02-05,"(870.25, 1137.0]",3,2,1
31032.0,2020-02-05,"(886.25, 1041.0]",5,2,3
,,,,1.0,
,,,,1.0,
31034.0,2020-02-05,"(476.054, 713.5]",2,3,-1
31034.0,2020-02-05,"(713.5, 950.0]",1,2,-1
31034.0,2020-02-05,"(950.0, 1186.5]",2,6,-4
31035.0,2020-02-05,"(774.0, 921.5]",1,3,-2
31035.0,2020-02-05,"(921.5, 1069.0]",2,1,1
31036.0,2020-02-05,"(642.0, 796.0]",1,3,-2
31036.0,2020-02-05,"(950.0, 1104.0]",3,2,1
31037.0,2020-02-05,"(392.173, 599.75]",12,16,-4
31037.0,2020-02-05,"(599.75, 806.5]",2,3,-1
31037.0,2020-02-05,"(806.5, 1013.25]",4,9,-5
31037.0,2020-02-05,"(1013.25, 1220.0]",4,13,-9
31038.0,2020-02-05,"(740.5, 824.0]",1,1,0
31039.0,2020-02-05,"(394.26, 580.0]",1,5,-4
31039.0,2020-02-05,"(580.0, 765.0]",1,1,0
31039.0,2020-02-05,"(765.0, 950.0]",2,3,-1
31039.0,2020-02-05,"(950.0, 1135.0]",2,7,-5
31040.0,2020-02-05,"(444.128, 663.0]",3,3,0
31040.0,2020-02-05,"(663.0, 881.0]",2,2,0
31041.0,2020-02-05,"(990.5, 1167.0]",2,1,1
31042.0,2020-02-05,"(437.334, 604.5]",7,7,0
31042.0,2020-02-05,"(937.5, 1104.0]",2,1,1
31043.0,2020-02-05,"(492.398, 643.5]",2,3,-1
31043.0,2020-02-05,"(944.5, 1095.0]",2,1,1
31044.0,2020-02-05,"(309.5, 559.0]",1,1,0
31044.0,2020-02-05,"(559.0, 808.5]",2,1,1
31044.0,2020-02-05,"(808.5, 1058.0]",1,4,-3
31045.0,2020-02-05,"(866.0, 1036.0]",1,2,-1
31045.0,2020-02-05,"(1036.0, 1206.0]",1,1,0
31046.0,2020-02-05,"(931.75, 1069.0]",2,1,1
31047.0,2020-02-05,"(351.295, 528.25]",6,11,-5
31047.0,2020-02-05,"(528.25, 704.5]",3,3,0
31047.0,2020-02-05,"(880.75, 1057.0]",5,15,-10
31048.0,2020-02-05,"(406.247, 595.25]",4,8,-4
31048.0,2020-02-05,"(783.5, 971.75]",1,1,0
31048.0,2020-02-05,"(971.75, 1160.0]",2,5,-3
31049.0,2020-02-05,"(450.272, 633.0]",1,2,-1
31049.0,2020-02-05,"(633.0, 815.0]",1,1,0
31049.0,2020-02-05,"(997.0, 1179.0]",2,4,-2
,,,,1.0,
,,,,5.0,
31051.0,2020-02-05,"(788.5, 956.75]",1,4,-3
31051.0,2020-02-05,"(956.75, 1125.0]",5,1,4
31052.0,2020-02-05,"(517.234, 709.5]",3,5,-2
31052.0,2020-02-05,"(901.0, 1092.5]",2,3,-1
31052.0,2020-02-05,"(1092.5, 1284.0]",1,2,-1
31053.0,2020-02-05,"(519.458, 655.5]",1,2,-1
31053.0,2020-02-05,"(926.5, 1062.0]",1,1,0
,,,,2.0,
31055.0,2020-02-05,"(284.0, 568.0]",1,1,0
31055.0,2020-02-05,"(852.0, 1136.0]",1,1,0
31056.0,2020-02-05,"(-1.046, 261.5]",2,3,-1
31056.0,2020-02-05,"(784.5, 1046.0]",1,1,0
,,,,2.0,
31058.0,2020-02-05,"(555.75, 741.0]",1,1,0
31059.0,2020-02-05,"(406.375, 563.25]",1,2,-1
31059.0,2020-02-05,"(875.75, 1032.0]",1,1,0
31060.0,2020-02-05,"(223.75, 439.5]",1,1,0
31061.0,2020-02-05,"(446.394, 598.5]",1,3,-2
31061.0,2020-02-05,"(750.0, 901.5]",1,1,0
31061.0,2020-02-05,"(901.5, 1053.0]",1,1,0
31062.0,2020-02-05,"(579.75, 773.0]",1,1,0
31063.0,2020-02-05,"(564.75, 753.0]",1,1,0
,,,,2.0,
31065.0,2020-02-05,"(782.5, 994.25]",1,1,0
31065.0,2020-02-05,"(994.25, 1206.0]",2,2,0
31066.0,2020-02-05,"(949.0, 1100.0]",1,2,-1
31067.0,2020-02-05,"(16.932, 285.0]",1,1,0
31067.0,2020-02-05,"(819.0, 1086.0]",2,1,1
31068.0,2020-02-05,"(627.0, 868.0]",1,2,-1
31068.0,2020-02-05,"(1109.0, 1350.0]",1,2,-1
31069.0,2020-02-05,"(955.25, 1130.0]",3,2,1
31070.0,2020-02-05,"(531.5, 771.0]",1,1,0
31070.0,2020-02-05,"(771.0, 1010.5]",1,2,-1
31070.0,2020-02-05,"(1010.5, 1250.0]",4,3,1
31071.0,2020-02-05,"(890.5, 1042.0]",5,2,3
,,,,1.0,
,,,,2.0,
31073.0,2020-02-05,"(447.412, 595.0]",1,2,-1
31073.0,2020-02-05,"(889.0, 1036.0]",1,2,-1
31074.0,2020-02-05,"(403.224, 598.0]",2,4,-2
31074.0,2020-02-05,"(792.0, 986.0]",2,1,1
31074.0,2020-02-05,"(986.0, 1180.0]",1,3,-2
31075.0,2020-02-05,"(954.0, 1110.0]",1,2,-1
31076.0,2020-02-05,"(264.0, 528.0]",1,1,0
31076.0,2020-02-05,"(792.0, 1056.0]",1,1,0
31077.0,2020-02-05,"(510.097, 736.75]",4,12,-8
31077.0,2020-02-05,"(736.75, 962.5]",1,2,-1
31077.0,2020-02-05,"(962.5, 1188.25]",3,4,-1
31077.0,2020-02-05,"(1188.25, 1414.0]",1,2,-1
31078.0,2020-02-05,"(464.385, 618.75]",9,10,-1
31078.0,2020-02-05,"(926.25, 1080.0]",1,11,-10
31079.0,2020-02-05,"(488.145, 702.75]",2,9,-7
31079.0,2020-02-05,"(702.75, 916.5]",1,2,-1
31079.0,2020-02-05,"(1130.25, 1344.0]",2,2,0
31080.0,2020-02-05,"(1071.25, 1298.0]",6,6,0
31081.0,2020-02-05,"(475.408, 624.0]",1,1,0
31081.0,2020-02-05,"(624.0, 772.0]",2,2,0
31081.0,2020-02-05,"(772.0, 920.0]",1,2,-1
31082.0,2020-02-05,"(515.399, 666.25]",1,1,0
31082.0,2020-02-05,"(666.25, 816.5]",1,2,-1
31082.0,2020-02-05,"(966.75, 1117.0]",1,1,0
31083.0,2020-02-05,"(947.75, 1129.0]",4,1,3
31084.0,2020-02-05,"(503.409, 651.75]",3,4,-1
31084.0,2020-02-05,"(651.75, 799.5]",1,1,0
31084.0,2020-02-05,"(799.5, 947.25]",1,1,0
31084.0,2020-02-05,"(947.25, 1095.0]",1,6,-5
31085.0,2020-02-05,"(745.5, 875.75]",2,3,-1
31085.0,2020-02-05,"(875.75, 1006.0]",1,2,-1
31086.0,2020-02-05,"(150.865, 435.75]",1,2,-1
31086.0,2020-02-05,"(1003.25, 1287.0]",1,1,0
31087.0,2020-02-05,"(911.75, 1061.0]",3,4,-1
31088.0,2020-02-05,"(845.5, 1070.25]",2,3,-1
31088.0,2020-02-05,"(1070.25, 1295.0]",2,2,0
31089.0,2020-02-05,"(453.152, 666.0]",6,10,-4
31089.0,2020-02-05,"(666.0, 878.0]",1,3,-2
31089.0,2020-02-05,"(1090.0, 1302.0]",4,6,-2
31090.0,2020-02-05,"(889.25, 1042.0]",1,2,-1
31091.0,2020-02-05,"(73.687, 403.25]",1,1,0
31091.0,2020-02-05,"(731.5, 1059.75]",1,4,-3
31091.0,2020-02-05,"(1059.75, 1388.0]",3,1,2
31092.0,2020-02-05,"(563.75, 739.5]",1,5,-4
31092.0,2020-02-05,"(739.5, 915.25]",1,3,-2
31092.0,2020-02-05,"(915.25, 1091.0]",5,1,4
31093.0,2020-02-05,"(936.5, 1115.0]",2,4,-2
31094.0,2020-02-05,"(696.75, 929.0]",1,1,0
31095.0,2020-02-05,"(980.5, 1136.0]",1,3,-2
31096.0,2020-02-05,"(1037.25, 1383.0]",1,1,0
31097.0,2020-02-05,"(512.183, 717.25]",2,3,-1
31097.0,2020-02-05,"(921.5, 1125.75]",2,2,0
31097.0,2020-02-05,"(1125.75, 1330.0]",1,3,-2
31098.0,2020-02-05,"(62.938, 329.5]",1,1,0
31098.0,2020-02-05,"(329.5, 595.0]",4,10,-6
31098.0,2020-02-05,"(595.0, 860.5]",1,1,0
31098.0,2020-02-05,"(860.5, 1126.0]",10,14,-4
31099.0,2020-02-05,"(462.321, 632.75]",1,2,-1
31099.0,2020-02-05,"(972.25, 1142.0]",1,1,0
31100.0,2020-02-05,"(430.231, 623.25]",14,15,-1
31100.0,2020-02-05,"(623.25, 815.5]",1,1,0
31100.0,2020-02-05,"(815.5, 1007.75]",4,8,-4
31100.0,2020-02-05,"(1007.75, 1200.0]",5,19,-14
31101.0,2020-02-05,"(336.0, 653.0]",15,1,14
31101.0,2020-02-05,"(653.0, 970.0]",10,49,-39
31101.0,2020-02-05,"(970.0, 1287.0]",39,18,21
31102.0,2020-02-05,"(140.765, 450.75]",1,9,-8
31102.0,2020-02-05,"(759.5, 1068.25]",3,12,-9
31102.0,2020-02-05,"(1068.25, 1377.0]",9,3,6
31103.0,2020-02-05,"(610.0, 880.0]",5,30,-25
31103.0,2020-02-05,"(880.0, 1150.0]",9,12,-3
31103.0,2020-02-05,"(1150.0, 1420.0]",8,17,-9
31104.0,2020-02-05,"(325.911, 599.25]",1,18,-17
31104.0,2020-02-05,"(599.25, 871.5]",3,4,-1
31104.0,2020-02-05,"(871.5, 1143.75]",18,25,-7
31104.0,2020-02-05,"(1143.75, 1416.0]",5,9,-4
31105.0,2020-02-05,"(349.977, 606.75]",1,5,-4
31105.0,2020-02-05,"(606.75, 862.5]",1,3,-2
31105.0,2020-02-05,"(862.5, 1118.25]",1,5,-4
31105.0,2020-02-05,"(1118.25, 1374.0]",1,3,-2
31106.0,2020-02-05,"(342.227, 536.25]",3,6,-3
31106.0,2020-02-05,"(922.75, 1116.0]",2,1,1
31107.0,2020-02-05,"(46.761, 357.75]",1,2,-1
31107.0,2020-02-05,"(357.75, 667.5]",8,31,-23
31107.0,2020-02-05,"(667.5, 977.25]",4,14,-10
31107.0,2020-02-05,"(977.25, 1287.0]",16,25,-9
31108.0,2020-02-05,"(344.1, 570.0]",11,34,-23
31108.0,2020-02-05,"(570.0, 795.0]",6,15,-9
31108.0,2020-02-05,"(795.0, 1020.0]",9,12,-3
31108.0,2020-02-05,"(1020.0, 1245.0]",20,32,-12
31109.0,2020-02-05,"(87.751, 401.25]",2,3,-1
31109.0,2020-02-05,"(401.25, 713.5]",5,19,-14
31109.0,2020-02-05,"(713.5, 1025.75]",5,10,-5
31109.0,2020-02-05,"(1025.75, 1338.0]",17,23,-6
31110.0,2020-02-05,"(327.94, 594.0]",8,27,-19
31110.0,2020-02-05,"(594.0, 859.0]",9,14,-5
31110.0,2020-02-05,"(859.0, 1124.0]",16,30,-14
31110.0,2020-02-05,"(1124.0, 1389.0]",8,18,-10
31111.0,2020-02-05,"(12.579, 369.25]",1,1,0
31111.0,2020-02-05,"(369.25, 724.5]",5,18,-13
31111.0,2020-02-05,"(724.5, 1079.75]",4,8,-4
31111.0,2020-02-05,"(1079.75, 1435.0]",9,13,-4
31112.0,2020-02-05,"(502.39, 655.5]",1,4,-3
31112.0,2020-02-05,"(960.5, 1113.0]",5,8,-3
31113.0,2020-02-05,"(349.044, 589.0]",1,20,-19
31113.0,2020-02-05,"(828.0, 1067.0]",6,3,3
31113.0,2020-02-05,"(1067.0, 1306.0]",7,8,-1
31114.0,2020-02-05,"(158.815, 456.25]",2,9,-7
31114.0,2020-02-05,"(456.25, 752.5]",2,15,-13
31114.0,2020-02-05,"(752.5, 1048.75]",2,6,-4
31114.0,2020-02-05,"(1048.75, 1345.0]",22,32,-10
31115.0,2020-02-05,"(234.863, 520.25]",1,17,-16
31115.0,2020-02-05,"(804.5, 1088.75]",4,10,-6
31115.0,2020-02-05,"(1088.75, 1373.0]",7,6,1
31116.0,2020-02-05,"(346.024, 591.0]",6,28,-22
31116.0,2020-02-05,"(591.0, 835.0]",3,4,-1
31116.0,2020-02-05,"(835.0, 1079.0]",13,20,-7
31116.0,2020-02-05,"(1079.0, 1323.0]",17,25,-8
31117.0,2020-02-05,"(302.993, 555.75]",4,29,-25
31117.0,2020-02-05,"(555.75, 807.5]",3,15,-12
31117.0,2020-02-05,"(807.5, 1059.25]",3,10,-7
31117.0,2020-02-05,"(1059.25, 1311.0]",13,20,-7
31118.0,2020-02-05,"(313.982, 569.5]",3,19,-16
31118.0,2020-02-05,"(824.0, 1078.5]",2,2,0
31118.0,2020-02-05,"(1078.5, 1333.0]",10,2,8
31119.0,2020-02-05,"(310.936, 578.0]",4,22,-18
31119.0,2020-02-05,"(578.0, 844.0]",5,8,-3
31119.0,2020-02-05,"(844.0, 1110.0]",11,17,-6
31119.0,2020-02-05,"(1110.0, 1376.0]",13,19,-6
31120.0,2020-02-05,"(454.08, 685.0]",1,16,-15
31120.0,2020-02-05,"(685.0, 915.0]",3,8,-5
31120.0,2020-02-05,"(915.0, 1145.0]",7,13,-6
31120.0,2020-02-05,"(1145.0, 1375.0]",7,9,-2
31121.0,2020-02-05,"(355.995, 608.25]",5,10,-5
31121.0,2020-02-05,"(608.25, 859.5]",4,5,-1
31121.0,2020-02-05,"(859.5, 1110.75]",5,14,-9
31121.0,2020-02-05,"(1110.75, 1362.0]",4,9,-5
31122.0,2020-02-05,"(69.724, 390.0]",1,1,0
31122.0,2020-02-05,"(390.0, 709.0]",3,16,-13
31122.0,2020-02-05,"(709.0, 1028.0]",1,4,-3
31122.0,2020-02-05,"(1028.0, 1347.0]",12,19,-7
31123.0,2020-02-05,"(845.0, 1076.5]",3,10,-7
31123.0,2020-02-05,"(1076.5, 1308.0]",5,6,-1
31124.0,2020-02-05,"(12.578, 369.5]",3,6,-3
31124.0,2020-02-05,"(369.5, 725.0]",19,51,-32
31124.0,2020-02-05,"(725.0, 1080.5]",12,42,-30
31124.0,2020-02-05,"(1080.5, 1436.0]",11,35,-24
31125.0,2020-02-05,"(254.872, 538.0]",5,26,-21
31125.0,2020-02-05,"(538.0, 820.0]",3,9,-6
31125.0,2020-02-05,"(820.0, 1102.0]",13,21,-8
31125.0,2020-02-05,"(1102.0, 1384.0]",15,19,-4
31126.0,2020-02-05,"(45.671, 379.25]",1,3,-2
31126.0,2020-02-05,"(379.25, 711.5]",3,22,-19
31126.0,2020-02-05,"(711.5, 1043.75]",9,17,-8
31126.0,2020-02-05,"(1043.75, 1376.0]",18,26,-8
31127.0,2020-02-05,"(405.031, 648.25]",11,14,-3
31127.0,2020-02-05,"(648.25, 890.5]",10,18,-8
31127.0,2020-02-05,"(890.5, 1132.75]",20,40,-20
31127.0,2020-02-05,"(1132.75, 1375.0]",6,18,-12
31128.0,2020-02-05,"(341.25, 662.5]",29,2,27
31128.0,2020-02-05,"(662.5, 983.75]",17,42,-25
31128.0,2020-02-05,"(983.75, 1305.0]",22,28,-6
31129.0,2020-02-05,"(420.249, 608.75]",14,15,-1
31129.0,2020-02-05,"(608.75, 796.5]",6,8,-2
31129.0,2020-02-05,"(984.25, 1172.0]",7,14,-7
31130.0,2020-02-05,"(382.5, 705.0]",4,2,2
31130.0,2020-02-05,"(705.0, 1027.5]",3,16,-13
31130.0,2020-02-05,"(1027.5, 1350.0]",7,4,3
31131.0,2020-02-05,"(115.76, 427.0]",1,3,-2
31131.0,2020-02-05,"(427.0, 737.0]",1,10,-9
31131.0,2020-02-05,"(737.0, 1047.0]",3,9,-6
31131.0,2020-02-05,"(1047.0, 1357.0]",5,9,-4
31200.0,2020-02-05,"(17.718, 339.5]",2,3,-1
31200.0,2020-02-05,"(339.5, 660.0]",29,44,-15
31200.0,2020-02-05,"(660.0, 980.5]",6,12,-6
31200.0,2020-02-05,"(980.5, 1301.0]",21,46,-25
31201.0,2020-02-05,"(26.62, 373.0]",4,6,-2
31201.0,2020-02-05,"(373.0, 718.0]",30,69,-39
31201.0,2020-02-05,"(718.0, 1063.0]",31,47,-16
31201.0,2020-02-05,"(1063.0, 1408.0]",20,46,-26
,,,,2.0,
31203.0,2020-02-05,"(321.91, 595.5]",7,23,-16
31203.0,2020-02-05,"(595.5, 868.0]",5,11,-6
31203.0,2020-02-05,"(868.0, 1140.5]",34,47,-13
31203.0,2020-02-05,"(1140.5, 1413.0]",2,4,-2
31204.0,2020-02-05,"(37.714, 360.5]",1,1,0
31204.0,2020-02-05,"(360.5, 682.0]",12,16,-4
31204.0,2020-02-05,"(682.0, 1003.5]",7,14,-7
31204.0,2020-02-05,"(1003.5, 1325.0]",11,28,-17
31205.0,2020-02-05,"(20.611, 369.25]",1,2,-1
31205.0,2020-02-05,"(369.25, 716.5]",36,41,-5
31205.0,2020-02-05,"(716.5, 1063.75]",14,33,-19
31205.0,2020-02-05,"(1063.75, 1411.0]",4,15,-11
31206.0,2020-02-05,"(385.296, 562.0]",8,9,-1
31206.0,2020-02-05,"(738.0, 914.0]",2,2,0
31206.0,2020-02-05,"(914.0, 1090.0]",2,2,0
31207.0,2020-02-05,"(656.5, 859.0]",1,5,-4
31207.0,2020-02-05,"(859.0, 1061.5]",2,2,0
31207.0,2020-02-05,"(1061.5, 1264.0]",5,2,3
31208.0,2020-02-05,"(361.147, 575.25]",8,10,-2
31208.0,2020-02-05,"(1001.75, 1215.0]",4,4,0
31209.0,2020-02-05,"(392.284, 572.0]",8,9,-1
31209.0,2020-02-05,"(930.0, 1109.0]",5,5,0
31211.0,2020-02-05,"(14.644, 355.0]",2,2,0
31211.0,2020-02-05,"(355.0, 694.0]",8,10,-2
31211.0,2020-02-05,"(694.0, 1033.0]",1,1,0
31211.0,2020-02-05,"(1033.0, 1372.0]",5,13,-8
31212.0,2020-02-05,"(105.689, 434.75]",6,12,-6
31212.0,2020-02-05,"(434.75, 762.5]",33,47,-14
31212.0,2020-02-05,"(762.5, 1090.25]",8,24,-16
31212.0,2020-02-05,"(1090.25, 1418.0]",11,25,-14
31213.0,2020-02-05,"(272.954, 535.5]",19,28,-9
31213.0,2020-02-05,"(535.5, 797.0]",13,27,-14
31213.0,2020-02-05,"(797.0, 1058.5]",11,22,-11
31213.0,2020-02-05,"(1058.5, 1320.0]",9,20,-11
31214.0,2020-02-05,"(5.725, 325.75]",2,3,-1
31214.0,2020-02-05,"(325.75, 644.5]",5,26,-21
31214.0,2020-02-05,"(644.5, 963.25]",9,16,-7
31214.0,2020-02-05,"(963.25, 1282.0]",29,43,-14
31215.0,2020-02-05,"(469.199, 670.25]",19,19,0
31215.0,2020-02-05,"(670.25, 870.5]",3,7,-4
31215.0,2020-02-05,"(870.5, 1070.75]",3,9,-6
31215.0,2020-02-05,"(1070.75, 1271.0]",1,8,-7
31216.0,2020-02-05,"(93.804, 394.0]",1,2,-1
31216.0,2020-02-05,"(394.0, 693.0]",22,24,-2
31216.0,2020-02-05,"(693.0, 992.0]",6,10,-4
31216.0,2020-02-05,"(992.0, 1291.0]",2,19,-17
31217.0,2020-02-05,"(323.142, 538.5]",11,12,-1
31217.0,2020-02-05,"(538.5, 753.0]",3,3,0
31217.0,2020-02-05,"(967.5, 1182.0]",3,1,2
31218.0,2020-02-05,"(368.272, 551.0]",14,35,-21
31218.0,2020-02-05,"(551.0, 733.0]",4,4,0
31218.0,2020-02-05,"(733.0, 915.0]",1,3,-2
31218.0,2020-02-05,"(915.0, 1097.0]",17,23,-6
31219.0,2020-02-05,"(391.245, 580.75]",12,12,0
31219.0,2020-02-05,"(580.75, 769.5]",3,3,0
31219.0,2020-02-05,"(769.5, 958.25]",2,8,-6
31220.0,2020-02-05,"(306.143, 521.25]",20,26,-6
31220.0,2020-02-05,"(521.25, 735.5]",1,3,-2
31220.0,2020-02-05,"(735.5, 949.75]",3,9,-6
31221.0,2020-02-05,"(413.082, 643.5]",29,32,-3
31221.0,2020-02-05,"(643.5, 873.0]",14,22,-8
31221.0,2020-02-05,"(873.0, 1102.5]",10,32,-22
31221.0,2020-02-05,"(1102.5, 1332.0]",7,17,-10
31222.0,2020-02-05,"(403.191, 606.25]",20,21,-1
31222.0,2020-02-05,"(1010.75, 1213.0]",1,1,0
31223.0,2020-02-05,"(49.786, 354.5]",2,3,-1
31223.0,2020-02-05,"(354.5, 658.0]",16,43,-27
31223.0,2020-02-05,"(658.0, 961.5]",1,5,-4
31223.0,2020-02-05,"(961.5, 1265.0]",17,29,-12
31224.0,2020-02-05,"(347.1, 573.0]",17,20,-3
31224.0,2020-02-05,"(573.0, 798.0]",7,10,-3
31224.0,2020-02-05,"(1023.0, 1248.0]",3,1,2
31225.0,2020-02-05,"(420.155, 632.25]",8,11,-3
31225.0,2020-02-05,"(632.25, 843.5]",2,6,-4
31225.0,2020-02-05,"(843.5, 1054.75]",7,12,-5
31225.0,2020-02-05,"(1054.75, 1266.0]",7,17,-10
31226.0,2020-02-05,"(299.059, 535.25]",5,10,-5
31226.0,2020-02-05,"(535.25, 770.5]",3,6,-3
31226.0,2020-02-05,"(770.5, 1005.75]",1,4,-3
31226.0,2020-02-05,"(1005.75, 1241.0]",6,11,-5
31227.0,2020-02-05,"(385.135, 602.25]",25,27,-2
31227.0,2020-02-05,"(602.25, 818.5]",7,10,-3
31227.0,2020-02-05,"(818.5, 1034.75]",6,9,-3
31227.0,2020-02-05,"(1034.75, 1251.0]",4,26,-22
31228.0,2020-02-05,"(374.051, 612.25]",24,35,-11
31228.0,2020-02-05,"(612.25, 849.5]",10,18,-8
31228.0,2020-02-05,"(849.5, 1086.75]",9,19,-10
31228.0,2020-02-05,"(1086.75, 1324.0]",5,14,-9
31229.0,2020-02-05,"(340.926, 610.5]",15,57,-42
31229.0,2020-02-05,"(610.5, 879.0]",12,26,-14
31229.0,2020-02-05,"(879.0, 1147.5]",23,39,-16
31229.0,2020-02-05,"(1147.5, 1416.0]",2,8,-6
31230.0,2020-02-05,"(73.685, 403.75]",4,6,-2
31230.0,2020-02-05,"(403.75, 732.5]",50,60,-10
31230.0,2020-02-05,"(732.5, 1061.25]",12,28,-16
31230.0,2020-02-05,"(1061.25, 1390.0]",7,35,-28
31231.0,2020-02-05,"(395.247, 584.25]",24,26,-2
31231.0,2020-02-05,"(584.25, 772.5]",4,5,-1
31231.0,2020-02-05,"(772.5, 960.75]",2,6,-4
31231.0,2020-02-05,"(960.75, 1149.0]",5,20,-15
31232.0,2020-02-05,"(98.676, 431.0]",4,7,-3
31232.0,2020-02-05,"(431.0, 762.0]",13,21,-8
31232.0,2020-02-05,"(762.0, 1093.0]",8,22,-14
31232.0,2020-02-05,"(1093.0, 1424.0]",10,22,-12
31233.0,2020-02-05,"(382.0, 724.0]",47,1,46
31233.0,2020-02-05,"(724.0, 1066.0]",18,53,-35
31233.0,2020-02-05,"(1066.0, 1408.0]",7,30,-23
31234.0,2020-02-05,"(363.019, 609.25]",15,25,-10
31234.0,2020-02-05,"(609.25, 854.5]",10,14,-4
31234.0,2020-02-05,"(854.5, 1099.75]",13,23,-10
31234.0,2020-02-05,"(1099.75, 1345.0]",10,15,-5
31235.0,2020-02-05,"(387.087, 616.25]",5,6,-1
31235.0,2020-02-05,"(844.5, 1072.75]",1,2,-1
31236.0,2020-02-05,"(337.75, 670.5]",23,1,22
31236.0,2020-02-05,"(670.5, 1003.25]",11,29,-18
31236.0,2020-02-05,"(1003.25, 1336.0]",8,23,-15
31237.0,2020-02-05,"(92.766, 402.5]",1,2,-1
31237.0,2020-02-05,"(402.5, 711.0]",6,19,-13
31237.0,2020-02-05,"(711.0, 1019.5]",6,11,-5
31237.0,2020-02-05,"(1019.5, 1328.0]",17,28,-11
31238.0,2020-02-05,"(56.738, 373.5]",2,2,0
31238.0,2020-02-05,"(373.5, 689.0]",17,18,-1
31238.0,2020-02-05,"(689.0, 1004.5]",6,14,-8
31238.0,2020-02-05,"(1004.5, 1320.0]",5,24,-19
31239.0,2020-02-05,"(12.752, 326.0]",1,1,0
31239.0,2020-02-05,"(326.0, 638.0]",24,28,-4
31239.0,2020-02-05,"(638.0, 950.0]",9,13,-4
31239.0,2020-02-05,"(950.0, 1262.0]",9,34,-25
31240.0,2020-02-05,"(736.747, 800.25]",1,2,-1
31240.0,2020-02-05,"(863.5, 926.75]",1,2,-1
31241.0,2020-02-05,"(57.674, 390.5]",2,4,-2
31241.0,2020-02-05,"(390.5, 722.0]",32,58,-26
31241.0,2020-02-05,"(722.0, 1053.5]",7,22,-15
31241.0,2020-02-05,"(1053.5, 1385.0]",21,32,-11
31242.0,2020-02-05,"(325.12, 546.0]",28,29,-1
31242.0,2020-02-05,"(546.0, 766.0]",3,6,-3
31242.0,2020-02-05,"(766.0, 986.0]",3,8,-5
31242.0,2020-02-05,"(986.0, 1206.0]",3,27,-24
31243.0,2020-02-05,"(375.243, 565.25]",22,28,-6
31243.0,2020-02-05,"(565.25, 754.5]",2,4,-2
31243.0,2020-02-05,"(754.5, 943.75]",2,6,-4
31243.0,2020-02-05,"(943.75, 1133.0]",4,25,-21
31244.0,2020-02-05,"(357.0, 685.0]",13,2,11
31244.0,2020-02-05,"(685.0, 1013.0]",6,24,-18
31244.0,2020-02-05,"(1013.0, 1341.0]",8,17,-9
31245.0,2020-02-05,"(147.794, 450.5]",2,4,-2
31245.0,2020-02-05,"(450.5, 752.0]",6,19,-13
31245.0,2020-02-05,"(752.0, 1053.5]",7,11,-4
31245.0,2020-02-05,"(1053.5, 1355.0]",13,16,-3
31246.0,2020-02-05,"(348.011, 596.25]",10,16,-6
31246.0,2020-02-05,"(596.25, 843.5]",10,14,-4
31246.0,2020-02-05,"(843.5, 1090.75]",7,18,-11
31246.0,2020-02-05,"(1090.75, 1338.0]",9,14,-5
31247.0,2020-02-05,"(353.188, 557.0]",14,22,-8
31247.0,2020-02-05,"(557.0, 760.0]",2,2,0
31247.0,2020-02-05,"(760.0, 963.0]",3,4,-1
31247.0,2020-02-05,"(963.0, 1166.0]",2,9,-7
31248.0,2020-02-05,"(358.226, 552.5]",6,11,-5
31248.0,2020-02-05,"(552.5, 746.0]",3,6,-3
31248.0,2020-02-05,"(746.0, 939.5]",2,3,-1
31248.0,2020-02-05,"(939.5, 1133.0]",6,15,-9
31249.0,2020-02-05,"(394.317, 565.75]",6,11,-5
31249.0,2020-02-05,"(565.75, 736.5]",1,2,-1
31249.0,2020-02-05,"(736.5, 907.25]",1,3,-2
31249.0,2020-02-05,"(907.25, 1078.0]",13,20,-7
31250.0,2020-02-05,"(413.999, 665.25]",19,21,-2
31250.0,2020-02-05,"(665.25, 915.5]",2,4,-2
31250.0,2020-02-05,"(915.5, 1165.75]",3,16,-13
31250.0,2020-02-05,"(1165.75, 1416.0]",2,6,-4
31251.0,2020-02-05,"(33.648, 373.0]",2,3,-1
31251.0,2020-02-05,"(373.0, 711.0]",18,38,-20
31251.0,2020-02-05,"(711.0, 1049.0]",12,26,-14
31251.0,2020-02-05,"(1049.0, 1387.0]",13,22,-9
31252.0,2020-02-05,"(397.123, 617.25]",21,23,-2
31252.0,2020-02-05,"(617.25, 836.5]",5,9,-4
31252.0,2020-02-05,"(836.5, 1055.75]",1,9,-8
31252.0,2020-02-05,"(1055.75, 1275.0]",4,19,-15
31253.0,2020-02-05,"(407.096, 634.0]",25,27,-2
31253.0,2020-02-05,"(634.0, 860.0]",2,4,-2
31253.0,2020-02-05,"(860.0, 1086.0]",4,11,-7
31253.0,2020-02-05,"(1086.0, 1312.0]",2,7,-5
31254.0,2020-02-05,"(334.5, 660.0]",22,2,20
31254.0,2020-02-05,"(660.0, 985.5]",4,25,-21
31254.0,2020-02-05,"(985.5, 1311.0]",8,11,-3
31255.0,2020-02-05,"(360.19, 563.5]",18,24,-6
31255.0,2020-02-05,"(563.5, 766.0]",4,8,-4
31255.0,2020-02-05,"(766.0, 968.5]",1,3,-2
31255.0,2020-02-05,"(968.5, 1171.0]",7,19,-12
31256.0,2020-02-05,"(27.731, 346.25]",1,4,-3
31256.0,2020-02-05,"(346.25, 663.5]",8,9,-1
31256.0,2020-02-05,"(980.75, 1298.0]",4,16,-12
31257.0,2020-02-05,"(335.003, 585.25]",21,33,-12
31257.0,2020-02-05,"(585.25, 834.5]",9,13,-4
31257.0,2020-02-05,"(834.5, 1083.75]",9,18,-9
31257.0,2020-02-05,"(1083.75, 1333.0]",11,24,-13
31258.0,2020-02-05,"(47.686, 377.5]",5,6,-1
31258.0,2020-02-05,"(377.5, 706.0]",7,23,-16
31258.0,2020-02-05,"(706.0, 1034.5]",3,13,-10
31258.0,2020-02-05,"(1034.5, 1363.0]",5,8,-3
31259.0,2020-02-05,"(453.201, 653.75]",10,10,0
31259.0,2020-02-05,"(653.75, 853.5]",3,6,-3
31259.0,2020-02-05,"(853.5, 1053.25]",1,9,-8
31259.0,2020-02-05,"(1053.25, 1253.0]",1,7,-6
31260.0,2020-02-05,"(384.09, 612.5]",12,16,-4
31260.0,2020-02-05,"(612.5, 840.0]",2,3,-1
31260.0,2020-02-05,"(1067.5, 1295.0]",3,8,-5
31261.0,2020-02-05,"(408.335, 575.25]",14,14,0
31261.0,2020-02-05,"(575.25, 741.5]",1,2,-1
31261.0,2020-02-05,"(907.75, 1074.0]",1,3,-2
31262.0,2020-02-05,"(323.888, 603.0]",12,13,-1
31262.0,2020-02-05,"(603.0, 881.0]",2,3,-1
31262.0,2020-02-05,"(881.0, 1159.0]",6,13,-7
31263.0,2020-02-05,"(367.051, 605.25]",22,27,-5
31263.0,2020-02-05,"(605.25, 842.5]",6,10,-4
31263.0,2020-02-05,"(842.5, 1079.75]",4,13,-9
31263.0,2020-02-05,"(1079.75, 1317.0]",5,13,-8
31264.0,2020-02-05,"(355.06, 591.0]",10,13,-3
31264.0,2020-02-05,"(591.0, 826.0]",1,3,-2
31264.0,2020-02-05,"(826.0, 1061.0]",3,10,-7
31264.0,2020-02-05,"(1061.0, 1296.0]",4,9,-5
31265.0,2020-02-05,"(78.686, 408.5]",3,4,-1
31265.0,2020-02-05,"(408.5, 737.0]",17,43,-26
31265.0,2020-02-05,"(737.0, 1065.5]",16,30,-14
31265.0,2020-02-05,"(1065.5, 1394.0]",15,33,-18
31266.0,2020-02-05,"(114.781, 420.75]",2,10,-8
31266.0,2020-02-05,"(420.75, 725.5]",4,19,-15
31266.0,2020-02-05,"(725.5, 1030.25]",10,17,-7
31266.0,2020-02-05,"(1030.25, 1335.0]",25,37,-12
31267.0,2020-02-05,"(357.25, 683.5]",25,1,24
31267.0,2020-02-05,"(683.5, 1009.75]",12,45,-33
31267.0,2020-02-05,"(1009.75, 1336.0]",15,24,-9
31268.0,2020-02-05,"(334.964, 595.0]",14,44,-30
31268.0,2020-02-05,"(595.0, 854.0]",4,10,-6
31268.0,2020-02-05,"(854.0, 1113.0]",16,25,-9
31268.0,2020-02-05,"(1113.0, 1372.0]",11,16,-5
31269.0,2020-02-05,"(350.12, 571.0]",7,14,-7
31269.0,2020-02-05,"(571.0, 791.0]",5,8,-3
31269.0,2020-02-05,"(791.0, 1011.0]",3,6,-3
31269.0,2020-02-05,"(1011.0, 1231.0]",16,31,-15
31270.0,2020-02-05,"(360.061, 595.75]",16,19,-3
31270.0,2020-02-05,"(595.75, 830.5]",6,11,-5
31270.0,2020-02-05,"(830.5, 1065.25]",3,9,-6
31270.0,2020-02-05,"(1065.25, 1300.0]",5,6,-1
31271.0,2020-02-05,"(381.143, 596.25]",17,19,-2
31271.0,2020-02-05,"(596.25, 810.5]",2,3,-1
31271.0,2020-02-05,"(810.5, 1024.75]",6,11,-5
31271.0,2020-02-05,"(1024.75, 1239.0]",5,17,-12
31272.0,2020-02-05,"(303.163, 513.25]",16,18,-2
31272.0,2020-02-05,"(513.25, 722.5]",19,20,-1
31272.0,2020-02-05,"(722.5, 931.75]",3,8,-5
31272.0,2020-02-05,"(931.75, 1141.0]",2,18,-16
31273.0,2020-02-05,"(631.0, 774.0]",1,2,-1
31273.0,2020-02-05,"(917.0, 1060.0]",2,2,0
31274.0,2020-02-05,"(312.0, 613.0]",17,1,16
31274.0,2020-02-05,"(613.0, 914.0]",2,20,-18
31274.0,2020-02-05,"(914.0, 1215.0]",8,3,5
31275.0,2020-02-05,"(8.635, 351.25]",2,4,-2
31275.0,2020-02-05,"(351.25, 692.5]",24,35,-11
31275.0,2020-02-05,"(692.5, 1033.75]",7,15,-8
31275.0,2020-02-05,"(1033.75, 1375.0]",11,22,-11
31276.0,2020-02-05,"(436.218, 632.5]",25,27,-2
31276.0,2020-02-05,"(632.5, 828.0]",1,2,-1
31276.0,2020-02-05,"(828.0, 1023.5]",2,6,-4
31276.0,2020-02-05,"(1023.5, 1219.0]",4,28,-24
31277.0,2020-02-05,"(430.06, 666.0]",35,40,-5
31277.0,2020-02-05,"(666.0, 901.0]",8,13,-5
31277.0,2020-02-05,"(901.0, 1136.0]",5,30,-25
31277.0,2020-02-05,"(1136.0, 1371.0]",1,6,-5
31278.0,2020-02-05,"(324.013, 571.75]",9,32,-23
31278.0,2020-02-05,"(571.75, 818.5]",5,12,-7
31278.0,2020-02-05,"(818.5, 1065.25]",12,21,-9
31278.0,2020-02-05,"(1065.25, 1312.0]",15,23,-8
31279.0,2020-02-05,"(421.154, 633.5]",25,29,-4
31279.0,2020-02-05,"(633.5, 845.0]",3,8,-5
31279.0,2020-02-05,"(845.0, 1056.5]",7,18,-11
31279.0,2020-02-05,"(1056.5, 1268.0]",3,20,-17
31280.0,2020-02-05,"(58.665, 393.75]",2,3,-1
31280.0,2020-02-05,"(393.75, 727.5]",6,29,-23
31280.0,2020-02-05,"(727.5, 1061.25]",10,14,-4
31280.0,2020-02-05,"(1061.25, 1395.0]",15,17,-2
31000.0,2020-02-06,"(803.25, 1071.0]",1,1,0
31001.0,2020-02-06,"(924.0, 1232.0]",1,1,0
31002.0,2020-02-06,"(440.373, 597.75]",3,6,-3
31002.0,2020-02-06,"(911.25, 1068.0]",1,1,0
31003.0,2020-02-06,"(403.619, 499.25]",1,3,-2
31003.0,2020-02-06,"(689.75, 785.0]",1,2,-1
,,,,2.0,
31005.0,2020-02-06,"(439.304, 614.0]",2,3,-1
,,,,2.0,
31007.0,2020-02-06,"(434.311, 607.25]",6,14,-8
31007.0,2020-02-06,"(951.75, 1124.0]",3,9,-6
31009.0,2020-02-06,"(390.0, 520.0]",3,1,2
31010.0,2020-02-06,"(450.432, 593.0]",1,2,-1
31010.0,2020-02-06,"(877.0, 1019.0]",1,1,0
31011.0,2020-02-06,"(329.209, 527.75]",3,3,0
31011.0,2020-02-06,"(527.75, 725.5]",2,4,-2
31011.0,2020-02-06,"(923.25, 1121.0]",1,3,-2
31012.0,2020-02-06,"(407.374, 564.5]",3,4,-1
31013.0,2020-02-06,"(504.5, 541.0]",1,1,0
31014.0,2020-02-06,"(347.959, 609.25]",11,14,-3
31014.0,2020-02-06,"(869.5, 1129.75]",8,18,-10
31014.0,2020-02-06,"(1129.75, 1390.0]",6,9,-3
31015.0,2020-02-06,"(427.227, 621.25]",9,11,-2
31015.0,2020-02-06,"(621.25, 814.5]",1,1,0
31015.0,2020-02-06,"(814.5, 1007.75]",1,1,0
31015.0,2020-02-06,"(1007.75, 1201.0]",5,7,-2
31016.0,2020-02-06,"(425.317, 596.75]",3,7,-4
31016.0,2020-02-06,"(596.75, 767.5]",1,2,-1
31016.0,2020-02-06,"(767.5, 938.25]",1,2,-1
31016.0,2020-02-06,"(938.25, 1109.0]",1,3,-2
31017.0,2020-02-06,"(489.193, 691.75]",4,5,-1
31018.0,2020-02-06,"(901.25, 1059.0]",1,2,-1
31019.0,2020-02-06,"(1142.5, 1265.75]",2,1,1
,,,,1.0,
,,,,2.0,
31021.0,2020-02-06,"(999.75, 1183.0]",1,4,-3
31022.0,2020-02-06,"(568.278, 749.5]",2,2,0
31022.0,2020-02-06,"(749.5, 930.0]",1,2,-1
31022.0,2020-02-06,"(930.0, 1110.5]",1,2,-1
,,,,2.0,
31024.0,2020-02-06,"(455.133, 672.75]",4,7,-3
31024.0,2020-02-06,"(1106.25, 1323.0]",3,2,1
31025.0,2020-02-06,"(1039.5, 1386.0]",2,1,1
31026.0,2020-02-06,"(1026.25, 1192.0]",1,2,-1
31027.0,2020-02-06,"(693.25, 852.5]",1,2,-1
31027.0,2020-02-06,"(1011.75, 1171.0]",2,2,0
,,,,1.0,
,,,,2.0,
31029.0,2020-02-06,"(905.0, 1134.5]",1,8,-7
31029.0,2020-02-06,"(1134.5, 1364.0]",2,1,1
31030.0,2020-02-06,"(455.063, 690.25]",1,8,-7
31030.0,2020-02-06,"(924.5, 1158.75]",4,4,0
31030.0,2020-02-06,"(1158.75, 1393.0]",2,4,-2
31031.0,2020-02-06,"(12.91, 286.5]",1,1,0
31031.0,2020-02-06,"(559.0, 831.5]",1,1,0
31031.0,2020-02-06,"(831.5, 1104.0]",1,1,0
31032.0,2020-02-06,"(884.5, 1089.25]",1,2,-1
31032.0,2020-02-06,"(1089.25, 1294.0]",1,2,-1
,,,,2.0,
31034.0,2020-02-06,"(533.357, 694.75]",3,3,0
31035.0,2020-02-06,"(897.5, 1038.0]",1,3,-2
31036.0,2020-02-06,"(507.439, 648.25]",1,2,-1
31036.0,2020-02-06,"(928.75, 1069.0]",4,4,0
31037.0,2020-02-06,"(419.062, 654.5]",8,12,-4
31037.0,2020-02-06,"(1123.5, 1358.0]",1,6,-5
31038.0,2020-02-06,"(1254.75, 1286.0]",1,1,0
31039.0,2020-02-06,"(465.141, 680.75]",2,2,0
31040.0,2020-02-06,"(455.075, 687.25]",4,4,0
,,,,1.0,
,,,,1.0,
31042.0,2020-02-06,"(451.357, 612.75]",6,7,-1
31042.0,2020-02-06,"(612.75, 773.5]",1,1,0
31042.0,2020-02-06,"(934.25, 1095.0]",1,3,-2
31043.0,2020-02-06,"(376.5, 502.0]",2,1,1
31044.0,2020-02-06,"(535.94, 551.0]",1,2,-1
31044.0,2020-02-06,"(581.0, 596.0]",1,1,0
31045.0,2020-02-06,"(1007.75, 1164.0]",1,1,0
,,,,1.0,
,,,,1.0,
31047.0,2020-02-06,"(357.098, 583.5]",8,14,-6
31047.0,2020-02-06,"(809.0, 1034.5]",1,3,-2
31047.0,2020-02-06,"(1034.5, 1260.0]",1,3,-2
31048.0,2020-02-06,"(518.154, 730.5]",1,4,-3
31048.0,2020-02-06,"(942.0, 1153.5]",2,1,1
31049.0,2020-02-06,"(915.75, 1221.0]",1,1,0
31050.0,2020-02-06,"(793.5, 1058.0]",1,1,0
31051.0,2020-02-06,"(985.5, 1165.0]",4,2,2
31052.0,2020-02-06,"(541.427, 685.25]",1,1,0
31052.0,2020-02-06,"(971.75, 1115.0]",1,1,0
,,,,1.0,
,,,,1.0,
,,,,1.0,
,,,,2.0,
31055.0,2020-02-06,"(277.75, 555.5]",1,1,0
31055.0,2020-02-06,"(833.25, 1111.0]",1,1,0
,,,,2.0,
,,,,2.0,
,,,,2.0,
,,,,2.0,
,,,,2.0,
31061.0,2020-02-06,"(461.25, 477.0]",1,1,0
31062.0,2020-02-06,"(773.968, 782.0]",1,1,0
,,,,2.0,
31064.0,2020-02-06,"(431.93, 449.5]",1,2,-1
31064.0,2020-02-06,"(484.5, 502.0]",1,1,0
,,,,1.0,
,,,,2.0,
,,,,1.0,
,,,,1.0,
,,,,1.0,
,,,,1.0,
,,,,1.0,
,,,,2.0,
31069.0,2020-02-06,"(1033.75, 1236.0]",3,4,-1
31070.0,2020-02-06,"(1026.5, 1154.25]",1,1,0
31070.0,2020-02-06,"(1154.25, 1282.0]",1,2,-1
31071.0,2020-02-06,"(323.034, 565.5]",1,3,-2
31071.0,2020-02-06,"(807.0, 1048.5]",1,1,0
31071.0,2020-02-06,"(1048.5, 1290.0]",2,3,-1
,,,,1.0,
,,,,1.0,
,,,,1.0,
,,,,1.0,
,,,,1.0,
,,,,1.0,
,,,,1.0,
,,,,1.0,
31076.0,2020-02-06,"(792.0, 1056.0]",1,1,0
31077.0,2020-02-06,"(458.359, 619.25]",2,6,-4
31077.0,2020-02-06,"(939.75, 1100.0]",3,4,-1
31078.0,2020-02-06,"(460.5, 614.0]",2,1,1
31079.0,2020-02-06,"(690.5, 895.0]",1,5,-4
31079.0,2020-02-06,"(1099.5, 1304.0]",3,2,1
31080.0,2020-02-06,"(848.5, 1099.75]",4,4,0
31080.0,2020-02-06,"(1099.75, 1351.0]",3,1,2
31081.0,2020-02-06,"(475.479, 606.25]",1,1,0
31081.0,2020-02-06,"(866.75, 997.0]",1,2,-1
31082.0,2020-02-06,"(411.0, 548.0]",1,1,0
31083.0,2020-02-06,"(533.0, 659.0]",1,1,0
31084.0,2020-02-06,"(514.145, 728.75]",3,4,-1
31084.0,2020-02-06,"(728.75, 942.5]",1,1,0
31084.0,2020-02-06,"(1156.25, 1370.0]",1,3,-2
31085.0,2020-02-06,"(399.134, 616.5]",1,4,-3
31085.0,2020-02-06,"(1049.5, 1266.0]",1,1,0
,,,,1.0,
,,,,1.0,
,,,,1.0,
,,,,1.0,
31088.0,2020-02-06,"(841.5, 1122.0]",2,1,1
31089.0,2020-02-06,"(479.121, 699.75]",4,6,-2
31090.0,2020-02-06,"(418.384, 573.0]",1,3,-2
31090.0,2020-02-06,"(881.0, 1035.0]",1,1,0
31091.0,2020-02-06,"(942.0, 1110.0]",2,2,0
31092.0,2020-02-06,"(901.0, 1118.0]",1,4,-3
31092.0,2020-02-06,"(1118.0, 1335.0]",1,1,0
,,,,1.0,
,,,,2.0,
,,,,2.0,
,,,,1.0,
,,,,1.0,
31096.0,2020-02-06,"(284.75, 569.5]",1,1,0
31096.0,2020-02-06,"(854.25, 1139.0]",1,1,0
31097.0,2020-02-06,"(506.418, 652.5]",2,2,0
31098.0,2020-02-06,"(418.384, 573.0]",2,9,-7
31098.0,2020-02-06,"(881.0, 1035.0]",1,1,0
31099.0,2020-02-06,"(475.75, 481.0]",1,1,0
31100.0,2020-02-06,"(354.0, 684.0]",11,1,10
31100.0,2020-02-06,"(1014.0, 1344.0]",1,12,-11
31101.0,2020-02-06,"(441.119, 662.25]",6,40,-34
31101.0,2020-02-06,"(662.25, 882.5]",2,2,0
31101.0,2020-02-06,"(882.5, 1102.75]",8,11,-3
31101.0,2020-02-06,"(1102.75, 1323.0]",19,28,-9
31102.0,2020-02-06,"(44.649, 383.75]",1,4,-3
31102.0,2020-02-06,"(383.75, 721.5]",1,18,-17
31102.0,2020-02-06,"(721.5, 1059.25]",1,1,0
31102.0,2020-02-06,"(1059.25, 1397.0]",4,6,-2
31103.0,2020-02-06,"(606.25, 863.5]",1,14,-13
31103.0,2020-02-06,"(863.5, 1120.75]",4,5,-1
31103.0,2020-02-06,"(1120.75, 1378.0]",3,9,-6
31104.0,2020-02-06,"(124.708, 449.0]",3,7,-4
31104.0,2020-02-06,"(449.0, 772.0]",6,24,-18
31104.0,2020-02-06,"(772.0, 1095.0]",5,9,-4
31104.0,2020-02-06,"(1095.0, 1418.0]",5,14,-9
31105.0,2020-02-06,"(353.963, 614.25]",1,7,-6
31105.0,2020-02-06,"(873.5, 1132.75]",1,1,0
31105.0,2020-02-06,"(1132.75, 1392.0]",1,4,-3
31106.0,2020-02-06,"(504.25, 521.0]",1,1,0
31107.0,2020-02-06,"(327.927, 597.25]",4,28,-24
31107.0,2020-02-06,"(865.5, 1133.75]",9,2,7
31107.0,2020-02-06,"(1133.75, 1402.0]",6,14,-8
31108.0,2020-02-06,"(65.675, 398.25]",1,3,-2
31108.0,2020-02-06,"(398.25, 729.5]",9,33,-24
31108.0,2020-02-06,"(729.5, 1060.75]",7,13,-6
31108.0,2020-02-06,"(1060.75, 1392.0]",11,15,-4
31109.0,2020-02-06,"(319.011, 567.25]",7,15,-8
31109.0,2020-02-06,"(567.25, 814.5]",3,5,-2
31109.0,2020-02-06,"(814.5, 1061.75]",2,5,-3
31109.0,2020-02-06,"(1061.75, 1309.0]",12,19,-7
31110.0,2020-02-06,"(361.962, 622.5]",12,25,-13
31110.0,2020-02-06,"(622.5, 882.0]",2,5,-3
31110.0,2020-02-06,"(882.0, 1141.5]",10,20,-10
31110.0,2020-02-06,"(1141.5, 1401.0]",5,12,-7
31111.0,2020-02-06,"(34.619, 381.25]",1,2,-1
31111.0,2020-02-06,"(381.25, 726.5]",5,19,-14
31111.0,2020-02-06,"(726.5, 1071.75]",5,7,-2
31111.0,2020-02-06,"(1071.75, 1417.0]",9,13,-4
31112.0,2020-02-06,"(26.86, 313.0]",1,1,0
31112.0,2020-02-06,"(313.0, 598.0]",1,4,-3
31112.0,2020-02-06,"(883.0, 1168.0]",4,5,-1
31113.0,2020-02-06,"(369.973, 627.75]",1,16,-15
31113.0,2020-02-06,"(884.5, 1141.25]",1,3,-2
31113.0,2020-02-06,"(1141.25, 1398.0]",4,2,2
31114.0,2020-02-06,"(391.0, 708.0]",2,5,-3
31114.0,2020-02-06,"(708.0, 1025.0]",4,21,-17
31114.0,2020-02-06,"(1025.0, 1342.0]",10,6,4
31115.0,2020-02-06,"(384.0, 716.0]",2,3,-1
31115.0,2020-02-06,"(716.0, 1048.0]",2,17,-15
31115.0,2020-02-06,"(1048.0, 1380.0]",11,5,6
31116.0,2020-02-06,"(320.919, 592.25]",4,23,-19
31116.0,2020-02-06,"(592.25, 862.5]",3,5,-2
31116.0,2020-02-06,"(862.5, 1132.75]",5,7,-2
31116.0,2020-02-06,"(1132.75, 1403.0]",8,9,-1
31117.0,2020-02-06,"(34.691, 363.25]",2,3,-1
31117.0,2020-02-06,"(363.25, 690.5]",2,18,-16
31117.0,2020-02-06,"(690.5, 1017.75]",4,9,-5
31117.0,2020-02-06,"(1017.75, 1345.0]",4,11,-7
31118.0,2020-02-06,"(316.093, 543.75]",2,13,-11
31118.0,2020-02-06,"(997.25, 1224.0]",7,1,6
31119.0,2020-02-06,"(341.961, 602.75]",6,26,-20
31119.0,2020-02-06,"(602.75, 862.5]",2,4,-2
31119.0,2020-02-06,"(862.5, 1122.25]",4,5,-1
31119.0,2020-02-06,"(1122.25, 1382.0]",4,8,-4
31120.0,2020-02-06,"(475.184, 680.0]",1,9,-8
31120.0,2020-02-06,"(680.0, 884.0]",1,1,0
31120.0,2020-02-06,"(884.0, 1088.0]",2,3,-1
31120.0,2020-02-06,"(1088.0, 1292.0]",3,6,-3
31121.0,2020-02-06,"(326.0, 629.0]",13,1,12
31121.0,2020-02-06,"(932.0, 1235.0]",5,20,-15
31122.0,2020-02-06,"(459.082, 689.5]",1,17,-16
31122.0,2020-02-06,"(919.0, 1148.5]",2,1,1
31122.0,2020-02-06,"(1148.5, 1378.0]",5,2,3
31123.0,2020-02-06,"(309.031, 552.25]",1,14,-13
31123.0,2020-02-06,"(794.5, 1036.75]",1,2,-1
31123.0,2020-02-06,"(1036.75, 1279.0]",3,7,-4
31124.0,2020-02-06,"(3.581, 359.75]",2,3,-1
31124.0,2020-02-06,"(359.75, 714.5]",15,39,-24
31124.0,2020-02-06,"(714.5, 1069.25]",4,18,-14
31124.0,2020-02-06,"(1069.25, 1424.0]",13,31,-18
31125.0,2020-02-06,"(10.709, 334.75]",1,1,0
31125.0,2020-02-06,"(334.75, 657.5]",10,23,-13
31125.0,2020-02-06,"(657.5, 980.25]",1,1,0
31125.0,2020-02-06,"(980.25, 1303.0]",10,14,-4
31126.0,2020-02-06,"(118.751, 432.25]",2,7,-5
31126.0,2020-02-06,"(432.25, 744.5]",3,17,-14
31126.0,2020-02-06,"(744.5, 1056.75]",4,8,-4
31126.0,2020-02-06,"(1056.75, 1369.0]",13,19,-6
31127.0,2020-02-06,"(380.023, 625.25]",17,21,-4
31127.0,2020-02-06,"(625.25, 869.5]",2,4,-2
31127.0,2020-02-06,"(869.5, 1113.75]",4,8,-4
31127.0,2020-02-06,"(1113.75, 1358.0]",2,12,-10
31128.0,2020-02-06,"(7.574, 365.5]",1,2,-1
31128.0,2020-02-06,"(365.5, 722.0]",22,29,-7
31128.0,2020-02-06,"(722.0, 1078.5]",10,14,-4
31128.0,2020-02-06,"(1078.5, 1435.0]",8,13,-5
31129.0,2020-02-06,"(429.029, 672.75]",10,14,-4
31129.0,2020-02-06,"(915.5, 1158.25]",1,1,0
31129.0,2020-02-06,"(1158.25, 1401.0]",2,4,-2
31130.0,2020-02-06,"(411.993, 664.75]",3,13,-10
31130.0,2020-02-06,"(664.75, 916.5]",1,2,-1
31130.0,2020-02-06,"(916.5, 1168.25]",2,3,-1
31130.0,2020-02-06,"(1168.25, 1420.0]",3,4,-1
31131.0,2020-02-06,"(1115.75, 1371.0]",2,7,-5
31200.0,2020-02-06,"(380.971, 639.25]",11,20,-9
31200.0,2020-02-06,"(896.5, 1153.75]",8,1,7
31200.0,2020-02-06,"(1153.75, 1411.0]",9,20,-11
31201.0,2020-02-06,"(372.965, 632.75]",11,34,-23
31201.0,2020-02-06,"(632.75, 891.5]",5,11,-6
31201.0,2020-02-06,"(891.5, 1150.25]",18,27,-9
31201.0,2020-02-06,"(1150.25, 1409.0]",13,24,-11
,,,,2.0,
31203.0,2020-02-06,"(0.601, 351.75]",1,3,-2
31203.0,2020-02-06,"(351.75, 701.5]",6,22,-16
31203.0,2020-02-06,"(701.5, 1051.25]",9,17,-8
31203.0,2020-02-06,"(1051.25, 1401.0]",19,27,-8
31204.0,2020-02-06,"(325.93, 594.5]",12,13,-1
31204.0,2020-02-06,"(594.5, 862.0]",3,7,-4
31204.0,2020-02-06,"(862.0, 1129.5]",7,15,-8
31204.0,2020-02-06,"(1129.5, 1397.0]",3,9,-6
31205.0,2020-02-06,"(326.5, 650.0]",26,2,24
31205.0,2020-02-06,"(650.0, 973.5]",4,30,-26
31205.0,2020-02-06,"(973.5, 1297.0]",5,6,-1
31206.0,2020-02-06,"(457.374, 614.5]",3,5,-2
31207.0,2020-02-06,"(611.0, 865.0]",1,6,-5
31207.0,2020-02-06,"(865.0, 1119.0]",1,1,0
31207.0,2020-02-06,"(1119.0, 1373.0]",3,2,1
31208.0,2020-02-06,"(363.241, 553.75]",9,12,-3
31208.0,2020-02-06,"(933.25, 1123.0]",2,7,-5
31209.0,2020-02-06,"(296.0, 592.0]",5,1,4
31209.0,2020-02-06,"(888.0, 1184.0]",3,5,-2
31211.0,2020-02-06,"(536.269, 719.75]",3,3,0
31211.0,2020-02-06,"(902.5, 1085.25]",2,2,0
31211.0,2020-02-06,"(1085.25, 1268.0]",1,2,-1
31212.0,2020-02-06,"(319.931, 588.25]",30,45,-15
31212.0,2020-02-06,"(588.25, 855.5]",8,8,0
31212.0,2020-02-06,"(855.5, 1122.75]",7,13,-6
31212.0,2020-02-06,"(1122.75, 1390.0]",5,10,-5
31213.0,2020-02-06,"(277.885, 557.75]",27,40,-13
31213.0,2020-02-06,"(557.75, 836.5]",6,12,-6
31213.0,2020-02-06,"(836.5, 1115.25]",5,11,-6
31213.0,2020-02-06,"(1115.25, 1394.0]",1,4,-3
31214.0,2020-02-06,"(321.932, 590.0]",4,26,-22
31214.0,2020-02-06,"(590.0, 857.0]",3,6,-3
31214.0,2020-02-06,"(857.0, 1124.0]",15,17,-2
31214.0,2020-02-06,"(1124.0, 1391.0]",4,7,-3
31215.0,2020-02-06,"(453.11, 676.5]",16,18,-2
31215.0,2020-02-06,"(676.5, 899.0]",1,1,0
31215.0,2020-02-06,"(899.0, 1121.5]",3,9,-6
31215.0,2020-02-06,"(1121.5, 1344.0]",1,6,-5
31216.0,2020-02-06,"(477.267, 661.25]",13,13,0
31217.0,2020-02-06,"(343.192, 546.0]",3,5,-2
31217.0,2020-02-06,"(546.0, 748.0]",3,3,0
31217.0,2020-02-06,"(950.0, 1152.0]",2,1,1
31218.0,2020-02-06,"(378.298, 554.5]",11,22,-11
31218.0,2020-02-06,"(554.5, 730.0]",3,3,0
31218.0,2020-02-06,"(730.0, 905.5]",2,2,0
31218.0,2020-02-06,"(905.5, 1081.0]",5,8,-3
31219.0,2020-02-06,"(371.117, 592.75]",6,6,0
31219.0,2020-02-06,"(592.75, 813.5]",4,4,0
31219.0,2020-02-06,"(1034.25, 1255.0]",2,1,1
31220.0,2020-02-06,"(385.29, 563.5]",15,18,-3
31221.0,2020-02-06,"(407.132, 625.0]",20,22,-2
31221.0,2020-02-06,"(625.0, 842.0]",2,6,-4
31221.0,2020-02-06,"(842.0, 1059.0]",1,10,-9
31221.0,2020-02-06,"(1059.0, 1276.0]",6,10,-4
31222.0,2020-02-06,"(484.41, 632.5]",16,18,-2
31222.0,2020-02-06,"(632.5, 780.0]",1,2,-1
31222.0,2020-02-06,"(927.5, 1075.0]",2,8,-6
31223.0,2020-02-06,"(41.623, 387.25]",2,3,-1
31223.0,2020-02-06,"(387.25, 731.5]",11,34,-23
31223.0,2020-02-06,"(731.5, 1075.75]",7,11,-4
31223.0,2020-02-06,"(1075.75, 1420.0]",6,11,-5
31224.0,2020-02-06,"(458.223, 653.25]",13,16,-3
31224.0,2020-02-06,"(653.25, 847.5]",4,5,-1
31224.0,2020-02-06,"(1041.75, 1236.0]",2,1,1
31225.0,2020-02-06,"(424.044, 664.0]",4,10,-6
31225.0,2020-02-06,"(903.0, 1142.0]",4,1,3
31225.0,2020-02-06,"(1142.0, 1381.0]",4,6,-2
31226.0,2020-02-06,"(297.963, 558.25]",5,11,-6
31226.0,2020-02-06,"(817.5, 1076.75]",1,1,0
31226.0,2020-02-06,"(1076.75, 1336.0]",2,2,0
31227.0,2020-02-06,"(449.183, 654.25]",24,26,-2
31227.0,2020-02-06,"(858.5, 1062.75]",1,8,-7
31227.0,2020-02-06,"(1062.75, 1267.0]",1,13,-12
31228.0,2020-02-06,"(342.922, 613.5]",21,26,-5
31228.0,2020-02-06,"(613.5, 883.0]",4,9,-5
31228.0,2020-02-06,"(883.0, 1152.5]",7,12,-5
31228.0,2020-02-06,"(1152.5, 1422.0]",2,4,-2
31229.0,2020-02-06,"(51.651, 390.25]",3,8,-5
31229.0,2020-02-06,"(390.25, 727.5]",13,56,-43
31229.0,2020-02-06,"(727.5, 1064.75]",11,16,-5
31229.0,2020-02-06,"(1064.75, 1402.0]",16,33,-17
31230.0,2020-02-06,"(395.978, 652.5]",38,46,-8
31230.0,2020-02-06,"(908.0, 1163.5]",3,14,-11
31231.0,2020-02-06,"(329.188, 533.0]",5,5,0
31231.0,2020-02-06,"(533.0, 736.0]",12,12,0
31231.0,2020-02-06,"(736.0, 939.0]",1,2,-1
31231.0,2020-02-06,"(939.0, 1142.0]",4,13,-9
31232.0,2020-02-06,"(3.685, 333.75]",1,3,-2
31232.0,2020-02-06,"(333.75, 662.5]",16,21,-5
31232.0,2020-02-06,"(662.5, 991.25]",2,3,-1
31232.0,2020-02-06,"(991.25, 1320.0]",5,12,-7
31233.0,2020-02-06,"(327.032, 570.0]",27,27,0
31233.0,2020-02-06,"(812.0, 1054.0]",2,6,-4
31233.0,2020-02-06,"(1054.0, 1296.0]",5,19,-14
31234.0,2020-02-06,"(23.646, 363.5]",3,3,0
31234.0,2020-02-06,"(363.5, 702.0]",23,40,-17
31234.0,2020-02-06,"(702.0, 1040.5]",7,8,-1
31234.0,2020-02-06,"(1040.5, 1379.0]",12,21,-9
31235.0,2020-02-06,"(476.405, 625.75]",8,8,0
31235.0,2020-02-06,"(923.25, 1072.0]",1,2,-1
31236.0,2020-02-06,"(344.5, 676.0]",22,2,20
31236.0,2020-02-06,"(676.0, 1007.5]",2,24,-22
31236.0,2020-02-06,"(1007.5, 1339.0]",4,6,-2
31237.0,2020-02-06,"(129.823, 425.25]",2,3,-1
31237.0,2020-02-06,"(425.25, 719.5]",12,24,-12
31237.0,2020-02-06,"(719.5, 1013.75]",2,5,-3
31237.0,2020-02-06,"(1013.75, 1308.0]",7,15,-8
31238.0,2020-02-06,"(48.707, 373.25]",1,1,0
31238.0,2020-02-06,"(373.25, 696.5]",16,19,-3
31238.0,2020-02-06,"(696.5, 1019.75]",2,4,-2
31238.0,2020-02-06,"(1019.75, 1343.0]",1,13,-12
31239.0,2020-02-06,"(330.089, 558.75]",18,20,-2
31239.0,2020-02-06,"(558.75, 786.5]",8,11,-3
31239.0,2020-02-06,"(786.5, 1014.25]",2,3,-1
31239.0,2020-02-06,"(1014.25, 1242.0]",7,26,-19
,,,,1.0,
,,,,2.0,
31241.0,2020-02-06,"(332.921, 603.75]",21,44,-23
31241.0,2020-02-06,"(603.75, 873.5]",7,11,-4
31241.0,2020-02-06,"(873.5, 1143.25]",8,15,-7
31241.0,2020-02-06,"(1143.25, 1413.0]",5,11,-6
31242.0,2020-02-06,"(301.038, 542.5]",16,17,-1
31242.0,2020-02-06,"(542.5, 783.0]",8,9,-1
31242.0,2020-02-06,"(1023.5, 1264.0]",2,2,0
31243.0,2020-02-06,"(378.205, 577.75]",19,24,-5
31243.0,2020-02-06,"(577.75, 776.5]",2,2,0
31243.0,2020-02-06,"(776.5, 975.25]",2,4,-2
31243.0,2020-02-06,"(975.25, 1174.0]",1,13,-12
31244.0,2020-02-06,"(356.008, 605.0]",12,20,-8
31244.0,2020-02-06,"(605.0, 853.0]",3,5,-2
31244.0,2020-02-06,"(853.0, 1101.0]",4,11,-7
31244.0,2020-02-06,"(1101.0, 1349.0]",4,9,-5
31245.0,2020-02-06,"(268.864, 554.0]",8,23,-15
31245.0,2020-02-06,"(554.0, 838.0]",5,9,-4
31245.0,2020-02-06,"(838.0, 1122.0]",7,14,-7
31245.0,2020-02-06,"(1122.0, 1406.0]",3,7,-4
31246.0,2020-02-06,"(410.036, 652.0]",11,20,-9
31246.0,2020-02-06,"(652.0, 893.0]",2,2,0
31246.0,2020-02-06,"(893.0, 1134.0]",5,9,-4
31246.0,2020-02-06,"(1134.0, 1375.0]",4,8,-4
31247.0,2020-02-06,"(423.357, 584.75]",9,12,-3
31247.0,2020-02-06,"(906.25, 1067.0]",4,1,3
31248.0,2020-02-06,"(356.277, 537.75]",4,6,-2
31248.0,2020-02-06,"(537.75, 718.5]",2,5,-3
31248.0,2020-02-06,"(899.25, 1080.0]",4,7,-3
31249.0,2020-02-06,"(438.342, 603.5]",1,1,0
31249.0,2020-02-06,"(932.5, 1097.0]",2,5,-3
31250.0,2020-02-06,"(416.016, 663.0]",16,21,-5
31250.0,2020-02-06,"(909.0, 1155.0]",2,9,-7
31250.0,2020-02-06,"(1155.0, 1401.0]",1,3,-2
31251.0,2020-02-06,"(432.25, 754.5]",20,3,17
31251.0,2020-02-06,"(754.5, 1076.75]",2,35,-33
31251.0,2020-02-06,"(1076.75, 1399.0]",5,7,-2
31252.0,2020-02-06,"(443.126, 662.5]",21,24,-3
31253.0,2020-02-06,"(403.072, 636.0]",18,20,-2
31253.0,2020-02-06,"(868.0, 1100.0]",3,1,2
31254.0,2020-02-06,"(410.106, 634.5]",22,24,-2
31254.0,2020-02-06,"(634.5, 858.0]",1,2,-1
31254.0,2020-02-06,"(858.0, 1081.5]",1,9,-8
31254.0,2020-02-06,"(1081.5, 1305.0]",3,6,-3
31255.0,2020-02-06,"(375.105, 599.75]",12,18,-6
31255.0,2020-02-06,"(823.5, 1047.25]",1,1,0
31255.0,2020-02-06,"(1047.25, 1271.0]",3,7,-4
31256.0,2020-02-06,"(269.854, 557.5]",9,9,0
31256.0,2020-02-06,"(1130.5, 1417.0]",1,5,-4
31257.0,2020-02-06,"(328.937, 595.75]",18,32,-14
31257.0,2020-02-06,"(861.5, 1127.25]",8,19,-11
31257.0,2020-02-06,"(1127.25, 1393.0]",3,11,-8
31258.0,2020-02-06,"(517.433, 659.75]",4,9,-5
31258.0,2020-02-06,"(943.25, 1085.0]",1,3,-2
31259.0,2020-02-06,"(433.131, 651.25]",12,12,0
31259.0,2020-02-06,"(651.25, 868.5]",1,2,-1
31260.0,2020-02-06,"(382.21, 580.5]",18,19,-1
31260.0,2020-02-06,"(580.5, 778.0]",1,3,-2
31260.0,2020-02-06,"(975.5, 1173.0]",2,13,-11
31261.0,2020-02-06,"(392.321, 562.75]",1,1,0
31261.0,2020-02-06,"(562.75, 732.5]",1,2,-1
31261.0,2020-02-06,"(902.25, 1072.0]",1,4,-3
31262.0,2020-02-06,"(433.128, 652.0]",6,6,0
31262.0,2020-02-06,"(652.0, 870.0]",1,3,-2
31262.0,2020-02-06,"(1088.0, 1306.0]",2,1,1
31263.0,2020-02-06,"(365.21, 563.5]",16,23,-7
31263.0,2020-02-06,"(761.0, 958.5]",1,1,0
31263.0,2020-02-06,"(958.5, 1156.0]",1,2,-1
31264.0,2020-02-06,"(357.0, 654.0]",8,1,7
31264.0,2020-02-06,"(654.0, 951.0]",1,10,-9
31265.0,2020-02-06,"(14.61, 363.5]",1,1,0
31265.0,2020-02-06,"(363.5, 711.0]",13,29,-16
31265.0,2020-02-06,"(711.0, 1058.5]",8,11,-3
31265.0,2020-02-06,"(1058.5, 1406.0]",12,23,-11
31266.0,2020-02-06,"(221.834, 514.5]",2,20,-18
31266.0,2020-02-06,"(514.5, 806.0]",5,8,-3
31266.0,2020-02-06,"(806.0, 1097.5]",6,10,-4
31266.0,2020-02-06,"(1097.5, 1389.0]",9,14,-5
31267.0,2020-02-06,"(365.75, 682.5]",21,1,20
31267.0,2020-02-06,"(682.5, 999.25]",10,39,-29
31267.0,2020-02-06,"(999.25, 1316.0]",15,12,3
31268.0,2020-02-06,"(327.929, 596.75]",17,47,-30
31268.0,2020-02-06,"(864.5, 1132.25]",12,3,9
31268.0,2020-02-06,"(1132.25, 1400.0]",3,13,-10
31269.0,2020-02-06,"(351.069, 584.75]",3,8,-5
31269.0,2020-02-06,"(584.75, 817.5]",2,3,-1
31269.0,2020-02-06,"(817.5, 1050.25]",1,7,-6
31269.0,2020-02-06,"(1050.25, 1283.0]",1,6,-5
31270.0,2020-02-06,"(449.127, 668.25]",10,13,-3
31270.0,2020-02-06,"(668.25, 886.5]",1,2,-1
31270.0,2020-02-06,"(886.5, 1104.75]",4,7,-3
31270.0,2020-02-06,"(1104.75, 1323.0]",2,4,-2
31271.0,2020-02-06,"(383.279, 564.25]",15,17,-2
31271.0,2020-02-06,"(564.25, 744.5]",3,3,0
31271.0,2020-02-06,"(744.5, 924.75]",1,2,-1
31271.0,2020-02-06,"(924.75, 1105.0]",2,10,-8
31272.0,2020-02-06,"(301.024, 546.0]",22,24,-2
31272.0,2020-02-06,"(546.0, 790.0]",3,5,-2
31272.0,2020-02-06,"(1034.0, 1278.0]",2,3,-1
31273.0,2020-02-06,"(808.5, 905.0]",1,1,0
31274.0,2020-02-06,"(395.014, 642.5]",11,12,-1
31274.0,2020-02-06,"(889.0, 1135.5]",1,3,-2
31275.0,2020-02-06,"(217.915, 490.25]",8,13,-5
31275.0,2020-02-06,"(490.25, 761.5]",8,18,-10
31275.0,2020-02-06,"(761.5, 1032.75]",2,4,-2
31275.0,2020-02-06,"(1032.75, 1304.0]",10,20,-10
31276.0,2020-02-06,"(397.015, 644.25]",26,30,-4
31276.0,2020-02-06,"(644.25, 890.5]",1,2,-1
31276.0,2020-02-06,"(890.5, 1136.75]",2,9,-7
31276.0,2020-02-06,"(1136.75, 1383.0]",2,6,-4
31277.0,2020-02-06,"(390.182, 595.5]",32,35,-3
31277.0,2020-02-06,"(595.5, 800.0]",9,11,-2
31277.0,2020-02-06,"(800.0, 1004.5]",1,4,-3
31277.0,2020-02-06,"(1004.5, 1209.0]",4,17,-13
31278.0,2020-02-06,"(159.791, 463.25]",3,6,-3
31278.0,2020-02-06,"(463.25, 765.5]",7,23,-16
31278.0,2020-02-06,"(765.5, 1067.75]",4,6,-2
31278.0,2020-02-06,"(1067.75, 1370.0]",7,11,-4
31279.0,2020-02-06,"(420.145, 634.75]",23,26,-3
31280.0,2020-02-06,"(355.026, 599.5]",9,29,-20
31280.0,2020-02-06,"(599.5, 843.0]",2,4,-2
31280.0,2020-02-06,"(843.0, 1086.5]",4,6,-2
31280.0,2020-02-06,"(1086.5, 1330.0]",5,7,-2
,,,,1.0,
,,,,1.0,
31001.0,2020-02-07,"(758.479, 889.25]",1,2,-1
31001.0,2020-02-07,"(889.25, 1019.5]",1,2,-1
31001.0,2020-02-07,"(1149.75, 1280.0]",1,2,-1
31002.0,2020-02-07,"(532.455, 669.25]",1,4,-3
31002.0,2020-02-07,"(669.25, 805.5]",2,4,-2
31002.0,2020-02-07,"(805.5, 941.75]",2,2,0
31002.0,2020-02-07,"(941.75, 1078.0]",5,5,0
31003.0,2020-02-07,"(432.31, 605.5]",2,3,-1
31003.0,2020-02-07,"(778.0, 950.5]",4,1,3
31003.0,2020-02-07,"(950.5, 1123.0]",2,5,-3
31004.0,2020-02-07,"(980.25, 1043.0]",2,1,1
31005.0,2020-02-07,"(434.065, 668.75]",1,1,0
31005.0,2020-02-07,"(668.75, 902.5]",3,3,0
31005.0,2020-02-07,"(902.5, 1136.25]",4,10,-6
31005.0,2020-02-07,"(1136.25, 1370.0]",2,2,0
31006.0,2020-02-07,"(898.582, 1003.5]",3,4,-1
31006.0,2020-02-07,"(1003.5, 1108.0]",1,2,-1
31006.0,2020-02-07,"(1212.5, 1317.0]",1,2,-1
31007.0,2020-02-07,"(783.518, 904.5]",1,3,-2
31007.0,2020-02-07,"(904.5, 1025.0]",3,8,-5
31007.0,2020-02-07,"(1025.0, 1145.5]",6,13,-7
,,,,1.0,
,,,,3.0,
31010.0,2020-02-07,"(425.25, 567.0]",1,1,0
31011.0,2020-02-07,"(476.397, 627.75]",1,1,0
31011.0,2020-02-07,"(929.25, 1080.0]",3,1,2
31012.0,2020-02-07,"(500.425, 644.75]",1,2,-1
31012.0,2020-02-07,"(644.75, 788.5]",1,1,0
31012.0,2020-02-07,"(788.5, 932.25]",1,1,0
31012.0,2020-02-07,"(932.25, 1076.0]",1,7,-6
31013.0,2020-02-07,"(861.5, 1092.25]",3,1,2
31013.0,2020-02-07,"(1092.25, 1323.0]",3,4,-1
31014.0,2020-02-07,"(504.374, 661.5]",4,6,-2
31014.0,2020-02-07,"(661.5, 818.0]",1,1,0
31014.0,2020-02-07,"(818.0, 974.5]",2,2,0
31014.0,2020-02-07,"(974.5, 1131.0]",11,16,-5
31015.0,2020-02-07,"(456.176, 663.0]",4,6,-2
31015.0,2020-02-07,"(663.0, 869.0]",3,6,-3
31015.0,2020-02-07,"(869.0, 1075.0]",3,7,-4
31015.0,2020-02-07,"(1075.0, 1281.0]",3,4,-1
31016.0,2020-02-07,"(469.174, 676.5]",1,4,-3
31016.0,2020-02-07,"(676.5, 883.0]",1,2,-1
31016.0,2020-02-07,"(883.0, 1089.5]",2,4,-2
31016.0,2020-02-07,"(1089.5, 1296.0]",2,5,-3
31017.0,2020-02-07,"(763.5, 976.0]",1,2,-1
31017.0,2020-02-07,"(1188.5, 1401.0]",2,3,-1
31018.0,2020-02-07,"(867.0, 1073.5]",2,1,1
31018.0,2020-02-07,"(1073.5, 1280.0]",1,3,-2
31019.0,2020-02-07,"(654.36, 815.0]",1,1,0
31019.0,2020-02-07,"(815.0, 975.0]",1,1,0
31019.0,2020-02-07,"(1135.0, 1295.0]",1,4,-3
31020.0,2020-02-07,"(943.25, 1254.0]",1,1,0
31021.0,2020-02-07,"(403.172, 611.0]",1,2,-1
31021.0,2020-02-07,"(818.0, 1025.0]",1,1,0
31021.0,2020-02-07,"(1025.0, 1232.0]",2,1,1
31022.0,2020-02-07,"(486.15, 699.5]",1,2,-1
31022.0,2020-02-07,"(912.0, 1124.5]",2,2,0
31022.0,2020-02-07,"(1124.5, 1337.0]",1,5,-4
31023.0,2020-02-07,"(434.123, 654.25]",1,1,0
31023.0,2020-02-07,"(1092.75, 1312.0]",1,2,-1
31024.0,2020-02-07,"(643.75, 814.5]",1,1,0
31024.0,2020-02-07,"(814.5, 985.25]",3,2,1
31024.0,2020-02-07,"(985.25, 1156.0]",2,6,-4
31025.0,2020-02-07,"(674.25, 899.0]",1,1,0
31026.0,2020-02-07,"(1045.642, 1135.5]",2,5,-3
31026.0,2020-02-07,"(1135.5, 1225.0]",1,3,-2
31026.0,2020-02-07,"(1225.0, 1314.5]",2,2,0
31026.0,2020-02-07,"(1314.5, 1404.0]",2,4,-2
31027.0,2020-02-07,"(546.456, 683.0]",1,2,-1
31028.0,2020-02-07,"(491.507, 615.25]",1,1,0
31029.0,2020-02-07,"(865.25, 1051.5]",3,1,2
31029.0,2020-02-07,"(1051.5, 1237.75]",1,3,-2
31029.0,2020-02-07,"(1237.75, 1424.0]",2,1,1
31030.0,2020-02-07,"(11.731, 330.25]",1,1,0
31030.0,2020-02-07,"(964.75, 1282.0]",5,2,3
31031.0,2020-02-07,"(858.0, 1101.5]",1,1,0
31031.0,2020-02-07,"(1101.5, 1345.0]",2,2,0
31032.0,2020-02-07,"(955.0, 1116.0]",1,1,0
,,,,2.0,
31034.0,2020-02-07,"(1028.25, 1133.0]",2,1,1
31035.0,2020-02-07,"(905.5, 1048.0]",1,1,0
31036.0,2020-02-07,"(1112.75, 1164.0]",1,1,0
31037.0,2020-02-07,"(425.032, 668.0]",2,4,-2
31037.0,2020-02-07,"(910.0, 1152.0]",4,1,3
31037.0,2020-02-07,"(1152.0, 1394.0]",1,13,-12
31038.0,2020-02-07,"(242.0, 484.0]",1,1,0
31038.0,2020-02-07,"(726.0, 968.0]",1,1,0
31039.0,2020-02-07,"(688.75, 894.5]",4,1,3
31039.0,2020-02-07,"(894.5, 1100.25]",3,5,-2
31039.0,2020-02-07,"(1100.25, 1306.0]",1,7,-6
31040.0,2020-02-07,"(390.5, 710.0]",1,1,0
31040.0,2020-02-07,"(710.0, 1029.5]",1,1,0
31040.0,2020-02-07,"(1029.5, 1349.0]",2,3,-1
31041.0,2020-02-07,"(856.0, 1032.0]",1,1,0
31041.0,2020-02-07,"(1032.0, 1208.0]",2,1,1
31042.0,2020-02-07,"(462.382, 617.5]",4,5,-1
31042.0,2020-02-07,"(617.5, 772.0]",1,2,-1
31042.0,2020-02-07,"(926.5, 1081.0]",1,5,-4
31043.0,2020-02-07,"(500.374, 657.5]",2,2,0
31044.0,2020-02-07,"(507.073, 739.75]",2,3,-1
31044.0,2020-02-07,"(1203.25, 1435.0]",1,2,-1
31045.0,2020-02-07,"(966.0, 987.0]",1,1,0
31045.0,2020-02-07,"(1008.0, 1029.0]",1,1,0
31046.0,2020-02-07,"(390.358, 551.5]",1,3,-2
31046.0,2020-02-07,"(872.5, 1033.0]",1,1,0
31047.0,2020-02-07,"(448.229, 641.75]",6,9,-3
31047.0,2020-02-07,"(641.75, 834.5]",3,3,0
31047.0,2020-02-07,"(834.5, 1027.25]",4,8,-4
31047.0,2020-02-07,"(1027.25, 1220.0]",3,10,-7
31048.0,2020-02-07,"(670.0, 848.0]",1,1,0
31048.0,2020-02-07,"(1026.0, 1204.0]",1,2,-1
31049.0,2020-02-07,"(649.5, 843.0]",1,1,0
31049.0,2020-02-07,"(843.0, 1036.5]",1,1,0
31049.0,2020-02-07,"(1036.5, 1230.0]",1,2,-1
31050.0,2020-02-07,"(1038.697, 1114.75]",3,3,0
31050.0,2020-02-07,"(1266.25, 1342.0]",1,1,0
31051.0,2020-02-07,"(648.75, 839.5]",1,2,-1
31051.0,2020-02-07,"(1030.25, 1221.0]",4,1,3
31052.0,2020-02-07,"(454.426, 598.5]",1,1,0
31053.0,2020-02-07,"(945.0, 1153.5]",1,1,0
,,,,2.0,
31055.0,2020-02-07,"(309.0, 412.0]",1,1,0
31056.0,2020-02-07,"(828.75, 1105.0]",1,1,0
31057.0,2020-02-07,"(954.999, 955.25]",1,1,0
31058.0,2020-02-07,"(94.25, 112.0]",1,1,0
,,,,1.0,
,,,,1.0,
31060.0,2020-02-07,"(425.314, 597.5]",1,1,0
31060.0,2020-02-07,"(597.5, 769.0]",1,1,0
31060.0,2020-02-07,"(940.5, 1112.0]",3,5,-2
31061.0,2020-02-07,"(456.389, 609.75]",1,2,-1
31061.0,2020-02-07,"(915.25, 1068.0]",1,1,0
31062.0,2020-02-07,"(972.725, 1041.75]",2,4,-2
31062.0,2020-02-07,"(1179.25, 1248.0]",2,3,-1
,,,,2.0,
31064.0,2020-02-07,"(983.936, 1000.0]",1,1,0
31064.0,2020-02-07,"(1016.0, 1032.0]",1,2,-1
31064.0,2020-02-07,"(1032.0, 1048.0]",1,2,-1
31065.0,2020-02-07,"(702.0, 936.0]",2,1,1
,,,,1.0,
,,,,1.0,
,,,,1.0,
31067.0,2020-02-07,"(43.98, 300.0]",1,2,-1
31067.0,2020-02-07,"(810.0, 1065.0]",2,3,-1
31068.0,2020-02-07,"(980.25, 1017.5]",1,2,-1
31069.0,2020-02-07,"(747.0, 907.5]",1,2,-1
31069.0,2020-02-07,"(907.5, 1068.0]",1,1,0
31070.0,2020-02-07,"(1299.5, 1410.0]",3,2,1
31071.0,2020-02-07,"(821.546, 935.5]",1,3,-2
31071.0,2020-02-07,"(1049.0, 1162.5]",2,1,1
,,,,2.0,
31073.0,2020-02-07,"(1042.75, 1106.5]",1,1,0
,,,,2.0,
31075.0,2020-02-07,"(842.25, 1123.0]",1,1,0
,,,,2.0,
31077.0,2020-02-07,"(463.164, 673.0]",1,3,-2
31077.0,2020-02-07,"(673.0, 882.0]",3,4,-1
31077.0,2020-02-07,"(882.0, 1091.0]",7,7,0
31077.0,2020-02-07,"(1091.0, 1300.0]",2,7,-5
31078.0,2020-02-07,"(481.48, 612.0]",1,1,0
31078.0,2020-02-07,"(742.0, 872.0]",1,2,-1
31079.0,2020-02-07,"(76.866, 361.5]",1,1,0
31079.0,2020-02-07,"(645.0, 928.5]",3,2,1
31079.0,2020-02-07,"(928.5, 1212.0]",2,5,-3
31080.0,2020-02-07,"(935.5, 1119.75]",2,1,1
31080.0,2020-02-07,"(1119.75, 1304.0]",3,1,2
,,,,1.0,
,,,,1.0,
31082.0,2020-02-07,"(1119.991, 1122.25]",1,1,0
31083.0,2020-02-07,"(820.5, 1094.0]",1,1,0
31084.0,2020-02-07,"(741.46, 877.0]",1,2,-1
31084.0,2020-02-07,"(877.0, 1012.0]",2,3,-1
31084.0,2020-02-07,"(1012.0, 1147.0]",1,2,-1
31084.0,2020-02-07,"(1147.0, 1282.0]",1,4,-3
31085.0,2020-02-07,"(395.926, 414.5]",1,1,0
31086.0,2020-02-07,"(410.467, 544.25]",1,2,-1
31086.0,2020-02-07,"(810.75, 944.0]",1,1,0
31087.0,2020-02-07,"(772.5, 1030.0]",1,1,0
31088.0,2020-02-07,"(1087.75, 1107.5]",1,1,0
31088.0,2020-02-07,"(1127.25, 1147.0]",1,1,0
31089.0,2020-02-07,"(476.154, 688.5]",4,6,-2
31089.0,2020-02-07,"(688.5, 900.0]",1,6,-5
31089.0,2020-02-07,"(900.0, 1111.5]",5,16,-11
31089.0,2020-02-07,"(1111.5, 1323.0]",5,9,-4
,,,,1.0,
,,,,1.0,
,,,,1.0,
31091.0,2020-02-07,"(914.0, 1154.5]",5,1,4
31091.0,2020-02-07,"(1154.5, 1395.0]",1,6,-5
31092.0,2020-02-07,"(804.5, 869.25]",1,2,-1
31092.0,2020-02-07,"(869.25, 934.0]",1,1,0
31093.0,2020-02-07,"(911.75, 983.0]",1,1,0
31094.0,2020-02-07,"(769.5, 1026.0]",1,1,0
31095.0,2020-02-07,"(882.75, 1177.0]",1,1,0
,,,,2.0,
31097.0,2020-02-07,"(534.35, 697.5]",1,1,0
31097.0,2020-02-07,"(860.0, 1022.5]",1,3,-2
31097.0,2020-02-07,"(1022.5, 1185.0]",1,2,-1
31098.0,2020-02-07,"(470.288, 649.0]",1,5,-4
31098.0,2020-02-07,"(827.0, 1005.0]",1,1,0
31098.0,2020-02-07,"(1005.0, 1183.0]",6,10,-4
31099.0,2020-02-07,"(972.0, 1141.0]",1,1,0
31100.0,2020-02-07,"(464.171, 672.25]",4,5,-1
31100.0,2020-02-07,"(672.25, 879.5]",6,9,-3
31100.0,2020-02-07,"(879.5, 1086.75]",3,12,-9
31100.0,2020-02-07,"(1086.75, 1294.0]",2,8,-6
31101.0,2020-02-07,"(63.682, 394.5]",1,3,-2
31101.0,2020-02-07,"(394.5, 724.0]",11,21,-10
31101.0,2020-02-07,"(724.0, 1053.5]",32,52,-20
31101.0,2020-02-07,"(1053.5, 1383.0]",28,48,-20
31102.0,2020-02-07,"(373.25, 703.5]",1,2,-1
31102.0,2020-02-07,"(703.5, 1033.75]",4,7,-3
31102.0,2020-02-07,"(1033.75, 1364.0]",10,9,1
31103.0,2020-02-07,"(595.5, 848.0]",3,6,-3
31103.0,2020-02-07,"(848.0, 1100.5]",5,8,-3
31103.0,2020-02-07,"(1100.5, 1353.0]",7,19,-12
31104.0,2020-02-07,"(140.737, 457.75]",2,4,-2
31104.0,2020-02-07,"(457.75, 773.5]",4,16,-12
31104.0,2020-02-07,"(773.5, 1089.25]",18,31,-13
31104.0,2020-02-07,"(1089.25, 1405.0]",20,35,-15
31105.0,2020-02-07,"(474.19, 677.5]",2,2,0
31105.0,2020-02-07,"(677.5, 880.0]",1,5,-4
31105.0,2020-02-07,"(880.0, 1082.5]",1,3,-2
31105.0,2020-02-07,"(1082.5, 1285.0]",1,6,-5
,,,,2.0,
31107.0,2020-02-07,"(434.001, 684.75]",2,15,-13
31107.0,2020-02-07,"(684.75, 934.5]",5,14,-9
31107.0,2020-02-07,"(934.5, 1184.25]",10,21,-11
31107.0,2020-02-07,"(1184.25, 1434.0]",7,10,-3
31108.0,2020-02-07,"(344.015, 591.25]",4,11,-7
31108.0,2020-02-07,"(591.25, 837.5]",5,14,-9
31108.0,2020-02-07,"(837.5, 1083.75]",14,22,-8
31108.0,2020-02-07,"(1083.75, 1330.0]",14,19,-5
31109.0,2020-02-07,"(31.607, 381.25]",2,4,-2
31109.0,2020-02-07,"(381.25, 729.5]",6,13,-7
31109.0,2020-02-07,"(729.5, 1077.75]",20,30,-10
31109.0,2020-02-07,"(1077.75, 1426.0]",9,16,-7
31110.0,2020-02-07,"(362.056, 599.0]",8,18,-10
31110.0,2020-02-07,"(599.0, 835.0]",6,13,-7
31110.0,2020-02-07,"(835.0, 1071.0]",11,22,-11
31110.0,2020-02-07,"(1071.0, 1307.0]",10,23,-13
31111.0,2020-02-07,"(404.281, 584.75]",5,9,-4
31111.0,2020-02-07,"(584.75, 764.5]",1,6,-5
31111.0,2020-02-07,"(764.5, 944.25]",1,3,-2
31111.0,2020-02-07,"(944.25, 1124.0]",12,14,-2
31112.0,2020-02-07,"(316.141, 531.75]",1,3,-2
31112.0,2020-02-07,"(961.25, 1176.0]",5,7,-2
31113.0,2020-02-07,"(69.633, 412.75]",1,5,-4
31113.0,2020-02-07,"(412.75, 754.5]",2,8,-6
31113.0,2020-02-07,"(754.5, 1096.25]",7,12,-5
31113.0,2020-02-07,"(1096.25, 1438.0]",9,14,-5
31114.0,2020-02-07,"(209.819, 506.25]",2,14,-12
31114.0,2020-02-07,"(506.25, 801.5]",4,7,-3
31114.0,2020-02-07,"(801.5, 1096.75]",10,19,-9
31114.0,2020-02-07,"(1096.75, 1392.0]",20,25,-5
31115.0,2020-02-07,"(245.856, 533.0]",3,14,-11
31115.0,2020-02-07,"(819.0, 1105.0]",6,4,2
31115.0,2020-02-07,"(1105.0, 1391.0]",3,8,-5
31116.0,2020-02-07,"(330.933, 598.75]",5,12,-7
31116.0,2020-02-07,"(598.75, 865.5]",3,5,-2
31116.0,2020-02-07,"(865.5, 1132.25]",9,11,-2
31116.0,2020-02-07,"(1132.25, 1399.0]",7,12,-5
31117.0,2020-02-07,"(327.893, 605.75]",2,4,-2
31117.0,2020-02-07,"(605.75, 882.5]",2,8,-6
31117.0,2020-02-07,"(882.5, 1159.25]",7,23,-16
31117.0,2020-02-07,"(1159.25, 1436.0]",10,11,-1
31118.0,2020-02-07,"(688.75, 921.5]",2,3,-1
31118.0,2020-02-07,"(921.5, 1154.25]",9,5,4
31118.0,2020-02-07,"(1154.25, 1387.0]",4,11,-7
31119.0,2020-02-07,"(48.624, 394.0]",2,3,-1
31119.0,2020-02-07,"(394.0, 738.0]",1,5,-4
31119.0,2020-02-07,"(738.0, 1082.0]",6,13,-7
31119.0,2020-02-07,"(1082.0, 1426.0]",14,23,-9
31120.0,2020-02-07,"(464.029, 707.75]",1,3,-2
31120.0,2020-02-07,"(707.75, 950.5]",3,3,0
31120.0,2020-02-07,"(950.5, 1193.25]",8,15,-7
31120.0,2020-02-07,"(1193.25, 1436.0]",6,9,-3
31121.0,2020-02-07,"(389.962, 650.5]",4,8,-4
31121.0,2020-02-07,"(650.5, 910.0]",3,5,-2
31121.0,2020-02-07,"(910.0, 1169.5]",9,17,-8
31122.0,2020-02-07,"(442.148, 656.0]",1,4,-3
31122.0,2020-02-07,"(869.0, 1082.0]",2,3,-1
31122.0,2020-02-07,"(1082.0, 1295.0]",5,8,-3
31123.0,2020-02-07,"(372.191, 575.25]",1,6,-5
31123.0,2020-02-07,"(575.25, 777.5]",1,4,-3
31123.0,2020-02-07,"(777.5, 979.75]",3,7,-4
31123.0,2020-02-07,"(979.75, 1182.0]",10,13,-3
31124.0,2020-02-07,"(312.877, 594.75]",7,13,-6
31124.0,2020-02-07,"(594.75, 875.5]",8,19,-11
31124.0,2020-02-07,"(875.5, 1156.25]",16,38,-22
31124.0,2020-02-07,"(1156.25, 1437.0]",6,28,-22
31125.0,2020-02-07,"(399.036, 641.0]",1,16,-15
31125.0,2020-02-07,"(641.0, 882.0]",3,10,-7
31125.0,2020-02-07,"(882.0, 1123.0]",22,28,-6
31125.0,2020-02-07,"(1123.0, 1364.0]",9,17,-8
31126.0,2020-02-07,"(308.886, 588.5]",4,22,-18
31126.0,2020-02-07,"(588.5, 867.0]",4,9,-5
31126.0,2020-02-07,"(867.0, 1145.5]",16,26,-10
31126.0,2020-02-07,"(1145.5, 1424.0]",4,8,-4
31127.0,2020-02-07,"(88.667, 423.25]",2,2,0
31127.0,2020-02-07,"(423.25, 756.5]",6,10,-4
31127.0,2020-02-07,"(756.5, 1089.75]",12,29,-17
31127.0,2020-02-07,"(1089.75, 1423.0]",3,12,-9
31128.0,2020-02-07,"(46.661, 382.75]",3,4,-1
31128.0,2020-02-07,"(382.75, 717.5]",10,14,-4
31128.0,2020-02-07,"(717.5, 1052.25]",16,31,-15
31128.0,2020-02-07,"(1052.25, 1387.0]",8,15,-7
31129.0,2020-02-07,"(476.307, 650.25]",4,5,-1
31129.0,2020-02-07,"(650.25, 823.5]",2,2,0
31129.0,2020-02-07,"(823.5, 996.75]",9,11,-2
31129.0,2020-02-07,"(996.75, 1170.0]",3,9,-6
31130.0,2020-02-07,"(670.0, 879.0]",1,2,-1
31130.0,2020-02-07,"(879.0, 1088.0]",6,4,2
31130.0,2020-02-07,"(1088.0, 1297.0]",15,10,5
31131.0,2020-02-07,"(791.5, 1014.75]",3,5,-2
31131.0,2020-02-07,"(1014.75, 1238.0]",4,1,3
31200.0,2020-02-07,"(419.034, 661.5]",14,20,-6
31200.0,2020-02-07,"(661.5, 903.0]",10,21,-11
31200.0,2020-02-07,"(903.0, 1144.5]",12,29,-17
31200.0,2020-02-07,"(1144.5, 1386.0]",5,12,-7
31201.0,2020-02-07,"(98.672, 432.0]",8,11,-3
31201.0,2020-02-07,"(432.0, 764.0]",11,27,-16
31201.0,2020-02-07,"(764.0, 1096.0]",32,50,-18
31201.0,2020-02-07,"(1096.0, 1428.0]",19,39,-20
,,,,2.0,
31203.0,2020-02-07,"(355.25, 703.5]",5,2,3
31203.0,2020-02-07,"(703.5, 1051.75]",24,14,10
31203.0,2020-02-07,"(1051.75, 1400.0]",22,35,-13
31204.0,2020-02-07,"(75.689, 404.75]",1,1,0
31204.0,2020-02-07,"(404.75, 732.5]",9,11,-2
31204.0,2020-02-07,"(732.5, 1060.25]",8,19,-11
31204.0,2020-02-07,"(1060.25, 1388.0]",6,16,-10
31205.0,2020-02-07,"(169.917, 441.75]",3,4,-1
31205.0,2020-02-07,"(441.75, 712.5]",9,12,-3
31205.0,2020-02-07,"(712.5, 983.25]",4,12,-8
31205.0,2020-02-07,"(983.25, 1254.0]",3,21,-18
31206.0,2020-02-07,"(408.322, 578.5]",2,2,0
31206.0,2020-02-07,"(578.5, 748.0]",1,2,-1
31207.0,2020-02-07,"(864.5, 1113.25]",4,1,3
31207.0,2020-02-07,"(1113.25, 1362.0]",1,1,0
31208.0,2020-02-07,"(445.111, 668.25]",4,5,-1
31208.0,2020-02-07,"(668.25, 890.5]",1,2,-1
31208.0,2020-02-07,"(890.5, 1112.75]",2,8,-6
31208.0,2020-02-07,"(1112.75, 1335.0]",3,3,0
31209.0,2020-02-07,"(993.5, 1173.75]",4,2,2
31209.0,2020-02-07,"(1173.75, 1354.0]",2,5,-3
31211.0,2020-02-07,"(523.264, 708.0]",5,6,-1
31211.0,2020-02-07,"(892.0, 1076.0]",1,3,-2
31211.0,2020-02-07,"(1076.0, 1260.0]",4,6,-2
31212.0,2020-02-07,"(322.933, 590.75]",11,17,-6
31212.0,2020-02-07,"(590.75, 857.5]",11,19,-8
31212.0,2020-02-07,"(857.5, 1124.25]",11,15,-4
31213.0,2020-02-07,"(281.937, 548.75]",12,15,-3
31213.0,2020-02-07,"(548.75, 814.5]",7,17,-10
31213.0,2020-02-07,"(814.5, 1080.25]",10,16,-6
31213.0,2020-02-07,"(1080.25, 1346.0]",3,10,-7
31214.0,2020-02-07,"(295.863, 581.25]",4,19,-15
31214.0,2020-02-07,"(581.25, 865.5]",6,15,-9
31214.0,2020-02-07,"(865.5, 1149.75]",23,31,-8
31214.0,2020-02-07,"(1149.75, 1434.0]",12,22,-10
31215.0,2020-02-07,"(383.052, 621.0]",9,10,-1
31215.0,2020-02-07,"(621.0, 858.0]",5,8,-3
31215.0,2020-02-07,"(858.0, 1095.0]",2,9,-7
31215.0,2020-02-07,"(1095.0, 1332.0]",5,10,-5
31216.0,2020-02-07,"(329.041, 569.75]",4,5,-1
31216.0,2020-02-07,"(569.75, 809.5]",4,5,-1
31216.0,2020-02-07,"(809.5, 1049.25]",10,24,-14
31216.0,2020-02-07,"(1049.25, 1289.0]",2,9,-7
31217.0,2020-02-07,"(505.144, 720.0]",4,8,-4
31217.0,2020-02-07,"(934.0, 1148.0]",2,5,-3
31217.0,2020-02-07,"(1148.0, 1362.0]",1,2,-1
31218.0,2020-02-07,"(374.22, 570.0]",4,13,-9
31218.0,2020-02-07,"(570.0, 765.0]",1,2,-1
31218.0,2020-02-07,"(765.0, 960.0]",7,10,-3
31218.0,2020-02-07,"(960.0, 1155.0]",2,5,-3
31219.0,2020-02-07,"(382.26, 568.0]",3,3,0
31219.0,2020-02-07,"(568.0, 753.0]",2,3,-1
31219.0,2020-02-07,"(753.0, 938.0]",8,13,-5
31219.0,2020-02-07,"(938.0, 1123.0]",6,14,-8
31220.0,2020-02-07,"(287.952, 551.0]",7,7,0
31220.0,2020-02-07,"(551.0, 813.0]",2,4,-2
31220.0,2020-02-07,"(1075.0, 1337.0]",1,15,-14
31221.0,2020-02-07,"(388.25, 691.5]",9,1,8
31221.0,2020-02-07,"(691.5, 994.75]",12,11,1
31221.0,2020-02-07,"(994.75, 1298.0]",4,20,-16
31222.0,2020-02-07,"(479.337, 645.75]",3,3,0
31222.0,2020-02-07,"(645.75, 811.5]",3,4,-1
31222.0,2020-02-07,"(811.5, 977.25]",1,5,-4
31222.0,2020-02-07,"(977.25, 1143.0]",6,12,-6
31223.0,2020-02-07,"(67.66, 404.0]",1,2,-1
31223.0,2020-02-07,"(404.0, 739.0]",10,17,-7
31223.0,2020-02-07,"(739.0, 1074.0]",8,22,-14
31223.0,2020-02-07,"(1074.0, 1409.0]",8,19,-11
31224.0,2020-02-07,"(446.274, 628.5]",6,6,0
31224.0,2020-02-07,"(628.5, 810.0]",6,9,-3
31224.0,2020-02-07,"(810.0, 991.5]",1,7,-6
31224.0,2020-02-07,"(991.5, 1173.0]",5,13,-8
31225.0,2020-02-07,"(380.162, 590.5]",3,9,-6
31225.0,2020-02-07,"(590.5, 800.0]",1,2,-1
31225.0,2020-02-07,"(800.0, 1009.5]",5,8,-3
31225.0,2020-02-07,"(1009.5, 1219.0]",3,8,-5
31226.0,2020-02-07,"(298.162, 508.5]",1,3,-2
31226.0,2020-02-07,"(508.5, 718.0]",1,3,-2
31226.0,2020-02-07,"(718.0, 927.5]",2,3,-1
31226.0,2020-02-07,"(927.5, 1137.0]",7,14,-7
31227.0,2020-02-07,"(443.06, 679.0]",10,11,-1
31227.0,2020-02-07,"(679.0, 914.0]",13,18,-5
31227.0,2020-02-07,"(914.0, 1149.0]",2,13,-11
31227.0,2020-02-07,"(1149.0, 1384.0]",1,3,-2
31228.0,2020-02-07,"(421.025, 665.75]",6,6,0
31228.0,2020-02-07,"(665.75, 909.5]",15,26,-11
31228.0,2020-02-07,"(909.5, 1153.25]",18,29,-11
31228.0,2020-02-07,"(1153.25, 1397.0]",3,8,-5
31229.0,2020-02-07,"(55.624, 401.0]",3,6,-3
31229.0,2020-02-07,"(401.0, 745.0]",10,32,-22
31229.0,2020-02-07,"(745.0, 1089.0]",29,49,-20
31229.0,2020-02-07,"(1089.0, 1433.0]",16,31,-15
31230.0,2020-02-07,"(392.074, 624.5]",15,18,-3
31230.0,2020-02-07,"(624.5, 856.0]",8,14,-6
31230.0,2020-02-07,"(856.0, 1087.5]",9,28,-19
31230.0,2020-02-07,"(1087.5, 1319.0]",7,20,-13
31231.0,2020-02-07,"(617.25, 823.0]",1,1,0
31232.0,2020-02-07,"(272.856, 560.0]",9,14,-5
31232.0,2020-02-07,"(560.0, 846.0]",5,9,-4
31232.0,2020-02-07,"(846.0, 1132.0]",14,24,-10
31232.0,2020-02-07,"(1132.0, 1418.0]",3,10,-7
31233.0,2020-02-07,"(377.0, 690.0]",12,1,11
31233.0,2020-02-07,"(690.0, 1003.0]",16,15,1
31233.0,2020-02-07,"(1003.0, 1316.0]",14,26,-12
31234.0,2020-02-07,"(422.047, 661.25]",4,6,-2
31234.0,2020-02-07,"(661.25, 899.5]",13,16,-3
31234.0,2020-02-07,"(899.5, 1137.75]",14,26,-12
31234.0,2020-02-07,"(1137.75, 1376.0]",4,11,-7
31235.0,2020-02-07,"(654.355, 816.25]",2,2,0
31235.0,2020-02-07,"(977.5, 1138.75]",2,1,1
31235.0,2020-02-07,"(1138.75, 1300.0]",1,4,-3
31236.0,2020-02-07,"(564.175, 771.25]",13,18,-5
31236.0,2020-02-07,"(771.25, 977.5]",5,12,-7
31236.0,2020-02-07,"(977.5, 1183.75]",4,22,-18
31237.0,2020-02-07,"(172.822, 468.5]",3,5,-2
31237.0,2020-02-07,"(468.5, 763.0]",8,14,-6
31237.0,2020-02-07,"(763.0, 1057.5]",15,27,-12
31237.0,2020-02-07,"(1057.5, 1352.0]",8,17,-9
31238.0,2020-02-07,"(73.701, 399.75]",1,3,-2
31238.0,2020-02-07,"(399.75, 724.5]",8,9,-1
31238.0,2020-02-07,"(724.5, 1049.25]",10,28,-18
31238.0,2020-02-07,"(1049.25, 1374.0]",5,14,-9
31239.0,2020-02-07,"(199.797, 501.75]",7,9,-2
31239.0,2020-02-07,"(501.75, 802.5]",10,17,-7
31239.0,2020-02-07,"(802.5, 1103.25]",12,28,-16
31239.0,2020-02-07,"(1103.25, 1404.0]",5,12,-7
31240.0,2020-02-07,"(905.955, 917.25]",1,1,0
31241.0,2020-02-07,"(53.626, 398.5]",1,2,-1
31241.0,2020-02-07,"(398.5, 742.0]",17,37,-20
31241.0,2020-02-07,"(742.0, 1085.5]",8,20,-12
31241.0,2020-02-07,"(1085.5, 1429.0]",18,37,-19
31242.0,2020-02-07,"(428.103, 653.25]",7,9,-2
31242.0,2020-02-07,"(653.25, 877.5]",4,10,-6
31242.0,2020-02-07,"(877.5, 1101.75]",7,24,-17
31242.0,2020-02-07,"(1101.75, 1326.0]",1,6,-5
31243.0,2020-02-07,"(374.255, 561.25]",7,12,-5
31243.0,2020-02-07,"(561.25, 747.5]",2,3,-1
31243.0,2020-02-07,"(747.5, 933.75]",4,8,-4
31244.0,2020-02-07,"(486.13, 704.5]",2,4,-2
31244.0,2020-02-07,"(704.5, 922.0]",4,9,-5
31244.0,2020-02-07,"(922.0, 1139.5]",3,8,-5
31244.0,2020-02-07,"(1139.5, 1357.0]",4,6,-2
31245.0,2020-02-07,"(462.025, 706.75]",7,14,-7
31245.0,2020-02-07,"(706.75, 950.5]",2,8,-6
31245.0,2020-02-07,"(950.5, 1194.25]",17,31,-14
31245.0,2020-02-07,"(1194.25, 1438.0]",3,4,-1
31246.0,2020-02-07,"(407.981, 663.75]",5,8,-3
31246.0,2020-02-07,"(663.75, 918.5]",10,15,-5
31246.0,2020-02-07,"(918.5, 1173.25]",12,22,-10
31246.0,2020-02-07,"(1173.25, 1428.0]",3,7,-4
31247.0,2020-02-07,"(468.334, 635.5]",2,3,-1
31247.0,2020-02-07,"(635.5, 802.0]",2,3,-1
31247.0,2020-02-07,"(802.0, 968.5]",3,4,-1
31247.0,2020-02-07,"(968.5, 1135.0]",4,13,-9
31248.0,2020-02-07,"(412.15, 625.5]",3,4,-1
31248.0,2020-02-07,"(625.5, 838.0]",7,13,-6
31248.0,2020-02-07,"(838.0, 1050.5]",9,17,-8
31248.0,2020-02-07,"(1050.5, 1263.0]",4,6,-2
31249.0,2020-02-07,"(442.363, 602.25]",2,3,-1
31249.0,2020-02-07,"(761.5, 920.75]",4,7,-3
31249.0,2020-02-07,"(920.75, 1080.0]",2,6,-4
31250.0,2020-02-07,"(71.782, 377.5]",1,2,-1
31250.0,2020-02-07,"(377.5, 682.0]",8,10,-2
31250.0,2020-02-07,"(682.0, 986.5]",6,12,-6
31250.0,2020-02-07,"(986.5, 1291.0]",3,18,-15
31251.0,2020-02-07,"(429.0, 745.0]",14,2,12
31251.0,2020-02-07,"(745.0, 1061.0]",9,28,-19
31251.0,2020-02-07,"(1061.0, 1377.0]",6,26,-20
31252.0,2020-02-07,"(491.369, 649.75]",6,6,0
31252.0,2020-02-07,"(649.75, 807.5]",2,5,-3
31252.0,2020-02-07,"(807.5, 965.25]",2,6,-4
31253.0,2020-02-07,"(408.213, 605.75]",6,6,0
31253.0,2020-02-07,"(605.75, 802.5]",3,5,-2
31253.0,2020-02-07,"(802.5, 999.25]",4,9,-5
31253.0,2020-02-07,"(999.25, 1196.0]",2,15,-13
31254.0,2020-02-07,"(417.06, 653.0]",9,10,-1
31254.0,2020-02-07,"(653.0, 888.0]",10,18,-8
31254.0,2020-02-07,"(888.0, 1123.0]",3,13,-10
31254.0,2020-02-07,"(1123.0, 1358.0]",2,4,-2
31255.0,2020-02-07,"(366.176, 573.0]",7,7,0
31255.0,2020-02-07,"(573.0, 779.0]",3,5,-2
31255.0,2020-02-07,"(779.0, 985.0]",2,5,-3
31255.0,2020-02-07,"(985.0, 1191.0]",4,11,-7
31256.0,2020-02-07,"(266.989, 520.75]",7,7,0
31256.0,2020-02-07,"(520.75, 773.5]",3,9,-6
31256.0,2020-02-07,"(773.5, 1026.25]",3,8,-5
31256.0,2020-02-07,"(1026.25, 1279.0]",7,15,-8
31257.0,2020-02-07,"(332.991, 586.25]",11,15,-4
31257.0,2020-02-07,"(586.25, 838.5]",6,14,-8
31257.0,2020-02-07,"(838.5, 1090.75]",15,33,-18
31257.0,2020-02-07,"(1090.75, 1343.0]",8,20,-12
31258.0,2020-02-07,"(371.003, 621.25]",3,5,-2
31258.0,2020-02-07,"(621.25, 870.5]",4,6,-2
31258.0,2020-02-07,"(870.5, 1119.75]",7,22,-15
31258.0,2020-02-07,"(1119.75, 1369.0]",1,2,-1
31259.0,2020-02-07,"(430.141, 645.75]",4,4,0
31259.0,2020-02-07,"(1075.25, 1290.0]",1,4,-3
31260.0,2020-02-07,"(491.252, 679.0]",6,7,-1
31260.0,2020-02-07,"(866.0, 1053.0]",4,2,2
31260.0,2020-02-07,"(1053.0, 1240.0]",1,11,-10
31261.0,2020-02-07,"(385.065, 619.75]",5,5,0
31261.0,2020-02-07,"(619.75, 853.5]",2,3,-1
31261.0,2020-02-07,"(853.5, 1087.25]",2,14,-12
31261.0,2020-02-07,"(1087.25, 1321.0]",1,3,-2
31262.0,2020-02-07,"(454.225, 648.75]",4,4,0
31262.0,2020-02-07,"(648.75, 842.5]",2,4,-2
31262.0,2020-02-07,"(842.5, 1036.25]",5,12,-7
31262.0,2020-02-07,"(1036.25, 1230.0]",2,11,-9
31263.0,2020-02-07,"(446.114, 668.5]",6,8,-2
31263.0,2020-02-07,"(668.5, 890.0]",6,17,-11
31263.0,2020-02-07,"(890.0, 1111.5]",10,31,-21
31263.0,2020-02-07,"(1111.5, 1333.0]",3,3,0
31264.0,2020-02-07,"(419.306, 593.5]",4,5,-1
31264.0,2020-02-07,"(593.5, 767.0]",2,4,-2
31264.0,2020-02-07,"(767.0, 940.5]",4,5,-1
31264.0,2020-02-07,"(940.5, 1114.0]",7,21,-14
31265.0,2020-02-07,"(360.957, 622.75]",5,13,-8
31265.0,2020-02-07,"(622.75, 883.5]",12,27,-15
31265.0,2020-02-07,"(883.5, 1144.25]",20,36,-16
31265.0,2020-02-07,"(1144.25, 1405.0]",8,13,-5
31266.0,2020-02-07,"(291.039, 532.25]",3,14,-11
31266.0,2020-02-07,"(532.25, 772.5]",6,9,-3
31266.0,2020-02-07,"(772.5, 1012.75]",10,22,-12
31266.0,2020-02-07,"(1012.75, 1253.0]",23,36,-13
31267.0,2020-02-07,"(384.25, 715.5]",10,1,9
31267.0,2020-02-07,"(715.5, 1046.75]",14,20,-6
31267.0,2020-02-07,"(1046.75, 1378.0]",20,30,-10
31268.0,2020-02-07,"(335.993, 588.75]",6,17,-11
31268.0,2020-02-07,"(588.75, 840.5]",5,6,-1
31268.0,2020-02-07,"(840.5, 1092.25]",19,25,-6
31268.0,2020-02-07,"(1092.25, 1344.0]",16,24,-8
31269.0,2020-02-07,"(465.157, 676.75]",7,9,-2
31269.0,2020-02-07,"(676.75, 887.5]",5,9,-4
31269.0,2020-02-07,"(887.5, 1098.25]",4,10,-6
31269.0,2020-02-07,"(1098.25, 1309.0]",2,8,-6
31270.0,2020-02-07,"(265.987, 520.25]",3,5,-2
31270.0,2020-02-07,"(520.25, 773.5]",4,5,-1
31270.0,2020-02-07,"(773.5, 1026.75]",6,14,-8
31270.0,2020-02-07,"(1026.75, 1280.0]",5,7,-2
31271.0,2020-02-07,"(377.028, 621.0]",9,9,0
31271.0,2020-02-07,"(621.0, 864.0]",5,13,-8
31271.0,2020-02-07,"(864.0, 1107.0]",3,11,-8
31271.0,2020-02-07,"(1107.0, 1350.0]",3,11,-8
31272.0,2020-02-07,"(301.011, 549.25]",7,8,-1
31272.0,2020-02-07,"(549.25, 796.5]",5,8,-3
31272.0,2020-02-07,"(796.5, 1043.75]",6,11,-5
31272.0,2020-02-07,"(1043.75, 1291.0]",3,10,-7
31273.0,2020-02-07,"(419.489, 547.75]",2,3,-1
31273.0,2020-02-07,"(675.5, 803.25]",1,1,0
31274.0,2020-02-07,"(390.021, 635.75]",4,4,0
31274.0,2020-02-07,"(635.75, 880.5]",5,9,-4
31274.0,2020-02-07,"(880.5, 1125.25]",4,12,-8
31274.0,2020-02-07,"(1125.25, 1370.0]",7,10,-3
31275.0,2020-02-07,"(337.949, 601.75]",1,1,0
31276.0,2020-02-07,"(397.021, 642.75]",8,10,-2
31276.0,2020-02-07,"(642.75, 887.5]",5,9,-4
31276.0,2020-02-07,"(887.5, 1132.25]",3,16,-13
31276.0,2020-02-07,"(1132.25, 1377.0]",2,6,-4
31277.0,2020-02-07,"(277.122, 497.5]",12,12,0
31277.0,2020-02-07,"(717.0, 936.5]",5,11,-6
31277.0,2020-02-07,"(936.5, 1156.0]",5,26,-21
31278.0,2020-02-07,"(96.68, 428.0]",1,2,-1
31278.0,2020-02-07,"(428.0, 758.0]",8,17,-9
31278.0,2020-02-07,"(758.0, 1088.0]",16,23,-7
31278.0,2020-02-07,"(1088.0, 1418.0]",12,22,-10
31279.0,2020-02-07,"(405.204, 605.0]",9,11,-2
31279.0,2020-02-07,"(605.0, 804.0]",2,5,-3
31279.0,2020-02-07,"(804.0, 1003.0]",3,8,-5
31279.0,2020-02-07,"(1003.0, 1202.0]",1,20,-19
31280.0,2020-02-07,"(363.997, 615.75]",3,12,-9
31280.0,2020-02-07,"(615.75, 866.5]",5,10,-5
31280.0,2020-02-07,"(866.5, 1117.25]",10,22,-12
31280.0,2020-02-07,"(1117.25, 1368.0]",9,11,-2
31000.0,2020-02-08,"(593.721, 663.75]",1,1,0
31001.0,2020-02-08,"(691.47, 824.5]",3,5,-2
31001.0,2020-02-08,"(957.0, 1089.5]",2,3,-1
31001.0,2020-02-08,"(1089.5, 1222.0]",2,4,-2
31002.0,2020-02-08,"(476.258, 662.5]",3,5,-2
31002.0,2020-02-08,"(662.5, 848.0]",4,7,-3
31002.0,2020-02-08,"(1033.5, 1219.0]",1,1,0
31003.0,2020-02-08,"(582.494, 709.5]",1,2,-1
31003.0,2020-02-08,"(962.5, 1089.0]",1,1,0
,,,,1.0,
,,,,1.0,
31005.0,2020-02-08,"(617.41, 765.5]",3,6,-3
31005.0,2020-02-08,"(765.5, 913.0]",2,4,-2
31005.0,2020-02-08,"(1060.5, 1208.0]",1,1,0
31006.0,2020-02-08,"(648.234, 840.5]",5,11,-6
31006.0,2020-02-08,"(840.5, 1032.0]",5,8,-3
31006.0,2020-02-08,"(1032.0, 1223.5]",1,1,0
31007.0,2020-02-08,"(523.306, 697.5]",1,4,-3
31007.0,2020-02-08,"(697.5, 871.0]",2,3,-1
31007.0,2020-02-08,"(871.0, 1044.5]",1,4,-3
31007.0,2020-02-08,"(1044.5, 1218.0]",1,3,-2
,,,,2.0,
31010.0,2020-02-08,"(689.768, 748.0]",1,2,-1
31010.0,2020-02-08,"(864.0, 922.0]",2,4,-2
31011.0,2020-02-08,"(421.36, 582.0]",1,1,0
31011.0,2020-02-08,"(582.0, 742.0]",2,4,-2
,,,,2.0,
31013.0,2020-02-08,"(530.109, 753.75]",1,1,0
31013.0,2020-02-08,"(976.5, 1199.25]",1,2,-1
31013.0,2020-02-08,"(1199.25, 1422.0]",1,1,0
31014.0,2020-02-08,"(47.699, 374.25]",1,1,0
31014.0,2020-02-08,"(374.25, 699.5]",6,10,-4
31014.0,2020-02-08,"(699.5, 1024.75]",5,13,-8
31014.0,2020-02-08,"(1024.75, 1350.0]",1,3,-2
31015.0,2020-02-08,"(624.5, 912.75]",3,1,2
31015.0,2020-02-08,"(912.75, 1201.0]",7,6,1
31016.0,2020-02-08,"(461.07, 694.5]",4,6,-2
31016.0,2020-02-08,"(694.5, 927.0]",1,3,-2
31016.0,2020-02-08,"(927.0, 1159.5]",5,8,-3
31016.0,2020-02-08,"(1159.5, 1392.0]",1,1,0
31017.0,2020-02-08,"(725.336, 892.0]",3,5,-2
31017.0,2020-02-08,"(892.0, 1058.0]",2,5,-3
,,,,1.0,
,,,,1.0,
31019.0,2020-02-08,"(772.449, 910.75]",3,4,-1
31020.0,2020-02-08,"(738.39, 891.5]",2,4,-2
31020.0,2020-02-08,"(891.5, 1044.0]",3,3,0
31020.0,2020-02-08,"(1196.5, 1349.0]",1,3,-2
31021.0,2020-02-08,"(466.268, 650.0]",3,4,-1
31021.0,2020-02-08,"(833.0, 1016.0]",1,1,0
31021.0,2020-02-08,"(1016.0, 1199.0]",1,1,0
31022.0,2020-02-08,"(57.645, 397.75]",1,2,-1
31022.0,2020-02-08,"(397.75, 736.5]",3,5,-2
31022.0,2020-02-08,"(736.5, 1075.25]",6,11,-5
31022.0,2020-02-08,"(1075.25, 1414.0]",2,6,-4
31023.0,2020-02-08,"(443.227, 637.25]",3,3,0
31023.0,2020-02-08,"(637.25, 830.5]",4,6,-2
31023.0,2020-02-08,"(830.5, 1023.75]",3,5,-2
31023.0,2020-02-08,"(1023.75, 1217.0]",1,2,-1
31024.0,2020-02-08,"(449.311, 622.25]",1,2,-1
31024.0,2020-02-08,"(622.25, 794.5]",2,3,-1
31024.0,2020-02-08,"(794.5, 966.75]",2,3,-1
31024.0,2020-02-08,"(966.75, 1139.0]",1,2,-1
31025.0,2020-02-08,"(927.5, 961.0]",2,1,1
31026.0,2020-02-08,"(556.508, 680.0]",1,1,0
31026.0,2020-02-08,"(680.0, 803.0]",2,2,0
31027.0,2020-02-08,"(532.097, 758.75]",2,4,-2
31027.0,2020-02-08,"(984.5, 1210.25]",1,1,0
31027.0,2020-02-08,"(1210.25, 1436.0]",2,3,-1
31028.0,2020-02-08,"(729.622, 824.5]",1,2,-1
31029.0,2020-02-08,"(683.75, 901.5]",2,5,-3
31029.0,2020-02-08,"(901.5, 1119.25]",3,4,-1
31029.0,2020-02-08,"(1119.25, 1337.0]",4,7,-3
31030.0,2020-02-08,"(454.109, 677.75]",1,6,-5
31030.0,2020-02-08,"(900.5, 1123.25]",1,3,-2
31031.0,2020-02-08,"(559.2, 760.0]",1,3,-2
31031.0,2020-02-08,"(760.0, 960.0]",2,5,-3
31031.0,2020-02-08,"(1160.0, 1360.0]",1,3,-2
31032.0,2020-02-08,"(867.5, 944.0]",1,1,0
31033.0,2020-02-08,"(933.733, 1000.75]",1,2,-1
31033.0,2020-02-08,"(1134.25, 1201.0]",1,2,-1
31034.0,2020-02-08,"(875.548, 989.0]",2,4,-2
31034.0,2020-02-08,"(989.0, 1102.0]",1,1,0
,,,,1.0,
,,,,1.0,
31036.0,2020-02-08,"(844.75, 956.0]",1,4,-3
31037.0,2020-02-08,"(420.352, 583.0]",3,3,0
31037.0,2020-02-08,"(745.0, 907.0]",6,2,4
31037.0,2020-02-08,"(907.0, 1069.0]",2,11,-9
31038.0,2020-02-08,"(532.474, 664.5]",2,2,0
31038.0,2020-02-08,"(796.0, 927.5]",1,2,-1
31039.0,2020-02-08,"(517.232, 710.0]",3,4,-1
31039.0,2020-02-08,"(710.0, 902.0]",4,11,-7
31039.0,2020-02-08,"(902.0, 1094.0]",1,4,-3
31039.0,2020-02-08,"(1094.0, 1286.0]",4,6,-2
31040.0,2020-02-08,"(741.5, 930.0]",2,1,1
31041.0,2020-02-08,"(582.376, 739.0]",1,3,-2
31041.0,2020-02-08,"(1051.0, 1207.0]",3,1,2
31042.0,2020-02-08,"(573.176, 780.0]",4,8,-4
31042.0,2020-02-08,"(780.0, 986.0]",4,4,0
31042.0,2020-02-08,"(986.0, 1192.0]",1,3,-2
31043.0,2020-02-08,"(157.266, 341.5]",1,1,0
31044.0,2020-02-08,"(99.063, 334.25]",1,2,-1
31044.0,2020-02-08,"(334.25, 568.5]",1,2,-1
31044.0,2020-02-08,"(802.75, 1037.0]",2,3,-1
31045.0,2020-02-08,"(1225.75, 1409.0]",1,1,0
31046.0,2020-02-08,"(704.0, 800.5]",1,1,0
31047.0,2020-02-08,"(354.922, 625.5]",1,3,-2
31047.0,2020-02-08,"(625.5, 895.0]",1,6,-5
31047.0,2020-02-08,"(895.0, 1164.5]",4,8,-4
31047.0,2020-02-08,"(1164.5, 1434.0]",2,7,-5
,,,,1.0,
,,,,1.0,
31049.0,2020-02-08,"(772.5, 884.75]",2,1,1
31049.0,2020-02-08,"(884.75, 997.0]",1,1,0
31050.0,2020-02-08,"(924.75, 993.0]",1,3,-2
31051.0,2020-02-08,"(754.75, 763.5]",1,2,-1
31051.0,2020-02-08,"(763.5, 772.25]",1,1,0
31052.0,2020-02-08,"(738.25, 901.5]",1,1,0
31052.0,2020-02-08,"(901.5, 1064.75]",2,2,0
31052.0,2020-02-08,"(1064.75, 1228.0]",3,3,0
31053.0,2020-02-08,"(796.789, 849.75]",1,2,-1
,,,,2.0,
31055.0,2020-02-08,"(279.75, 559.5]",1,1,0
31055.0,2020-02-08,"(839.25, 1119.0]",1,1,0
31056.0,2020-02-08,"(938.5, 1086.0]",2,2,0
,,,,2.0,
,,,,2.0,
31059.0,2020-02-08,"(424.397, 575.75]",1,1,0
31059.0,2020-02-08,"(575.75, 726.5]",2,2,0
31059.0,2020-02-08,"(726.5, 877.25]",1,1,0
31059.0,2020-02-08,"(877.25, 1028.0]",2,5,-3
31060.0,2020-02-08,"(506.43, 649.5]",1,1,0
31060.0,2020-02-08,"(649.5, 792.0]",1,2,-1
31060.0,2020-02-08,"(934.5, 1077.0]",1,2,-1
31061.0,2020-02-08,"(525.311, 698.25]",1,1,0
31061.0,2020-02-08,"(1042.75, 1215.0]",1,2,-1
31062.0,2020-02-08,"(472.54, 588.0]",4,5,-1
31062.0,2020-02-08,"(703.0, 818.0]",3,1,2
31062.0,2020-02-08,"(818.0, 933.0]",1,9,-8
31063.0,2020-02-08,"(785.25, 1047.0]",1,1,0
31064.0,2020-02-08,"(359.5, 595.0]",4,1,3
31064.0,2020-02-08,"(595.0, 830.5]",7,8,-1
31064.0,2020-02-08,"(830.5, 1066.0]",5,13,-8
31065.0,2020-02-08,"(817.849, 855.75]",1,2,-1
31065.0,2020-02-08,"(931.25, 969.0]",1,1,0
31066.0,2020-02-08,"(807.25, 896.5]",2,1,1
31067.0,2020-02-08,"(830.75, 906.0]",2,1,1
31068.0,2020-02-08,"(80.994, 333.5]",1,1,0
31068.0,2020-02-08,"(836.5, 1088.0]",3,1,2
31069.0,2020-02-08,"(831.75, 971.0]",5,1,4
31070.0,2020-02-08,"(588.532, 706.0]",2,3,-1
31070.0,2020-02-08,"(823.0, 940.0]",1,1,0
31070.0,2020-02-08,"(940.0, 1057.0]",1,2,-1
31071.0,2020-02-08,"(415.205, 614.75]",1,4,-3
31071.0,2020-02-08,"(614.75, 813.5]",3,3,0
31071.0,2020-02-08,"(813.5, 1012.25]",2,6,-4
31071.0,2020-02-08,"(1012.25, 1211.0]",4,5,-1
,,,,1.0,
,,,,1.0,
31073.0,2020-02-08,"(828.893, 855.75]",1,2,-1
31074.0,2020-02-08,"(590.0, 743.0]",1,1,0
31074.0,2020-02-08,"(743.0, 896.0]",1,1,0
31074.0,2020-02-08,"(896.0, 1049.0]",1,1,0
31075.0,2020-02-08,"(838.999, 839.25]",1,1,0
31076.0,2020-02-08,"(659.25, 879.0]",4,1,3
31077.0,2020-02-08,"(48.956, 311.0]",1,1,0
31077.0,2020-02-08,"(572.0, 833.0]",3,6,-3
31077.0,2020-02-08,"(833.0, 1094.0]",11,15,-4
,,,,2.0,
31079.0,2020-02-08,"(21.603, 372.25]",2,2,0
31079.0,2020-02-08,"(721.5, 1070.75]",1,4,-3
31079.0,2020-02-08,"(1070.75, 1420.0]",3,3,0
31080.0,2020-02-08,"(772.0, 926.0]",4,4,0
31080.0,2020-02-08,"(926.0, 1080.0]",1,1,0
,,,,1.0,
,,,,1.0,
,,,,1.0,
,,,,1.0,
,,,,1.0,
,,,,2.0,
,,,,2.0,
31084.0,2020-02-08,"(681.278, 862.5]",2,3,-1
31085.0,2020-02-08,"(751.25, 947.5]",1,2,-1
31085.0,2020-02-08,"(1143.75, 1340.0]",1,1,0
31086.0,2020-02-08,"(427.193, 629.75]",2,2,0
31086.0,2020-02-08,"(629.75, 831.5]",3,6,-3
31086.0,2020-02-08,"(831.5, 1033.25]",1,1,0
31086.0,2020-02-08,"(1033.25, 1235.0]",2,5,-3
31087.0,2020-02-08,"(-0.896, 224.0]",1,2,-1
31087.0,2020-02-08,"(672.0, 896.0]",1,1,0
31088.0,2020-02-08,"(850.0, 890.0]",1,1,0
31089.0,2020-02-08,"(576.0, 855.0]",2,2,0
31089.0,2020-02-08,"(855.0, 1134.0]",7,6,1
31090.0,2020-02-08,"(530.475, 662.25]",1,1,0
31090.0,2020-02-08,"(662.25, 793.5]",2,4,-2
31090.0,2020-02-08,"(924.75, 1056.0]",1,1,0
31091.0,2020-02-08,"(742.5, 794.0]",2,2,0
31092.0,2020-02-08,"(582.725, 651.75]",1,2,-1
31093.0,2020-02-08,"(886.5, 973.25]",1,1,0
31093.0,2020-02-08,"(973.25, 1060.0]",1,2,-1
,,,,2.0,
,,,,1.0,
,,,,1.0,
31096.0,2020-02-08,"(544.44, 685.0]",1,3,-2
31096.0,2020-02-08,"(825.0, 965.0]",1,1,0
31096.0,2020-02-08,"(965.0, 1105.0]",1,2,-1
31097.0,2020-02-08,"(722.563, 832.25]",4,5,-1
31097.0,2020-02-08,"(1050.75, 1160.0]",1,1,0
31098.0,2020-02-08,"(349.305, 523.75]",1,2,-1
31098.0,2020-02-08,"(523.75, 697.5]",2,4,-2
31098.0,2020-02-08,"(697.5, 871.25]",1,2,-1
31098.0,2020-02-08,"(871.25, 1045.0]",3,3,0
31099.0,2020-02-08,"(659.638, 750.5]",1,1,0
31099.0,2020-02-08,"(931.5, 1022.0]",1,1,0
31100.0,2020-02-08,"(347.276, 529.0]",2,2,0
31100.0,2020-02-08,"(529.0, 710.0]",3,4,-1
31100.0,2020-02-08,"(710.0, 891.0]",2,3,-1
31100.0,2020-02-08,"(891.0, 1072.0]",2,8,-6
31101.0,2020-02-08,"(-0.407, 352.75]",6,7,-1
31101.0,2020-02-08,"(352.75, 704.5]",26,43,-17
31101.0,2020-02-08,"(704.5, 1056.25]",50,77,-27
31101.0,2020-02-08,"(1056.25, 1408.0]",15,33,-18
31102.0,2020-02-08,"(34.634, 377.5]",2,4,-2
31102.0,2020-02-08,"(377.5, 719.0]",2,13,-11
31102.0,2020-02-08,"(719.0, 1060.5]",9,27,-18
31102.0,2020-02-08,"(1060.5, 1402.0]",10,17,-7
31103.0,2020-02-08,"(7.576, 365.0]",3,3,0
31103.0,2020-02-08,"(365.0, 721.0]",3,20,-17
31103.0,2020-02-08,"(721.0, 1077.0]",10,32,-22
31103.0,2020-02-08,"(1077.0, 1433.0]",9,23,-14
31104.0,2020-02-08,"(5.574, 363.5]",1,5,-4
31104.0,2020-02-08,"(363.5, 720.0]",6,18,-12
31104.0,2020-02-08,"(720.0, 1076.5]",20,43,-23
31104.0,2020-02-08,"(1076.5, 1433.0]",14,31,-17
31105.0,2020-02-08,"(561.188, 765.0]",7,13,-6
31105.0,2020-02-08,"(765.0, 968.0]",1,1,0
31105.0,2020-02-08,"(968.0, 1171.0]",1,6,-5
31105.0,2020-02-08,"(1171.0, 1374.0]",3,8,-5
31106.0,2020-02-08,"(794.406, 943.5]",1,3,-2
31106.0,2020-02-08,"(943.5, 1092.0]",3,8,-5
31106.0,2020-02-08,"(1092.0, 1240.5]",1,1,0
31106.0,2020-02-08,"(1240.5, 1389.0]",1,2,-1
31107.0,2020-02-08,"(65.627, 410.25]",3,4,-1
31107.0,2020-02-08,"(410.25, 753.5]",11,27,-16
31107.0,2020-02-08,"(753.5, 1096.75]",13,31,-18
31107.0,2020-02-08,"(1096.75, 1440.0]",5,11,-6
31108.0,2020-02-08,"(20.658, 357.5]",1,2,-1
31108.0,2020-02-08,"(357.5, 693.0]",3,11,-8
31108.0,2020-02-08,"(693.0, 1028.5]",19,37,-18
31108.0,2020-02-08,"(1028.5, 1364.0]",15,17,-2
31109.0,2020-02-08,"(363.75, 712.5]",8,4,4
31109.0,2020-02-08,"(712.5, 1061.25]",18,16,2
31109.0,2020-02-08,"(1061.25, 1410.0]",17,33,-16
31110.0,2020-02-08,"(303.881, 584.75]",9,14,-5
31110.0,2020-02-08,"(584.75, 864.5]",17,39,-22
31110.0,2020-02-08,"(864.5, 1144.25]",13,23,-10
31110.0,2020-02-08,"(1144.25, 1424.0]",5,7,-2
31111.0,2020-02-08,"(371.75, 703.5]",9,3,6
31111.0,2020-02-08,"(703.5, 1035.25]",11,15,-4
31111.0,2020-02-08,"(1035.25, 1367.0]",12,21,-9
31112.0,2020-02-08,"(632.623, 727.25]",2,3,-1
31113.0,2020-02-08,"(313.97, 572.5]",1,5,-4
31113.0,2020-02-08,"(572.5, 830.0]",6,19,-13
31113.0,2020-02-08,"(830.0, 1087.5]",10,19,-9
31113.0,2020-02-08,"(1087.5, 1345.0]",6,11,-5
31114.0,2020-02-08,"(9.591, 363.25]",4,8,-4
31114.0,2020-02-08,"(363.25, 715.5]",11,28,-17
31114.0,2020-02-08,"(715.5, 1067.75]",28,49,-21
31114.0,2020-02-08,"(1067.75, 1420.0]",6,10,-4
31115.0,2020-02-08,"(366.25, 697.5]",1,1,0
31115.0,2020-02-08,"(697.5, 1028.75]",6,14,-8
31115.0,2020-02-08,"(1028.75, 1360.0]",10,15,-5
31116.0,2020-02-08,"(87.694, 415.5]",1,3,-2
31116.0,2020-02-08,"(415.5, 742.0]",9,19,-10
31116.0,2020-02-08,"(742.0, 1068.5]",16,39,-23
31116.0,2020-02-08,"(1068.5, 1395.0]",16,23,-7
31117.0,2020-02-08,"(471.75, 793.5]",9,6,3
31117.0,2020-02-08,"(793.5, 1115.25]",18,20,-2
31117.0,2020-02-08,"(1115.25, 1437.0]",6,39,-33
31118.0,2020-02-08,"(40.689, 369.75]",1,1,0
31118.0,2020-02-08,"(697.5, 1025.25]",9,4,5
31118.0,2020-02-08,"(1025.25, 1353.0]",8,19,-11
31119.0,2020-02-08,"(17.585, 372.75]",2,2,0
31119.0,2020-02-08,"(372.75, 726.5]",14,35,-21
31119.0,2020-02-08,"(726.5, 1080.25]",20,35,-15
31119.0,2020-02-08,"(1080.25, 1434.0]",6,16,-10
31120.0,2020-02-08,"(4.616, 352.0]",1,2,-1
31120.0,2020-02-08,"(352.0, 698.0]",1,6,-5
31120.0,2020-02-08,"(698.0, 1044.0]",2,7,-5
31120.0,2020-02-08,"(1044.0, 1390.0]",12,17,-5
31121.0,2020-02-08,"(113.758, 425.5]",2,3,-1
31121.0,2020-02-08,"(425.5, 736.0]",8,18,-10
31121.0,2020-02-08,"(736.0, 1046.5]",12,26,-14
31121.0,2020-02-08,"(1046.5, 1357.0]",11,18,-7
31122.0,2020-02-08,"(415.5, 738.0]",5,1,4
31122.0,2020-02-08,"(738.0, 1060.5]",7,12,-5
31122.0,2020-02-08,"(1060.5, 1383.0]",5,11,-6
31123.0,2020-02-08,"(634.75, 834.5]",3,8,-5
31123.0,2020-02-08,"(834.5, 1034.25]",1,23,-22
31123.0,2020-02-08,"(1034.25, 1234.0]",4,4,0
31124.0,2020-02-08,"(32.602, 383.5]",3,5,-2
31124.0,2020-02-08,"(383.5, 733.0]",16,41,-25
31124.0,2020-02-08,"(733.0, 1082.5]",13,47,-34
31124.0,2020-02-08,"(1082.5, 1432.0]",9,26,-17
31125.0,2020-02-08,"(134.734, 452.5]",1,3,-2
31125.0,2020-02-08,"(452.5, 769.0]",10,22,-12
31125.0,2020-02-08,"(769.0, 1085.5]",19,33,-14
31125.0,2020-02-08,"(1085.5, 1402.0]",16,27,-11
31126.0,2020-02-08,"(4.645, 344.75]",1,2,-1
31126.0,2020-02-08,"(344.75, 683.5]",1,12,-11
31126.0,2020-02-08,"(1022.25, 1361.0]",1,5,-4
31127.0,2020-02-08,"(469.096, 696.0]",8,8,0
31127.0,2020-02-08,"(696.0, 922.0]",4,9,-5
31127.0,2020-02-08,"(922.0, 1148.0]",5,13,-8
31127.0,2020-02-08,"(1148.0, 1374.0]",5,12,-7
31128.0,2020-02-08,"(55.635, 398.25]",3,5,-2
31128.0,2020-02-08,"(398.25, 739.5]",11,22,-11
31128.0,2020-02-08,"(739.5, 1080.75]",17,34,-17
31128.0,2020-02-08,"(1080.75, 1422.0]",4,8,-4
31129.0,2020-02-08,"(757.5, 1080.75]",18,1,17
31129.0,2020-02-08,"(1080.75, 1404.0]",8,3,5
31130.0,2020-02-08,"(714.0, 919.0]",8,3,5
31130.0,2020-02-08,"(919.0, 1124.0]",2,16,-14
31130.0,2020-02-08,"(1124.0, 1329.0]",3,5,-2
31131.0,2020-02-08,"(360.25, 714.5]",2,1,1
31131.0,2020-02-08,"(714.5, 1068.75]",5,9,-4
31131.0,2020-02-08,"(1068.75, 1423.0]",3,14,-11
31200.0,2020-02-08,"(134.723, 455.25]",2,2,0
31200.0,2020-02-08,"(455.25, 774.5]",29,39,-10
31200.0,2020-02-08,"(774.5, 1093.75]",18,32,-14
31200.0,2020-02-08,"(1093.75, 1413.0]",8,16,-8
31201.0,2020-02-08,"(13.598, 365.5]",2,5,-3
31201.0,2020-02-08,"(365.5, 716.0]",21,39,-18
31201.0,2020-02-08,"(716.0, 1066.5]",44,93,-49
31201.0,2020-02-08,"(1066.5, 1417.0]",25,42,-17
,,,,2.0,
31203.0,2020-02-08,"(10.575, 368.25]",2,6,-4
31203.0,2020-02-08,"(368.25, 724.5]",19,29,-10
31203.0,2020-02-08,"(724.5, 1080.75]",33,60,-27
31203.0,2020-02-08,"(1080.75, 1437.0]",15,26,-11
31204.0,2020-02-08,"(508.074, 740.5]",2,9,-7
31204.0,2020-02-08,"(740.5, 972.0]",5,10,-5
31204.0,2020-02-08,"(972.0, 1203.5]",8,12,-4
31204.0,2020-02-08,"(1203.5, 1435.0]",2,3,-1
31205.0,2020-02-08,"(415.998, 667.5]",2,2,0
31205.0,2020-02-08,"(667.5, 918.0]",5,9,-4
31205.0,2020-02-08,"(918.0, 1168.5]",1,4,-3
31205.0,2020-02-08,"(1168.5, 1419.0]",2,4,-2
31206.0,2020-02-08,"(732.533, 849.75]",1,1,0
31207.0,2020-02-08,"(556.463, 691.25]",2,2,0
31207.0,2020-02-08,"(691.25, 825.5]",2,6,-4
31207.0,2020-02-08,"(825.5, 959.75]",2,7,-5
31207.0,2020-02-08,"(959.75, 1094.0]",5,6,-1
31208.0,2020-02-08,"(126.906, 401.5]",1,1,0
31208.0,2020-02-08,"(401.5, 675.0]",4,7,-3
31208.0,2020-02-08,"(675.0, 948.5]",4,4,0
31208.0,2020-02-08,"(948.5, 1222.0]",7,12,-5
31209.0,2020-02-08,"(638.415, 785.25]",7,10,-3
31209.0,2020-02-08,"(785.25, 931.5]",7,9,-2
31209.0,2020-02-08,"(931.5, 1077.75]",5,10,-5
31209.0,2020-02-08,"(1077.75, 1224.0]",1,3,-2
31211.0,2020-02-08,"(589.214, 786.5]",2,3,-1
31211.0,2020-02-08,"(786.5, 983.0]",5,6,-1
31211.0,2020-02-08,"(983.0, 1179.5]",1,2,-1
31212.0,2020-02-08,"(58.632, 402.0]",1,2,-1
31212.0,2020-02-08,"(402.0, 744.0]",8,20,-12
31212.0,2020-02-08,"(744.0, 1086.0]",13,27,-14
31212.0,2020-02-08,"(1086.0, 1428.0]",5,10,-5
31213.0,2020-02-08,"(305.962, 566.5]",3,3,0
31213.0,2020-02-08,"(566.5, 826.0]",13,17,-4
31213.0,2020-02-08,"(826.0, 1085.5]",3,4,-1
31214.0,2020-02-08,"(17.594, 370.5]",4,6,-2
31214.0,2020-02-08,"(370.5, 722.0]",15,34,-19
31214.0,2020-02-08,"(722.0, 1073.5]",24,49,-25
31214.0,2020-02-08,"(1073.5, 1425.0]",18,33,-15
31215.0,2020-02-08,"(599.526, 718.5]",6,7,-1
31215.0,2020-02-08,"(718.5, 837.0]",2,5,-3
31215.0,2020-02-08,"(837.0, 955.5]",8,12,-4
31215.0,2020-02-08,"(955.5, 1074.0]",6,6,0
31216.0,2020-02-08,"(722.613, 819.75]",2,3,-1
31216.0,2020-02-08,"(819.75, 916.5]",3,3,0
31216.0,2020-02-08,"(1013.25, 1110.0]",1,3,-2
31217.0,2020-02-08,"(25.91, 299.5]",1,1,0
31217.0,2020-02-08,"(572.0, 844.5]",2,5,-3
31217.0,2020-02-08,"(844.5, 1117.0]",7,10,-3
31218.0,2020-02-08,"(543.151, 756.25]",2,4,-2
31218.0,2020-02-08,"(756.25, 968.5]",3,4,-1
31218.0,2020-02-08,"(968.5, 1180.75]",1,4,-3
31218.0,2020-02-08,"(1180.75, 1393.0]",1,1,0
31219.0,2020-02-08,"(676.432, 819.0]",4,4,0
31219.0,2020-02-08,"(819.0, 961.0]",6,13,-7
31219.0,2020-02-08,"(961.0, 1103.0]",3,10,-7
31219.0,2020-02-08,"(1103.0, 1245.0]",3,3,0
,,,,1.0,
,,,,1.0,
31221.0,2020-02-08,"(369.75, 703.5]",1,1,0
31221.0,2020-02-08,"(703.5, 1037.25]",15,1,14
31221.0,2020-02-08,"(1037.25, 1371.0]",4,19,-15
31222.0,2020-02-08,"(581.5, 870.25]",2,1,1
31222.0,2020-02-08,"(870.25, 1159.0]",5,6,-1
31223.0,2020-02-08,"(410.25, 748.5]",7,3,4
31223.0,2020-02-08,"(748.5, 1086.75]",7,12,-5
31223.0,2020-02-08,"(1086.75, 1425.0]",4,14,-10
31224.0,2020-02-08,"(478.259, 664.25]",2,4,-2
31224.0,2020-02-08,"(664.25, 849.5]",4,7,-3
31224.0,2020-02-08,"(849.5, 1034.75]",1,3,-2
31224.0,2020-02-08,"(1034.75, 1220.0]",4,4,0
31225.0,2020-02-08,"(405.031, 648.25]",1,4,-3
31225.0,2020-02-08,"(648.25, 890.5]",7,10,-3
31225.0,2020-02-08,"(890.5, 1132.75]",6,10,-4
31225.0,2020-02-08,"(1132.75, 1375.0]",2,5,-3
31226.0,2020-02-08,"(548.274, 730.5]",1,5,-4
31226.0,2020-02-08,"(730.5, 912.0]",3,4,-1
31226.0,2020-02-08,"(912.0, 1093.5]",3,5,-2
31226.0,2020-02-08,"(1093.5, 1275.0]",1,4,-3
31227.0,2020-02-08,"(369.5, 709.0]",4,1,3
31227.0,2020-02-08,"(709.0, 1048.5]",14,6,8
31228.0,2020-02-08,"(7.577, 364.75]",1,1,0
31228.0,2020-02-08,"(364.75, 720.5]",5,8,-3
31228.0,2020-02-08,"(720.5, 1076.25]",17,34,-17
31228.0,2020-02-08,"(1076.25, 1432.0]",9,18,-9
31229.0,2020-02-08,"(7.585, 362.75]",2,5,-3
31229.0,2020-02-08,"(362.75, 716.5]",17,40,-23
31229.0,2020-02-08,"(716.5, 1070.25]",30,63,-33
31229.0,2020-02-08,"(1070.25, 1424.0]",17,35,-18
31230.0,2020-02-08,"(347.5, 668.0]",7,1,6
31230.0,2020-02-08,"(668.0, 988.5]",16,10,6
31230.0,2020-02-08,"(988.5, 1309.0]",10,25,-15
,,,,1.0,
,,,,1.0,
,,,,1.0,
31232.0,2020-02-08,"(174.753, 487.75]",2,3,-1
31232.0,2020-02-08,"(487.75, 799.5]",25,33,-8
31232.0,2020-02-08,"(799.5, 1111.25]",34,55,-21
31232.0,2020-02-08,"(1111.25, 1423.0]",6,16,-10
31233.0,2020-02-08,"(620.287, 799.25]",4,6,-2
31233.0,2020-02-08,"(799.25, 977.5]",4,11,-7
31233.0,2020-02-08,"(977.5, 1155.75]",6,6,0
31234.0,2020-02-08,"(75.836, 368.0]",1,1,0
31234.0,2020-02-08,"(368.0, 659.0]",3,9,-6
31234.0,2020-02-08,"(659.0, 950.0]",12,20,-8
31234.0,2020-02-08,"(950.0, 1241.0]",13,22,-9
31235.0,2020-02-08,"(597.296, 774.0]",1,3,-2
31235.0,2020-02-08,"(950.0, 1126.0]",1,2,-1
31236.0,2020-02-08,"(41.626, 386.5]",2,3,-1
31236.0,2020-02-08,"(386.5, 730.0]",8,15,-7
31236.0,2020-02-08,"(730.0, 1073.5]",14,23,-9
31236.0,2020-02-08,"(1073.5, 1417.0]",6,16,-10
31237.0,2020-02-08,"(126.902, 402.5]",1,1,0
31237.0,2020-02-08,"(402.5, 677.0]",4,8,-4
31237.0,2020-02-08,"(677.0, 951.5]",11,23,-12
31237.0,2020-02-08,"(951.5, 1226.0]",7,13,-6
31238.0,2020-02-08,"(13.703, 339.25]",2,5,-3
31238.0,2020-02-08,"(339.25, 663.5]",2,2,0
31238.0,2020-02-08,"(663.5, 987.75]",7,12,-5
31238.0,2020-02-08,"(987.75, 1312.0]",1,8,-7
31239.0,2020-02-08,"(465.25, 747.5]",11,2,9
31239.0,2020-02-08,"(747.5, 1029.75]",8,11,-3
31239.0,2020-02-08,"(1029.75, 1312.0]",4,16,-12
31240.0,2020-02-08,"(387.325, 556.75]",1,2,-1
31240.0,2020-02-08,"(556.75, 725.5]",5,9,-4
31240.0,2020-02-08,"(725.5, 894.25]",2,7,-5
31240.0,2020-02-08,"(894.25, 1063.0]",6,9,-3
31241.0,2020-02-08,"(512.75, 818.5]",8,2,6
31241.0,2020-02-08,"(818.5, 1124.25]",22,29,-7
31241.0,2020-02-08,"(1124.25, 1430.0]",5,35,-30
31242.0,2020-02-08,"(556.214, 753.5]",3,3,0
31242.0,2020-02-08,"(753.5, 950.0]",1,3,-2
31242.0,2020-02-08,"(950.0, 1146.5]",6,12,-6
31243.0,2020-02-08,"(725.585, 829.75]",2,3,-1
31243.0,2020-02-08,"(829.75, 933.5]",4,4,0
31243.0,2020-02-08,"(933.5, 1037.25]",7,7,0
31243.0,2020-02-08,"(1037.25, 1141.0]",2,6,-4
31244.0,2020-02-08,"(500.105, 724.75]",4,9,-5
31244.0,2020-02-08,"(724.75, 948.5]",2,6,-4
31244.0,2020-02-08,"(948.5, 1172.25]",1,1,0
31244.0,2020-02-08,"(1172.25, 1396.0]",3,7,-4
31245.0,2020-02-08,"(404.969, 663.75]",7,15,-8
31245.0,2020-02-08,"(663.75, 921.5]",14,29,-15
31245.0,2020-02-08,"(921.5, 1179.25]",14,30,-16
31245.0,2020-02-08,"(1179.25, 1437.0]",4,8,-4
31246.0,2020-02-08,"(252.836, 545.0]",1,1,0
31246.0,2020-02-08,"(545.0, 836.0]",22,28,-6
31246.0,2020-02-08,"(836.0, 1127.0]",16,31,-15
31246.0,2020-02-08,"(1127.0, 1418.0]",6,11,-5
31247.0,2020-02-08,"(386.25, 692.5]",14,1,13
31247.0,2020-02-08,"(692.5, 998.75]",30,17,13
31247.0,2020-02-08,"(998.75, 1305.0]",10,62,-52
31248.0,2020-02-08,"(461.262, 646.5]",3,10,-7
31248.0,2020-02-08,"(646.5, 831.0]",19,41,-22
31248.0,2020-02-08,"(831.0, 1015.5]",18,32,-14
31248.0,2020-02-08,"(1015.5, 1200.0]",7,22,-15
31249.0,2020-02-08,"(598.273, 780.75]",11,24,-13
31249.0,2020-02-08,"(780.75, 962.5]",12,23,-11
31249.0,2020-02-08,"(962.5, 1144.25]",5,11,-6
31249.0,2020-02-08,"(1144.25, 1326.0]",5,7,-2
31250.0,2020-02-08,"(539.544, 654.0]",3,3,0
31250.0,2020-02-08,"(654.0, 768.0]",2,3,-1
31250.0,2020-02-08,"(768.0, 882.0]",1,1,0
31250.0,2020-02-08,"(882.0, 996.0]",3,3,0
31251.0,2020-02-08,"(6.8, 308.0]",2,5,-3
31251.0,2020-02-08,"(308.0, 608.0]",2,5,-3
31251.0,2020-02-08,"(608.0, 908.0]",7,15,-8
31251.0,2020-02-08,"(908.0, 1208.0]",1,10,-9
31252.0,2020-02-08,"(60.969, 319.75]",1,1,0
31252.0,2020-02-08,"(835.25, 1093.0]",2,1,1
31253.0,2020-02-08,"(643.75, 834.5]",1,1,0
31253.0,2020-02-08,"(834.5, 1025.25]",3,2,1
31253.0,2020-02-08,"(1025.25, 1216.0]",3,4,-1
31254.0,2020-02-08,"(514.079, 745.25]",3,4,-1
31254.0,2020-02-08,"(745.25, 975.5]",2,3,-1
31254.0,2020-02-08,"(975.5, 1205.75]",5,6,-1
31254.0,2020-02-08,"(1205.75, 1436.0]",3,3,0
31255.0,2020-02-08,"(470.275, 652.25]",1,3,-2
31255.0,2020-02-08,"(652.25, 833.5]",2,5,-3
31255.0,2020-02-08,"(833.5, 1014.75]",4,5,-1
31255.0,2020-02-08,"(1014.75, 1196.0]",2,2,0
31256.0,2020-02-08,"(414.25, 677.5]",4,1,3
31256.0,2020-02-08,"(677.5, 940.75]",11,4,7
31256.0,2020-02-08,"(940.75, 1204.0]",6,19,-13
31257.0,2020-02-08,"(329.976, 587.0]",4,6,-2
31257.0,2020-02-08,"(587.0, 843.0]",14,24,-10
31257.0,2020-02-08,"(843.0, 1099.0]",13,27,-14
31257.0,2020-02-08,"(1099.0, 1355.0]",8,13,-5
31258.0,2020-02-08,"(123.731, 442.25]",1,2,-1
31258.0,2020-02-08,"(442.25, 759.5]",22,41,-19
31258.0,2020-02-08,"(759.5, 1076.75]",54,106,-52
31258.0,2020-02-08,"(1076.75, 1394.0]",14,19,-5
31259.0,2020-02-08,"(703.654, 790.5]",1,4,-3
31259.0,2020-02-08,"(963.5, 1050.0]",1,1,0
31260.0,2020-02-08,"(9.784, 315.0]",1,1,0
31260.0,2020-02-08,"(619.0, 923.0]",1,4,-3
31260.0,2020-02-08,"(923.0, 1227.0]",4,7,-3
31261.0,2020-02-08,"(675.249, 863.75]",2,4,-2
31261.0,2020-02-08,"(863.75, 1051.5]",2,4,-2
31261.0,2020-02-08,"(1239.25, 1427.0]",2,1,1
31262.0,2020-02-08,"(398.049, 636.75]",4,4,0
31262.0,2020-02-08,"(636.75, 874.5]",10,16,-6
31262.0,2020-02-08,"(874.5, 1112.25]",5,10,-5
31262.0,2020-02-08,"(1112.25, 1350.0]",3,9,-6
31263.0,2020-02-08,"(73.734, 391.5]",1,1,0
31263.0,2020-02-08,"(391.5, 708.0]",5,12,-7
31263.0,2020-02-08,"(708.0, 1024.5]",9,20,-11
31263.0,2020-02-08,"(1024.5, 1341.0]",7,13,-6
31264.0,2020-02-08,"(636.207, 835.25]",4,6,-2
31264.0,2020-02-08,"(835.25, 1033.5]",6,12,-6
31264.0,2020-02-08,"(1033.5, 1231.75]",8,8,0
31265.0,2020-02-08,"(8.618, 355.5]",1,2,-1
31265.0,2020-02-08,"(355.5, 701.0]",12,21,-9
31265.0,2020-02-08,"(701.0, 1046.5]",16,33,-17
31265.0,2020-02-08,"(1046.5, 1392.0]",12,19,-7
31266.0,2020-02-08,"(307.871, 591.25]",1,12,-11
31266.0,2020-02-08,"(591.25, 873.5]",16,34,-18
31266.0,2020-02-08,"(873.5, 1155.75]",14,31,-17
31266.0,2020-02-08,"(1155.75, 1438.0]",13,24,-11
31267.0,2020-02-08,"(418.5, 755.0]",12,1,11
31267.0,2020-02-08,"(755.0, 1091.5]",8,22,-14
31267.0,2020-02-08,"(1091.5, 1428.0]",4,19,-15
31268.0,2020-02-08,"(30.594, 383.5]",1,5,-4
31268.0,2020-02-08,"(383.5, 735.0]",9,15,-6
31268.0,2020-02-08,"(735.0, 1086.5]",17,35,-18
31268.0,2020-02-08,"(1086.5, 1438.0]",14,20,-6
31269.0,2020-02-08,"(446.173, 653.75]",4,4,0
31269.0,2020-02-08,"(653.75, 860.5]",4,9,-5
31269.0,2020-02-08,"(860.5, 1067.25]",4,10,-6
31269.0,2020-02-08,"(1067.25, 1274.0]",3,10,-7
31270.0,2020-02-08,"(521.5, 777.0]",6,2,4
31270.0,2020-02-08,"(777.0, 1032.5]",9,6,3
31270.0,2020-02-08,"(1032.5, 1288.0]",5,19,-14
31271.0,2020-02-08,"(599.21, 797.5]",3,11,-8
31271.0,2020-02-08,"(797.5, 995.0]",4,9,-5
31271.0,2020-02-08,"(1192.5, 1390.0]",4,1,3
31272.0,2020-02-08,"(540.333, 707.75]",10,11,-1
31272.0,2020-02-08,"(707.75, 874.5]",6,8,-2
31272.0,2020-02-08,"(874.5, 1041.25]",7,26,-19
31272.0,2020-02-08,"(1041.25, 1208.0]",1,2,-1
31273.0,2020-02-08,"(553.531, 671.25]",1,1,0
31273.0,2020-02-08,"(905.75, 1023.0]",1,1,0
31274.0,2020-02-08,"(434.133, 651.75]",5,5,0
31274.0,2020-02-08,"(651.75, 868.5]",3,7,-4
31274.0,2020-02-08,"(868.5, 1085.25]",7,9,-2
31274.0,2020-02-08,"(1085.25, 1302.0]",8,9,-1
31275.0,2020-02-08,"(33.266, 217.5]",1,2,-1
31275.0,2020-02-08,"(217.5, 401.0]",1,2,-1
31275.0,2020-02-08,"(401.0, 584.5]",5,8,-3
31275.0,2020-02-08,"(584.5, 768.0]",3,4,-1
31276.0,2020-02-08,"(470.113, 692.75]",3,4,-1
31276.0,2020-02-08,"(692.75, 914.5]",4,6,-2
31276.0,2020-02-08,"(914.5, 1136.25]",4,12,-8
31276.0,2020-02-08,"(1136.25, 1358.0]",2,4,-2
31277.0,2020-02-08,"(276.056, 513.0]",3,3,0
31277.0,2020-02-08,"(513.0, 749.0]",2,3,-1
31277.0,2020-02-08,"(749.0, 985.0]",13,27,-14
31278.0,2020-02-08,"(105.677, 437.75]",1,1,0
31278.0,2020-02-08,"(437.75, 768.5]",7,22,-15
31278.0,2020-02-08,"(768.5, 1099.25]",18,35,-17
31278.0,2020-02-08,"(1099.25, 1430.0]",14,22,-8
31279.0,2020-02-08,"(563.414, 710.5]",3,3,0
31279.0,2020-02-08,"(710.5, 857.0]",1,4,-3
31279.0,2020-02-08,"(1003.5, 1150.0]",1,1,0
31280.0,2020-02-08,"(415.25, 733.5]",7,1,6
31280.0,2020-02-08,"(733.5, 1051.75]",16,14,2
31280.0,2020-02-08,"(1051.75, 1370.0]",5,24,-19
,,,,1.0,
,,,,1.0,
31001.0,2020-02-09,"(701.282, 881.5]",3,9,-6
31001.0,2020-02-09,"(881.5, 1061.0]",1,4,-3
31001.0,2020-02-09,"(1061.0, 1240.5]",3,3,0
31001.0,2020-02-09,"(1240.5, 1420.0]",1,1,0
31002.0,2020-02-09,"(744.402, 894.5]",5,7,-2
31002.0,2020-02-09,"(894.5, 1044.0]",2,2,0
31002.0,2020-02-09,"(1044.0, 1193.5]",2,3,-1
31002.0,2020-02-09,"(1193.5, 1343.0]",1,1,0
31003.0,2020-02-09,"(508.174, 715.5]",5,9,-4
31003.0,2020-02-09,"(715.5, 922.0]",3,4,-1
31003.0,2020-02-09,"(922.0, 1128.5]",2,4,-2
31004.0,2020-02-09,"(784.5, 1046.0]",2,1,1
31005.0,2020-02-09,"(525.285, 704.75]",1,3,-2
31005.0,2020-02-09,"(704.75, 883.5]",4,6,-2
31005.0,2020-02-09,"(883.5, 1062.25]",3,3,0
31005.0,2020-02-09,"(1062.25, 1241.0]",6,7,-1
31006.0,2020-02-09,"(545.205, 744.75]",5,6,-1
31006.0,2020-02-09,"(744.75, 943.5]",5,8,-3
31006.0,2020-02-09,"(943.5, 1142.25]",1,2,-1
31006.0,2020-02-09,"(1142.25, 1341.0]",1,2,-1
31007.0,2020-02-09,"(799.25, 944.5]",1,2,-1
31007.0,2020-02-09,"(944.5, 1089.75]",5,1,4
31007.0,2020-02-09,"(1089.75, 1235.0]",1,9,-8
,,,,2.0,
31010.0,2020-02-09,"(497.384, 652.0]",2,6,-4
31010.0,2020-02-09,"(652.0, 806.0]",3,6,-3
31010.0,2020-02-09,"(806.0, 960.0]",4,6,-2
31010.0,2020-02-09,"(960.0, 1114.0]",1,1,0
31011.0,2020-02-09,"(695.355, 857.25]",1,4,-3
31011.0,2020-02-09,"(1018.5, 1179.75]",1,2,-1
31012.0,2020-02-09,"(659.595, 761.25]",1,1,0
31012.0,2020-02-09,"(963.75, 1065.0]",1,2,-1
31013.0,2020-02-09,"(750.642, 840.5]",1,2,-1
31013.0,2020-02-09,"(840.5, 930.0]",1,1,0
31013.0,2020-02-09,"(1019.5, 1109.0]",1,1,0
31014.0,2020-02-09,"(20.682, 351.5]",2,2,0
31014.0,2020-02-09,"(681.0, 1010.5]",8,1,7
31014.0,2020-02-09,"(1010.5, 1340.0]",6,16,-10
31015.0,2020-02-09,"(336.129, 554.75]",1,1,0
31015.0,2020-02-09,"(554.75, 772.5]",1,3,-2
31015.0,2020-02-09,"(772.5, 990.25]",2,8,-6
31015.0,2020-02-09,"(990.25, 1208.0]",2,2,0
31016.0,2020-02-09,"(585.239, 776.25]",3,7,-4
31016.0,2020-02-09,"(776.25, 966.5]",3,5,-2
31016.0,2020-02-09,"(966.5, 1156.75]",2,2,0
31016.0,2020-02-09,"(1156.75, 1347.0]",1,2,-1
31017.0,2020-02-09,"(561.0, 835.5]",2,1,1
31017.0,2020-02-09,"(835.5, 1110.0]",1,3,-2
31018.0,2020-02-09,"(662.25, 883.0]",1,1,0
31019.0,2020-02-09,"(49.85, 338.5]",2,4,-2
31019.0,2020-02-09,"(338.5, 626.0]",1,1,0
31019.0,2020-02-09,"(626.0, 913.5]",5,7,-2
31019.0,2020-02-09,"(913.5, 1201.0]",1,7,-6
31020.0,2020-02-09,"(585.5, 721.0]",2,1,1
,,,,1.0,
,,,,1.0,
,,,,4.0,
31022.0,2020-02-09,"(334.25, 633.5]",3,3,0
31022.0,2020-02-09,"(633.5, 932.75]",6,6,0
31022.0,2020-02-09,"(932.75, 1232.0]",1,13,-12
31023.0,2020-02-09,"(578.439, 719.25]",3,3,0
31023.0,2020-02-09,"(999.75, 1140.0]",1,1,0
31024.0,2020-02-09,"(574.204, 774.0]",2,4,-2
31024.0,2020-02-09,"(774.0, 973.0]",2,4,-2
31024.0,2020-02-09,"(973.0, 1172.0]",1,2,-1
31024.0,2020-02-09,"(1172.0, 1371.0]",3,4,-1
31025.0,2020-02-09,"(186.924, 457.0]",1,1,0
31025.0,2020-02-09,"(726.0, 995.0]",2,1,1
31025.0,2020-02-09,"(995.0, 1264.0]",1,3,-2
31026.0,2020-02-09,"(780.75, 1041.0]",1,1,0
31027.0,2020-02-09,"(933.75, 1032.0]",1,2,-1
31028.0,2020-02-09,"(880.611, 978.25]",1,3,-2
31028.0,2020-02-09,"(1075.5, 1172.75]",1,1,0
31029.0,2020-02-09,"(14.846, 304.5]",1,1,0
31029.0,2020-02-09,"(593.0, 881.5]",3,1,2
31029.0,2020-02-09,"(881.5, 1170.0]",4,8,-4
31030.0,2020-02-09,"(496.567, 605.25]",1,1,0
31030.0,2020-02-09,"(713.5, 821.75]",1,3,-2
31030.0,2020-02-09,"(821.75, 930.0]",4,1,3
31031.0,2020-02-09,"(716.5, 928.0]",2,2,0
31031.0,2020-02-09,"(928.0, 1139.5]",1,3,-2
31031.0,2020-02-09,"(1139.5, 1351.0]",1,1,0
,,,,1.0,
,,,,2.0,
31033.0,2020-02-09,"(656.718, 727.5]",1,3,-2
31033.0,2020-02-09,"(868.5, 939.0]",2,1,1
31034.0,2020-02-09,"(635.315, 807.25]",2,3,-1
31034.0,2020-02-09,"(978.5, 1149.75]",1,1,0
31035.0,2020-02-09,"(1268.928, 1287.0]",1,2,-1
31036.0,2020-02-09,"(814.25, 932.0]",2,1,1
31037.0,2020-02-09,"(440.0, 658.5]",2,1,1
31037.0,2020-02-09,"(658.5, 877.0]",1,3,-2
31038.0,2020-02-09,"(600.556, 712.0]",2,3,-1
31039.0,2020-02-09,"(589.529, 707.75]",1,2,-1
31039.0,2020-02-09,"(825.5, 943.25]",2,4,-2
31039.0,2020-02-09,"(943.25, 1061.0]",2,4,-2
31040.0,2020-02-09,"(622.375, 779.25]",1,1,0
31040.0,2020-02-09,"(779.25, 935.5]",1,2,-1
31041.0,2020-02-09,"(868.578, 974.5]",3,3,0
31041.0,2020-02-09,"(1080.0, 1185.5]",1,1,0
31042.0,2020-02-09,"(8.941, 274.75]",1,2,-1
31042.0,2020-02-09,"(539.5, 804.25]",2,4,-2
31042.0,2020-02-09,"(804.25, 1069.0]",5,9,-4
31043.0,2020-02-09,"(781.704, 856.0]",1,2,-1
31043.0,2020-02-09,"(856.0, 930.0]",2,2,0
31043.0,2020-02-09,"(930.0, 1004.0]",1,2,-1
31043.0,2020-02-09,"(1004.0, 1078.0]",1,1,0
31044.0,2020-02-09,"(933.692, 1011.0]",2,3,-1
,,,,1.0,
,,,,2.0,
,,,,1.0,
,,,,2.0,
,,,,1.0,
,,,,1.0,
,,,,1.0,
,,,,4.0,
31048.0,2020-02-09,"(1266.25, 1301.0]",1,1,0
31049.0,2020-02-09,"(697.25, 808.5]",1,2,-1
31049.0,2020-02-09,"(919.75, 1031.0]",1,1,0
,,,,1.0,
,,,,4.0,
,,,,1.0,
,,,,1.0,
31052.0,2020-02-09,"(666.75, 832.5]",1,1,0
31052.0,2020-02-09,"(832.5, 998.25]",1,4,-3
31053.0,2020-02-09,"(537.143, 752.25]",1,3,-2
31053.0,2020-02-09,"(1180.75, 1395.0]",1,1,0
,,,,2.0,
31055.0,2020-02-09,"(663.648, 752.0]",3,6,-3
31055.0,2020-02-09,"(752.0, 840.0]",1,3,-2
31055.0,2020-02-09,"(840.0, 928.0]",1,1,0
31055.0,2020-02-09,"(928.0, 1016.0]",5,5,0
31056.0,2020-02-09,"(871.5, 976.0]",3,1,2
,,,,2.0,
,,,,1.0,
,,,,1.0,
31059.0,2020-02-09,"(535.5, 714.0]",1,1,0
31060.0,2020-02-09,"(439.299, 615.25]",1,2,-1
31060.0,2020-02-09,"(615.25, 790.5]",1,1,0
31060.0,2020-02-09,"(790.5, 965.75]",4,8,-4
31060.0,2020-02-09,"(965.75, 1141.0]",2,2,0
31061.0,2020-02-09,"(411.0, 548.0]",1,1,0
31062.0,2020-02-09,"(556.557, 667.75]",1,2,-1
31062.0,2020-02-09,"(667.75, 778.5]",6,11,-5
31062.0,2020-02-09,"(778.5, 889.25]",6,10,-4
31062.0,2020-02-09,"(889.25, 1000.0]",3,6,-3
31063.0,2020-02-09,"(531.5, 797.25]",1,1,0
31063.0,2020-02-09,"(797.25, 1063.0]",1,1,0
31064.0,2020-02-09,"(467.29, 645.5]",4,7,-3
31064.0,2020-02-09,"(645.5, 823.0]",3,8,-5
31064.0,2020-02-09,"(823.0, 1000.5]",12,23,-11
31064.0,2020-02-09,"(1000.5, 1178.0]",8,17,-9
31065.0,2020-02-09,"(512.609, 610.75]",1,2,-1
31065.0,2020-02-09,"(806.25, 904.0]",2,1,1
31066.0,2020-02-09,"(792.786, 846.5]",2,2,0
31066.0,2020-02-09,"(846.5, 900.0]",1,2,-1
31066.0,2020-02-09,"(900.0, 953.5]",1,1,0
31067.0,2020-02-09,"(741.458, 877.5]",1,3,-2
31067.0,2020-02-09,"(1148.5, 1284.0]",1,1,0
31068.0,2020-02-09,"(913.25, 959.5]",1,1,0
31068.0,2020-02-09,"(1005.75, 1052.0]",1,2,-1
31069.0,2020-02-09,"(761.5, 786.0]",2,3,-1
31069.0,2020-02-09,"(810.5, 835.0]",1,2,-1
31070.0,2020-02-09,"(1093.0, 1200.0]",1,1,0
31071.0,2020-02-09,"(567.445, 706.75]",2,4,-2
31071.0,2020-02-09,"(845.5, 984.25]",1,3,-2
,,,,1.0,
,,,,2.0,
31073.0,2020-02-09,"(1093.5, 1270.0]",1,1,0
31074.0,2020-02-09,"(841.47, 974.5]",2,2,0
31074.0,2020-02-09,"(1107.0, 1239.5]",1,1,0
31074.0,2020-02-09,"(1239.5, 1372.0]",2,1,1
31075.0,2020-02-09,"(884.969, 892.75]",1,1,0
31075.0,2020-02-09,"(908.25, 916.0]",1,1,0
,,,,1.0,
,,,,1.0,
31077.0,2020-02-09,"(563.309, 736.75]",3,3,0
31077.0,2020-02-09,"(736.75, 909.5]",8,9,-1
31077.0,2020-02-09,"(909.5, 1082.25]",1,1,0
,,,,2.0,
31079.0,2020-02-09,"(587.435, 729.25]",2,8,-6
31079.0,2020-02-09,"(729.25, 870.5]",1,3,-2
31079.0,2020-02-09,"(870.5, 1011.75]",2,5,-3
31079.0,2020-02-09,"(1011.75, 1153.0]",3,5,-2
31080.0,2020-02-09,"(495.101, 720.75]",2,5,-3
31080.0,2020-02-09,"(720.75, 945.5]",3,6,-3
31080.0,2020-02-09,"(945.5, 1170.25]",1,2,-1
31080.0,2020-02-09,"(1170.25, 1395.0]",1,1,0
31081.0,2020-02-09,"(694.75, 800.5]",2,1,1
31081.0,2020-02-09,"(906.25, 1012.0]",1,2,-1
,,,,2.0,
,,,,1.0,
,,,,1.0,
,,,,2.0,
31085.0,2020-02-09,"(533.5, 800.25]",1,1,0
31085.0,2020-02-09,"(800.25, 1067.0]",2,1,1
31086.0,2020-02-09,"(718.75, 832.5]",4,1,3
31086.0,2020-02-09,"(832.5, 946.25]",4,4,0
31087.0,2020-02-09,"(-0.005, 252.25]",2,2,0
31087.0,2020-02-09,"(252.25, 503.5]",1,1,0
31087.0,2020-02-09,"(503.5, 754.75]",1,2,-1
31087.0,2020-02-09,"(754.75, 1006.0]",1,2,-1
31088.0,2020-02-09,"(693.75, 825.5]",1,1,0
31088.0,2020-02-09,"(957.25, 1089.0]",3,2,1
31089.0,2020-02-09,"(615.478, 746.5]",3,6,-3
31089.0,2020-02-09,"(746.5, 877.0]",1,5,-4
31090.0,2020-02-09,"(637.0, 755.0]",3,1,2
31090.0,2020-02-09,"(873.0, 991.0]",2,3,-1
31091.0,2020-02-09,"(970.5, 1294.0]",2,1,1
31092.0,2020-02-09,"(852.0, 882.0]",1,2,-1
31093.0,2020-02-09,"(711.5, 810.0]",2,1,1
31093.0,2020-02-09,"(908.5, 1007.0]",2,3,-1
31094.0,2020-02-09,"(865.5, 1154.0]",3,1,2
31095.0,2020-02-09,"(660.25, 693.5]",2,2,0
31095.0,2020-02-09,"(726.75, 760.0]",1,2,-1
31096.0,2020-02-09,"(829.636, 921.0]",1,3,-2
31096.0,2020-02-09,"(1103.0, 1194.0]",1,2,-1
31097.0,2020-02-09,"(808.5, 1076.0]",4,2,2
31098.0,2020-02-09,"(894.0, 1013.0]",1,1,0
31098.0,2020-02-09,"(1013.0, 1132.0]",1,1,0
31098.0,2020-02-09,"(1132.0, 1251.0]",1,1,0
31099.0,2020-02-09,"(810.5, 828.0]",1,1,0
31100.0,2020-02-09,"(1087.889, 1115.75]",1,1,0
31100.0,2020-02-09,"(1171.25, 1199.0]",1,1,0
31101.0,2020-02-09,"(18.588, 373.0]",3,8,-5
31101.0,2020-02-09,"(373.0, 726.0]",24,37,-13
31101.0,2020-02-09,"(726.0, 1079.0]",43,73,-30
31101.0,2020-02-09,"(1079.0, 1432.0]",10,23,-13
31102.0,2020-02-09,"(33.619, 380.25]",2,9,-7
31102.0,2020-02-09,"(380.25, 725.5]",1,11,-10
31102.0,2020-02-09,"(725.5, 1070.75]",13,34,-21
31102.0,2020-02-09,"(1070.75, 1416.0]",2,10,-8
31103.0,2020-02-09,"(357.25, 700.5]",3,1,2
31103.0,2020-02-09,"(700.5, 1043.75]",14,16,-2
31103.0,2020-02-09,"(1043.75, 1387.0]",7,42,-35
31104.0,2020-02-09,"(23.593, 376.75]",3,7,-4
31104.0,2020-02-09,"(376.75, 728.5]",10,25,-15
31104.0,2020-02-09,"(728.5, 1080.25]",18,38,-20
31104.0,2020-02-09,"(1080.25, 1432.0]",9,15,-6
31105.0,2020-02-09,"(679.255, 866.25]",1,2,-1
31105.0,2020-02-09,"(866.25, 1052.5]",7,12,-5
31105.0,2020-02-09,"(1052.5, 1238.75]",1,4,-3
31105.0,2020-02-09,"(1238.75, 1425.0]",2,5,-3
31106.0,2020-02-09,"(0.732, 319.0]",1,2,-1
31106.0,2020-02-09,"(636.0, 953.0]",4,2,2
31106.0,2020-02-09,"(953.0, 1270.0]",3,10,-7
31107.0,2020-02-09,"(23.701, 349.75]",3,3,0
31107.0,2020-02-09,"(349.75, 674.5]",2,10,-8
31107.0,2020-02-09,"(674.5, 999.25]",14,30,-16
31107.0,2020-02-09,"(999.25, 1324.0]",10,20,-10
31108.0,2020-02-09,"(8.574, 366.5]",3,3,0
31108.0,2020-02-09,"(366.5, 723.0]",5,11,-6
31108.0,2020-02-09,"(723.0, 1079.5]",32,58,-26
31108.0,2020-02-09,"(1079.5, 1436.0]",9,16,-7
31109.0,2020-02-09,"(39.609, 388.75]",2,9,-7
31109.0,2020-02-09,"(388.75, 736.5]",5,15,-10
31109.0,2020-02-09,"(736.5, 1084.25]",29,52,-23
31109.0,2020-02-09,"(1084.25, 1432.0]",9,19,-10
31110.0,2020-02-09,"(313.889, 592.75]",5,7,-2
31110.0,2020-02-09,"(592.75, 870.5]",8,27,-19
31110.0,2020-02-09,"(870.5, 1148.25]",16,28,-12
31110.0,2020-02-09,"(1148.25, 1426.0]",4,12,-8
31111.0,2020-02-09,"(443.0, 738.0]",9,1,8
31111.0,2020-02-09,"(738.0, 1033.0]",16,16,0
31111.0,2020-02-09,"(1033.0, 1328.0]",12,21,-9
31112.0,2020-02-09,"(668.469, 801.75]",5,6,-1
31112.0,2020-02-09,"(801.75, 934.5]",7,11,-4
31112.0,2020-02-09,"(934.5, 1067.25]",5,9,-4
31112.0,2020-02-09,"(1067.25, 1200.0]",1,1,0
31113.0,2020-02-09,"(5.572, 364.0]",3,6,-3
31113.0,2020-02-09,"(364.0, 721.0]",6,16,-10
31113.0,2020-02-09,"(721.0, 1078.0]",11,28,-17
31113.0,2020-02-09,"(1078.0, 1435.0]",5,14,-9
31114.0,2020-02-09,"(4.567, 364.25]",2,4,-2
31114.0,2020-02-09,"(364.25, 722.5]",2,15,-13
31114.0,2020-02-09,"(722.5, 1080.75]",12,29,-17
31114.0,2020-02-09,"(1080.75, 1439.0]",6,8,-2
31115.0,2020-02-09,"(107.68, 439.0]",3,4,-1
31115.0,2020-02-09,"(439.0, 769.0]",2,13,-11
31115.0,2020-02-09,"(769.0, 1099.0]",6,16,-10
31115.0,2020-02-09,"(1099.0, 1429.0]",6,9,-3
31116.0,2020-02-09,"(32.594, 385.5]",1,1,0
31116.0,2020-02-09,"(385.5, 737.0]",6,13,-7
31116.0,2020-02-09,"(737.0, 1088.5]",19,35,-16
31116.0,2020-02-09,"(1088.5, 1440.0]",8,12,-4
31117.0,2020-02-09,"(6.669, 340.75]",4,8,-4
31117.0,2020-02-09,"(340.75, 673.5]",4,12,-8
31117.0,2020-02-09,"(673.5, 1006.25]",5,26,-21
31117.0,2020-02-09,"(1006.25, 1339.0]",8,13,-5
31118.0,2020-02-09,"(16.584, 372.0]",1,2,-1
31118.0,2020-02-09,"(372.0, 726.0]",4,15,-11
31118.0,2020-02-09,"(726.0, 1080.0]",9,20,-11
31118.0,2020-02-09,"(1080.0, 1434.0]",5,7,-2
31119.0,2020-02-09,"(17.583, 373.25]",2,3,-1
31119.0,2020-02-09,"(373.25, 727.5]",8,20,-12
31119.0,2020-02-09,"(727.5, 1081.75]",17,31,-14
31119.0,2020-02-09,"(1081.75, 1436.0]",11,20,-9
31120.0,2020-02-09,"(199.78, 506.0]",2,2,0
31120.0,2020-02-09,"(506.0, 811.0]",9,18,-9
31120.0,2020-02-09,"(811.0, 1116.0]",4,15,-11
31120.0,2020-02-09,"(1116.0, 1421.0]",10,12,-2
31121.0,2020-02-09,"(108.723, 429.25]",2,2,0
31121.0,2020-02-09,"(429.25, 748.5]",4,9,-5
31121.0,2020-02-09,"(748.5, 1067.75]",9,24,-15
31121.0,2020-02-09,"(1067.75, 1387.0]",2,5,-3
31122.0,2020-02-09,"(175.85, 464.5]",1,2,-1
31122.0,2020-02-09,"(464.5, 752.0]",5,11,-6
31122.0,2020-02-09,"(752.0, 1039.5]",8,20,-12
31122.0,2020-02-09,"(1039.5, 1327.0]",5,9,-4
31123.0,2020-02-09,"(60.689, 389.75]",3,4,-1
31123.0,2020-02-09,"(389.75, 717.5]",2,13,-11
31123.0,2020-02-09,"(717.5, 1045.25]",7,13,-6
31123.0,2020-02-09,"(1045.25, 1373.0]",3,6,-3
31124.0,2020-02-09,"(349.0, 693.0]",5,3,2
31124.0,2020-02-09,"(693.0, 1037.0]",17,25,-8
31124.0,2020-02-09,"(1037.0, 1381.0]",14,43,-29
31125.0,2020-02-09,"(19.591, 373.25]",2,4,-2
31125.0,2020-02-09,"(373.25, 725.5]",9,27,-18
31125.0,2020-02-09,"(725.5, 1077.75]",21,42,-21
31125.0,2020-02-09,"(1077.75, 1430.0]",7,12,-5
31126.0,2020-02-09,"(0.573, 358.75]",2,2,0
31126.0,2020-02-09,"(358.75, 715.5]",5,12,-7
31126.0,2020-02-09,"(715.5, 1072.25]",11,38,-27
31126.0,2020-02-09,"(1072.25, 1429.0]",12,23,-11
31127.0,2020-02-09,"(-0.352, 339.0]",2,2,0
31127.0,2020-02-09,"(339.0, 677.0]",4,4,0
31127.0,2020-02-09,"(677.0, 1015.0]",5,17,-12
31127.0,2020-02-09,"(1015.0, 1353.0]",9,14,-5
31128.0,2020-02-09,"(18.64, 360.0]",1,2,-1
31128.0,2020-02-09,"(360.0, 700.0]",6,11,-5
31128.0,2020-02-09,"(700.0, 1040.0]",22,40,-18
31128.0,2020-02-09,"(1040.0, 1380.0]",4,10,-6
31129.0,2020-02-09,"(624.499, 750.25]",5,15,-10
31129.0,2020-02-09,"(750.25, 875.5]",6,7,-1
31129.0,2020-02-09,"(875.5, 1000.75]",5,8,-3
31129.0,2020-02-09,"(1000.75, 1126.0]",2,3,-1
31130.0,2020-02-09,"(549.319, 720.25]",2,6,-4
31130.0,2020-02-09,"(720.25, 890.5]",3,5,-2
31130.0,2020-02-09,"(890.5, 1060.75]",5,8,-3
31130.0,2020-02-09,"(1060.75, 1231.0]",1,2,-1
31131.0,2020-02-09,"(15.873, 298.75]",4,6,-2
31131.0,2020-02-09,"(580.5, 862.25]",1,4,-3
31131.0,2020-02-09,"(862.25, 1144.0]",4,9,-5
31200.0,2020-02-09,"(15.651, 354.25]",1,2,-1
31200.0,2020-02-09,"(354.25, 691.5]",8,12,-4
31200.0,2020-02-09,"(691.5, 1028.75]",36,74,-38
31200.0,2020-02-09,"(1028.75, 1366.0]",7,20,-13
31201.0,2020-02-09,"(392.5, 737.0]",28,3,25
31201.0,2020-02-09,"(737.0, 1081.5]",33,46,-13
31201.0,2020-02-09,"(1081.5, 1426.0]",14,72,-58
,,,,2.0,
31203.0,2020-02-09,"(-0.436, 360.0]",3,8,-5
31203.0,2020-02-09,"(360.0, 719.0]",15,28,-13
31203.0,2020-02-09,"(719.0, 1078.0]",41,72,-31
31203.0,2020-02-09,"(1078.0, 1437.0]",13,21,-8
31204.0,2020-02-09,"(60.645, 400.75]",2,2,0
31204.0,2020-02-09,"(400.75, 739.5]",3,10,-7
31204.0,2020-02-09,"(739.5, 1078.25]",7,15,-8
31204.0,2020-02-09,"(1078.25, 1417.0]",9,19,-10
31205.0,2020-02-09,"(591.159, 802.25]",7,11,-4
31205.0,2020-02-09,"(802.25, 1012.5]",6,12,-6
31205.0,2020-02-09,"(1012.5, 1222.75]",8,10,-2
31205.0,2020-02-09,"(1222.75, 1433.0]",2,7,-5
31206.0,2020-02-09,"(594.491, 722.25]",1,1,0
31206.0,2020-02-09,"(722.25, 849.5]",1,1,0
31206.0,2020-02-09,"(976.75, 1104.0]",2,1,1
31207.0,2020-02-09,"(730.5, 986.25]",2,2,0
31207.0,2020-02-09,"(986.25, 1242.0]",5,1,4
31208.0,2020-02-09,"(504.252, 692.0]",2,3,-1
31208.0,2020-02-09,"(692.0, 879.0]",1,3,-2
31208.0,2020-02-09,"(879.0, 1066.0]",4,6,-2
31209.0,2020-02-09,"(612.698, 688.5]",2,5,-3
31209.0,2020-02-09,"(688.5, 764.0]",1,1,0
31209.0,2020-02-09,"(839.5, 915.0]",5,5,0
31211.0,2020-02-09,"(619.487, 748.25]",1,2,-1
31211.0,2020-02-09,"(876.5, 1004.75]",6,10,-4
31211.0,2020-02-09,"(1004.75, 1133.0]",1,2,-1
31212.0,2020-02-09,"(67.732, 386.0]",2,4,-2
31212.0,2020-02-09,"(386.0, 703.0]",9,19,-10
31212.0,2020-02-09,"(703.0, 1020.0]",17,28,-11
31212.0,2020-02-09,"(1020.0, 1337.0]",9,15,-6
31213.0,2020-02-09,"(322.095, 549.25]",2,2,0
31213.0,2020-02-09,"(549.25, 775.5]",1,5,-4
31213.0,2020-02-09,"(775.5, 1001.75]",7,12,-5
31213.0,2020-02-09,"(1001.75, 1228.0]",1,5,-4
31214.0,2020-02-09,"(-0.395, 349.75]",4,6,-2
31214.0,2020-02-09,"(349.75, 698.5]",14,28,-14
31214.0,2020-02-09,"(698.5, 1047.25]",32,64,-32
31214.0,2020-02-09,"(1047.25, 1396.0]",23,34,-11
31215.0,2020-02-09,"(563.0, 844.5]",14,1,13
31215.0,2020-02-09,"(844.5, 1126.0]",23,21,2
31216.0,2020-02-09,"(434.75, 715.5]",3,1,2
31216.0,2020-02-09,"(715.5, 996.25]",6,3,3
31216.0,2020-02-09,"(996.25, 1277.0]",2,13,-11
31217.0,2020-02-09,"(797.566, 906.5]",3,6,-3
31217.0,2020-02-09,"(906.5, 1015.0]",2,2,0
31217.0,2020-02-09,"(1015.0, 1123.5]",1,6,-5
31217.0,2020-02-09,"(1123.5, 1232.0]",1,2,-1
31218.0,2020-02-09,"(11.78, 318.0]",1,3,-2
31218.0,2020-02-09,"(623.0, 928.0]",7,12,-5
31218.0,2020-02-09,"(928.0, 1233.0]",3,6,-3
31219.0,2020-02-09,"(629.43, 772.5]",7,10,-3
31219.0,2020-02-09,"(772.5, 915.0]",6,15,-9
31219.0,2020-02-09,"(915.0, 1057.5]",6,9,-3
31219.0,2020-02-09,"(1057.5, 1200.0]",2,6,-4
31220.0,2020-02-09,"(618.674, 700.5]",1,1,0
31220.0,2020-02-09,"(782.0, 863.5]",1,1,0
31221.0,2020-02-09,"(341.911, 615.25]",3,6,-3
31221.0,2020-02-09,"(615.25, 887.5]",7,12,-5
31221.0,2020-02-09,"(887.5, 1159.75]",2,6,-4
31221.0,2020-02-09,"(1159.75, 1432.0]",4,5,-1
31222.0,2020-02-09,"(69.887, 349.25]",1,2,-1
31222.0,2020-02-09,"(349.25, 627.5]",3,4,-1
31222.0,2020-02-09,"(627.5, 905.75]",6,12,-6
31222.0,2020-02-09,"(905.75, 1184.0]",9,13,-4
31223.0,2020-02-09,"(367.75, 721.5]",6,1,5
31223.0,2020-02-09,"(721.5, 1075.25]",3,11,-8
31223.0,2020-02-09,"(1075.25, 1429.0]",4,7,-3
31224.0,2020-02-09,"(597.75, 872.5]",1,1,0
31224.0,2020-02-09,"(872.5, 1147.25]",5,3,2
31224.0,2020-02-09,"(1147.25, 1422.0]",1,7,-6
31225.0,2020-02-09,"(465.255, 652.25]",1,3,-2
31225.0,2020-02-09,"(652.25, 838.5]",6,7,-1
31225.0,2020-02-09,"(838.5, 1024.75]",4,10,-6
31225.0,2020-02-09,"(1024.75, 1211.0]",5,9,-4
31226.0,2020-02-09,"(571.335, 738.25]",3,6,-3
31226.0,2020-02-09,"(738.25, 904.5]",8,17,-9
31226.0,2020-02-09,"(904.5, 1070.75]",4,6,-2
31226.0,2020-02-09,"(1070.75, 1237.0]",1,3,-2
31227.0,2020-02-09,"(80.899, 357.25]",1,1,0
31227.0,2020-02-09,"(357.25, 632.5]",2,2,0
31227.0,2020-02-09,"(632.5, 907.75]",4,6,-2
31227.0,2020-02-09,"(907.75, 1183.0]",6,11,-5
31228.0,2020-02-09,"(36.607, 386.25]",1,3,-2
31228.0,2020-02-09,"(386.25, 734.5]",10,12,-2
31228.0,2020-02-09,"(734.5, 1082.75]",23,35,-12
31228.0,2020-02-09,"(1082.75, 1431.0]",9,22,-13
31229.0,2020-02-09,"(42.615, 390.25]",1,10,-9
31229.0,2020-02-09,"(390.25, 736.5]",15,27,-12
31229.0,2020-02-09,"(736.5, 1082.75]",39,72,-33
31229.0,2020-02-09,"(1082.75, 1429.0]",11,28,-17
31230.0,2020-02-09,"(519.268, 703.0]",5,5,0
31230.0,2020-02-09,"(703.0, 886.0]",6,12,-6
31230.0,2020-02-09,"(886.0, 1069.0]",11,20,-9
31230.0,2020-02-09,"(1069.0, 1252.0]",8,14,-6
31231.0,2020-02-09,"(759.693, 836.75]",7,7,0
31231.0,2020-02-09,"(836.75, 913.5]",4,8,-4
31231.0,2020-02-09,"(913.5, 990.25]",2,2,0
31231.0,2020-02-09,"(990.25, 1067.0]",1,2,-1
31232.0,2020-02-09,"(10.628, 355.0]",2,7,-5
31232.0,2020-02-09,"(355.0, 698.0]",3,10,-7
31232.0,2020-02-09,"(698.0, 1041.0]",20,40,-20
31232.0,2020-02-09,"(1041.0, 1384.0]",20,32,-12
31233.0,2020-02-09,"(112.724, 433.0]",4,4,0
31233.0,2020-02-09,"(433.0, 752.0]",4,8,-4
31233.0,2020-02-09,"(752.0, 1071.0]",12,15,-3
31233.0,2020-02-09,"(1071.0, 1390.0]",1,4,-3
31234.0,2020-02-09,"(50.647, 390.25]",2,2,0
31234.0,2020-02-09,"(390.25, 728.5]",27,38,-11
31234.0,2020-02-09,"(728.5, 1066.75]",19,41,-22
31234.0,2020-02-09,"(1066.75, 1405.0]",8,11,-3
31235.0,2020-02-09,"(647.571, 755.25]",1,5,-4
31235.0,2020-02-09,"(755.25, 862.5]",2,4,-2
31235.0,2020-02-09,"(862.5, 969.75]",5,14,-9
31235.0,2020-02-09,"(969.75, 1077.0]",6,8,-2
31236.0,2020-02-09,"(393.0, 711.0]",8,1,7
31236.0,2020-02-09,"(711.0, 1029.0]",17,10,7
31236.0,2020-02-09,"(1029.0, 1347.0]",8,35,-27
31237.0,2020-02-09,"(547.147, 761.25]",4,15,-11
31237.0,2020-02-09,"(761.25, 974.5]",14,24,-10
31237.0,2020-02-09,"(974.5, 1187.75]",10,21,-11
31237.0,2020-02-09,"(1187.75, 1401.0]",2,3,-1
31238.0,2020-02-09,"(54.777, 361.75]",2,2,0
31238.0,2020-02-09,"(361.75, 667.5]",1,3,-2
31238.0,2020-02-09,"(667.5, 973.25]",8,10,-2
31238.0,2020-02-09,"(973.25, 1279.0]",3,8,-5
31239.0,2020-02-09,"(334.25, 602.5]",2,1,1
31239.0,2020-02-09,"(602.5, 870.75]",13,4,9
31239.0,2020-02-09,"(870.75, 1139.0]",6,17,-11
31240.0,2020-02-09,"(145.748, 460.0]",2,2,0
31240.0,2020-02-09,"(460.0, 773.0]",5,12,-7
31240.0,2020-02-09,"(773.0, 1086.0]",13,28,-15
31240.0,2020-02-09,"(1086.0, 1399.0]",7,8,-1
31241.0,2020-02-09,"(358.0, 715.0]",3,2,1
31241.0,2020-02-09,"(715.0, 1072.0]",17,23,-6
31241.0,2020-02-09,"(1072.0, 1429.0]",14,33,-19
31242.0,2020-02-09,"(350.028, 594.0]",1,2,-1
31242.0,2020-02-09,"(594.0, 837.0]",7,12,-5
31242.0,2020-02-09,"(837.0, 1080.0]",5,6,-1
31243.0,2020-02-09,"(454.155, 666.25]",2,5,-3
31243.0,2020-02-09,"(666.25, 877.5]",6,7,-1
31243.0,2020-02-09,"(877.5, 1088.75]",2,8,-6
31243.0,2020-02-09,"(1088.75, 1300.0]",2,2,0
31244.0,2020-02-09,"(97.774, 405.5]",2,4,-2
31244.0,2020-02-09,"(405.5, 712.0]",2,3,-1
31244.0,2020-02-09,"(712.0, 1018.5]",4,12,-8
31244.0,2020-02-09,"(1018.5, 1325.0]",6,10,-4
31245.0,2020-02-09,"(517.148, 731.0]",4,6,-2
31245.0,2020-02-09,"(731.0, 944.0]",11,18,-7
31245.0,2020-02-09,"(944.0, 1157.0]",9,21,-12
31245.0,2020-02-09,"(1157.0, 1370.0]",3,5,-2
31246.0,2020-02-09,"(24.86, 311.0]",2,3,-1
31246.0,2020-02-09,"(311.0, 596.0]",5,6,-1
31246.0,2020-02-09,"(596.0, 881.0]",28,43,-15
31246.0,2020-02-09,"(881.0, 1166.0]",28,44,-16
31247.0,2020-02-09,"(475.27, 658.5]",4,8,-4
31247.0,2020-02-09,"(658.5, 841.0]",25,45,-20
31247.0,2020-02-09,"(841.0, 1023.5]",27,51,-24
31247.0,2020-02-09,"(1023.5, 1206.0]",15,32,-17
31248.0,2020-02-09,"(519.375, 676.25]",4,5,-1
31248.0,2020-02-09,"(676.25, 832.5]",28,40,-12
31248.0,2020-02-09,"(832.5, 988.75]",22,56,-34
31248.0,2020-02-09,"(988.75, 1145.0]",11,25,-14
31249.0,2020-02-09,"(30.815, 328.25]",1,4,-3
31249.0,2020-02-09,"(624.5, 920.75]",17,33,-16
31249.0,2020-02-09,"(920.75, 1217.0]",12,24,-12
31250.0,2020-02-09,"(584.0, 860.5]",5,2,3
31251.0,2020-02-09,"(349.116, 571.0]",1,4,-3
31251.0,2020-02-09,"(571.0, 792.0]",5,8,-3
31251.0,2020-02-09,"(792.0, 1013.0]",6,14,-8
31251.0,2020-02-09,"(1013.0, 1234.0]",6,8,-2
31252.0,2020-02-09,"(126.787, 431.25]",1,1,0
31252.0,2020-02-09,"(734.5, 1037.75]",1,4,-3
31252.0,2020-02-09,"(1037.75, 1341.0]",1,1,0
31253.0,2020-02-09,"(444.258, 630.5]",1,1,0
31253.0,2020-02-09,"(630.5, 816.0]",2,3,-1
31253.0,2020-02-09,"(816.0, 1001.5]",3,4,-1
31253.0,2020-02-09,"(1001.5, 1187.0]",2,4,-2
31254.0,2020-02-09,"(99.808, 399.0]",2,5,-3
31254.0,2020-02-09,"(399.0, 697.0]",1,1,0
31254.0,2020-02-09,"(697.0, 995.0]",1,6,-5
31254.0,2020-02-09,"(995.0, 1293.0]",3,4,-1
31255.0,2020-02-09,"(524.106, 748.5]",3,5,-2
31255.0,2020-02-09,"(748.5, 972.0]",2,5,-3
31255.0,2020-02-09,"(972.0, 1195.5]",3,4,-1
31255.0,2020-02-09,"(1195.5, 1419.0]",2,4,-2
31256.0,2020-02-09,"(415.045, 654.75]",4,7,-3
31256.0,2020-02-09,"(654.75, 893.5]",19,24,-5
31256.0,2020-02-09,"(893.5, 1132.25]",7,17,-10
31256.0,2020-02-09,"(1132.25, 1371.0]",3,6,-3
31257.0,2020-02-09,"(314.5, 612.0]",5,3,2
31257.0,2020-02-09,"(612.0, 909.5]",12,8,4
31257.0,2020-02-09,"(909.5, 1207.0]",10,24,-14
31258.0,2020-02-09,"(105.859, 392.25]",2,2,0
31258.0,2020-02-09,"(392.25, 677.5]",5,12,-7
31258.0,2020-02-09,"(677.5, 962.75]",47,113,-66
31258.0,2020-02-09,"(962.75, 1248.0]",11,26,-15
31259.0,2020-02-09,"(879.837, 920.75]",1,1,0
31260.0,2020-02-09,"(845.5, 1100.25]",2,3,-1
31260.0,2020-02-09,"(1100.25, 1355.0]",2,3,-1
31261.0,2020-02-09,"(617.531, 735.25]",6,8,-2
31261.0,2020-02-09,"(852.5, 969.75]",6,6,0
31261.0,2020-02-09,"(969.75, 1087.0]",2,7,-5
31262.0,2020-02-09,"(481.045, 720.75]",2,3,-1
31262.0,2020-02-09,"(720.75, 959.5]",5,7,-2
31262.0,2020-02-09,"(1198.25, 1437.0]",2,1,1
31263.0,2020-02-09,"(39.693, 367.75]",1,2,-1
31263.0,2020-02-09,"(367.75, 694.5]",8,13,-5
31263.0,2020-02-09,"(694.5, 1021.25]",12,16,-4
31263.0,2020-02-09,"(1021.25, 1348.0]",4,14,-10
31264.0,2020-02-09,"(654.604, 754.0]",3,7,-4
31264.0,2020-02-09,"(754.0, 853.0]",4,9,-5
31264.0,2020-02-09,"(853.0, 952.0]",6,7,-1
31264.0,2020-02-09,"(952.0, 1051.0]",2,10,-8
31265.0,2020-02-09,"(6.574, 364.5]",2,3,-1
31265.0,2020-02-09,"(364.5, 721.0]",3,11,-8
31265.0,2020-02-09,"(721.0, 1077.5]",23,44,-21
31265.0,2020-02-09,"(1077.5, 1434.0]",9,15,-6
31266.0,2020-02-09,"(24.601, 375.75]",2,5,-3
31266.0,2020-02-09,"(375.75, 725.5]",7,24,-17
31266.0,2020-02-09,"(725.5, 1075.25]",22,40,-18
31266.0,2020-02-09,"(1075.25, 1425.0]",20,38,-18
31267.0,2020-02-09,"(29.724, 350.0]",2,3,-1
31267.0,2020-02-09,"(350.0, 669.0]",5,9,-4
31267.0,2020-02-09,"(669.0, 988.0]",16,41,-25
31267.0,2020-02-09,"(988.0, 1307.0]",8,15,-7
31268.0,2020-02-09,"(8.591, 362.25]",4,12,-8
31268.0,2020-02-09,"(362.25, 714.5]",7,10,-3
31268.0,2020-02-09,"(714.5, 1066.75]",17,28,-11
31268.0,2020-02-09,"(1066.75, 1419.0]",7,17,-10
31269.0,2020-02-09,"(402.25, 734.5]",6,1,5
31269.0,2020-02-09,"(734.5, 1066.75]",6,10,-4
31269.0,2020-02-09,"(1066.75, 1399.0]",3,16,-13
31270.0,2020-02-09,"(522.0, 778.0]",9,1,8
31270.0,2020-02-09,"(778.0, 1034.0]",8,11,-3
31270.0,2020-02-09,"(1034.0, 1290.0]",5,13,-8
31271.0,2020-02-09,"(584.463, 719.25]",5,7,-2
31271.0,2020-02-09,"(719.25, 853.5]",2,3,-1
31271.0,2020-02-09,"(853.5, 987.75]",9,18,-9
31271.0,2020-02-09,"(987.75, 1122.0]",5,12,-7
31272.0,2020-02-09,"(529.439, 670.25]",5,6,-1
31272.0,2020-02-09,"(670.25, 810.5]",8,14,-6
31272.0,2020-02-09,"(810.5, 950.75]",6,15,-9
31272.0,2020-02-09,"(950.75, 1091.0]",6,10,-4
31273.0,2020-02-09,"(603.453, 740.75]",5,9,-4
31273.0,2020-02-09,"(740.75, 877.5]",1,3,-2
31273.0,2020-02-09,"(877.5, 1014.25]",4,8,-4
31273.0,2020-02-09,"(1014.25, 1151.0]",2,5,-3
31274.0,2020-02-09,"(425.263, 610.25]",4,6,-2
31274.0,2020-02-09,"(610.25, 794.5]",3,5,-2
31274.0,2020-02-09,"(794.5, 978.75]",11,15,-4
31274.0,2020-02-09,"(978.75, 1163.0]",1,5,-4
31275.0,2020-02-09,"(781.351, 944.25]",8,8,0
31275.0,2020-02-09,"(944.25, 1106.5]",1,6,-5
31275.0,2020-02-09,"(1106.5, 1268.75]",4,8,-4
31275.0,2020-02-09,"(1268.75, 1431.0]",5,8,-3
31276.0,2020-02-09,"(353.75, 639.5]",1,1,0
31276.0,2020-02-09,"(639.5, 925.25]",4,3,1
31276.0,2020-02-09,"(925.25, 1211.0]",4,10,-6
31277.0,2020-02-09,"(277.048, 516.0]",2,2,0
31277.0,2020-02-09,"(516.0, 754.0]",6,11,-5
31277.0,2020-02-09,"(754.0, 992.0]",12,22,-10
31277.0,2020-02-09,"(992.0, 1230.0]",3,6,-3
31278.0,2020-02-09,"(1.585, 356.75]",2,3,-1
31278.0,2020-02-09,"(356.75, 710.5]",13,24,-11
31278.0,2020-02-09,"(710.5, 1064.25]",27,53,-26
31278.0,2020-02-09,"(1064.25, 1418.0]",6,14,-8
31279.0,2020-02-09,"(587.342, 752.5]",1,3,-2
31279.0,2020-02-09,"(917.0, 1081.5]",2,3,-1
31279.0,2020-02-09,"(1081.5, 1246.0]",1,1,0
31280.0,2020-02-09,"(154.923, 425.25]",2,3,-1
31280.0,2020-02-09,"(425.25, 694.5]",10,16,-6
31280.0,2020-02-09,"(694.5, 963.75]",14,31,-17
31280.0,2020-02-09,"(963.75, 1233.0]",13,19,-6
,,,,1.0,
,,,,1.0,
,,,,1.0,
,,,,1.0,
31002.0,2020-02-10,"(585.294, 762.5]",3,7,-4
31002.0,2020-02-10,"(939.0, 1115.5]",1,2,-1
31002.0,2020-02-10,"(1115.5, 1292.0]",1,1,0
31003.0,2020-02-10,"(561.5, 743.0]",1,1,0
31003.0,2020-02-10,"(924.5, 1106.0]",1,2,-1
31004.0,2020-02-10,"(825.0, 1100.0]",1,1,0
31005.0,2020-02-10,"(374.278, 555.5]",1,2,-1
31005.0,2020-02-10,"(555.5, 736.0]",3,3,0
31006.0,2020-02-10,"(539.209, 737.75]",2,5,-3
31006.0,2020-02-10,"(935.5, 1133.25]",1,1,0
31006.0,2020-02-10,"(1133.25, 1331.0]",1,2,-1
31007.0,2020-02-10,"(319.209, 517.75]",2,5,-3
31007.0,2020-02-10,"(913.25, 1111.0]",1,3,-2
31009.0,2020-02-10,"(1005.25, 1009.0]",1,1,0
31010.0,2020-02-10,"(809.496, 936.0]",1,2,-1
31010.0,2020-02-10,"(1188.0, 1314.0]",1,2,-1
31011.0,2020-02-10,"(172.059, 408.25]",1,1,0
31011.0,2020-02-10,"(408.25, 643.5]",2,2,0
31011.0,2020-02-10,"(643.5, 878.75]",1,1,0
31011.0,2020-02-10,"(878.75, 1114.0]",3,6,-3
31012.0,2020-02-10,"(367.385, 521.75]",3,3,0
31012.0,2020-02-10,"(521.75, 675.5]",1,1,0
31012.0,2020-02-10,"(829.25, 983.0]",1,2,-1
31013.0,2020-02-10,"(386.05, 624.5]",1,2,-1
31014.0,2020-02-10,"(344.017, 590.75]",6,6,0
31014.0,2020-02-10,"(590.75, 836.5]",1,4,-3
31014.0,2020-02-10,"(836.5, 1082.25]",8,8,0
31014.0,2020-02-10,"(1082.25, 1328.0]",6,10,-4
31015.0,2020-02-10,"(279.5, 554.0]",1,1,0
31015.0,2020-02-10,"(554.0, 828.5]",2,2,0
31015.0,2020-02-10,"(828.5, 1103.0]",3,3,0
31016.0,2020-02-10,"(363.269, 546.75]",1,2,-1
31016.0,2020-02-10,"(912.25, 1095.0]",1,2,-1
31017.0,2020-02-10,"(674.306, 848.5]",1,4,-3
31017.0,2020-02-10,"(1022.0, 1195.5]",1,2,-1
,,,,2.0,
31019.0,2020-02-10,"(651.323, 821.25]",1,1,0
31019.0,2020-02-10,"(821.25, 990.5]",1,2,-1
31019.0,2020-02-10,"(990.5, 1159.75]",1,1,0
31019.0,2020-02-10,"(1159.75, 1329.0]",2,6,-4
31020.0,2020-02-10,"(639.985, 643.75]",1,1,0
31021.0,2020-02-10,"(833.0, 1039.5]",1,2,-1
31021.0,2020-02-10,"(1039.5, 1246.0]",1,3,-2
31022.0,2020-02-10,"(495.081, 725.75]",3,4,-1
31022.0,2020-02-10,"(725.75, 955.5]",1,1,0
31022.0,2020-02-10,"(955.5, 1185.25]",1,1,0
31022.0,2020-02-10,"(1185.25, 1415.0]",3,7,-4
,,,,1.0,
,,,,1.0,
31024.0,2020-02-10,"(495.75, 642.5]",1,1,0
31024.0,2020-02-10,"(789.25, 936.0]",3,2,1
,,,,1.0,
,,,,1.0,
31026.0,2020-02-10,"(433.25, 761.5]",1,1,0
31026.0,2020-02-10,"(1089.75, 1418.0]",1,1,0
31027.0,2020-02-10,"(717.9, 743.0]",1,2,-1
31027.0,2020-02-10,"(793.0, 818.0]",1,1,0
31028.0,2020-02-10,"(1194.5, 1282.25]",1,1,0
31028.0,2020-02-10,"(1282.25, 1370.0]",1,1,0
31029.0,2020-02-10,"(889.5, 1087.75]",1,3,-2
31029.0,2020-02-10,"(1087.75, 1286.0]",3,1,2
31030.0,2020-02-10,"(424.103, 649.25]",1,3,-2
31030.0,2020-02-10,"(873.5, 1097.75]",1,2,-1
31030.0,2020-02-10,"(1097.75, 1322.0]",2,3,-1
31031.0,2020-02-10,"(598.0, 836.0]",2,1,1
31031.0,2020-02-10,"(1074.0, 1312.0]",3,2,1
31032.0,2020-02-10,"(693.5, 829.0]",2,1,1
31032.0,2020-02-10,"(964.5, 1100.0]",1,4,-3
31033.0,2020-02-10,"(978.75, 1305.0]",2,1,1
31034.0,2020-02-10,"(1323.5, 1355.0]",1,1,0
,,,,1.0,
,,,,1.0,
31036.0,2020-02-10,"(720.5, 933.0]",1,1,0
31036.0,2020-02-10,"(933.0, 1145.5]",3,1,2
31036.0,2020-02-10,"(1145.5, 1358.0]",1,3,-2
31037.0,2020-02-10,"(316.964, 577.0]",5,6,-1
31037.0,2020-02-10,"(577.0, 836.0]",2,2,0
31037.0,2020-02-10,"(836.0, 1095.0]",2,7,-5
31038.0,2020-02-10,"(354.5, 531.75]",1,1,0
31038.0,2020-02-10,"(531.75, 709.0]",1,1,0
31039.0,2020-02-10,"(499.208, 698.0]",2,2,0
31039.0,2020-02-10,"(1094.0, 1292.0]",1,1,0
31040.0,2020-02-10,"(568.25, 756.5]",2,2,0
,,,,2.0,
31042.0,2020-02-10,"(466.5, 699.75]",3,1,2
31042.0,2020-02-10,"(699.75, 933.0]",3,3,0
,,,,1.0,
,,,,1.0,
,,,,1.0,
31044.0,2020-02-10,"(590.444, 730.0]",1,1,0
31044.0,2020-02-10,"(1008.0, 1147.0]",1,1,0
31045.0,2020-02-10,"(621.497, 747.75]",1,1,0
31045.0,2020-02-10,"(999.25, 1125.0]",2,1,1
,,,,1.0,
,,,,2.0,
31047.0,2020-02-10,"(418.077, 649.75]",4,5,-1
31047.0,2020-02-10,"(1111.25, 1342.0]",1,4,-3
31048.0,2020-02-10,"(749.75, 913.5]",1,4,-3
31048.0,2020-02-10,"(913.5, 1077.25]",3,3,0
31049.0,2020-02-10,"(1299.0, 1325.0]",1,1,0
,,,,1.0,
,,,,1.0,
31051.0,2020-02-10,"(967.0, 1118.0]",4,2,2
31052.0,2020-02-10,"(527.719, 598.25]",1,2,-1
31052.0,2020-02-10,"(738.75, 809.0]",1,1,0
,,,,2.0,
,,,,2.0,
31055.0,2020-02-10,"(397.266, 581.5]",1,2,-1
31055.0,2020-02-10,"(948.5, 1132.0]",1,1,0
31056.0,2020-02-10,"(17.637, 359.75]",1,1,0
31056.0,2020-02-10,"(1041.25, 1382.0]",1,2,-1
,,,,2.0,
31058.0,2020-02-10,"(96.666, 431.5]",1,2,-1
31058.0,2020-02-10,"(1098.5, 1432.0]",2,4,-2
31059.0,2020-02-10,"(780.999, 781.25]",1,1,0
,,,,3.0,
,,,,2.0,
,,,,2.0,
31062.0,2020-02-10,"(842.784, 897.0]",1,1,0
31062.0,2020-02-10,"(1005.0, 1059.0]",1,2,-1
31063.0,2020-02-10,"(12.75, 17.0]",1,1,0
31064.0,2020-02-10,"(824.739, 890.25]",1,2,-1
31064.0,2020-02-10,"(955.5, 1020.75]",1,2,-1
31064.0,2020-02-10,"(1020.75, 1086.0]",2,4,-2
,,,,2.0,
31066.0,2020-02-10,"(675.25, 721.0]",2,1,1
31067.0,2020-02-10,"(102.054, 339.5]",1,2,-1
31067.0,2020-02-10,"(339.5, 576.0]",1,1,0
31068.0,2020-02-10,"(1005.0, 1340.0]",1,1,0
31069.0,2020-02-10,"(1035.5, 1237.0]",1,2,-1
31070.0,2020-02-10,"(925.5, 1091.0]",1,2,-1
31070.0,2020-02-10,"(1091.0, 1256.5]",1,1,0
31070.0,2020-02-10,"(1256.5, 1422.0]",1,1,0
31071.0,2020-02-10,"(471.426, 615.5]",1,2,-1
31071.0,2020-02-10,"(615.5, 759.0]",2,4,-2
31071.0,2020-02-10,"(902.5, 1046.0]",1,1,0
,,,,2.0,
31073.0,2020-02-10,"(472.399, 623.25]",1,2,-1
31073.0,2020-02-10,"(923.75, 1074.0]",1,1,0
31074.0,2020-02-10,"(912.75, 1056.0]",1,1,0
,,,,2.0,
31076.0,2020-02-10,"(785.25, 1047.0]",1,1,0
31077.0,2020-02-10,"(731.0, 904.0]",2,1,1
31077.0,2020-02-10,"(1077.0, 1250.0]",2,2,0
31078.0,2020-02-10,"(507.571, 615.25]",1,1,0
31079.0,2020-02-10,"(466.059, 702.25]",2,7,-5
31079.0,2020-02-10,"(937.5, 1172.75]",2,2,0
31079.0,2020-02-10,"(1172.75, 1408.0]",6,2,4
31080.0,2020-02-10,"(518.183, 723.25]",2,6,-4
31080.0,2020-02-10,"(927.5, 1131.75]",1,1,0
31080.0,2020-02-10,"(1131.75, 1336.0]",2,2,0
,,,,1.0,
,,,,2.0,
31082.0,2020-02-10,"(768.74, 834.0]",1,2,-1
,,,,2.0,
31084.0,2020-02-10,"(635.566, 744.5]",3,3,0
31084.0,2020-02-10,"(961.5, 1070.0]",1,3,-2
31085.0,2020-02-10,"(402.882, 432.5]",1,1,0
31086.0,2020-02-10,"(863.0, 1011.0]",1,1,0
31087.0,2020-02-10,"(946.75, 1123.0]",2,3,-1
31088.0,2020-02-10,"(1031.705, 1105.75]",2,2,0
31088.0,2020-02-10,"(1179.5, 1253.25]",1,2,-1
31088.0,2020-02-10,"(1253.25, 1327.0]",1,1,0
31089.0,2020-02-10,"(471.161, 681.75]",5,7,-2
31089.0,2020-02-10,"(891.5, 1101.25]",1,2,-1
31089.0,2020-02-10,"(1101.25, 1311.0]",1,7,-6
31090.0,2020-02-10,"(891.5, 1043.0]",1,1,0
31091.0,2020-02-10,"(377.035, 619.25]",1,4,-3
31091.0,2020-02-10,"(1101.75, 1343.0]",4,4,0
31092.0,2020-02-10,"(790.0, 934.5]",1,2,-1
31092.0,2020-02-10,"(934.5, 1079.0]",1,1,0
31093.0,2020-02-10,"(910.75, 1078.0]",1,1,0
,,,,2.0,
,,,,1.0,
,,,,1.0,
,,,,2.0,
31097.0,2020-02-10,"(517.486, 646.5]",1,1,0
31098.0,2020-02-10,"(714.25, 937.5]",1,2,-1
31098.0,2020-02-10,"(1160.75, 1384.0]",1,2,-1
31099.0,2020-02-10,"(919.5, 1125.0]",1,1,0
31100.0,2020-02-10,"(434.058, 670.5]",6,7,-1
31100.0,2020-02-10,"(670.5, 906.0]",2,2,0
31100.0,2020-02-10,"(906.0, 1141.5]",1,3,-2
31100.0,2020-02-10,"(1141.5, 1377.0]",1,3,-2
31101.0,2020-02-10,"(21.725, 341.75]",2,3,-1
31101.0,2020-02-10,"(341.75, 660.5]",7,19,-12
31101.0,2020-02-10,"(660.5, 979.25]",9,16,-7
31101.0,2020-02-10,"(979.25, 1298.0]",22,33,-11
31102.0,2020-02-10,"(337.967, 597.25]",1,11,-10
31102.0,2020-02-10,"(855.5, 1113.75]",2,1,1
31102.0,2020-02-10,"(1113.75, 1372.0]",5,3,2
31103.0,2020-02-10,"(388.043, 628.25]",1,8,-7
31103.0,2020-02-10,"(628.25, 867.5]",1,3,-2
31103.0,2020-02-10,"(867.5, 1106.75]",3,5,-2
31103.0,2020-02-10,"(1106.75, 1346.0]",5,13,-8
31104.0,2020-02-10,"(0.642, 341.5]",1,4,-3
31104.0,2020-02-10,"(341.5, 681.0]",1,12,-11
31104.0,2020-02-10,"(681.0, 1020.5]",2,2,0
31104.0,2020-02-10,"(1020.5, 1360.0]",7,14,-7
31105.0,2020-02-10,"(1166.25, 1380.0]",2,4,-2
31106.0,2020-02-10,"(352.07, 585.5]",1,1,0
31106.0,2020-02-10,"(818.0, 1050.5]",1,1,0
31106.0,2020-02-10,"(1050.5, 1283.0]",1,1,0
31107.0,2020-02-10,"(296.939, 563.25]",2,9,-7
31107.0,2020-02-10,"(563.25, 828.5]",4,13,-9
31107.0,2020-02-10,"(828.5, 1093.75]",4,7,-3
31107.0,2020-02-10,"(1093.75, 1359.0]",10,16,-6
31108.0,2020-02-10,"(350.009, 598.75]",2,7,-5
31108.0,2020-02-10,"(598.75, 846.5]",6,12,-6
31108.0,2020-02-10,"(846.5, 1094.25]",3,5,-2
31108.0,2020-02-10,"(1094.25, 1342.0]",10,13,-3
31109.0,2020-02-10,"(63.691, 392.25]",1,2,-1
31109.0,2020-02-10,"(392.25, 719.5]",4,10,-6
31109.0,2020-02-10,"(719.5, 1046.75]",5,5,0
31109.0,2020-02-10,"(1046.75, 1374.0]",8,14,-6
31110.0,2020-02-10,"(310.902, 586.5]",7,15,-8
31110.0,2020-02-10,"(586.5, 861.0]",2,4,-2
31110.0,2020-02-10,"(861.0, 1135.5]",9,15,-6
31110.0,2020-02-10,"(1135.5, 1410.0]",6,14,-8
31111.0,2020-02-10,"(323.185, 527.75]",4,7,-3
31111.0,2020-02-10,"(935.25, 1139.0]",5,2,3
31112.0,2020-02-10,"(360.217, 556.75]",1,4,-3
31112.0,2020-02-10,"(556.75, 752.5]",1,1,0
31112.0,2020-02-10,"(948.25, 1144.0]",4,6,-2
31113.0,2020-02-10,"(566.0, 815.0]",1,7,-6
31113.0,2020-02-10,"(815.0, 1064.0]",1,6,-5
31113.0,2020-02-10,"(1064.0, 1313.0]",2,2,0
31114.0,2020-02-10,"(335.042, 575.5]",2,14,-12
31114.0,2020-02-10,"(575.5, 815.0]",1,3,-2
31114.0,2020-02-10,"(815.0, 1054.5]",5,9,-4
31114.0,2020-02-10,"(1054.5, 1294.0]",9,15,-6
31115.0,2020-02-10,"(346.988, 601.0]",1,8,-7
31115.0,2020-02-10,"(854.0, 1107.0]",2,5,-3
31115.0,2020-02-10,"(1107.0, 1360.0]",6,8,-2
31116.0,2020-02-10,"(329.896, 607.0]",4,11,-7
31116.0,2020-02-10,"(607.0, 883.0]",3,4,-1
31116.0,2020-02-10,"(883.0, 1159.0]",10,14,-4
31116.0,2020-02-10,"(1159.0, 1435.0]",5,6,-1
31117.0,2020-02-10,"(303.0, 599.0]",6,1,5
31117.0,2020-02-10,"(599.0, 895.0]",1,20,-19
31117.0,2020-02-10,"(895.0, 1191.0]",6,6,0
31118.0,2020-02-10,"(413.078, 644.5]",2,8,-6
31118.0,2020-02-10,"(875.0, 1105.5]",4,6,-2
31118.0,2020-02-10,"(1105.5, 1336.0]",9,11,-2
31119.0,2020-02-10,"(351.75, 702.5]",7,1,6
31119.0,2020-02-10,"(702.5, 1053.25]",7,18,-11
31119.0,2020-02-10,"(1053.25, 1404.0]",13,12,1
31120.0,2020-02-10,"(400.992, 654.0]",1,10,-9
31120.0,2020-02-10,"(654.0, 906.0]",1,4,-3
31120.0,2020-02-10,"(906.0, 1158.0]",1,2,-1
31120.0,2020-02-10,"(1158.0, 1410.0]",2,3,-1
31121.0,2020-02-10,"(327.092, 555.0]",7,9,-2
31121.0,2020-02-10,"(555.0, 782.0]",1,3,-2
31121.0,2020-02-10,"(782.0, 1009.0]",2,3,-1
31121.0,2020-02-10,"(1009.0, 1236.0]",6,13,-7
31122.0,2020-02-10,"(90.66, 427.0]",1,1,0
31122.0,2020-02-10,"(427.0, 762.0]",2,7,-5
31122.0,2020-02-10,"(762.0, 1097.0]",2,5,-3
31122.0,2020-02-10,"(1097.0, 1432.0]",7,13,-6
31123.0,2020-02-10,"(370.179, 576.25]",1,6,-5
31123.0,2020-02-10,"(986.75, 1192.0]",1,3,-2
31124.0,2020-02-10,"(326.9, 603.0]",7,14,-7
31124.0,2020-02-10,"(603.0, 878.0]",2,10,-8
31124.0,2020-02-10,"(878.0, 1153.0]",9,16,-7
31124.0,2020-02-10,"(1153.0, 1428.0]",7,18,-11
31125.0,2020-02-10,"(75.671, 409.25]",1,2,-1
31125.0,2020-02-10,"(409.25, 741.5]",3,11,-8
31125.0,2020-02-10,"(741.5, 1073.75]",12,17,-5
31125.0,2020-02-10,"(1073.75, 1406.0]",11,15,-4
31126.0,2020-02-10,"(13.646, 353.5]",1,4,-3
31126.0,2020-02-10,"(353.5, 692.0]",2,12,-10
31126.0,2020-02-10,"(692.0, 1030.5]",6,8,-2
31126.0,2020-02-10,"(1030.5, 1369.0]",16,22,-6
31127.0,2020-02-10,"(332.0, 664.0]",2,1,1
31127.0,2020-02-10,"(664.0, 996.0]",11,4,7
31127.0,2020-02-10,"(996.0, 1328.0]",4,15,-11
31128.0,2020-02-10,"(379.069, 612.75]",15,18,-3
31128.0,2020-02-10,"(612.75, 845.5]",6,11,-5
31128.0,2020-02-10,"(845.5, 1078.25]",2,5,-3
31128.0,2020-02-10,"(1078.25, 1311.0]",5,12,-7
31129.0,2020-02-10,"(425.345, 589.75]",2,4,-2
31129.0,2020-02-10,"(589.75, 753.5]",2,2,0
31129.0,2020-02-10,"(753.5, 917.25]",1,1,0
31129.0,2020-02-10,"(917.25, 1081.0]",2,4,-2
31130.0,2020-02-10,"(437.009, 685.75]",1,5,-4
31130.0,2020-02-10,"(933.5, 1181.25]",7,1,6
31130.0,2020-02-10,"(1181.25, 1429.0]",1,10,-9
31131.0,2020-02-10,"(675.0, 917.0]",1,3,-2
31131.0,2020-02-10,"(917.0, 1159.0]",1,3,-2
31131.0,2020-02-10,"(1159.0, 1401.0]",3,2,1
31200.0,2020-02-10,"(358.99, 612.5]",10,14,-4
31200.0,2020-02-10,"(612.5, 865.0]",2,3,-1
31200.0,2020-02-10,"(865.0, 1117.5]",5,11,-6
31200.0,2020-02-10,"(1117.5, 1370.0]",9,23,-14
31201.0,2020-02-10,"(8.608, 358.0]",3,4,-1
31201.0,2020-02-10,"(358.0, 706.0]",9,17,-8
31201.0,2020-02-10,"(706.0, 1054.0]",11,20,-9
31201.0,2020-02-10,"(1054.0, 1402.0]",13,30,-17
,,,,2.0,
31203.0,2020-02-10,"(13.589, 367.75]",1,2,-1
31203.0,2020-02-10,"(367.75, 720.5]",6,16,-10
31203.0,2020-02-10,"(720.5, 1073.25]",6,13,-7
31203.0,2020-02-10,"(1073.25, 1426.0]",11,22,-11
31204.0,2020-02-10,"(475.106, 699.5]",6,8,-2
31204.0,2020-02-10,"(699.5, 923.0]",4,8,-4
31204.0,2020-02-10,"(923.0, 1146.5]",3,9,-6
31204.0,2020-02-10,"(1146.5, 1370.0]",3,4,-1
31205.0,2020-02-10,"(404.5, 730.0]",9,3,6
31205.0,2020-02-10,"(730.0, 1055.5]",4,10,-6
31206.0,2020-02-10,"(385.305, 559.75]",1,1,0
31206.0,2020-02-10,"(559.75, 733.5]",2,3,-1
31206.0,2020-02-10,"(907.25, 1081.0]",1,3,-2
31207.0,2020-02-10,"(578.176, 785.0]",2,3,-1
31207.0,2020-02-10,"(785.0, 991.0]",2,4,-2
31207.0,2020-02-10,"(1197.0, 1403.0]",1,1,0
31208.0,2020-02-10,"(565.521, 685.75]",2,2,0
31208.0,2020-02-10,"(925.25, 1045.0]",3,9,-6
,,,,1.0,
,,,,1.0,
31211.0,2020-02-10,"(460.107, 684.25]",7,8,-1
31211.0,2020-02-10,"(907.5, 1130.75]",2,2,0
31211.0,2020-02-10,"(1130.75, 1354.0]",2,4,-2
31212.0,2020-02-10,"(334.911, 608.25]",12,20,-8
31212.0,2020-02-10,"(608.25, 880.5]",3,9,-6
31212.0,2020-02-10,"(880.5, 1152.75]",6,11,-5
31212.0,2020-02-10,"(1152.75, 1425.0]",4,9,-5
31213.0,2020-02-10,"(261.84, 553.0]",7,10,-3
31213.0,2020-02-10,"(553.0, 843.0]",5,10,-5
31213.0,2020-02-10,"(843.0, 1133.0]",4,8,-4
31213.0,2020-02-10,"(1133.0, 1423.0]",2,7,-5
31214.0,2020-02-10,"(330.914, 603.5]",4,21,-17
31214.0,2020-02-10,"(603.5, 875.0]",5,7,-2
31214.0,2020-02-10,"(875.0, 1146.5]",8,13,-5
31214.0,2020-02-10,"(1146.5, 1418.0]",7,9,-2
31215.0,2020-02-10,"(407.241, 597.75]",7,8,-1
31215.0,2020-02-10,"(597.75, 787.5]",3,4,-1
31215.0,2020-02-10,"(787.5, 977.25]",1,1,0
31215.0,2020-02-10,"(977.25, 1167.0]",1,8,-7
31216.0,2020-02-10,"(334.027, 578.25]",4,4,0
31216.0,2020-02-10,"(578.25, 821.5]",3,4,-1
31217.0,2020-02-10,"(345.5, 671.0]",5,1,4
31217.0,2020-02-10,"(671.0, 996.5]",1,6,-5
31217.0,2020-02-10,"(996.5, 1322.0]",1,3,-2
31218.0,2020-02-10,"(336.087, 565.25]",6,18,-12
31218.0,2020-02-10,"(565.25, 793.5]",3,3,0
31218.0,2020-02-10,"(793.5, 1021.75]",4,6,-2
31218.0,2020-02-10,"(1021.75, 1250.0]",2,3,-1
31219.0,2020-02-10,"(391.343, 556.25]",2,2,0
31219.0,2020-02-10,"(556.25, 720.5]",4,4,0
31219.0,2020-02-10,"(720.5, 884.75]",1,3,-2
31219.0,2020-02-10,"(884.75, 1049.0]",1,7,-6
31220.0,2020-02-10,"(306.307, 480.25]",3,4,-1
31220.0,2020-02-10,"(480.25, 653.5]",6,6,0
31220.0,2020-02-10,"(653.5, 826.75]",1,5,-4
31220.0,2020-02-10,"(826.75, 1000.0]",2,9,-7
31221.0,2020-02-10,"(358.75, 716.5]",15,1,14
31221.0,2020-02-10,"(716.5, 1074.25]",2,15,-13
31221.0,2020-02-10,"(1074.25, 1432.0]",1,9,-8
31222.0,2020-02-10,"(418.132, 636.0]",4,4,0
31222.0,2020-02-10,"(636.0, 853.0]",1,2,-1
31223.0,2020-02-10,"(11.688, 341.0]",1,2,-1
31223.0,2020-02-10,"(341.0, 669.0]",11,20,-9
31223.0,2020-02-10,"(669.0, 997.0]",4,7,-3
31223.0,2020-02-10,"(997.0, 1325.0]",10,19,-9
31224.0,2020-02-10,"(380.097, 606.75]",6,8,-2
31224.0,2020-02-10,"(606.75, 832.5]",3,5,-2
31225.0,2020-02-10,"(318.049, 556.75]",1,4,-3
31225.0,2020-02-10,"(556.75, 794.5]",2,3,-1
31225.0,2020-02-10,"(794.5, 1032.25]",1,4,-3
31225.0,2020-02-10,"(1032.25, 1270.0]",3,6,-3
31226.0,2020-02-10,"(347.015, 594.25]",2,4,-2
31226.0,2020-02-10,"(594.25, 840.5]",1,2,-1
31226.0,2020-02-10,"(840.5, 1086.75]",1,4,-3
31226.0,2020-02-10,"(1086.75, 1333.0]",3,6,-3
31227.0,2020-02-10,"(452.116, 674.0]",14,15,-1
31227.0,2020-02-10,"(674.0, 895.0]",1,2,-1
31227.0,2020-02-10,"(895.0, 1116.0]",1,6,-5
31227.0,2020-02-10,"(1116.0, 1337.0]",2,6,-4
31228.0,2020-02-10,"(352.959, 614.25]",13,14,-1
31228.0,2020-02-10,"(614.25, 874.5]",3,5,-2
31228.0,2020-02-10,"(874.5, 1134.75]",8,14,-6
31228.0,2020-02-10,"(1134.75, 1395.0]",2,7,-5
31229.0,2020-02-10,"(353.0, 700.0]",7,1,6
31229.0,2020-02-10,"(700.0, 1047.0]",10,30,-20
31229.0,2020-02-10,"(1047.0, 1394.0]",12,20,-8
31230.0,2020-02-10,"(347.967, 607.25]",18,22,-4
31230.0,2020-02-10,"(607.25, 865.5]",6,9,-3
31230.0,2020-02-10,"(865.5, 1123.75]",3,11,-8
31230.0,2020-02-10,"(1123.75, 1382.0]",3,7,-4
31231.0,2020-02-10,"(323.153, 535.75]",6,6,0
31231.0,2020-02-10,"(535.75, 747.5]",2,4,-2
31231.0,2020-02-10,"(747.5, 959.25]",5,8,-3
31231.0,2020-02-10,"(959.25, 1171.0]",4,13,-9
31232.0,2020-02-10,"(252.895, 530.25]",4,5,-1
31232.0,2020-02-10,"(530.25, 806.5]",5,12,-7
31232.0,2020-02-10,"(806.5, 1082.75]",6,10,-4
31232.0,2020-02-10,"(1082.75, 1359.0]",2,7,-5
31233.0,2020-02-10,"(402.089, 630.75]",19,20,-1
31233.0,2020-02-10,"(630.75, 858.5]",3,6,-3
31233.0,2020-02-10,"(858.5, 1086.25]",5,10,-5
31233.0,2020-02-10,"(1086.25, 1314.0]",4,8,-4
31234.0,2020-02-10,"(388.028, 632.0]",15,25,-10
31234.0,2020-02-10,"(632.0, 875.0]",2,4,-2
31234.0,2020-02-10,"(875.0, 1118.0]",3,3,0
31234.0,2020-02-10,"(1118.0, 1361.0]",6,12,-6
31235.0,2020-02-10,"(543.483, 673.25]",2,2,0
31236.0,2020-02-10,"(136.723, 457.25]",1,2,-1
31236.0,2020-02-10,"(457.25, 776.5]",11,15,-4
31236.0,2020-02-10,"(776.5, 1095.75]",4,13,-9
31236.0,2020-02-10,"(1095.75, 1415.0]",1,10,-9
31237.0,2020-02-10,"(184.836, 477.0]",2,5,-3
31237.0,2020-02-10,"(477.0, 768.0]",4,9,-5
31237.0,2020-02-10,"(768.0, 1059.0]",2,5,-3
31237.0,2020-02-10,"(1059.0, 1350.0]",7,15,-8
31238.0,2020-02-10,"(22.611, 371.25]",2,3,-1
31238.0,2020-02-10,"(371.25, 718.5]",9,10,-1
31238.0,2020-02-10,"(718.5, 1065.75]",4,10,-6
31238.0,2020-02-10,"(1065.75, 1413.0]",1,4,-3
31239.0,2020-02-10,"(351.066, 585.5]",9,11,-2
31239.0,2020-02-10,"(585.5, 819.0]",6,8,-2
31239.0,2020-02-10,"(819.0, 1052.5]",2,9,-7
31239.0,2020-02-10,"(1052.5, 1286.0]",2,9,-7
31240.0,2020-02-10,"(778.0, 818.0]",2,2,0
31241.0,2020-02-10,"(296.918, 568.5]",9,16,-7
31241.0,2020-02-10,"(568.5, 839.0]",6,12,-6
31241.0,2020-02-10,"(839.0, 1109.5]",5,10,-5
31241.0,2020-02-10,"(1109.5, 1380.0]",6,10,-4
31242.0,2020-02-10,"(303.95, 567.5]",5,5,0
31242.0,2020-02-10,"(567.5, 830.0]",8,8,0
31242.0,2020-02-10,"(830.0, 1092.5]",2,10,-8
31243.0,2020-02-10,"(383.258, 569.5]",8,9,-1
31243.0,2020-02-10,"(569.5, 755.0]",2,2,0
31243.0,2020-02-10,"(755.0, 940.5]",2,5,-3
31243.0,2020-02-10,"(940.5, 1126.0]",2,8,-6
31244.0,2020-02-10,"(405.054, 642.5]",4,7,-3
31244.0,2020-02-10,"(642.5, 879.0]",2,5,-3
31244.0,2020-02-10,"(879.0, 1115.5]",2,5,-3
31244.0,2020-02-10,"(1115.5, 1352.0]",4,7,-3
31245.0,2020-02-10,"(326.06, 562.0]",8,15,-7
31245.0,2020-02-10,"(562.0, 797.0]",2,6,-4
31245.0,2020-02-10,"(797.0, 1032.0]",5,10,-5
31245.0,2020-02-10,"(1032.0, 1267.0]",5,8,-3
31246.0,2020-02-10,"(5.625, 350.75]",1,1,0
31246.0,2020-02-10,"(350.75, 694.5]",4,9,-5
31246.0,2020-02-10,"(694.5, 1038.25]",2,7,-5
31246.0,2020-02-10,"(1038.25, 1382.0]",7,11,-4
31247.0,2020-02-10,"(472.397, 623.75]",3,5,-2
31247.0,2020-02-10,"(623.75, 774.5]",2,3,-1
31247.0,2020-02-10,"(925.25, 1076.0]",3,4,-1
31248.0,2020-02-10,"(357.309, 530.75]",2,4,-2
31248.0,2020-02-10,"(530.75, 703.5]",3,3,0
31248.0,2020-02-10,"(876.25, 1049.0]",3,4,-1
31249.0,2020-02-10,"(430.143, 645.25]",2,3,-1
31249.0,2020-02-10,"(859.5, 1073.75]",4,7,-3
31249.0,2020-02-10,"(1073.75, 1288.0]",1,4,-3
31250.0,2020-02-10,"(423.041, 663.75]",7,10,-3
31250.0,2020-02-10,"(663.75, 903.5]",5,7,-2
31250.0,2020-02-10,"(903.5, 1143.25]",2,9,-7
31250.0,2020-02-10,"(1143.25, 1383.0]",6,11,-5
31251.0,2020-02-10,"(432.005, 681.75]",10,21,-11
31251.0,2020-02-10,"(681.75, 930.5]",2,2,0
31251.0,2020-02-10,"(930.5, 1179.25]",5,15,-10
31251.0,2020-02-10,"(1179.25, 1428.0]",5,7,-2
31252.0,2020-02-10,"(523.3, 699.0]",11,12,-1
31252.0,2020-02-10,"(699.0, 874.0]",1,3,-2
31252.0,2020-02-10,"(874.0, 1049.0]",1,2,-1
31252.0,2020-02-10,"(1049.0, 1224.0]",1,8,-7
31253.0,2020-02-10,"(387.089, 615.75]",6,6,0
31253.0,2020-02-10,"(615.75, 843.5]",6,9,-3
31253.0,2020-02-10,"(843.5, 1071.25]",5,9,-4
31254.0,2020-02-10,"(56.754, 369.5]",1,2,-1
31254.0,2020-02-10,"(369.5, 681.0]",12,15,-3
31254.0,2020-02-10,"(681.0, 992.5]",2,5,-3
31254.0,2020-02-10,"(992.5, 1304.0]",5,15,-10
31255.0,2020-02-10,"(429.302, 604.5]",6,8,-2
31255.0,2020-02-10,"(604.5, 779.0]",1,3,-2
31255.0,2020-02-10,"(779.0, 953.5]",2,3,-1
31255.0,2020-02-10,"(953.5, 1128.0]",1,10,-9
31256.0,2020-02-10,"(22.659, 359.25]",2,3,-1
31256.0,2020-02-10,"(359.25, 694.5]",7,8,-1
31256.0,2020-02-10,"(1029.75, 1365.0]",1,3,-2
31257.0,2020-02-10,"(317.945, 582.75]",12,14,-2
31257.0,2020-02-10,"(582.75, 846.5]",9,13,-4
31257.0,2020-02-10,"(846.5, 1110.25]",5,14,-9
31257.0,2020-02-10,"(1110.25, 1374.0]",8,21,-13
,,,,1.0,
,,,,1.0,
31259.0,2020-02-10,"(29.844, 320.0]",1,1,0
31259.0,2020-02-10,"(320.0, 609.0]",3,3,0
31259.0,2020-02-10,"(609.0, 898.0]",1,1,0
31259.0,2020-02-10,"(898.0, 1187.0]",1,7,-6
31260.0,2020-02-10,"(450.222, 645.5]",7,7,0
31260.0,2020-02-10,"(1034.5, 1229.0]",1,3,-2
31261.0,2020-02-10,"(366.243, 556.25]",7,7,0
31261.0,2020-02-10,"(556.25, 745.5]",1,1,0
31262.0,2020-02-10,"(471.081, 701.75]",1,1,0
31262.0,2020-02-10,"(931.5, 1161.25]",1,3,-2
31263.0,2020-02-10,"(365.022, 610.5]",9,15,-6
31263.0,2020-02-10,"(610.5, 855.0]",3,6,-3
31263.0,2020-02-10,"(855.0, 1099.5]",3,10,-7
31263.0,2020-02-10,"(1099.5, 1344.0]",3,10,-7
31264.0,2020-02-10,"(353.119, 574.25]",3,4,-1
31264.0,2020-02-10,"(574.25, 794.5]",1,3,-2
31264.0,2020-02-10,"(794.5, 1014.75]",2,5,-3
31264.0,2020-02-10,"(1014.75, 1235.0]",3,9,-6
31265.0,2020-02-10,"(411.041, 651.75]",6,16,-10
31265.0,2020-02-10,"(651.75, 891.5]",2,4,-2
31265.0,2020-02-10,"(891.5, 1131.25]",4,9,-5
31265.0,2020-02-10,"(1131.25, 1371.0]",4,9,-5
31266.0,2020-02-10,"(19.654, 357.5]",1,6,-5
31266.0,2020-02-10,"(357.5, 694.0]",2,12,-10
31266.0,2020-02-10,"(694.0, 1030.5]",8,15,-7
31266.0,2020-02-10,"(1030.5, 1367.0]",11,18,-7
31267.0,2020-02-10,"(471.118, 692.5]",13,19,-6
31267.0,2020-02-10,"(692.5, 913.0]",5,11,-6
31267.0,2020-02-10,"(913.0, 1133.5]",6,14,-8
31267.0,2020-02-10,"(1133.5, 1354.0]",7,13,-6
31268.0,2020-02-10,"(329.992, 583.0]",9,17,-8
31268.0,2020-02-10,"(583.0, 835.0]",2,4,-2
31268.0,2020-02-10,"(835.0, 1087.0]",4,5,-1
31268.0,2020-02-10,"(1087.0, 1339.0]",6,11,-5
31269.0,2020-02-10,"(3.751, 317.25]",1,1,0
31269.0,2020-02-10,"(317.25, 629.5]",2,4,-2
31269.0,2020-02-10,"(629.5, 941.75]",2,5,-3
31269.0,2020-02-10,"(941.75, 1254.0]",3,6,-3
31270.0,2020-02-10,"(378.088, 607.0]",3,5,-2
31270.0,2020-02-10,"(607.0, 835.0]",2,4,-2
31270.0,2020-02-10,"(835.0, 1063.0]",3,3,0
31270.0,2020-02-10,"(1063.0, 1291.0]",3,8,-5
31271.0,2020-02-10,"(390.182, 595.5]",1,2,-1
31271.0,2020-02-10,"(595.5, 800.0]",1,1,0
31271.0,2020-02-10,"(800.0, 1004.5]",1,1,0
31271.0,2020-02-10,"(1004.5, 1209.0]",1,5,-4
31272.0,2020-02-10,"(291.93, 560.5]",11,12,-1
31272.0,2020-02-10,"(560.5, 828.0]",5,7,-2
31272.0,2020-02-10,"(828.0, 1095.5]",3,11,-8
31272.0,2020-02-10,"(1095.5, 1363.0]",2,6,-4
31273.0,2020-02-10,"(653.5, 817.0]",1,3,-2
31273.0,2020-02-10,"(817.0, 980.5]",1,2,-1
31273.0,2020-02-10,"(980.5, 1144.0]",2,1,1
31274.0,2020-02-10,"(393.195, 595.25]",4,4,0
31274.0,2020-02-10,"(595.25, 796.5]",3,3,0
31274.0,2020-02-10,"(997.75, 1199.0]",2,4,-2
31275.0,2020-02-10,"(242.592, 345.0]",2,2,0
31275.0,2020-02-10,"(447.0, 549.0]",3,6,-3
31275.0,2020-02-10,"(549.0, 651.0]",4,5,-1
31276.0,2020-02-10,"(411.056, 648.0]",10,12,-2
31276.0,2020-02-10,"(648.0, 884.0]",4,4,0
31276.0,2020-02-10,"(884.0, 1120.0]",3,11,-8
31277.0,2020-02-10,"(440.023, 685.25]",14,15,-1
31277.0,2020-02-10,"(685.25, 929.5]",3,6,-3
31277.0,2020-02-10,"(929.5, 1173.75]",1,11,-10
31278.0,2020-02-10,"(374.963, 635.25]",3,14,-11
31278.0,2020-02-10,"(635.25, 894.5]",2,4,-2
31278.0,2020-02-10,"(894.5, 1153.75]",5,7,-2
31278.0,2020-02-10,"(1153.75, 1413.0]",9,13,-4
31279.0,2020-02-10,"(356.3, 532.0]",3,4,-1
31279.0,2020-02-10,"(532.0, 707.0]",5,8,-3
31279.0,2020-02-10,"(882.0, 1057.0]",1,2,-1
31280.0,2020-02-10,"(558.27, 741.5]",2,5,-3
31280.0,2020-02-10,"(741.5, 924.0]",1,2,-1
31280.0,2020-02-10,"(924.0, 1106.5]",2,3,-1
31280.0,2020-02-10,"(1106.5, 1289.0]",4,5,-1
31000.0,2020-02-11,"(923.694, 1000.5]",1,2,-1
31000.0,2020-02-11,"(1000.5, 1077.0]",1,1,0
31001.0,2020-02-11,"(1057.719, 1128.25]",1,5,-4
31001.0,2020-02-11,"(1198.5, 1268.75]",1,1,0
31001.0,2020-02-11,"(1268.75, 1339.0]",1,1,0
31002.0,2020-02-11,"(844.5, 1044.75]",4,3,1
31002.0,2020-02-11,"(1044.75, 1245.0]",1,5,-4
31003.0,2020-02-11,"(533.52, 654.0]",1,1,0
31003.0,2020-02-11,"(654.0, 774.0]",1,2,-1
31003.0,2020-02-11,"(894.0, 1014.0]",2,1,1
31004.0,2020-02-11,"(1051.817, 1097.75]",2,3,-1
31004.0,2020-02-11,"(1097.75, 1143.5]",1,1,0
31004.0,2020-02-11,"(1143.5, 1189.25]",1,1,0
31004.0,2020-02-11,"(1189.25, 1235.0]",1,1,0
31005.0,2020-02-11,"(431.195, 633.25]",1,1,0
31005.0,2020-02-11,"(834.5, 1035.75]",1,1,0
31005.0,2020-02-11,"(1035.75, 1237.0]",1,7,-6
31006.0,2020-02-11,"(1162.0, 1369.0]",3,1,2
31007.0,2020-02-11,"(464.205, 663.75]",6,10,-4
31007.0,2020-02-11,"(862.5, 1061.25]",2,1,1
31007.0,2020-02-11,"(1061.25, 1260.0]",6,9,-3
31009.0,2020-02-11,"(529.454, 666.5]",1,1,0
31009.0,2020-02-11,"(803.0, 939.5]",1,1,0
31010.0,2020-02-11,"(440.311, 613.25]",1,3,-2
31010.0,2020-02-11,"(785.5, 957.75]",2,5,-3
31010.0,2020-02-11,"(957.75, 1130.0]",4,5,-1
31011.0,2020-02-11,"(332.059, 568.25]",5,8,-3
31011.0,2020-02-11,"(568.25, 803.5]",2,2,0
31011.0,2020-02-11,"(803.5, 1038.75]",4,5,-1
31011.0,2020-02-11,"(1038.75, 1274.0]",2,4,-2
31012.0,2020-02-11,"(529.401, 679.75]",1,2,-1
31012.0,2020-02-11,"(679.75, 829.5]",1,2,-1
31012.0,2020-02-11,"(979.25, 1129.0]",1,1,0
31013.0,2020-02-11,"(830.0, 1046.5]",2,1,1
31013.0,2020-02-11,"(1046.5, 1263.0]",4,3,1
31014.0,2020-02-11,"(225.91, 499.5]",3,5,-2
31014.0,2020-02-11,"(499.5, 772.0]",17,22,-5
31014.0,2020-02-11,"(772.0, 1044.5]",7,14,-7
31014.0,2020-02-11,"(1044.5, 1317.0]",16,28,-12
31015.0,2020-02-11,"(291.016, 538.0]",4,5,-1
31015.0,2020-02-11,"(538.0, 784.0]",3,3,0
31015.0,2020-02-11,"(784.0, 1030.0]",1,4,-3
31015.0,2020-02-11,"(1030.0, 1276.0]",2,8,-6
31016.0,2020-02-11,"(456.193, 658.75]",4,6,-2
31016.0,2020-02-11,"(658.75, 860.5]",3,6,-3
31016.0,2020-02-11,"(860.5, 1062.25]",1,2,-1
31016.0,2020-02-11,"(1062.25, 1264.0]",3,8,-5
31017.0,2020-02-11,"(473.118, 694.5]",3,4,-1
31017.0,2020-02-11,"(915.0, 1135.5]",1,3,-2
31018.0,2020-02-11,"(966.25, 1136.0]",1,1,0
31019.0,2020-02-11,"(864.0, 1066.0]",4,2,2
31020.0,2020-02-11,"(435.0, 578.0]",1,1,0
31021.0,2020-02-11,"(916.0, 1081.5]",3,1,2
31021.0,2020-02-11,"(1081.5, 1247.0]",2,4,-2
31022.0,2020-02-11,"(569.18, 775.0]",2,2,0
31022.0,2020-02-11,"(980.0, 1185.0]",4,6,-2
31023.0,2020-02-11,"(619.327, 788.25]",1,1,0
31024.0,2020-02-11,"(471.254, 658.5]",2,6,-4
31024.0,2020-02-11,"(658.5, 845.0]",1,1,0
31024.0,2020-02-11,"(845.0, 1031.5]",2,8,-6
31024.0,2020-02-11,"(1031.5, 1218.0]",3,7,-4
31025.0,2020-02-11,"(605.329, 773.75]",1,2,-1
31025.0,2020-02-11,"(773.75, 941.5]",1,1,0
31025.0,2020-02-11,"(1109.25, 1277.0]",1,2,-1
31026.0,2020-02-11,"(940.0, 1146.0]",3,1,2
31026.0,2020-02-11,"(1146.0, 1352.0]",1,9,-8
31027.0,2020-02-11,"(1197.0, 1280.0]",2,1,1
31028.0,2020-02-11,"(470.447, 609.25]",1,1,0
31028.0,2020-02-11,"(885.75, 1024.0]",2,3,-1
31029.0,2020-02-11,"(730.25, 939.5]",1,5,-4
31029.0,2020-02-11,"(939.5, 1148.75]",1,2,-1
31029.0,2020-02-11,"(1148.75, 1358.0]",2,2,0
31030.0,2020-02-11,"(6.868, 291.0]",1,1,0
31030.0,2020-02-11,"(857.0, 1140.0]",6,2,4
31031.0,2020-02-11,"(986.877, 1017.75]",1,1,0
31031.0,2020-02-11,"(1079.25, 1110.0]",1,1,0
31032.0,2020-02-11,"(773.0, 980.0]",1,1,0
31032.0,2020-02-11,"(980.0, 1187.0]",2,2,0
31032.0,2020-02-11,"(1187.0, 1394.0]",1,2,-1
31033.0,2020-02-11,"(777.908, 801.0]",1,1,0
31034.0,2020-02-11,"(482.167, 691.25]",1,2,-1
31034.0,2020-02-11,"(899.5, 1107.75]",4,1,3
31034.0,2020-02-11,"(1107.75, 1316.0]",1,5,-4
31035.0,2020-02-11,"(955.0, 1111.0]",3,2,1
31035.0,2020-02-11,"(1111.0, 1267.0]",1,6,-5
31035.0,2020-02-11,"(1267.0, 1423.0]",1,1,0
31036.0,2020-02-11,"(938.0, 1092.0]",3,1,2
31036.0,2020-02-11,"(1092.0, 1246.0]",2,4,-2
31037.0,2020-02-11,"(475.13, 693.5]",5,6,-1
31037.0,2020-02-11,"(693.5, 911.0]",1,3,-2
31037.0,2020-02-11,"(911.0, 1128.5]",2,10,-8
31038.0,2020-02-11,"(907.75, 974.5]",1,1,0
31039.0,2020-02-11,"(610.373, 767.75]",2,2,0
31039.0,2020-02-11,"(924.5, 1081.25]",1,5,-4
31040.0,2020-02-11,"(455.139, 671.25]",2,2,0
31040.0,2020-02-11,"(886.5, 1101.75]",1,5,-4
31040.0,2020-02-11,"(1101.75, 1317.0]",2,4,-2
,,,,1.0,
,,,,1.0,
31042.0,2020-02-11,"(448.058, 684.5]",3,3,0
31042.0,2020-02-11,"(1155.5, 1391.0]",2,5,-3
31043.0,2020-02-11,"(1030.5, 1093.0]",2,1,1
31043.0,2020-02-11,"(1093.0, 1155.5]",1,3,-2
31043.0,2020-02-11,"(1155.5, 1218.0]",1,2,-1
31044.0,2020-02-11,"(524.411, 672.25]",2,3,-1
31045.0,2020-02-11,"(990.75, 1150.0]",1,1,0
31046.0,2020-02-11,"(467.348, 631.0]",1,1,0
31047.0,2020-02-11,"(331.03, 574.5]",7,10,-3
31047.0,2020-02-11,"(574.5, 817.0]",1,1,0
31047.0,2020-02-11,"(817.0, 1059.5]",2,10,-8
31047.0,2020-02-11,"(1059.5, 1302.0]",7,16,-9
31048.0,2020-02-11,"(816.0, 1082.0]",3,1,2
31049.0,2020-02-11,"(1050.25, 1253.0]",3,1,2
31050.0,2020-02-11,"(676.75, 878.5]",1,1,0
31050.0,2020-02-11,"(878.5, 1080.25]",1,1,0
31050.0,2020-02-11,"(1080.25, 1282.0]",1,1,0
31051.0,2020-02-11,"(863.5, 1145.75]",4,5,-1
31051.0,2020-02-11,"(1145.75, 1428.0]",3,4,-1
31052.0,2020-02-11,"(521.29, 699.5]",1,1,0
31052.0,2020-02-11,"(877.0, 1054.5]",2,5,-3
31052.0,2020-02-11,"(1054.5, 1232.0]",1,3,-2
31053.0,2020-02-11,"(951.25, 1105.0]",1,1,0
31054.0,2020-02-11,"(768.75, 1025.0]",1,1,0
31055.0,2020-02-11,"(306.0, 408.0]",1,1,0
,,,,1.0,
,,,,1.0,
,,,,1.0,
31057.0,2020-02-11,"(731.25, 975.0]",1,1,0
,,,,1.0,
,,,,1.0,
31059.0,2020-02-11,"(1020.5, 1067.75]",1,1,0
31059.0,2020-02-11,"(1067.75, 1115.0]",1,1,0
31060.0,2020-02-11,"(975.542, 1090.5]",3,3,0
31060.0,2020-02-11,"(1090.5, 1205.0]",1,1,0
31061.0,2020-02-11,"(804.5, 952.25]",1,1,0
31061.0,2020-02-11,"(952.25, 1100.0]",1,1,0
31062.0,2020-02-11,"(678.75, 905.0]",1,1,0
,,,,2.0,
31064.0,2020-02-11,"(948.786, 1002.5]",2,4,-2
31064.0,2020-02-11,"(1002.5, 1056.0]",1,2,-1
31064.0,2020-02-11,"(1109.5, 1163.0]",2,4,-2
31065.0,2020-02-11,"(893.615, 990.25]",1,2,-1
31065.0,2020-02-11,"(1182.75, 1279.0]",1,1,0
31066.0,2020-02-11,"(1062.966, 1071.5]",1,1,0
31066.0,2020-02-11,"(1088.5, 1097.0]",1,2,-1
31067.0,2020-02-11,"(485.136, 702.0]",1,1,0
31067.0,2020-02-11,"(918.0, 1134.0]",1,2,-1
31067.0,2020-02-11,"(1134.0, 1350.0]",1,1,0
31068.0,2020-02-11,"(1149.25, 1353.0]",3,1,2
31069.0,2020-02-11,"(866.5, 1022.75]",1,2,-1
31069.0,2020-02-11,"(1022.75, 1179.0]",4,1,3
31070.0,2020-02-11,"(961.0, 1163.5]",3,2,1
31070.0,2020-02-11,"(1163.5, 1366.0]",2,1,1
31071.0,2020-02-11,"(325.974, 583.5]",2,5,-3
31071.0,2020-02-11,"(840.0, 1096.5]",3,1,2
31071.0,2020-02-11,"(1096.5, 1353.0]",1,6,-5
,,,,1.0,
,,,,1.0,
,,,,1.0,
31073.0,2020-02-11,"(478.43, 621.5]",1,3,-2
31073.0,2020-02-11,"(906.5, 1049.0]",1,1,0
31074.0,2020-02-11,"(873.0, 1069.0]",1,1,0
31074.0,2020-02-11,"(1069.0, 1265.0]",4,1,3
31075.0,2020-02-11,"(834.0, 1112.0]",1,1,0
31076.0,2020-02-11,"(1050.656, 1137.0]",1,1,0
31076.0,2020-02-11,"(1309.0, 1395.0]",1,1,0
31077.0,2020-02-11,"(832.0, 1070.0]",1,3,-2
31077.0,2020-02-11,"(1070.0, 1308.0]",3,2,1
31078.0,2020-02-11,"(482.409, 630.75]",2,2,0
31078.0,2020-02-11,"(926.25, 1074.0]",2,8,-6
31079.0,2020-02-11,"(467.061, 702.75]",1,4,-3
31079.0,2020-02-11,"(937.5, 1172.25]",2,2,0
31079.0,2020-02-11,"(1172.25, 1407.0]",6,5,1
31080.0,2020-02-11,"(704.25, 939.5]",1,4,-3
31080.0,2020-02-11,"(939.5, 1174.75]",5,2,3
31080.0,2020-02-11,"(1174.75, 1410.0]",4,8,-4
31081.0,2020-02-11,"(1099.0, 1177.0]",1,1,0
31081.0,2020-02-11,"(1177.0, 1255.0]",1,2,-1
31082.0,2020-02-11,"(1025.812, 1073.0]",1,1,0
31083.0,2020-02-11,"(914.25, 1068.0]",2,1,1
31084.0,2020-02-11,"(21.618, 368.5]",1,1,0
31084.0,2020-02-11,"(368.5, 714.0]",2,2,0
31084.0,2020-02-11,"(714.0, 1059.5]",1,4,-3
31084.0,2020-02-11,"(1059.5, 1405.0]",2,7,-5
31085.0,2020-02-11,"(1066.75, 1268.0]",2,3,-1
31086.0,2020-02-11,"(877.75, 1013.0]",2,1,1
31087.0,2020-02-11,"(805.5, 1046.25]",2,2,0
31087.0,2020-02-11,"(1046.25, 1287.0]",2,2,0
31088.0,2020-02-11,"(987.75, 1041.5]",2,1,1
31088.0,2020-02-11,"(1041.5, 1095.25]",3,2,1
31088.0,2020-02-11,"(1095.25, 1149.0]",1,3,-2
31089.0,2020-02-11,"(467.077, 698.75]",5,7,-2
31089.0,2020-02-11,"(698.75, 929.5]",2,5,-3
31089.0,2020-02-11,"(929.5, 1160.25]",3,16,-13
31089.0,2020-02-11,"(1160.25, 1391.0]",3,9,-6
31090.0,2020-02-11,"(779.5, 959.25]",1,1,0
31090.0,2020-02-11,"(959.25, 1139.0]",2,2,0
31091.0,2020-02-11,"(938.25, 1108.0]",3,3,0
31092.0,2020-02-11,"(860.5, 1063.75]",1,2,-1
31092.0,2020-02-11,"(1063.75, 1267.0]",1,2,-1
31093.0,2020-02-11,"(879.25, 1036.0]",1,1,0
,,,,1.0,
,,,,1.0,
31095.0,2020-02-11,"(776.25, 1035.0]",1,1,0
31096.0,2020-02-11,"(1078.786, 1132.5]",1,1,0
31096.0,2020-02-11,"(1239.5, 1293.0]",1,1,0
31097.0,2020-02-11,"(976.75, 1039.5]",4,5,-1
31097.0,2020-02-11,"(1039.5, 1102.0]",1,1,0
31097.0,2020-02-11,"(1102.0, 1164.5]",1,1,0
31097.0,2020-02-11,"(1164.5, 1227.0]",1,2,-1
31098.0,2020-02-11,"(441.036, 683.0]",2,4,-2
31098.0,2020-02-11,"(924.0, 1165.0]",8,10,-2
31099.0,2020-02-11,"(1198.5, 1230.0]",1,1,0
31100.0,2020-02-11,"(434.134, 651.5]",9,10,-1
31100.0,2020-02-11,"(868.0, 1084.5]",1,13,-12
31100.0,2020-02-11,"(1084.5, 1301.0]",1,3,-2
31101.0,2020-02-11,"(7.589, 361.75]",2,3,-1
31101.0,2020-02-11,"(361.75, 714.5]",8,32,-24
31101.0,2020-02-11,"(714.5, 1067.25]",27,38,-11
31101.0,2020-02-11,"(1067.25, 1420.0]",24,45,-21
31102.0,2020-02-11,"(710.5, 1064.75]",5,2,3
31102.0,2020-02-11,"(1064.75, 1419.0]",15,9,6
31103.0,2020-02-11,"(435.133, 652.75]",1,20,-19
31103.0,2020-02-11,"(652.75, 869.5]",1,9,-8
31103.0,2020-02-11,"(869.5, 1086.25]",1,10,-9
31103.0,2020-02-11,"(1086.25, 1303.0]",10,18,-8
31104.0,2020-02-11,"(352.958, 614.5]",2,15,-13
31104.0,2020-02-11,"(614.5, 875.0]",3,4,-1
31104.0,2020-02-11,"(875.0, 1135.5]",11,21,-10
31104.0,2020-02-11,"(1135.5, 1396.0]",7,18,-11
31105.0,2020-02-11,"(452.062, 687.5]",4,9,-5
31105.0,2020-02-11,"(922.0, 1156.5]",1,4,-3
31105.0,2020-02-11,"(1156.5, 1391.0]",4,7,-3
31106.0,2020-02-11,"(450.12, 671.0]",1,6,-5
31106.0,2020-02-11,"(891.0, 1111.0]",4,2,2
31106.0,2020-02-11,"(1111.0, 1331.0]",2,6,-4
31107.0,2020-02-11,"(431.062, 666.5]",1,19,-18
31107.0,2020-02-11,"(666.5, 901.0]",2,6,-4
31107.0,2020-02-11,"(901.0, 1135.5]",16,27,-11
31107.0,2020-02-11,"(1135.5, 1370.0]",9,12,-3
31108.0,2020-02-11,"(99.692, 428.0]",1,4,-3
31108.0,2020-02-11,"(428.0, 755.0]",4,19,-15
31108.0,2020-02-11,"(755.0, 1082.0]",23,32,-9
31108.0,2020-02-11,"(1082.0, 1409.0]",16,26,-10
31109.0,2020-02-11,"(84.679, 416.25]",1,1,0
31109.0,2020-02-11,"(416.25, 746.5]",2,9,-7
31109.0,2020-02-11,"(746.5, 1076.75]",15,21,-6
31109.0,2020-02-11,"(1076.75, 1407.0]",9,20,-11
31110.0,2020-02-11,"(328.921, 599.75]",9,24,-15
31110.0,2020-02-11,"(599.75, 869.5]",6,13,-7
31110.0,2020-02-11,"(869.5, 1139.25]",19,39,-20
31110.0,2020-02-11,"(1139.25, 1409.0]",12,18,-6
31111.0,2020-02-11,"(349.102, 574.5]",4,9,-5
31111.0,2020-02-11,"(799.0, 1023.5]",5,5,0
31111.0,2020-02-11,"(1023.5, 1248.0]",20,7,13
31112.0,2020-02-11,"(312.242, 502.5]",1,2,-1
31112.0,2020-02-11,"(881.5, 1071.0]",4,1,3
31113.0,2020-02-11,"(823.0, 1062.0]",5,13,-8
31113.0,2020-02-11,"(1062.0, 1301.0]",5,3,2
31114.0,2020-02-11,"(12.589, 366.75]",2,2,0
31114.0,2020-02-11,"(719.5, 1072.25]",10,5,5
31114.0,2020-02-11,"(1072.25, 1425.0]",26,17,9
31115.0,2020-02-11,"(535.5, 823.0]",5,13,-8
31115.0,2020-02-11,"(823.0, 1110.5]",4,6,-2
31115.0,2020-02-11,"(1110.5, 1398.0]",14,12,2
31116.0,2020-02-11,"(346.009, 594.75]",5,16,-11
31116.0,2020-02-11,"(594.75, 842.5]",3,4,-1
31116.0,2020-02-11,"(842.5, 1090.25]",9,11,-2
31116.0,2020-02-11,"(1090.25, 1338.0]",20,31,-11
31117.0,2020-02-11,"(315.947, 580.25]",2,16,-14
31117.0,2020-02-11,"(580.25, 843.5]",1,3,-2
31117.0,2020-02-11,"(843.5, 1106.75]",12,23,-11
31117.0,2020-02-11,"(1106.75, 1370.0]",15,32,-17
31118.0,2020-02-11,"(853.0, 1054.5]",3,8,-5
31118.0,2020-02-11,"(1054.5, 1256.0]",14,2,12
31119.0,2020-02-11,"(383.07, 616.5]",4,17,-13
31119.0,2020-02-11,"(616.5, 849.0]",2,4,-2
31119.0,2020-02-11,"(849.0, 1081.5]",8,15,-7
31119.0,2020-02-11,"(1081.5, 1314.0]",23,33,-10
31120.0,2020-02-11,"(379.966, 639.5]",1,10,-9
31120.0,2020-02-11,"(639.5, 898.0]",1,3,-2
31120.0,2020-02-11,"(898.0, 1156.5]",8,10,-2
31120.0,2020-02-11,"(1156.5, 1415.0]",11,13,-2
31121.0,2020-02-11,"(417.094, 644.5]",15,20,-5
31121.0,2020-02-11,"(644.5, 871.0]",1,1,0
31121.0,2020-02-11,"(871.0, 1097.5]",5,14,-9
31121.0,2020-02-11,"(1097.5, 1324.0]",8,13,-5
31122.0,2020-02-11,"(6.588, 361.0]",1,1,0
31122.0,2020-02-11,"(714.0, 1067.0]",1,9,-8
31122.0,2020-02-11,"(1067.0, 1420.0]",8,8,0
31123.0,2020-02-11,"(368.993, 621.75]",1,8,-7
31123.0,2020-02-11,"(873.5, 1125.25]",4,2,2
31123.0,2020-02-11,"(1125.25, 1377.0]",7,8,-1
31124.0,2020-02-11,"(312.919, 584.25]",10,22,-12
31124.0,2020-02-11,"(584.25, 854.5]",3,5,-2
31124.0,2020-02-11,"(854.5, 1124.75]",22,45,-23
31124.0,2020-02-11,"(1124.75, 1395.0]",16,32,-16
31125.0,2020-02-11,"(347.953, 610.75]",5,23,-18
31125.0,2020-02-11,"(872.5, 1134.25]",25,2,23
31125.0,2020-02-11,"(1134.25, 1396.0]",11,31,-20
31126.0,2020-02-11,"(309.009, 557.75]",3,18,-15
31126.0,2020-02-11,"(805.5, 1053.25]",3,1,2
31126.0,2020-02-11,"(1053.25, 1301.0]",18,9,9
31127.0,2020-02-11,"(426.144, 641.0]",10,12,-2
31127.0,2020-02-11,"(641.0, 855.0]",4,6,-2
31127.0,2020-02-11,"(855.0, 1069.0]",6,18,-12
31127.0,2020-02-11,"(1069.0, 1283.0]",7,24,-17
31128.0,2020-02-11,"(394.072, 627.0]",16,20,-4
31128.0,2020-02-11,"(627.0, 859.0]",3,7,-4
31128.0,2020-02-11,"(859.0, 1091.0]",16,23,-7
31128.0,2020-02-11,"(1091.0, 1323.0]",11,25,-14
31129.0,2020-02-11,"(449.301, 624.75]",4,5,-1
31129.0,2020-02-11,"(799.5, 974.25]",4,7,-3
31129.0,2020-02-11,"(974.25, 1149.0]",1,6,-5
31130.0,2020-02-11,"(418.064, 653.0]",1,3,-2
31130.0,2020-02-11,"(653.0, 887.0]",1,2,-1
31130.0,2020-02-11,"(887.0, 1121.0]",5,11,-6
31130.0,2020-02-11,"(1121.0, 1355.0]",4,6,-2
31131.0,2020-02-11,"(453.021, 698.75]",1,9,-8
31131.0,2020-02-11,"(698.75, 943.5]",1,2,-1
31131.0,2020-02-11,"(943.5, 1188.25]",5,10,-5
31131.0,2020-02-11,"(1188.25, 1433.0]",8,9,-1
31200.0,2020-02-11,"(338.025, 582.75]",21,27,-6
31200.0,2020-02-11,"(582.75, 826.5]",1,4,-3
31200.0,2020-02-11,"(826.5, 1070.25]",5,24,-19
31200.0,2020-02-11,"(1070.25, 1314.0]",25,50,-25
31201.0,2020-02-11,"(85.674, 418.5]",5,7,-2
31201.0,2020-02-11,"(418.5, 750.0]",16,32,-16
31201.0,2020-02-11,"(750.0, 1081.5]",21,39,-18
31201.0,2020-02-11,"(1081.5, 1413.0]",38,72,-34
,,,,2.0,
31203.0,2020-02-11,"(386.0, 730.0]",5,1,4
31203.0,2020-02-11,"(730.0, 1074.0]",26,17,9
31203.0,2020-02-11,"(1074.0, 1418.0]",23,35,-12
31204.0,2020-02-11,"(484.193, 686.75]",5,5,0
31204.0,2020-02-11,"(686.75, 888.5]",1,3,-2
31204.0,2020-02-11,"(888.5, 1090.25]",4,14,-10
31204.0,2020-02-11,"(1090.25, 1292.0]",5,11,-6
31205.0,2020-02-11,"(458.1, 684.0]",12,15,-3
31205.0,2020-02-11,"(684.0, 909.0]",10,14,-4
31205.0,2020-02-11,"(909.0, 1134.0]",13,32,-19
31205.0,2020-02-11,"(1134.0, 1359.0]",2,13,-11
31206.0,2020-02-11,"(459.314, 631.5]",3,3,0
31206.0,2020-02-11,"(974.5, 1146.0]",4,2,2
31207.0,2020-02-11,"(445.049, 683.75]",1,3,-2
31207.0,2020-02-11,"(921.5, 1159.25]",8,3,5
31207.0,2020-02-11,"(1159.25, 1397.0]",4,11,-7
31208.0,2020-02-11,"(419.13, 637.5]",5,8,-3
31208.0,2020-02-11,"(855.0, 1072.5]",3,11,-8
31208.0,2020-02-11,"(1072.5, 1290.0]",7,11,-4
31209.0,2020-02-11,"(500.312, 673.0]",2,2,0
31209.0,2020-02-11,"(845.0, 1017.0]",1,3,-2
31209.0,2020-02-11,"(1017.0, 1189.0]",5,8,-3
31211.0,2020-02-11,"(482.169, 690.75]",8,12,-4
31211.0,2020-02-11,"(690.75, 898.5]",1,1,0
31211.0,2020-02-11,"(898.5, 1106.25]",2,7,-5
31211.0,2020-02-11,"(1106.25, 1314.0]",3,9,-6
31212.0,2020-02-11,"(397.017, 643.75]",20,29,-9
31212.0,2020-02-11,"(643.75, 889.5]",6,11,-5
31212.0,2020-02-11,"(889.5, 1135.25]",17,39,-22
31212.0,2020-02-11,"(1135.25, 1381.0]",12,23,-11
31213.0,2020-02-11,"(268.888, 548.0]",4,5,-1
31213.0,2020-02-11,"(548.0, 826.0]",10,17,-7
31213.0,2020-02-11,"(826.0, 1104.0]",13,25,-12
31213.0,2020-02-11,"(1104.0, 1382.0]",10,29,-19
31214.0,2020-02-11,"(385.5, 693.0]",8,2,6
31214.0,2020-02-11,"(693.0, 1000.5]",7,24,-17
31214.0,2020-02-11,"(1000.5, 1308.0]",28,12,16
31215.0,2020-02-11,"(476.043, 716.25]",13,17,-4
31215.0,2020-02-11,"(716.25, 955.5]",2,2,0
31215.0,2020-02-11,"(955.5, 1194.75]",3,11,-8
31215.0,2020-02-11,"(1194.75, 1434.0]",1,4,-3
31216.0,2020-02-11,"(463.32, 634.0]",9,9,0
31216.0,2020-02-11,"(634.0, 804.0]",2,2,0
31216.0,2020-02-11,"(804.0, 974.0]",2,4,-2
31216.0,2020-02-11,"(974.0, 1144.0]",2,20,-18
31217.0,2020-02-11,"(349.309, 522.75]",4,5,-1
31217.0,2020-02-11,"(522.75, 695.5]",3,4,-1
31217.0,2020-02-11,"(868.25, 1041.0]",1,11,-10
31218.0,2020-02-11,"(346.98, 603.0]",5,17,-12
31218.0,2020-02-11,"(603.0, 858.0]",1,2,-1
31218.0,2020-02-11,"(858.0, 1113.0]",12,19,-7
31218.0,2020-02-11,"(1113.0, 1368.0]",2,4,-2
31219.0,2020-02-11,"(470.192, 673.0]",8,8,0
31219.0,2020-02-11,"(875.0, 1077.0]",3,9,-6
31219.0,2020-02-11,"(1077.0, 1279.0]",2,4,-2
31220.0,2020-02-11,"(383.086, 612.5]",7,8,-1
31220.0,2020-02-11,"(1069.5, 1298.0]",1,1,0
31221.0,2020-02-11,"(381.963, 642.25]",16,18,-2
31221.0,2020-02-11,"(642.25, 901.5]",7,8,-1
31221.0,2020-02-11,"(901.5, 1160.75]",10,38,-28
31221.0,2020-02-11,"(1160.75, 1420.0]",8,19,-11
31222.0,2020-02-11,"(447.249, 635.75]",8,9,-1
31222.0,2020-02-11,"(635.75, 823.5]",4,4,0
31222.0,2020-02-11,"(1011.25, 1199.0]",4,5,-1
31223.0,2020-02-11,"(339.25, 678.5]",13,2,11
31223.0,2020-02-11,"(678.5, 1017.75]",11,27,-16
31223.0,2020-02-11,"(1017.75, 1357.0]",18,23,-5
31224.0,2020-02-11,"(471.241, 661.75]",6,6,0
31224.0,2020-02-11,"(661.75, 851.5]",1,1,0
31224.0,2020-02-11,"(851.5, 1041.25]",6,15,-9
31224.0,2020-02-11,"(1041.25, 1231.0]",4,16,-12
31225.0,2020-02-11,"(365.973, 623.75]",5,11,-6
31225.0,2020-02-11,"(623.75, 880.5]",3,5,-2
31225.0,2020-02-11,"(880.5, 1137.25]",4,10,-6
31225.0,2020-02-11,"(1137.25, 1394.0]",3,7,-4
31226.0,2020-02-11,"(316.015, 563.25]",3,6,-3
31226.0,2020-02-11,"(809.5, 1055.75]",3,7,-4
31226.0,2020-02-11,"(1055.75, 1302.0]",5,8,-3
31227.0,2020-02-11,"(475.176, 682.0]",22,22,0
31227.0,2020-02-11,"(682.0, 888.0]",4,7,-3
31227.0,2020-02-11,"(888.0, 1094.0]",5,18,-13
31227.0,2020-02-11,"(1094.0, 1300.0]",5,19,-14
31228.0,2020-02-11,"(354.968, 614.0]",12,14,-2
31228.0,2020-02-11,"(614.0, 872.0]",8,13,-5
31228.0,2020-02-11,"(872.0, 1130.0]",13,30,-17
31228.0,2020-02-11,"(1130.0, 1388.0]",6,14,-8
31229.0,2020-02-11,"(365.935, 633.25]",8,35,-27
31229.0,2020-02-11,"(633.25, 899.5]",3,7,-4
31229.0,2020-02-11,"(899.5, 1165.75]",35,49,-14
31229.0,2020-02-11,"(1165.75, 1432.0]",8,16,-8
31230.0,2020-02-11,"(388.039, 629.25]",23,27,-4
31230.0,2020-02-11,"(629.25, 869.5]",6,9,-3
31230.0,2020-02-11,"(869.5, 1109.75]",13,36,-23
31230.0,2020-02-11,"(1109.75, 1350.0]",9,30,-21
31231.0,2020-02-11,"(325.012, 573.0]",8,10,-2
31231.0,2020-02-11,"(573.0, 820.0]",3,4,-1
31231.0,2020-02-11,"(820.0, 1067.0]",6,16,-10
31231.0,2020-02-11,"(1067.0, 1314.0]",4,11,-7
31232.0,2020-02-11,"(260.892, 539.0]",10,13,-3
31232.0,2020-02-11,"(539.0, 816.0]",11,16,-5
31232.0,2020-02-11,"(816.0, 1093.0]",19,36,-17
31232.0,2020-02-11,"(1093.0, 1370.0]",10,29,-19
31233.0,2020-02-11,"(452.077, 683.75]",28,30,-2
31233.0,2020-02-11,"(683.75, 914.5]",3,6,-3
31233.0,2020-02-11,"(914.5, 1145.25]",18,41,-23
31233.0,2020-02-11,"(1145.25, 1376.0]",1,9,-8
31234.0,2020-02-11,"(353.75, 697.5]",11,1,10
31234.0,2020-02-11,"(697.5, 1041.25]",17,19,-2
31234.0,2020-02-11,"(1041.25, 1385.0]",14,25,-11
31235.0,2020-02-11,"(506.418, 652.5]",5,5,0
31235.0,2020-02-11,"(652.5, 798.0]",2,2,0
31235.0,2020-02-11,"(943.5, 1089.0]",2,8,-6
31236.0,2020-02-11,"(432.153, 644.75]",14,15,-1
31236.0,2020-02-11,"(644.75, 856.5]",4,8,-4
31236.0,2020-02-11,"(856.5, 1068.25]",8,22,-14
31236.0,2020-02-11,"(1068.25, 1280.0]",4,21,-17
31237.0,2020-02-11,"(326.93, 595.5]",4,11,-7
31237.0,2020-02-11,"(595.5, 863.0]",3,8,-5
31237.0,2020-02-11,"(863.0, 1130.5]",19,34,-15
31237.0,2020-02-11,"(1130.5, 1398.0]",5,15,-10
31238.0,2020-02-11,"(74.769, 383.75]",1,1,0
31238.0,2020-02-11,"(383.75, 691.5]",7,7,0
31238.0,2020-02-11,"(691.5, 999.25]",2,7,-5
31238.0,2020-02-11,"(999.25, 1307.0]",7,28,-21
31239.0,2020-02-11,"(431.183, 636.25]",11,11,0
31239.0,2020-02-11,"(840.5, 1044.75]",4,15,-11
31239.0,2020-02-11,"(1044.75, 1249.0]",4,24,-20
31240.0,2020-02-11,"(460.354, 622.5]",1,2,-1
31240.0,2020-02-11,"(945.5, 1107.0]",2,7,-5
31241.0,2020-02-11,"(15.675, 348.25]",1,1,0
31241.0,2020-02-11,"(348.25, 679.5]",15,36,-21
31241.0,2020-02-11,"(679.5, 1010.75]",11,21,-10
31241.0,2020-02-11,"(1010.75, 1342.0]",28,55,-27
31242.0,2020-02-11,"(420.256, 607.0]",15,16,-1
31242.0,2020-02-11,"(607.0, 793.0]",3,4,-1
31242.0,2020-02-11,"(793.0, 979.0]",5,8,-3
31242.0,2020-02-11,"(979.0, 1165.0]",1,28,-27
31243.0,2020-02-11,"(387.953, 650.75]",9,11,-2
31243.0,2020-02-11,"(912.5, 1174.25]",3,2,1
31243.0,2020-02-11,"(1174.25, 1436.0]",3,24,-21
31244.0,2020-02-11,"(455.039, 696.25]",10,15,-5
31244.0,2020-02-11,"(696.25, 936.5]",3,7,-4
31244.0,2020-02-11,"(936.5, 1176.75]",8,17,-9
31244.0,2020-02-11,"(1176.75, 1417.0]",8,10,-2
31245.0,2020-02-11,"(378.019, 624.25]",5,11,-6
31245.0,2020-02-11,"(624.25, 869.5]",1,2,-1
31245.0,2020-02-11,"(869.5, 1114.75]",12,23,-11
31245.0,2020-02-11,"(1114.75, 1360.0]",10,20,-10
31246.0,2020-02-11,"(14.763, 325.25]",1,1,0
31246.0,2020-02-11,"(325.25, 634.5]",6,8,-2
31246.0,2020-02-11,"(634.5, 943.75]",1,3,-2
31246.0,2020-02-11,"(943.75, 1253.0]",9,27,-18
31247.0,2020-02-11,"(479.201, 679.75]",4,6,-2
31247.0,2020-02-11,"(679.75, 879.5]",2,4,-2
31247.0,2020-02-11,"(879.5, 1079.25]",6,16,-10
31247.0,2020-02-11,"(1079.25, 1279.0]",4,8,-4
31248.0,2020-02-11,"(415.317, 586.75]",3,7,-4
31248.0,2020-02-11,"(757.5, 928.25]",2,1,1
31248.0,2020-02-11,"(928.25, 1099.0]",11,3,8
31249.0,2020-02-11,"(420.073, 652.75]",3,5,-2
31249.0,2020-02-11,"(884.5, 1116.25]",5,12,-7
31249.0,2020-02-11,"(1116.25, 1348.0]",2,4,-2
31250.0,2020-02-11,"(481.316, 653.0]",10,11,-1
31250.0,2020-02-11,"(653.0, 824.0]",1,2,-1
31250.0,2020-02-11,"(824.0, 995.0]",2,4,-2
31250.0,2020-02-11,"(995.0, 1166.0]",5,26,-21
31251.0,2020-02-11,"(238.826, 533.5]",4,9,-5
31251.0,2020-02-11,"(533.5, 827.0]",10,14,-4
31251.0,2020-02-11,"(827.0, 1120.5]",10,27,-17
31251.0,2020-02-11,"(1120.5, 1414.0]",10,17,-7
31252.0,2020-02-11,"(479.164, 689.0]",12,13,-1
31252.0,2020-02-11,"(689.0, 898.0]",5,7,-2
31252.0,2020-02-11,"(898.0, 1107.0]",6,23,-17
31253.0,2020-02-11,"(387.0, 693.0]",13,1,12
31253.0,2020-02-11,"(693.0, 999.0]",6,14,-8
31253.0,2020-02-11,"(999.0, 1305.0]",3,11,-8
31254.0,2020-02-11,"(409.057, 645.75]",11,12,-1
31254.0,2020-02-11,"(645.75, 881.5]",2,4,-2
31254.0,2020-02-11,"(881.5, 1117.25]",2,25,-23
31254.0,2020-02-11,"(1117.25, 1353.0]",1,7,-6
31255.0,2020-02-11,"(392.081, 622.75]",10,13,-3
31255.0,2020-02-11,"(622.75, 852.5]",3,5,-2
31255.0,2020-02-11,"(852.5, 1082.25]",11,24,-13
31255.0,2020-02-11,"(1082.25, 1312.0]",3,7,-4
31256.0,2020-02-11,"(264.004, 514.0]",5,5,0
31256.0,2020-02-11,"(514.0, 763.0]",7,7,0
31256.0,2020-02-11,"(763.0, 1012.0]",2,5,-3
31256.0,2020-02-11,"(1012.0, 1261.0]",8,22,-14
31257.0,2020-02-11,"(9.681, 340.75]",2,3,-1
31257.0,2020-02-11,"(340.75, 670.5]",14,20,-6
31257.0,2020-02-11,"(670.5, 1000.25]",5,11,-6
31257.0,2020-02-11,"(1000.25, 1330.0]",11,33,-22
31258.0,2020-02-11,"(458.128, 677.0]",2,5,-3
31258.0,2020-02-11,"(677.0, 895.0]",4,12,-8
31258.0,2020-02-11,"(895.0, 1113.0]",5,16,-11
31258.0,2020-02-11,"(1113.0, 1331.0]",2,3,-1
31259.0,2020-02-11,"(458.413, 605.75]",6,6,0
31259.0,2020-02-11,"(899.25, 1046.0]",1,9,-8
31260.0,2020-02-11,"(392.065, 626.75]",13,13,0
31260.0,2020-02-11,"(626.75, 860.5]",2,5,-3
31260.0,2020-02-11,"(860.5, 1094.25]",2,14,-12
31260.0,2020-02-11,"(1094.25, 1328.0]",5,13,-8
31261.0,2020-02-11,"(385.953, 648.75]",9,9,0
31261.0,2020-02-11,"(910.5, 1172.25]",4,18,-14
31262.0,2020-02-11,"(472.143, 687.25]",6,6,0
31262.0,2020-02-11,"(901.5, 1115.75]",2,12,-10
31262.0,2020-02-11,"(1115.75, 1330.0]",6,16,-10
31263.0,2020-02-11,"(87.653, 425.75]",1,3,-2
31263.0,2020-02-11,"(425.75, 762.5]",10,15,-5
31263.0,2020-02-11,"(762.5, 1099.25]",9,25,-16
31263.0,2020-02-11,"(1099.25, 1436.0]",8,15,-7
31264.0,2020-02-11,"(439.039, 680.25]",5,7,-2
31264.0,2020-02-11,"(920.5, 1160.75]",8,1,7
31264.0,2020-02-11,"(1160.75, 1401.0]",2,17,-15
31265.0,2020-02-11,"(423.039, 664.25]",7,18,-11
31265.0,2020-02-11,"(664.25, 904.5]",2,6,-4
31265.0,2020-02-11,"(904.5, 1144.75]",26,41,-15
31265.0,2020-02-11,"(1144.75, 1385.0]",9,18,-9
31266.0,2020-02-11,"(0.613, 348.75]",1,2,-1
31266.0,2020-02-11,"(348.75, 695.5]",1,18,-17
31266.0,2020-02-11,"(695.5, 1042.25]",13,21,-8
31266.0,2020-02-11,"(1042.25, 1389.0]",24,37,-13
31267.0,2020-02-11,"(469.158, 680.5]",20,31,-11
31267.0,2020-02-11,"(680.5, 891.0]",5,8,-3
31267.0,2020-02-11,"(891.0, 1101.5]",15,24,-9
31267.0,2020-02-11,"(1101.5, 1312.0]",10,33,-23
31268.0,2020-02-11,"(334.921, 605.75]",19,38,-19
31268.0,2020-02-11,"(605.75, 875.5]",3,7,-4
31268.0,2020-02-11,"(875.5, 1145.25]",31,41,-10
31268.0,2020-02-11,"(1145.25, 1415.0]",5,11,-6
31269.0,2020-02-11,"(478.102, 703.5]",4,7,-3
31269.0,2020-02-11,"(703.5, 928.0]",4,7,-3
31269.0,2020-02-11,"(928.0, 1152.5]",8,15,-7
31269.0,2020-02-11,"(1152.5, 1377.0]",3,7,-4
31270.0,2020-02-11,"(456.088, 685.0]",4,6,-2
31270.0,2020-02-11,"(685.0, 913.0]",1,5,-4
31270.0,2020-02-11,"(913.0, 1141.0]",7,14,-7
31270.0,2020-02-11,"(1141.0, 1369.0]",4,6,-2
31271.0,2020-02-11,"(466.211, 664.25]",8,10,-2
31271.0,2020-02-11,"(861.5, 1058.75]",4,12,-8
31271.0,2020-02-11,"(1058.75, 1256.0]",3,9,-6
31272.0,2020-02-11,"(302.085, 531.75]",10,11,-1
31272.0,2020-02-11,"(531.75, 760.5]",5,5,0
31272.0,2020-02-11,"(760.5, 989.25]",3,11,-8
31272.0,2020-02-11,"(989.25, 1218.0]",6,28,-22
31273.0,2020-02-11,"(694.0, 863.0]",1,3,-2
31273.0,2020-02-11,"(863.0, 1032.0]",2,2,0
31273.0,2020-02-11,"(1032.0, 1201.0]",3,2,1
31274.0,2020-02-11,"(437.03, 680.5]",4,4,0
31274.0,2020-02-11,"(680.5, 923.0]",1,1,0
31274.0,2020-02-11,"(923.0, 1165.5]",6,21,-15
31274.0,2020-02-11,"(1165.5, 1408.0]",3,8,-5
31275.0,2020-02-11,"(783.384, 938.0]",1,4,-3
31275.0,2020-02-11,"(938.0, 1092.0]",4,17,-13
31275.0,2020-02-11,"(1092.0, 1246.0]",4,12,-8
31275.0,2020-02-11,"(1246.0, 1400.0]",5,9,-4
31276.0,2020-02-11,"(327.895, 605.25]",18,21,-3
31276.0,2020-02-11,"(881.5, 1157.75]",5,24,-19
31276.0,2020-02-11,"(1157.75, 1434.0]",1,9,-8
31277.0,2020-02-11,"(440.308, 614.0]",15,15,0
31277.0,2020-02-11,"(614.0, 787.0]",1,2,-1
31277.0,2020-02-11,"(787.0, 960.0]",4,9,-5
31277.0,2020-02-11,"(960.0, 1133.0]",6,31,-25
31278.0,2020-02-11,"(408.042, 648.5]",5,21,-16
31278.0,2020-02-11,"(648.5, 888.0]",3,6,-3
31278.0,2020-02-11,"(888.0, 1127.5]",13,24,-11
31278.0,2020-02-11,"(1127.5, 1367.0]",15,20,-5
31279.0,2020-02-11,"(451.144, 666.0]",10,12,-2
31279.0,2020-02-11,"(666.0, 880.0]",4,12,-8
31279.0,2020-02-11,"(880.0, 1094.0]",7,25,-18
31279.0,2020-02-11,"(1094.0, 1308.0]",3,12,-9
31280.0,2020-02-11,"(177.764, 488.0]",5,9,-4
31280.0,2020-02-11,"(488.0, 797.0]",1,11,-10
31280.0,2020-02-11,"(797.0, 1106.0]",15,21,-6
31280.0,2020-02-11,"(1106.0, 1415.0]",9,15,-6
31000.0,2020-02-12,"(631.25, 774.5]",1,1,0
31000.0,2020-02-12,"(917.75, 1061.0]",1,2,-1
31001.0,2020-02-12,"(965.25, 1125.0]",1,1,0
31002.0,2020-02-12,"(459.246, 648.5]",3,4,-1
31002.0,2020-02-12,"(648.5, 837.0]",1,2,-1
31002.0,2020-02-12,"(1025.5, 1214.0]",3,1,2
31003.0,2020-02-12,"(380.254, 567.5]",2,6,-4
31003.0,2020-02-12,"(567.5, 754.0]",2,5,-3
31003.0,2020-02-12,"(754.0, 940.5]",1,2,-1
31003.0,2020-02-12,"(940.5, 1127.0]",4,6,-2
31004.0,2020-02-12,"(880.75, 1003.0]",1,1,0
31005.0,2020-02-12,"(421.156, 633.0]",3,6,-3
31005.0,2020-02-12,"(633.0, 844.0]",4,6,-2
31006.0,2020-02-12,"(534.347, 698.25]",1,2,-1
31006.0,2020-02-12,"(698.25, 861.5]",2,4,-2
31006.0,2020-02-12,"(861.5, 1024.75]",1,1,0
31006.0,2020-02-12,"(1024.75, 1188.0]",2,2,0
31007.0,2020-02-12,"(348.103, 573.25]",9,22,-13
31007.0,2020-02-12,"(573.25, 797.5]",5,10,-5
31007.0,2020-02-12,"(797.5, 1021.75]",5,10,-5
31007.0,2020-02-12,"(1021.75, 1246.0]",2,9,-7
31009.0,2020-02-12,"(506.411, 654.25]",3,3,0
31009.0,2020-02-12,"(654.25, 801.5]",2,3,-1
31009.0,2020-02-12,"(801.5, 948.75]",2,3,-1
31010.0,2020-02-12,"(436.129, 654.75]",1,1,0
31010.0,2020-02-12,"(872.5, 1090.25]",2,1,1
31010.0,2020-02-12,"(1090.25, 1308.0]",1,3,-2
31011.0,2020-02-12,"(437.285, 616.75]",7,9,-2
31011.0,2020-02-12,"(974.25, 1153.0]",2,1,1
31012.0,2020-02-12,"(357.108, 581.0]",6,7,-1
31012.0,2020-02-12,"(581.0, 804.0]",1,2,-1
31012.0,2020-02-12,"(1027.0, 1250.0]",2,3,-1
31013.0,2020-02-12,"(598.0, 801.0]",1,2,-1
31013.0,2020-02-12,"(801.0, 1004.0]",1,1,0
31013.0,2020-02-12,"(1004.0, 1207.0]",2,2,0
31014.0,2020-02-12,"(496.121, 716.75]",20,27,-7
31014.0,2020-02-12,"(716.75, 936.5]",8,12,-4
31014.0,2020-02-12,"(936.5, 1156.25]",13,22,-9
31014.0,2020-02-12,"(1156.25, 1376.0]",1,2,-1
31015.0,2020-02-12,"(10.95, 274.5]",2,2,0
31015.0,2020-02-12,"(274.5, 537.0]",16,20,-4
31015.0,2020-02-12,"(537.0, 799.5]",4,5,-1
31015.0,2020-02-12,"(799.5, 1062.0]",5,8,-3
31016.0,2020-02-12,"(428.256, 615.0]",7,12,-5
31016.0,2020-02-12,"(615.0, 801.0]",2,6,-4
31016.0,2020-02-12,"(801.0, 987.0]",2,2,0
31016.0,2020-02-12,"(987.0, 1173.0]",4,5,-1
31017.0,2020-02-12,"(505.233, 697.75]",3,4,-1
31017.0,2020-02-12,"(697.75, 889.5]",1,3,-2
31018.0,2020-02-12,"(721.75, 791.0]",1,1,0
31019.0,2020-02-12,"(430.324, 600.0]",2,4,-2
31019.0,2020-02-12,"(769.0, 938.0]",1,3,-2
31019.0,2020-02-12,"(938.0, 1107.0]",2,3,-1
31020.0,2020-02-12,"(958.75, 1099.0]",1,1,0
31021.0,2020-02-12,"(375.321, 545.75]",1,3,-2
31021.0,2020-02-12,"(545.75, 715.5]",1,2,-1
31021.0,2020-02-12,"(715.5, 885.25]",1,2,-1
31021.0,2020-02-12,"(885.25, 1055.0]",2,4,-2
31022.0,2020-02-12,"(309.901, 585.75]",3,9,-6
31022.0,2020-02-12,"(585.75, 860.5]",3,7,-4
31022.0,2020-02-12,"(860.5, 1135.25]",1,5,-4
31023.0,2020-02-12,"(1104.5, 1204.25]",1,2,-1
31024.0,2020-02-12,"(376.06, 612.0]",5,10,-5
31024.0,2020-02-12,"(612.0, 847.0]",3,4,-1
31024.0,2020-02-12,"(847.0, 1082.0]",3,8,-5
31024.0,2020-02-12,"(1082.0, 1317.0]",2,2,0
31025.0,2020-02-12,"(803.5, 937.75]",1,1,0
31025.0,2020-02-12,"(937.75, 1072.0]",3,1,2
31026.0,2020-02-12,"(394.102, 619.5]",3,6,-3
31026.0,2020-02-12,"(844.0, 1068.5]",2,3,-1
31026.0,2020-02-12,"(1068.5, 1293.0]",1,4,-3
31027.0,2020-02-12,"(138.274, 320.5]",1,2,-1
31027.0,2020-02-12,"(320.5, 502.0]",1,1,0
31027.0,2020-02-12,"(502.0, 683.5]",1,2,-1
31028.0,2020-02-12,"(487.446, 626.5]",1,1,0
31028.0,2020-02-12,"(903.5, 1042.0]",1,1,0
31029.0,2020-02-12,"(645.25, 854.5]",2,4,-2
31029.0,2020-02-12,"(854.5, 1063.75]",3,3,0
31029.0,2020-02-12,"(1063.75, 1273.0]",1,4,-3
31030.0,2020-02-12,"(795.0, 964.0]",1,6,-5
31030.0,2020-02-12,"(964.0, 1133.0]",3,3,0
31031.0,2020-02-12,"(536.25, 716.5]",1,3,-2
31031.0,2020-02-12,"(896.75, 1077.0]",3,4,-1
31032.0,2020-02-12,"(657.75, 851.5]",1,3,-2
31032.0,2020-02-12,"(1045.25, 1239.0]",1,2,-1
31033.0,2020-02-12,"(862.897, 888.75]",1,1,0
31033.0,2020-02-12,"(940.25, 966.0]",1,1,0
31034.0,2020-02-12,"(470.21, 668.5]",3,5,-2
31034.0,2020-02-12,"(668.5, 866.0]",2,3,-1
31034.0,2020-02-12,"(866.0, 1063.5]",1,4,-3
31034.0,2020-02-12,"(1063.5, 1261.0]",2,3,-1
31035.0,2020-02-12,"(606.25, 838.5]",1,2,-1
31035.0,2020-02-12,"(838.5, 1070.75]",2,2,0
31036.0,2020-02-12,"(874.0, 1088.5]",2,1,1
31036.0,2020-02-12,"(1088.5, 1303.0]",2,5,-3
31037.0,2020-02-12,"(325.045, 564.75]",9,11,-2
31037.0,2020-02-12,"(564.75, 803.5]",3,3,0
31037.0,2020-02-12,"(803.5, 1042.25]",4,9,-5
31037.0,2020-02-12,"(1042.25, 1281.0]",2,8,-6
31038.0,2020-02-12,"(548.434, 690.5]",1,2,-1
31038.0,2020-02-12,"(832.0, 973.5]",1,1,0
31038.0,2020-02-12,"(973.5, 1115.0]",1,2,-1
31039.0,2020-02-12,"(466.416, 613.0]",3,6,-3
31039.0,2020-02-12,"(759.0, 905.0]",1,2,-1
31039.0,2020-02-12,"(905.0, 1051.0]",2,3,-1
31040.0,2020-02-12,"(442.128, 661.0]",4,4,0
31040.0,2020-02-12,"(661.0, 879.0]",1,2,-1
31040.0,2020-02-12,"(879.0, 1097.0]",1,4,-3
31041.0,2020-02-12,"(804.75, 900.0]",1,1,0
31042.0,2020-02-12,"(435.298, 611.5]",4,5,-1
31042.0,2020-02-12,"(611.5, 787.0]",1,2,-1
31042.0,2020-02-12,"(787.0, 962.5]",2,2,0
31042.0,2020-02-12,"(962.5, 1138.0]",2,6,-4
31043.0,2020-02-12,"(410.321, 580.75]",1,2,-1
31043.0,2020-02-12,"(580.75, 750.5]",1,2,-1
31043.0,2020-02-12,"(750.5, 920.25]",3,5,-2
31043.0,2020-02-12,"(920.25, 1090.0]",1,3,-2
31044.0,2020-02-12,"(539.485, 668.75]",2,2,0
31045.0,2020-02-12,"(47.901, 323.75]",1,1,0
31045.0,2020-02-12,"(598.5, 873.25]",1,2,-1
31045.0,2020-02-12,"(873.25, 1148.0]",2,3,-1
31046.0,2020-02-12,"(565.0, 734.0]",1,3,-2
31046.0,2020-02-12,"(734.0, 903.0]",1,1,0
31046.0,2020-02-12,"(903.0, 1072.0]",2,3,-1
31047.0,2020-02-12,"(349.203, 549.25]",11,16,-5
31047.0,2020-02-12,"(549.25, 748.5]",2,6,-4
31047.0,2020-02-12,"(748.5, 947.75]",4,5,-1
31047.0,2020-02-12,"(947.75, 1147.0]",4,16,-12
31048.0,2020-02-12,"(509.133, 726.75]",2,3,-1
31048.0,2020-02-12,"(943.5, 1160.25]",2,1,1
31048.0,2020-02-12,"(1160.25, 1377.0]",1,5,-4
31049.0,2020-02-12,"(434.125, 653.75]",1,4,-3
31049.0,2020-02-12,"(872.5, 1091.25]",1,1,0
31049.0,2020-02-12,"(1091.25, 1310.0]",2,3,-1
31050.0,2020-02-12,"(1178.0, 1415.0]",2,3,-1
31051.0,2020-02-12,"(479.102, 704.5]",1,4,-3
31051.0,2020-02-12,"(704.5, 929.0]",1,2,-1
31051.0,2020-02-12,"(929.0, 1153.5]",4,4,0
31051.0,2020-02-12,"(1153.5, 1378.0]",1,1,0
31052.0,2020-02-12,"(522.467, 656.25]",2,3,-1
31052.0,2020-02-12,"(789.5, 922.75]",1,1,0
31052.0,2020-02-12,"(922.75, 1056.0]",1,1,0
31053.0,2020-02-12,"(944.75, 1062.0]",1,1,0
31054.0,2020-02-12,"(945.0, 998.0]",1,1,0
31055.0,2020-02-12,"(406.436, 548.0]",1,2,-1
31055.0,2020-02-12,"(830.0, 971.0]",2,2,0
31056.0,2020-02-12,"(3.724, 324.0]",1,1,0
31056.0,2020-02-12,"(962.0, 1281.0]",2,1,1
,,,,2.0,
,,,,2.0,
,,,,2.0,
31060.0,2020-02-12,"(496.5, 662.0]",1,1,0
31061.0,2020-02-12,"(951.75, 1113.0]",2,2,0
31062.0,2020-02-12,"(527.477, 658.75]",2,5,-3
31062.0,2020-02-12,"(658.75, 789.5]",1,2,-1
31062.0,2020-02-12,"(789.5, 920.25]",1,2,-1
31062.0,2020-02-12,"(920.25, 1051.0]",1,2,-1
,,,,2.0,
31064.0,2020-02-12,"(478.186, 682.5]",2,4,-2
31064.0,2020-02-12,"(682.5, 886.0]",1,2,-1
31064.0,2020-02-12,"(886.0, 1089.5]",1,2,-1
31064.0,2020-02-12,"(1089.5, 1293.0]",1,2,-1
31065.0,2020-02-12,"(751.25, 878.0]",1,2,-1
31066.0,2020-02-12,"(916.0, 1060.0]",1,2,-1
31067.0,2020-02-12,"(630.265, 814.75]",1,3,-2
31068.0,2020-02-12,"(1043.75, 1193.0]",1,1,0
31069.0,2020-02-12,"(680.0, 869.5]",1,3,-2
31069.0,2020-02-12,"(869.5, 1059.0]",1,2,-1
31070.0,2020-02-12,"(999.5, 1142.0]",1,2,-1
31071.0,2020-02-12,"(444.241, 634.75]",1,6,-5
31071.0,2020-02-12,"(634.75, 824.5]",2,4,-2
31071.0,2020-02-12,"(824.5, 1014.25]",2,3,-1
31071.0,2020-02-12,"(1014.25, 1204.0]",2,4,-2
,,,,2.0,
31073.0,2020-02-12,"(456.441, 596.75]",1,3,-2
31073.0,2020-02-12,"(876.25, 1016.0]",1,1,0
31074.0,2020-02-12,"(875.565, 984.75]",3,3,0
31074.0,2020-02-12,"(1202.25, 1311.0]",1,1,0
,,,,1.0,
,,,,2.0,
31076.0,2020-02-12,"(903.5, 1113.75]",1,2,-1
31076.0,2020-02-12,"(1113.75, 1324.0]",2,1,1
31077.0,2020-02-12,"(478.393, 630.75]",5,14,-9
31077.0,2020-02-12,"(782.5, 934.25]",2,2,0
31077.0,2020-02-12,"(934.25, 1086.0]",2,2,0
31078.0,2020-02-12,"(474.397, 625.75]",6,7,-1
31078.0,2020-02-12,"(927.25, 1078.0]",1,4,-3
31079.0,2020-02-12,"(464.106, 688.5]",1,9,-8
31079.0,2020-02-12,"(688.5, 912.0]",1,2,-1
31079.0,2020-02-12,"(912.0, 1135.5]",1,4,-3
31079.0,2020-02-12,"(1135.5, 1359.0]",4,4,0
31080.0,2020-02-12,"(860.0, 1089.0]",1,7,-6
31080.0,2020-02-12,"(1089.0, 1318.0]",4,1,3
31081.0,2020-02-12,"(366.146, 580.5]",2,4,-2
31081.0,2020-02-12,"(1007.5, 1221.0]",1,1,0
31082.0,2020-02-12,"(521.488, 650.0]",1,1,0
31083.0,2020-02-12,"(401.291, 579.25]",1,4,-3
31083.0,2020-02-12,"(933.75, 1111.0]",3,2,1
31084.0,2020-02-12,"(352.0, 660.0]",6,1,5
31084.0,2020-02-12,"(660.0, 968.0]",1,6,-5
31085.0,2020-02-12,"(400.316, 572.0]",1,5,-4
31085.0,2020-02-12,"(743.0, 914.0]",1,1,0
31085.0,2020-02-12,"(914.0, 1085.0]",1,1,0
31086.0,2020-02-12,"(893.0, 1052.0]",2,2,0
31087.0,2020-02-12,"(920.25, 1068.0]",4,1,3
31088.0,2020-02-12,"(714.5, 916.0]",1,3,-2
31088.0,2020-02-12,"(916.0, 1117.5]",1,1,0
31088.0,2020-02-12,"(1117.5, 1319.0]",1,1,0
31089.0,2020-02-12,"(459.065, 693.75]",10,14,-4
31089.0,2020-02-12,"(693.75, 927.5]",4,10,-6
31089.0,2020-02-12,"(927.5, 1161.25]",4,21,-17
31089.0,2020-02-12,"(1161.25, 1395.0]",2,3,-1
,,,,1.0,
,,,,2.0,
31091.0,2020-02-12,"(54.668, 389.0]",1,1,0
31091.0,2020-02-12,"(722.0, 1055.0]",1,5,-4
31091.0,2020-02-12,"(1055.0, 1388.0]",4,2,2
31092.0,2020-02-12,"(919.614, 1016.5]",1,1,0
31092.0,2020-02-12,"(1016.5, 1113.0]",3,3,0
31093.0,2020-02-12,"(932.25, 1117.0]",1,3,-2
31094.0,2020-02-12,"(450.212, 648.0]",1,3,-2
31094.0,2020-02-12,"(1042.0, 1239.0]",1,1,0
,,,,2.0,
31096.0,2020-02-12,"(38.903, 314.25]",1,1,0
31096.0,2020-02-12,"(862.75, 1137.0]",2,3,-1
31097.0,2020-02-12,"(466.565, 575.75]",1,2,-1
31097.0,2020-02-12,"(575.75, 684.5]",1,1,0
31097.0,2020-02-12,"(793.25, 902.0]",1,1,0
31098.0,2020-02-12,"(402.338, 568.5]",5,8,-3
31098.0,2020-02-12,"(899.5, 1065.0]",2,7,-5
31099.0,2020-02-12,"(958.75, 1126.0]",2,2,0
31100.0,2020-02-12,"(434.106, 658.5]",13,14,-1
31100.0,2020-02-12,"(658.5, 882.0]",2,7,-5
31100.0,2020-02-12,"(882.0, 1105.5]",9,15,-6
31100.0,2020-02-12,"(1105.5, 1329.0]",1,6,-5
31101.0,2020-02-12,"(327.917, 599.75]",14,52,-38
31101.0,2020-02-12,"(599.75, 870.5]",8,16,-8
31101.0,2020-02-12,"(870.5, 1141.25]",28,41,-13
31101.0,2020-02-12,"(1141.25, 1412.0]",15,25,-10
31102.0,2020-02-12,"(365.934, 633.5]",1,23,-22
31102.0,2020-02-12,"(900.0, 1166.5]",4,6,-2
31102.0,2020-02-12,"(1166.5, 1433.0]",5,9,-4
31103.0,2020-02-12,"(339.023, 584.25]",3,33,-30
31103.0,2020-02-12,"(828.5, 1072.75]",4,8,-4
31103.0,2020-02-12,"(1072.75, 1317.0]",6,11,-5
31104.0,2020-02-12,"(460.75, 785.5]",3,8,-5
31104.0,2020-02-12,"(785.5, 1110.25]",19,8,11
31104.0,2020-02-12,"(1110.25, 1435.0]",7,29,-22
31105.0,2020-02-12,"(332.001, 582.75]",3,14,-11
31105.0,2020-02-12,"(582.75, 832.5]",2,6,-4
31105.0,2020-02-12,"(832.5, 1082.25]",1,4,-3
31105.0,2020-02-12,"(1082.25, 1332.0]",3,9,-6
31106.0,2020-02-12,"(448.354, 610.5]",2,9,-7
31106.0,2020-02-12,"(933.5, 1095.0]",3,1,2
31107.0,2020-02-12,"(300.917, 572.75]",5,28,-23
31107.0,2020-02-12,"(572.75, 843.5]",3,9,-6
31107.0,2020-02-12,"(843.5, 1114.25]",12,21,-9
31107.0,2020-02-12,"(1114.25, 1385.0]",9,12,-3
31108.0,2020-02-12,"(406.07, 639.5]",6,23,-17
31108.0,2020-02-12,"(639.5, 872.0]",5,10,-5
31108.0,2020-02-12,"(872.0, 1104.5]",11,23,-12
31108.0,2020-02-12,"(1104.5, 1337.0]",11,14,-3
31109.0,2020-02-12,"(26.605, 376.75]",1,2,-1
31109.0,2020-02-12,"(376.75, 725.5]",9,29,-20
31109.0,2020-02-12,"(725.5, 1074.25]",14,20,-6
31109.0,2020-02-12,"(1074.25, 1423.0]",7,13,-6
31110.0,2020-02-12,"(24.607, 374.25]",5,6,-1
31110.0,2020-02-12,"(374.25, 722.5]",18,44,-26
31110.0,2020-02-12,"(722.5, 1070.75]",8,23,-15
31110.0,2020-02-12,"(1070.75, 1419.0]",8,14,-6
31111.0,2020-02-12,"(343.961, 604.75]",3,15,-12
31111.0,2020-02-12,"(604.75, 864.5]",2,6,-4
31111.0,2020-02-12,"(864.5, 1124.25]",7,10,-3
31111.0,2020-02-12,"(1124.25, 1384.0]",6,8,-2
31112.0,2020-02-12,"(489.36, 650.0]",1,3,-2
31112.0,2020-02-12,"(810.0, 970.0]",1,2,-1
31112.0,2020-02-12,"(970.0, 1130.0]",2,1,1
31113.0,2020-02-12,"(37.7, 364.0]",1,1,0
31113.0,2020-02-12,"(689.0, 1014.0]",7,23,-16
31113.0,2020-02-12,"(1014.0, 1339.0]",8,14,-6
31114.0,2020-02-12,"(313.933, 581.75]",6,30,-24
31114.0,2020-02-12,"(848.5, 1115.25]",12,14,-2
31114.0,2020-02-12,"(1115.25, 1382.0]",12,18,-6
31115.0,2020-02-12,"(342.918, 614.5]",2,20,-18
31115.0,2020-02-12,"(614.5, 885.0]",1,6,-5
31115.0,2020-02-12,"(885.0, 1155.5]",6,9,-3
31115.0,2020-02-12,"(1155.5, 1426.0]",5,7,-2
31116.0,2020-02-12,"(0.602, 351.5]",1,1,0
31116.0,2020-02-12,"(351.5, 701.0]",5,27,-22
31116.0,2020-02-12,"(701.0, 1050.5]",17,25,-8
31116.0,2020-02-12,"(1050.5, 1400.0]",14,19,-5
31117.0,2020-02-12,"(137.733, 455.75]",1,7,-6
31117.0,2020-02-12,"(455.75, 772.5]",4,13,-9
31117.0,2020-02-12,"(772.5, 1089.25]",6,12,-6
31117.0,2020-02-12,"(1089.25, 1406.0]",6,11,-5
31118.0,2020-02-12,"(415.041, 655.75]",1,17,-16
31118.0,2020-02-12,"(655.75, 895.5]",2,3,-1
31118.0,2020-02-12,"(895.5, 1135.25]",6,11,-5
31118.0,2020-02-12,"(1135.25, 1375.0]",3,3,0
31119.0,2020-02-12,"(46.657, 383.75]",1,4,-3
31119.0,2020-02-12,"(383.75, 719.5]",8,27,-19
31119.0,2020-02-12,"(719.5, 1055.25]",12,17,-5
31119.0,2020-02-12,"(1055.25, 1391.0]",12,20,-8
31120.0,2020-02-12,"(408.073, 640.75]",1,18,-17
31120.0,2020-02-12,"(640.75, 872.5]",5,9,-4
31120.0,2020-02-12,"(872.5, 1104.25]",2,7,-5
31120.0,2020-02-12,"(1104.25, 1336.0]",3,3,0
31121.0,2020-02-12,"(339.004, 589.0]",12,16,-4
31121.0,2020-02-12,"(589.0, 838.0]",1,3,-2
31121.0,2020-02-12,"(838.0, 1087.0]",4,12,-8
31121.0,2020-02-12,"(1087.0, 1336.0]",10,17,-7
31122.0,2020-02-12,"(18.645, 358.75]",1,1,0
31122.0,2020-02-12,"(358.75, 697.5]",1,14,-13
31122.0,2020-02-12,"(697.5, 1036.25]",6,10,-4
31122.0,2020-02-12,"(1036.25, 1375.0]",12,24,-12
31123.0,2020-02-12,"(10.664, 346.0]",1,2,-1
31123.0,2020-02-12,"(346.0, 680.0]",3,22,-19
31123.0,2020-02-12,"(1014.0, 1348.0]",5,12,-7
31124.0,2020-02-12,"(23.591, 377.25]",1,2,-1
31124.0,2020-02-12,"(377.25, 729.5]",16,49,-33
31124.0,2020-02-12,"(729.5, 1081.75]",18,41,-23
31124.0,2020-02-12,"(1081.75, 1434.0]",8,32,-24
31125.0,2020-02-12,"(345.979, 602.25]",8,34,-26
31125.0,2020-02-12,"(602.25, 857.5]",5,8,-3
31125.0,2020-02-12,"(857.5, 1112.75]",15,21,-6
31125.0,2020-02-12,"(1112.75, 1368.0]",12,13,-1
31126.0,2020-02-12,"(346.919, 618.25]",4,26,-22
31126.0,2020-02-12,"(618.25, 888.5]",2,4,-2
31126.0,2020-02-12,"(888.5, 1158.75]",10,13,-3
31126.0,2020-02-12,"(1158.75, 1429.0]",10,16,-6
31127.0,2020-02-12,"(94.75, 408.5]",3,3,0
31127.0,2020-02-12,"(408.5, 721.0]",20,27,-7
31127.0,2020-02-12,"(721.0, 1033.5]",16,29,-13
31127.0,2020-02-12,"(1033.5, 1346.0]",13,28,-15
31128.0,2020-02-12,"(3.571, 362.25]",3,5,-2
31128.0,2020-02-12,"(362.25, 719.5]",25,38,-13
31128.0,2020-02-12,"(719.5, 1076.75]",23,45,-22
31128.0,2020-02-12,"(1076.75, 1434.0]",8,15,-7
31129.0,2020-02-12,"(509.382, 664.5]",11,13,-2
31129.0,2020-02-12,"(664.5, 819.0]",2,2,0
31129.0,2020-02-12,"(819.0, 973.5]",4,5,-1
31129.0,2020-02-12,"(973.5, 1128.0]",3,6,-3
31130.0,2020-02-12,"(440.07, 673.5]",7,14,-7
31130.0,2020-02-12,"(906.0, 1138.5]",4,4,0
31130.0,2020-02-12,"(1138.5, 1371.0]",2,4,-2
31131.0,2020-02-12,"(277.883, 558.25]",2,16,-14
31131.0,2020-02-12,"(558.25, 837.5]",1,3,-2
31131.0,2020-02-12,"(837.5, 1116.75]",3,6,-3
31131.0,2020-02-12,"(1116.75, 1396.0]",7,10,-3
31200.0,2020-02-12,"(122.802, 423.5]",3,4,-1
31200.0,2020-02-12,"(423.5, 723.0]",35,58,-23
31200.0,2020-02-12,"(723.0, 1022.5]",11,23,-12
31200.0,2020-02-12,"(1022.5, 1322.0]",14,32,-18
31201.0,2020-02-12,"(36.651, 375.25]",2,2,0
31201.0,2020-02-12,"(375.25, 712.5]",19,50,-31
31201.0,2020-02-12,"(712.5, 1049.75]",28,54,-26
31201.0,2020-02-12,"(1049.75, 1387.0]",24,43,-19
,,,,2.0,
31203.0,2020-02-12,"(30.635, 373.25]",1,6,-5
31203.0,2020-02-12,"(373.25, 714.5]",10,35,-25
31203.0,2020-02-12,"(714.5, 1055.75]",16,28,-12
31203.0,2020-02-12,"(1055.75, 1397.0]",23,33,-10
31204.0,2020-02-12,"(12.682, 343.5]",2,2,0
31204.0,2020-02-12,"(343.5, 673.0]",11,15,-4
31204.0,2020-02-12,"(673.0, 1002.5]",9,17,-8
31204.0,2020-02-12,"(1002.5, 1332.0]",3,10,-7
31205.0,2020-02-12,"(26.652, 365.0]",1,3,-2
31205.0,2020-02-12,"(365.0, 702.0]",35,42,-7
31205.0,2020-02-12,"(702.0, 1039.0]",17,35,-18
31205.0,2020-02-12,"(1039.0, 1376.0]",6,20,-14
31206.0,2020-02-12,"(393.304, 568.0]",4,5,-1
31206.0,2020-02-12,"(742.0, 916.0]",1,1,0
31206.0,2020-02-12,"(916.0, 1090.0]",4,4,0
31207.0,2020-02-12,"(464.028, 708.0]",1,8,-7
31207.0,2020-02-12,"(708.0, 951.0]",3,5,-2
31207.0,2020-02-12,"(951.0, 1194.0]",3,5,-2
31207.0,2020-02-12,"(1194.0, 1437.0]",1,3,-2
31208.0,2020-02-12,"(386.187, 590.25]",15,20,-5
31208.0,2020-02-12,"(590.25, 793.5]",2,6,-4
31208.0,2020-02-12,"(793.5, 996.75]",2,4,-2
31208.0,2020-02-12,"(996.75, 1200.0]",1,4,-3
31209.0,2020-02-12,"(474.441, 614.75]",9,11,-2
31209.0,2020-02-12,"(614.75, 754.5]",1,3,-2
31209.0,2020-02-12,"(894.25, 1034.0]",2,3,-1
31211.0,2020-02-12,"(357.109, 580.75]",6,10,-4
31211.0,2020-02-12,"(580.75, 803.5]",3,6,-3
31211.0,2020-02-12,"(803.5, 1026.25]",3,7,-4
31211.0,2020-02-12,"(1026.25, 1249.0]",3,11,-8
31212.0,2020-02-12,"(10.643, 351.25]",1,2,-1
31212.0,2020-02-12,"(351.25, 690.5]",42,56,-14
31212.0,2020-02-12,"(690.5, 1029.75]",16,26,-10
31212.0,2020-02-12,"(1029.75, 1369.0]",13,27,-14
31213.0,2020-02-12,"(279.935, 547.25]",19,28,-9
31213.0,2020-02-12,"(547.25, 813.5]",9,22,-13
31213.0,2020-02-12,"(813.5, 1079.75]",14,23,-9
31213.0,2020-02-12,"(1079.75, 1346.0]",2,5,-3
31214.0,2020-02-12,"(298.878, 580.5]",7,31,-24
31214.0,2020-02-12,"(580.5, 861.0]",13,27,-14
31214.0,2020-02-12,"(861.0, 1141.5]",13,20,-7
31214.0,2020-02-12,"(1141.5, 1422.0]",10,12,-2
31215.0,2020-02-12,"(442.296, 619.0]",13,16,-3
31215.0,2020-02-12,"(619.0, 795.0]",4,7,-3
31215.0,2020-02-12,"(795.0, 971.0]",2,2,0
31215.0,2020-02-12,"(971.0, 1147.0]",3,9,-6
31216.0,2020-02-12,"(409.236, 601.0]",26,31,-5
31216.0,2020-02-12,"(601.0, 792.0]",1,2,-1
31216.0,2020-02-12,"(792.0, 983.0]",3,10,-7
31217.0,2020-02-12,"(324.181, 529.75]",12,14,-2
31217.0,2020-02-12,"(529.75, 734.5]",4,5,-1
31217.0,2020-02-12,"(734.5, 939.25]",1,4,-3
31217.0,2020-02-12,"(939.25, 1144.0]",2,11,-9
31218.0,2020-02-12,"(373.144, 588.0]",17,32,-15
31218.0,2020-02-12,"(802.0, 1016.0]",7,2,5
31218.0,2020-02-12,"(1016.0, 1230.0]",7,10,-3
31219.0,2020-02-12,"(468.126, 687.5]",14,14,0
31219.0,2020-02-12,"(906.0, 1124.5]",2,5,-3
31219.0,2020-02-12,"(1124.5, 1343.0]",1,6,-5
31220.0,2020-02-12,"(297.139, 513.25]",15,19,-4
31220.0,2020-02-12,"(513.25, 728.5]",3,4,-1
31220.0,2020-02-12,"(728.5, 943.75]",3,8,-5
31220.0,2020-02-12,"(943.75, 1159.0]",1,14,-13
31221.0,2020-02-12,"(392.0, 696.0]",29,1,28
31221.0,2020-02-12,"(696.0, 1000.0]",12,31,-19
31221.0,2020-02-12,"(1000.0, 1304.0]",7,27,-20
31222.0,2020-02-12,"(513.161, 723.75]",26,27,-1
31222.0,2020-02-12,"(723.75, 933.5]",10,17,-7
31222.0,2020-02-12,"(933.5, 1143.25]",3,14,-11
31222.0,2020-02-12,"(1143.25, 1353.0]",2,4,-2
31223.0,2020-02-12,"(5.59, 359.5]",7,8,-1
31223.0,2020-02-12,"(359.5, 712.0]",25,51,-26
31223.0,2020-02-12,"(712.0, 1064.5]",18,37,-19
31223.0,2020-02-12,"(1064.5, 1417.0]",7,16,-9
31224.0,2020-02-12,"(349.994, 602.5]",13,14,-1
31224.0,2020-02-12,"(602.5, 854.0]",9,13,-4
31224.0,2020-02-12,"(854.0, 1105.5]",4,13,-9
31224.0,2020-02-12,"(1105.5, 1357.0]",1,2,-1
31225.0,2020-02-12,"(365.75, 719.5]",9,1,8
31225.0,2020-02-12,"(719.5, 1073.25]",8,14,-6
31225.0,2020-02-12,"(1073.25, 1427.0]",5,20,-15
31226.0,2020-02-12,"(303.882, 584.5]",3,8,-5
31226.0,2020-02-12,"(584.5, 864.0]",3,4,-1
31226.0,2020-02-12,"(864.0, 1143.5]",4,7,-3
31226.0,2020-02-12,"(1143.5, 1423.0]",2,7,-5
31227.0,2020-02-12,"(420.13, 638.5]",23,25,-2
31227.0,2020-02-12,"(638.5, 856.0]",8,14,-6
31227.0,2020-02-12,"(856.0, 1073.5]",4,11,-7
31227.0,2020-02-12,"(1073.5, 1291.0]",1,9,-8
31228.0,2020-02-12,"(366.25, 708.5]",21,2,19
31228.0,2020-02-12,"(708.5, 1050.75]",13,26,-13
31228.0,2020-02-12,"(1050.75, 1393.0]",8,27,-19
31229.0,2020-02-12,"(14.613, 362.75]",2,4,-2
31229.0,2020-02-12,"(362.75, 709.5]",22,70,-48
31229.0,2020-02-12,"(709.5, 1056.25]",25,46,-21
31229.0,2020-02-12,"(1056.25, 1403.0]",9,17,-8
31230.0,2020-02-12,"(330.922, 601.5]",57,68,-11
31230.0,2020-02-12,"(601.5, 871.0]",12,15,-3
31230.0,2020-02-12,"(871.0, 1140.5]",17,37,-20
31230.0,2020-02-12,"(1140.5, 1410.0]",3,9,-6
31231.0,2020-02-12,"(402.092, 630.0]",22,26,-4
31231.0,2020-02-12,"(630.0, 857.0]",2,8,-6
31231.0,2020-02-12,"(857.0, 1084.0]",4,16,-12
31232.0,2020-02-12,"(263.91, 537.5]",14,19,-5
31232.0,2020-02-12,"(537.5, 810.0]",11,12,-1
31232.0,2020-02-12,"(810.0, 1082.5]",2,14,-12
31232.0,2020-02-12,"(1082.5, 1355.0]",4,9,-5
31233.0,2020-02-12,"(378.947, 643.25]",50,59,-9
31233.0,2020-02-12,"(643.25, 906.5]",19,26,-7
31233.0,2020-02-12,"(906.5, 1169.75]",10,22,-12
31233.0,2020-02-12,"(1169.75, 1433.0]",6,12,-6
31234.0,2020-02-12,"(19.648, 359.0]",1,2,-1
31234.0,2020-02-12,"(359.0, 697.0]",20,36,-16
31234.0,2020-02-12,"(697.0, 1035.0]",19,30,-11
31234.0,2020-02-12,"(1035.0, 1373.0]",15,29,-14
31235.0,2020-02-12,"(460.393, 612.75]",7,7,0
31236.0,2020-02-12,"(450.017, 696.75]",22,27,-5
31236.0,2020-02-12,"(696.75, 942.5]",13,22,-9
31236.0,2020-02-12,"(942.5, 1188.25]",5,24,-19
31236.0,2020-02-12,"(1188.25, 1434.0]",4,10,-6
31237.0,2020-02-12,"(35.619, 382.25]",2,4,-2
31237.0,2020-02-12,"(382.25, 727.5]",11,20,-9
31237.0,2020-02-12,"(727.5, 1072.75]",12,21,-9
31237.0,2020-02-12,"(1072.75, 1418.0]",6,11,-5
31238.0,2020-02-12,"(52.681, 383.75]",1,3,-2
31238.0,2020-02-12,"(383.75, 713.5]",20,23,-3
31238.0,2020-02-12,"(713.5, 1043.25]",5,14,-9
31238.0,2020-02-12,"(1043.25, 1373.0]",3,14,-11
31239.0,2020-02-12,"(358.08, 589.0]",28,32,-4
31239.0,2020-02-12,"(589.0, 819.0]",9,14,-5
31239.0,2020-02-12,"(819.0, 1049.0]",4,10,-6
31239.0,2020-02-12,"(1049.0, 1279.0]",9,25,-16
31240.0,2020-02-12,"(734.686, 813.5]",1,2,-1
31240.0,2020-02-12,"(970.5, 1049.0]",1,2,-1
31241.0,2020-02-12,"(29.651, 368.25]",1,2,-1
31241.0,2020-02-12,"(368.25, 705.5]",33,60,-27
31241.0,2020-02-12,"(705.5, 1042.75]",9,27,-18
31241.0,2020-02-12,"(1042.75, 1380.0]",14,29,-15
31242.0,2020-02-12,"(344.146, 558.5]",24,27,-3
31242.0,2020-02-12,"(558.5, 772.0]",7,10,-3
31242.0,2020-02-12,"(772.0, 985.5]",4,10,-6
31242.0,2020-02-12,"(985.5, 1199.0]",3,15,-12
31243.0,2020-02-12,"(284.0, 559.0]",22,1,21
31243.0,2020-02-12,"(559.0, 834.0]",8,27,-19
31243.0,2020-02-12,"(834.0, 1109.0]",6,14,-8
31244.0,2020-02-12,"(3.672, 337.0]",1,3,-2
31244.0,2020-02-12,"(337.0, 669.0]",17,28,-11
31244.0,2020-02-12,"(669.0, 1001.0]",6,13,-7
31244.0,2020-02-12,"(1001.0, 1333.0]",5,15,-10
31245.0,2020-02-12,"(20.673, 353.75]",1,2,-1
31245.0,2020-02-12,"(353.75, 685.5]",13,29,-16
31245.0,2020-02-12,"(685.5, 1017.25]",16,28,-12
31245.0,2020-02-12,"(1017.25, 1349.0]",7,15,-8
31246.0,2020-02-12,"(60.66, 397.0]",3,3,0
31246.0,2020-02-12,"(397.0, 732.0]",15,27,-12
31246.0,2020-02-12,"(732.0, 1067.0]",17,33,-16
31246.0,2020-02-12,"(1067.0, 1402.0]",8,15,-7
31247.0,2020-02-12,"(414.305, 588.75]",11,16,-5
31247.0,2020-02-12,"(588.75, 762.5]",1,6,-5
31247.0,2020-02-12,"(762.5, 936.25]",6,9,-3
31247.0,2020-02-12,"(936.25, 1110.0]",5,9,-4
31248.0,2020-02-12,"(357.231, 550.25]",7,8,-1
31248.0,2020-02-12,"(550.25, 742.5]",2,5,-3
31248.0,2020-02-12,"(742.5, 934.75]",3,5,-2
31248.0,2020-02-12,"(934.75, 1127.0]",6,13,-7
31249.0,2020-02-12,"(403.269, 586.75]",5,9,-4
31249.0,2020-02-12,"(952.25, 1135.0]",3,7,-4
31250.0,2020-02-12,"(413.084, 643.0]",16,18,-2
31250.0,2020-02-12,"(643.0, 872.0]",6,12,-6
31250.0,2020-02-12,"(872.0, 1101.0]",2,13,-11
31250.0,2020-02-12,"(1101.0, 1330.0]",1,4,-3
31251.0,2020-02-12,"(370.035, 612.25]",17,33,-16
31251.0,2020-02-12,"(612.25, 853.5]",6,9,-3
31251.0,2020-02-12,"(853.5, 1094.75]",9,24,-15
31251.0,2020-02-12,"(1094.75, 1336.0]",2,4,-2
31252.0,2020-02-12,"(461.079, 692.25]",17,19,-2
31252.0,2020-02-12,"(692.25, 922.5]",3,10,-7
31252.0,2020-02-12,"(922.5, 1152.75]",4,12,-8
31252.0,2020-02-12,"(1152.75, 1383.0]",1,4,-3
31253.0,2020-02-12,"(405.069, 638.75]",29,32,-3
31253.0,2020-02-12,"(638.75, 871.5]",4,10,-6
31253.0,2020-02-12,"(871.5, 1104.25]",6,17,-11
31253.0,2020-02-12,"(1104.25, 1337.0]",1,5,-4
31254.0,2020-02-12,"(376.023, 621.25]",27,28,-1
31254.0,2020-02-12,"(621.25, 865.5]",1,2,-1
31254.0,2020-02-12,"(865.5, 1109.75]",2,16,-14
31254.0,2020-02-12,"(1109.75, 1354.0]",5,6,-1
31255.0,2020-02-12,"(374.0, 713.0]",17,1,16
31255.0,2020-02-12,"(713.0, 1052.0]",9,26,-17
31255.0,2020-02-12,"(1052.0, 1391.0]",5,20,-15
31256.0,2020-02-12,"(259.871, 543.25]",14,15,-1
31256.0,2020-02-12,"(543.25, 825.5]",2,5,-3
31256.0,2020-02-12,"(825.5, 1107.75]",4,13,-9
31256.0,2020-02-12,"(1107.75, 1390.0]",1,5,-4
31257.0,2020-02-12,"(337.982, 593.5]",21,32,-11
31257.0,2020-02-12,"(593.5, 848.0]",7,13,-6
31257.0,2020-02-12,"(848.0, 1102.5]",5,15,-10
31257.0,2020-02-12,"(1102.5, 1357.0]",4,14,-10
31258.0,2020-02-12,"(29.669, 363.75]",5,6,-1
31258.0,2020-02-12,"(363.75, 696.5]",6,22,-16
31258.0,2020-02-12,"(696.5, 1029.25]",6,18,-12
31258.0,2020-02-12,"(1029.25, 1362.0]",3,7,-4
31259.0,2020-02-12,"(456.14, 672.0]",13,13,0
31259.0,2020-02-12,"(672.0, 887.0]",2,3,-1
31260.0,2020-02-12,"(340.943, 606.25]",19,23,-4
31260.0,2020-02-12,"(606.25, 870.5]",5,12,-7
31260.0,2020-02-12,"(1134.75, 1399.0]",1,14,-13
31261.0,2020-02-12,"(388.39, 541.5]",10,10,0
31261.0,2020-02-12,"(541.5, 694.0]",1,1,0
31261.0,2020-02-12,"(846.5, 999.0]",5,2,3
31262.0,2020-02-12,"(321.933, 589.75]",9,10,-1
31262.0,2020-02-12,"(589.75, 856.5]",4,5,-1
31262.0,2020-02-12,"(856.5, 1123.25]",2,7,-5
31263.0,2020-02-12,"(358.011, 606.25]",26,39,-13
31263.0,2020-02-12,"(606.25, 853.5]",4,8,-4
31263.0,2020-02-12,"(853.5, 1100.75]",7,16,-9
31263.0,2020-02-12,"(1100.75, 1348.0]",1,10,-9
31264.0,2020-02-12,"(357.315, 529.25]",6,8,-2
31264.0,2020-02-12,"(529.25, 700.5]",4,5,-1
31264.0,2020-02-12,"(700.5, 871.75]",3,4,-1
31264.0,2020-02-12,"(871.75, 1043.0]",1,8,-7
31265.0,2020-02-12,"(368.963, 629.25]",19,43,-24
31265.0,2020-02-12,"(629.25, 888.5]",14,24,-10
31265.0,2020-02-12,"(888.5, 1147.75]",13,27,-14
31265.0,2020-02-12,"(1147.75, 1407.0]",8,13,-5
31266.0,2020-02-12,"(307.918, 579.5]",2,19,-17
31266.0,2020-02-12,"(579.5, 850.0]",8,21,-13
31266.0,2020-02-12,"(850.0, 1120.5]",10,23,-13
31266.0,2020-02-12,"(1120.5, 1391.0]",16,23,-7
31267.0,2020-02-12,"(463.076, 695.0]",30,51,-21
31267.0,2020-02-12,"(695.0, 926.0]",12,23,-11
31267.0,2020-02-12,"(926.0, 1157.0]",7,18,-11
31267.0,2020-02-12,"(1157.0, 1388.0]",2,8,-6
31268.0,2020-02-12,"(18.65, 357.5]",1,1,0
31268.0,2020-02-12,"(357.5, 695.0]",16,42,-26
31268.0,2020-02-12,"(695.0, 1032.5]",11,19,-8
31268.0,2020-02-12,"(1032.5, 1370.0]",15,19,-4
31269.0,2020-02-12,"(349.037, 590.75]",10,16,-6
31269.0,2020-02-12,"(590.75, 831.5]",4,8,-4
31269.0,2020-02-12,"(831.5, 1072.25]",8,17,-9
31269.0,2020-02-12,"(1072.25, 1313.0]",4,7,-3
31270.0,2020-02-12,"(263.992, 517.0]",7,12,-5
31270.0,2020-02-12,"(517.0, 769.0]",8,16,-8
31270.0,2020-02-12,"(769.0, 1021.0]",8,14,-6
31270.0,2020-02-12,"(1021.0, 1273.0]",2,6,-4
31271.0,2020-02-12,"(378.224, 573.0]",17,20,-3
31271.0,2020-02-12,"(573.0, 767.0]",2,3,-1
31271.0,2020-02-12,"(767.0, 961.0]",1,4,-3
31271.0,2020-02-12,"(961.0, 1155.0]",5,10,-5
31272.0,2020-02-12,"(297.9, 574.0]",22,25,-3
31272.0,2020-02-12,"(574.0, 849.0]",6,12,-6
31272.0,2020-02-12,"(849.0, 1124.0]",5,18,-13
31272.0,2020-02-12,"(1124.0, 1399.0]",3,3,0
31273.0,2020-02-12,"(514.484, 644.0]",1,2,-1
31273.0,2020-02-12,"(902.0, 1031.0]",2,1,1
31274.0,2020-02-12,"(396.127, 615.25]",15,16,-1
31274.0,2020-02-12,"(615.25, 833.5]",7,12,-5
31274.0,2020-02-12,"(1051.75, 1270.0]",2,4,-2
31275.0,2020-02-12,"(18.618, 365.5]",2,6,-4
31275.0,2020-02-12,"(365.5, 711.0]",21,33,-12
31275.0,2020-02-12,"(711.0, 1056.5]",12,19,-7
31275.0,2020-02-12,"(1056.5, 1402.0]",2,11,-9
31276.0,2020-02-12,"(429.067, 663.25]",22,24,-2
31276.0,2020-02-12,"(663.25, 896.5]",4,8,-4
31276.0,2020-02-12,"(896.5, 1129.75]",6,18,-12
31276.0,2020-02-12,"(1129.75, 1363.0]",1,2,-1
31277.0,2020-02-12,"(275.051, 513.25]",21,22,-1
31277.0,2020-02-12,"(513.25, 750.5]",20,26,-6
31277.0,2020-02-12,"(750.5, 987.75]",8,18,-10
31277.0,2020-02-12,"(987.75, 1225.0]",5,20,-15
31278.0,2020-02-12,"(313.979, 570.25]",9,34,-25
31278.0,2020-02-12,"(570.25, 825.5]",10,18,-8
31278.0,2020-02-12,"(825.5, 1080.75]",14,20,-6
31278.0,2020-02-12,"(1080.75, 1336.0]",8,16,-8
31279.0,2020-02-12,"(415.137, 631.75]",22,23,-1
31279.0,2020-02-12,"(631.75, 847.5]",5,11,-6
31279.0,2020-02-12,"(847.5, 1063.25]",6,15,-9
31279.0,2020-02-12,"(1063.25, 1279.0]",1,8,-7
31280.0,2020-02-12,"(370.02, 616.0]",5,24,-19
31280.0,2020-02-12,"(616.0, 861.0]",2,6,-4
31280.0,2020-02-12,"(861.0, 1106.0]",15,21,-6
31280.0,2020-02-12,"(1106.0, 1351.0]",9,11,-2
31000.0,2020-02-13,"(886.75, 1084.0]",1,1,0
31001.0,2020-02-13,"(997.706, 1071.5]",1,2,-1
31001.0,2020-02-13,"(1218.5, 1292.0]",1,1,0
31002.0,2020-02-13,"(772.5, 931.75]",1,2,-1
31002.0,2020-02-13,"(931.75, 1091.0]",4,3,1
31003.0,2020-02-13,"(470.363, 630.25]",1,3,-2
31003.0,2020-02-13,"(630.25, 789.5]",1,1,0
31003.0,2020-02-13,"(948.75, 1108.0]",1,2,-1
31004.0,2020-02-13,"(843.75, 961.0]",1,1,0
31005.0,2020-02-13,"(493.237, 684.75]",1,1,0
31005.0,2020-02-13,"(1066.25, 1257.0]",1,2,-1
31006.0,2020-02-13,"(672.459, 808.25]",2,3,-1
31006.0,2020-02-13,"(808.25, 943.5]",1,1,0
31006.0,2020-02-13,"(943.5, 1078.75]",1,1,0
31006.0,2020-02-13,"(1078.75, 1214.0]",1,2,-1
31007.0,2020-02-13,"(668.242, 858.5]",3,4,-1
31007.0,2020-02-13,"(858.5, 1048.0]",1,8,-7
31007.0,2020-02-13,"(1048.0, 1237.5]",6,14,-8
31009.0,2020-02-13,"(767.25, 870.5]",2,2,0
31009.0,2020-02-13,"(973.75, 1077.0]",1,2,-1
31010.0,2020-02-13,"(429.068, 663.0]",1,1,0
31010.0,2020-02-13,"(1129.0, 1362.0]",1,2,-1
31011.0,2020-02-13,"(467.187, 671.25]",3,6,-3
31011.0,2020-02-13,"(874.5, 1077.75]",4,5,-1
,,,,1.0,
,,,,1.0,
,,,,3.0,
31013.0,2020-02-13,"(1008.5, 1214.0]",2,1,1
31014.0,2020-02-13,"(17.695, 345.25]",1,1,0
31014.0,2020-02-13,"(345.25, 671.5]",11,13,-2
31014.0,2020-02-13,"(671.5, 997.75]",4,10,-6
31014.0,2020-02-13,"(997.75, 1324.0]",14,26,-12
31015.0,2020-02-13,"(454.202, 654.5]",4,6,-2
31015.0,2020-02-13,"(654.5, 854.0]",1,2,-1
31015.0,2020-02-13,"(854.0, 1053.5]",4,4,0
31015.0,2020-02-13,"(1053.5, 1253.0]",2,6,-4
31016.0,2020-02-13,"(634.25, 820.5]",2,3,-1
31016.0,2020-02-13,"(820.5, 1006.75]",2,3,-1
31016.0,2020-02-13,"(1006.75, 1193.0]",3,4,-1
31017.0,2020-02-13,"(457.14, 673.0]",5,6,-1
31017.0,2020-02-13,"(888.0, 1103.0]",1,1,0
31017.0,2020-02-13,"(1103.0, 1318.0]",1,6,-5
31018.0,2020-02-13,"(959.595, 1061.25]",1,2,-1
31018.0,2020-02-13,"(1263.75, 1365.0]",1,1,0
31019.0,2020-02-13,"(892.5, 1041.0]",1,1,0
31019.0,2020-02-13,"(1041.0, 1189.5]",1,2,-1
31019.0,2020-02-13,"(1189.5, 1338.0]",1,1,0
,,,,1.0,
,,,,3.0,
31021.0,2020-02-13,"(386.0, 637.0]",1,2,-1
31021.0,2020-02-13,"(637.0, 887.0]",1,2,-1
31021.0,2020-02-13,"(887.0, 1137.0]",3,7,-4
31021.0,2020-02-13,"(1137.0, 1387.0]",2,4,-2
31022.0,2020-02-13,"(457.104, 682.0]",3,3,0
31022.0,2020-02-13,"(682.0, 906.0]",1,3,-2
31022.0,2020-02-13,"(906.0, 1130.0]",2,5,-3
31022.0,2020-02-13,"(1130.0, 1354.0]",1,6,-5
31023.0,2020-02-13,"(1030.75, 1121.5]",1,2,-1
31023.0,2020-02-13,"(1121.5, 1212.25]",1,2,-1
31024.0,2020-02-13,"(593.2, 794.0]",2,3,-1
31024.0,2020-02-13,"(794.0, 994.0]",2,4,-2
31024.0,2020-02-13,"(994.0, 1194.0]",1,7,-6
31024.0,2020-02-13,"(1194.0, 1394.0]",1,2,-1
31025.0,2020-02-13,"(916.79, 969.5]",1,1,0
31025.0,2020-02-13,"(969.5, 1022.0]",1,1,0
31025.0,2020-02-13,"(1074.5, 1127.0]",1,1,0
31026.0,2020-02-13,"(823.75, 1018.5]",1,1,0
31026.0,2020-02-13,"(1018.5, 1213.25]",2,2,0
31027.0,2020-02-13,"(1201.982, 1206.5]",1,1,0
31028.0,2020-02-13,"(959.25, 1036.0]",1,1,0
31029.0,2020-02-13,"(876.5, 1090.25]",1,6,-5
31029.0,2020-02-13,"(1090.25, 1304.0]",3,1,2
31030.0,2020-02-13,"(868.0, 1075.0]",1,3,-2
31030.0,2020-02-13,"(1075.0, 1282.0]",5,1,4
31031.0,2020-02-13,"(1069.5, 1196.0]",5,1,4
,,,,1.0,
,,,,1.0,
,,,,2.0,
31033.0,2020-02-13,"(512.406, 661.5]",1,2,-1
31033.0,2020-02-13,"(958.5, 1107.0]",1,1,0
31034.0,2020-02-13,"(635.213, 832.75]",1,1,0
31034.0,2020-02-13,"(1226.25, 1423.0]",2,3,-1
31035.0,2020-02-13,"(1166.75, 1200.0]",2,1,1
31036.0,2020-02-13,"(463.048, 702.0]",1,4,-3
31036.0,2020-02-13,"(940.0, 1178.0]",2,1,1
31036.0,2020-02-13,"(1178.0, 1416.0]",2,2,0
31037.0,2020-02-13,"(416.095, 643.25]",4,7,-3
31037.0,2020-02-13,"(643.25, 869.5]",2,2,0
31037.0,2020-02-13,"(869.5, 1095.75]",2,7,-5
31037.0,2020-02-13,"(1095.75, 1322.0]",1,7,-6
31038.0,2020-02-13,"(756.0, 1008.0]",1,1,0
31039.0,2020-02-13,"(572.221, 767.75]",3,5,-2
31039.0,2020-02-13,"(962.5, 1157.25]",3,1,2
,,,,1.0,
,,,,1.0,
31041.0,2020-02-13,"(816.0, 1088.0]",2,1,1
31042.0,2020-02-13,"(440.406, 589.5]",1,1,0
31042.0,2020-02-13,"(589.5, 738.0]",1,1,0
31042.0,2020-02-13,"(738.0, 886.5]",1,1,0
31042.0,2020-02-13,"(886.5, 1035.0]",2,6,-4
31043.0,2020-02-13,"(1052.0, 1093.0]",2,1,1
31043.0,2020-02-13,"(1093.0, 1134.0]",1,2,-1
31044.0,2020-02-13,"(544.436, 686.0]",2,2,0
31044.0,2020-02-13,"(968.0, 1109.0]",4,1,3
31045.0,2020-02-13,"(773.25, 1031.0]",1,1,0
,,,,1.0,
,,,,1.0,
,,,,1.0,
31047.0,2020-02-13,"(404.04, 645.0]",4,4,0
31047.0,2020-02-13,"(885.0, 1125.0]",4,13,-9
31047.0,2020-02-13,"(1125.0, 1365.0]",1,6,-5
31048.0,2020-02-13,"(713.25, 853.5]",1,4,-3
31048.0,2020-02-13,"(853.5, 993.75]",3,2,1
31048.0,2020-02-13,"(993.75, 1134.0]",2,3,-1
31049.0,2020-02-13,"(547.254, 734.5]",1,3,-2
31049.0,2020-02-13,"(734.5, 921.0]",1,1,0
31049.0,2020-02-13,"(921.0, 1107.5]",1,2,-1
31049.0,2020-02-13,"(1107.5, 1294.0]",2,2,0
31050.0,2020-02-13,"(778.0, 929.5]",1,1,0
31050.0,2020-02-13,"(929.5, 1081.0]",1,1,0
31051.0,2020-02-13,"(933.5, 1171.25]",5,4,1
31051.0,2020-02-13,"(1171.25, 1409.0]",2,5,-3
31052.0,2020-02-13,"(987.755, 1049.25]",1,3,-2
31052.0,2020-02-13,"(1110.5, 1171.75]",2,2,0
31052.0,2020-02-13,"(1171.75, 1233.0]",1,1,0
31053.0,2020-02-13,"(1034.75, 1151.5]",1,1,0
31053.0,2020-02-13,"(1268.25, 1385.0]",1,1,0
31054.0,2020-02-13,"(815.25, 1087.0]",2,1,1
31055.0,2020-02-13,"(317.5, 635.0]",1,1,0
31055.0,2020-02-13,"(952.5, 1270.0]",3,1,2
31056.0,2020-02-13,"(870.5, 1058.25]",1,1,0
31056.0,2020-02-13,"(1058.25, 1246.0]",2,2,0
31057.0,2020-02-13,"(927.0, 1236.0]",2,1,1
31058.0,2020-02-13,"(123.062, 358.5]",1,2,-1
31058.0,2020-02-13,"(827.5, 1062.0]",2,2,0
31059.0,2020-02-13,"(946.521, 1066.75]",1,2,-1
31059.0,2020-02-13,"(1306.25, 1426.0]",1,1,0
31060.0,2020-02-13,"(929.25, 1071.0]",3,1,2
31061.0,2020-02-13,"(910.75, 1049.0]",1,1,0
31062.0,2020-02-13,"(846.587, 950.25]",2,3,-1
31062.0,2020-02-13,"(1053.5, 1156.75]",3,5,-2
31062.0,2020-02-13,"(1156.75, 1260.0]",1,2,-1
31063.0,2020-02-13,"(972.789, 1025.75]",1,1,0
31064.0,2020-02-13,"(415.246, 604.5]",1,2,-1
31064.0,2020-02-13,"(981.5, 1170.0]",5,1,4
31065.0,2020-02-13,"(704.5, 865.25]",1,1,0
31065.0,2020-02-13,"(865.25, 1026.0]",2,1,1
31066.0,2020-02-13,"(835.5, 1114.0]",1,1,0
31067.0,2020-02-13,"(54.2, 255.0]",2,3,-1
31067.0,2020-02-13,"(455.0, 655.0]",1,1,0
31067.0,2020-02-13,"(655.0, 855.0]",1,1,0
31068.0,2020-02-13,"(938.681, 1018.75]",1,1,0
31068.0,2020-02-13,"(1018.75, 1098.5]",1,1,0
31068.0,2020-02-13,"(1098.5, 1178.25]",2,2,0
31068.0,2020-02-13,"(1178.25, 1258.0]",2,4,-2
31069.0,2020-02-13,"(764.0, 941.0]",1,1,0
31069.0,2020-02-13,"(941.0, 1118.0]",3,1,2
31069.0,2020-02-13,"(1118.0, 1295.0]",2,3,-1
31070.0,2020-02-13,"(1094.0, 1268.0]",4,1,3
31071.0,2020-02-13,"(919.5, 1226.0]",4,1,3
,,,,2.0,
,,,,2.0,
31074.0,2020-02-13,"(874.0, 1037.0]",1,1,0
31074.0,2020-02-13,"(1037.0, 1200.0]",1,2,-1
31074.0,2020-02-13,"(1200.0, 1363.0]",1,1,0
31075.0,2020-02-13,"(839.25, 1119.0]",1,1,0
,,,,2.0,
31077.0,2020-02-13,"(857.0, 977.0]",2,1,1
31078.0,2020-02-13,"(501.575, 608.25]",2,2,0
31078.0,2020-02-13,"(714.5, 820.75]",1,2,-1
31079.0,2020-02-13,"(1120.25, 1331.0]",4,2,2
31080.0,2020-02-13,"(615.5, 878.0]",1,4,-3
31080.0,2020-02-13,"(878.0, 1140.5]",6,1,5
31080.0,2020-02-13,"(1140.5, 1403.0]",4,8,-4
,,,,2.0,
31082.0,2020-02-13,"(721.5, 816.0]",1,1,0
31083.0,2020-02-13,"(780.75, 1041.0]",1,1,0
31084.0,2020-02-13,"(339.088, 568.0]",1,1,0
31084.0,2020-02-13,"(568.0, 796.0]",3,3,0
31085.0,2020-02-13,"(925.5, 1234.0]",2,1,1
31086.0,2020-02-13,"(909.0, 1041.0]",1,1,0
31087.0,2020-02-13,"(984.75, 1166.0]",3,1,2
31088.0,2020-02-13,"(958.5, 1119.0]",3,1,2
31088.0,2020-02-13,"(1279.5, 1440.0]",1,3,-2
31089.0,2020-02-13,"(477.115, 699.25]",4,5,-1
31089.0,2020-02-13,"(699.25, 920.5]",2,3,-1
31089.0,2020-02-13,"(920.5, 1141.75]",4,20,-16
31089.0,2020-02-13,"(1141.75, 1363.0]",2,4,-2
31090.0,2020-02-13,"(944.75, 1116.0]",2,1,1
31091.0,2020-02-13,"(664.0, 818.0]",1,1,0
31091.0,2020-02-13,"(972.0, 1126.0]",4,1,3
31092.0,2020-02-13,"(675.25, 906.5]",1,2,-1
31092.0,2020-02-13,"(906.5, 1137.75]",4,1,3
31092.0,2020-02-13,"(1137.75, 1369.0]",4,7,-3
,,,,1.0,
,,,,3.0,
,,,,2.0,
31095.0,2020-02-13,"(915.0, 1220.0]",1,1,0
31096.0,2020-02-13,"(1066.25, 1249.0]",1,1,0
,,,,1.0,
,,,,2.0,
31098.0,2020-02-13,"(433.1, 659.0]",1,3,-2
31098.0,2020-02-13,"(884.0, 1109.0]",5,1,4
31098.0,2020-02-13,"(1109.0, 1334.0]",1,8,-7
31099.0,2020-02-13,"(821.25, 1095.0]",1,1,0
31100.0,2020-02-13,"(536.4, 687.0]",3,3,0
31100.0,2020-02-13,"(687.0, 837.0]",1,3,-2
31100.0,2020-02-13,"(837.0, 987.0]",2,5,-3
31100.0,2020-02-13,"(987.0, 1137.0]",5,18,-13
31101.0,2020-02-13,"(343.987, 598.25]",5,11,-6
31101.0,2020-02-13,"(598.25, 851.5]",10,19,-9
31101.0,2020-02-13,"(851.5, 1104.75]",29,44,-15
31101.0,2020-02-13,"(1104.75, 1358.0]",16,30,-14
31102.0,2020-02-13,"(850.0, 1114.5]",4,6,-2
31102.0,2020-02-13,"(1114.5, 1379.0]",13,2,11
31103.0,2020-02-13,"(34.624, 380.0]",1,1,0
31103.0,2020-02-13,"(380.0, 724.0]",2,9,-7
31103.0,2020-02-13,"(724.0, 1068.0]",4,9,-5
31103.0,2020-02-13,"(1068.0, 1412.0]",14,28,-14
31104.0,2020-02-13,"(3.628, 348.0]",1,3,-2
31104.0,2020-02-13,"(348.0, 691.0]",3,10,-7
31104.0,2020-02-13,"(691.0, 1034.0]",4,9,-5
31104.0,2020-02-13,"(1034.0, 1377.0]",26,44,-18
31105.0,2020-02-13,"(689.5, 920.0]",1,3,-2
31105.0,2020-02-13,"(920.0, 1150.5]",1,2,-1
31105.0,2020-02-13,"(1150.5, 1381.0]",2,4,-2
31106.0,2020-02-13,"(944.642, 1034.5]",2,2,0
31106.0,2020-02-13,"(1034.5, 1124.0]",1,3,-2
31106.0,2020-02-13,"(1124.0, 1213.5]",1,2,-1
31106.0,2020-02-13,"(1213.5, 1303.0]",1,1,0
31107.0,2020-02-13,"(608.25, 871.5]",2,11,-9
31107.0,2020-02-13,"(871.5, 1134.75]",12,8,4
31108.0,2020-02-13,"(411.096, 638.0]",2,8,-6
31108.0,2020-02-13,"(638.0, 864.0]",5,11,-6
31108.0,2020-02-13,"(864.0, 1090.0]",15,23,-8
31108.0,2020-02-13,"(1090.0, 1316.0]",13,18,-5
31109.0,2020-02-13,"(334.911, 608.25]",3,8,-5
31109.0,2020-02-13,"(608.25, 880.5]",3,6,-3
31109.0,2020-02-13,"(880.5, 1152.75]",18,29,-11
31109.0,2020-02-13,"(1152.75, 1425.0]",6,14,-8
31110.0,2020-02-13,"(329.946, 594.5]",7,18,-11
31110.0,2020-02-13,"(594.5, 858.0]",9,16,-7
31110.0,2020-02-13,"(858.0, 1121.5]",13,28,-15
31110.0,2020-02-13,"(1121.5, 1385.0]",11,21,-10
31111.0,2020-02-13,"(428.038, 669.5]",6,12,-6
31111.0,2020-02-13,"(669.5, 910.0]",1,4,-3
31111.0,2020-02-13,"(910.0, 1150.5]",11,17,-6
31111.0,2020-02-13,"(1150.5, 1391.0]",4,9,-5
31112.0,2020-02-13,"(316.093, 543.75]",1,2,-1
31112.0,2020-02-13,"(770.5, 997.25]",3,1,2
31112.0,2020-02-13,"(997.25, 1224.0]",3,3,0
31113.0,2020-02-13,"(771.5, 970.75]",1,6,-5
31113.0,2020-02-13,"(970.75, 1170.0]",11,4,7
31114.0,2020-02-13,"(320.75, 629.5]",2,1,1
31114.0,2020-02-13,"(629.5, 938.25]",1,15,-14
31114.0,2020-02-13,"(938.25, 1247.0]",28,4,24
31115.0,2020-02-13,"(245.815, 543.25]",1,13,-12
31115.0,2020-02-13,"(543.25, 839.5]",3,10,-7
31115.0,2020-02-13,"(839.5, 1135.75]",12,16,-4
31115.0,2020-02-13,"(1135.75, 1432.0]",12,24,-12
31116.0,2020-02-13,"(326.918, 598.5]",4,12,-8
31116.0,2020-02-13,"(598.5, 869.0]",3,9,-6
31116.0,2020-02-13,"(869.0, 1139.5]",13,15,-2
31116.0,2020-02-13,"(1139.5, 1410.0]",5,11,-6
31117.0,2020-02-13,"(374.97, 633.5]",1,10,-9
31117.0,2020-02-13,"(633.5, 891.0]",1,4,-3
31117.0,2020-02-13,"(891.0, 1148.5]",8,21,-13
31117.0,2020-02-13,"(1148.5, 1406.0]",10,18,-8
31118.0,2020-02-13,"(621.25, 829.5]",1,5,-4
31118.0,2020-02-13,"(829.5, 1037.75]",6,2,4
31118.0,2020-02-13,"(1037.75, 1246.0]",16,9,7
31119.0,2020-02-13,"(31.799, 333.25]",1,2,-1
31119.0,2020-02-13,"(333.25, 633.5]",2,14,-12
31119.0,2020-02-13,"(633.5, 933.75]",4,9,-5
31119.0,2020-02-13,"(933.75, 1234.0]",25,38,-13
31120.0,2020-02-13,"(360.75, 695.5]",1,1,0
31120.0,2020-02-13,"(695.5, 1030.25]",2,4,-2
31120.0,2020-02-13,"(1030.25, 1365.0]",10,5,5
31121.0,2020-02-13,"(340.75, 680.5]",6,1,5
31121.0,2020-02-13,"(680.5, 1020.25]",3,9,-6
31121.0,2020-02-13,"(1020.25, 1360.0]",8,5,3
31122.0,2020-02-13,"(4.662, 340.5]",1,3,-2
31122.0,2020-02-13,"(340.5, 675.0]",3,6,-3
31122.0,2020-02-13,"(675.0, 1009.5]",5,10,-5
31122.0,2020-02-13,"(1009.5, 1344.0]",14,23,-9
31123.0,2020-02-13,"(308.922, 579.5]",2,11,-9
31123.0,2020-02-13,"(849.0, 1118.5]",4,3,1
31123.0,2020-02-13,"(1118.5, 1388.0]",7,7,0
31124.0,2020-02-13,"(29.593, 382.75]",3,5,-2
31124.0,2020-02-13,"(382.75, 734.5]",12,22,-10
31124.0,2020-02-13,"(734.5, 1086.25]",12,29,-17
31124.0,2020-02-13,"(1086.25, 1438.0]",16,46,-30
31125.0,2020-02-13,"(630.5, 836.0]",3,11,-8
31125.0,2020-02-13,"(836.0, 1041.5]",7,7,0
31125.0,2020-02-13,"(1041.5, 1247.0]",19,10,9
31126.0,2020-02-13,"(0.713, 323.75]",1,2,-1
31126.0,2020-02-13,"(323.75, 645.5]",3,15,-12
31126.0,2020-02-13,"(645.5, 967.25]",2,4,-2
31126.0,2020-02-13,"(967.25, 1289.0]",22,33,-11
31127.0,2020-02-13,"(382.002, 632.5]",5,9,-4
31127.0,2020-02-13,"(632.5, 882.0]",4,6,-2
31127.0,2020-02-13,"(882.0, 1131.5]",11,29,-18
31127.0,2020-02-13,"(1131.5, 1381.0]",7,17,-10
31128.0,2020-02-13,"(309.885, 589.75]",11,17,-6
31128.0,2020-02-13,"(589.75, 868.5]",9,20,-11
31128.0,2020-02-13,"(868.5, 1147.25]",20,27,-7
31128.0,2020-02-13,"(1147.25, 1426.0]",1,8,-7
31129.0,2020-02-13,"(535.118, 756.5]",2,5,-3
31129.0,2020-02-13,"(756.5, 977.0]",6,7,-1
31129.0,2020-02-13,"(977.0, 1197.5]",8,14,-6
31129.0,2020-02-13,"(1197.5, 1418.0]",2,8,-6
31130.0,2020-02-13,"(515.187, 719.25]",1,3,-2
31130.0,2020-02-13,"(719.25, 922.5]",2,3,-1
31130.0,2020-02-13,"(922.5, 1125.75]",5,14,-9
31130.0,2020-02-13,"(1125.75, 1329.0]",9,10,-1
31131.0,2020-02-13,"(628.25, 887.5]",1,6,-5
31131.0,2020-02-13,"(887.5, 1146.75]",5,3,2
31131.0,2020-02-13,"(1146.75, 1406.0]",3,9,-6
31200.0,2020-02-13,"(318.934, 586.5]",13,19,-6
31200.0,2020-02-13,"(586.5, 853.0]",3,6,-3
31200.0,2020-02-13,"(853.0, 1119.5]",14,36,-22
31200.0,2020-02-13,"(1119.5, 1386.0]",11,25,-14
31201.0,2020-02-13,"(50.624, 396.0]",6,7,-1
31201.0,2020-02-13,"(396.0, 740.0]",12,31,-19
31201.0,2020-02-13,"(740.0, 1084.0]",32,59,-27
31201.0,2020-02-13,"(1084.0, 1428.0]",33,60,-27
,,,,2.0,
31203.0,2020-02-13,"(4.603, 355.25]",1,3,-2
31203.0,2020-02-13,"(355.25, 704.5]",2,11,-9
31203.0,2020-02-13,"(704.5, 1053.75]",16,24,-8
31203.0,2020-02-13,"(1053.75, 1403.0]",27,47,-20
31204.0,2020-02-13,"(468.073, 700.75]",5,6,-1
31204.0,2020-02-13,"(700.75, 932.5]",6,12,-6
31204.0,2020-02-13,"(932.5, 1164.25]",7,25,-18
31204.0,2020-02-13,"(1164.25, 1396.0]",4,7,-3
31205.0,2020-02-13,"(415.142, 630.5]",6,6,0
31205.0,2020-02-13,"(630.5, 845.0]",10,18,-8
31205.0,2020-02-13,"(845.0, 1059.5]",3,13,-10
31205.0,2020-02-13,"(1059.5, 1274.0]",6,18,-12
31206.0,2020-02-13,"(521.392, 674.0]",2,2,0
31206.0,2020-02-13,"(978.0, 1130.0]",3,5,-2
31207.0,2020-02-13,"(810.0, 1044.5]",2,2,0
31207.0,2020-02-13,"(1044.5, 1279.0]",1,2,-1
31208.0,2020-02-13,"(341.981, 597.75]",6,8,-2
31208.0,2020-02-13,"(1107.25, 1362.0]",1,8,-7
31209.0,2020-02-13,"(1.771, 310.25]",1,1,0
31209.0,2020-02-13,"(617.5, 924.75]",1,1,0
31209.0,2020-02-13,"(924.75, 1232.0]",5,6,-1
31211.0,2020-02-13,"(535.243, 725.25]",3,3,0
31211.0,2020-02-13,"(725.25, 914.5]",1,2,-1
31211.0,2020-02-13,"(914.5, 1103.75]",8,15,-7
31212.0,2020-02-13,"(312.887, 592.25]",18,23,-5
31212.0,2020-02-13,"(592.25, 870.5]",2,7,-5
31212.0,2020-02-13,"(870.5, 1148.75]",13,29,-16
31212.0,2020-02-13,"(1148.75, 1427.0]",9,18,-9
31213.0,2020-02-13,"(281.844, 572.0]",10,13,-3
31213.0,2020-02-13,"(572.0, 861.0]",8,16,-8
31213.0,2020-02-13,"(861.0, 1150.0]",15,34,-19
31213.0,2020-02-13,"(1150.0, 1439.0]",2,8,-6
31214.0,2020-02-13,"(-0.389, 348.25]",2,3,-1
31214.0,2020-02-13,"(348.25, 695.5]",6,20,-14
31214.0,2020-02-13,"(695.5, 1042.75]",15,23,-8
31214.0,2020-02-13,"(1042.75, 1390.0]",22,36,-14
31215.0,2020-02-13,"(451.017, 697.75]",11,11,0
31215.0,2020-02-13,"(697.75, 943.5]",4,7,-3
31215.0,2020-02-13,"(943.5, 1189.25]",9,19,-10
31216.0,2020-02-13,"(477.336, 644.0]",5,5,0
31216.0,2020-02-13,"(644.0, 810.0]",2,3,-1
31216.0,2020-02-13,"(810.0, 976.0]",1,4,-3
31216.0,2020-02-13,"(976.0, 1142.0]",5,20,-15
31217.0,2020-02-13,"(330.274, 512.5]",4,5,-1
31217.0,2020-02-13,"(512.5, 694.0]",3,3,0
31217.0,2020-02-13,"(694.0, 875.5]",1,3,-2
31217.0,2020-02-13,"(875.5, 1057.0]",2,13,-11
31218.0,2020-02-13,"(377.22, 573.0]",1,6,-5
31218.0,2020-02-13,"(768.0, 963.0]",8,1,7
31218.0,2020-02-13,"(963.0, 1158.0]",14,11,3
31219.0,2020-02-13,"(355.313, 527.75]",2,2,0
31219.0,2020-02-13,"(527.75, 699.5]",2,2,0
31219.0,2020-02-13,"(699.5, 871.25]",3,5,-2
31219.0,2020-02-13,"(871.25, 1043.0]",4,8,-4
31220.0,2020-02-13,"(300.95, 564.5]",7,7,0
31220.0,2020-02-13,"(564.5, 827.0]",5,8,-3
31220.0,2020-02-13,"(827.0, 1089.5]",1,11,-10
31220.0,2020-02-13,"(1089.5, 1352.0]",2,3,-1
31221.0,2020-02-13,"(18.613, 366.75]",1,1,0
31221.0,2020-02-13,"(366.75, 713.5]",10,11,-1
31221.0,2020-02-13,"(713.5, 1060.25]",14,28,-14
31221.0,2020-02-13,"(1060.25, 1407.0]",10,27,-17
31222.0,2020-02-13,"(524.219, 720.25]",6,6,0
31222.0,2020-02-13,"(720.25, 915.5]",5,9,-4
31222.0,2020-02-13,"(915.5, 1110.75]",3,17,-14
31222.0,2020-02-13,"(1110.75, 1306.0]",1,4,-3
31223.0,2020-02-13,"(48.617, 395.75]",1,2,-1
31223.0,2020-02-13,"(395.75, 741.5]",9,15,-6
31223.0,2020-02-13,"(741.5, 1087.25]",9,23,-14
31223.0,2020-02-13,"(1087.25, 1433.0]",15,24,-9
31224.0,2020-02-13,"(380.956, 643.0]",3,3,0
31224.0,2020-02-13,"(643.0, 904.0]",3,3,0
31224.0,2020-02-13,"(904.0, 1165.0]",5,20,-15
31224.0,2020-02-13,"(1165.0, 1426.0]",3,6,-3
31225.0,2020-02-13,"(426.006, 675.5]",4,7,-3
31225.0,2020-02-13,"(675.5, 924.0]",1,2,-1
31225.0,2020-02-13,"(924.0, 1172.5]",7,13,-6
31225.0,2020-02-13,"(1172.5, 1421.0]",1,5,-4
31226.0,2020-02-13,"(766.531, 884.25]",1,1,0
31226.0,2020-02-13,"(1001.5, 1118.75]",1,2,-1
31226.0,2020-02-13,"(1118.75, 1236.0]",2,4,-2
31227.0,2020-02-13,"(487.199, 688.25]",14,16,-2
31227.0,2020-02-13,"(688.25, 888.5]",5,10,-5
31227.0,2020-02-13,"(888.5, 1088.75]",7,23,-16
31227.0,2020-02-13,"(1088.75, 1289.0]",2,12,-10
31228.0,2020-02-13,"(80.673, 413.75]",4,5,-1
31228.0,2020-02-13,"(413.75, 745.5]",4,6,-2
31228.0,2020-02-13,"(745.5, 1077.25]",12,22,-10
31228.0,2020-02-13,"(1077.25, 1409.0]",6,14,-8
31229.0,2020-02-13,"(356.94, 623.0]",9,27,-18
31229.0,2020-02-13,"(623.0, 888.0]",7,20,-13
31229.0,2020-02-13,"(888.0, 1153.0]",31,48,-17
31229.0,2020-02-13,"(1153.0, 1418.0]",17,30,-13
31230.0,2020-02-13,"(363.974, 621.5]",16,20,-4
31230.0,2020-02-13,"(621.5, 878.0]",4,7,-3
31230.0,2020-02-13,"(878.0, 1134.5]",10,33,-23
31230.0,2020-02-13,"(1134.5, 1391.0]",3,14,-11
31231.0,2020-02-13,"(327.018, 573.5]",2,2,0
31231.0,2020-02-13,"(573.5, 819.0]",3,6,-3
31231.0,2020-02-13,"(819.0, 1064.5]",4,11,-7
31231.0,2020-02-13,"(1064.5, 1310.0]",6,12,-6
31232.0,2020-02-13,"(106.75, 420.5]",4,8,-4
31232.0,2020-02-13,"(420.5, 733.0]",7,8,-1
31232.0,2020-02-13,"(733.0, 1045.5]",5,17,-12
31232.0,2020-02-13,"(1045.5, 1358.0]",12,24,-12
31233.0,2020-02-13,"(447.096, 674.0]",16,16,0
31233.0,2020-02-13,"(674.0, 900.0]",7,10,-3
31233.0,2020-02-13,"(900.0, 1126.0]",20,38,-18
31234.0,2020-02-13,"(301.865, 586.75]",6,9,-3
31234.0,2020-02-13,"(586.75, 870.5]",3,7,-4
31234.0,2020-02-13,"(870.5, 1154.25]",17,27,-10
31234.0,2020-02-13,"(1154.25, 1438.0]",7,12,-5
31235.0,2020-02-13,"(504.423, 649.25]",1,1,0
31235.0,2020-02-13,"(793.5, 937.75]",1,1,0
31236.0,2020-02-13,"(318.096, 545.0]",6,7,-1
31236.0,2020-02-13,"(545.0, 771.0]",7,10,-3
31236.0,2020-02-13,"(771.0, 997.0]",9,19,-10
31236.0,2020-02-13,"(997.0, 1223.0]",4,20,-16
31237.0,2020-02-13,"(333.996, 586.0]",4,9,-5
31237.0,2020-02-13,"(586.0, 837.0]",5,9,-4
31237.0,2020-02-13,"(837.0, 1088.0]",11,14,-3
31237.0,2020-02-13,"(1088.0, 1339.0]",5,12,-7
31238.0,2020-02-13,"(53.709, 377.75]",1,1,0
31238.0,2020-02-13,"(377.75, 700.5]",6,8,-2
31238.0,2020-02-13,"(700.5, 1023.25]",5,11,-6
31238.0,2020-02-13,"(1023.25, 1346.0]",2,19,-17
31239.0,2020-02-13,"(382.074, 614.5]",10,10,0
31239.0,2020-02-13,"(614.5, 846.0]",8,10,-2
31239.0,2020-02-13,"(846.0, 1077.5]",7,15,-8
31239.0,2020-02-13,"(1077.5, 1309.0]",5,26,-21
31240.0,2020-02-13,"(955.894, 982.5]",1,2,-1
31241.0,2020-02-13,"(291.874, 574.5]",6,13,-7
31241.0,2020-02-13,"(574.5, 856.0]",5,11,-6
31241.0,2020-02-13,"(856.0, 1137.5]",6,18,-12
31241.0,2020-02-13,"(1137.5, 1419.0]",10,21,-11
31242.0,2020-02-13,"(420.177, 626.75]",4,4,0
31242.0,2020-02-13,"(626.75, 832.5]",7,12,-5
31242.0,2020-02-13,"(832.5, 1038.25]",4,13,-9
31242.0,2020-02-13,"(1038.25, 1244.0]",4,21,-17
31243.0,2020-02-13,"(334.5, 643.0]",11,1,10
31243.0,2020-02-13,"(643.0, 951.5]",4,14,-10
31243.0,2020-02-13,"(951.5, 1260.0]",4,14,-10
31244.0,2020-02-13,"(393.076, 625.0]",7,10,-3
31244.0,2020-02-13,"(625.0, 856.0]",1,3,-2
31244.0,2020-02-13,"(856.0, 1087.0]",6,20,-14
31244.0,2020-02-13,"(1087.0, 1318.0]",7,11,-4
31245.0,2020-02-13,"(475.051, 713.25]",3,7,-4
31245.0,2020-02-13,"(713.25, 950.5]",5,5,0
31245.0,2020-02-13,"(950.5, 1187.75]",15,30,-15
31245.0,2020-02-13,"(1187.75, 1425.0]",11,21,-10
31246.0,2020-02-13,"(455.026, 699.5]",7,12,-5
31246.0,2020-02-13,"(699.5, 943.0]",6,11,-5
31246.0,2020-02-13,"(943.0, 1186.5]",14,27,-13
31246.0,2020-02-13,"(1186.5, 1430.0]",7,17,-10
31247.0,2020-02-13,"(462.156, 674.0]",3,5,-2
31247.0,2020-02-13,"(674.0, 885.0]",1,2,-1
31247.0,2020-02-13,"(885.0, 1096.0]",8,13,-5
31247.0,2020-02-13,"(1096.0, 1307.0]",2,3,-1
31248.0,2020-02-13,"(357.199, 558.25]",2,6,-4
31248.0,2020-02-13,"(758.5, 958.75]",2,1,1
31248.0,2020-02-13,"(958.75, 1159.0]",10,3,7
31249.0,2020-02-13,"(451.298, 627.5]",2,3,-1
31249.0,2020-02-13,"(803.0, 978.5]",1,3,-2
31249.0,2020-02-13,"(978.5, 1154.0]",6,13,-7
31250.0,2020-02-13,"(6.854, 294.5]",1,1,0
31250.0,2020-02-13,"(294.5, 581.0]",5,6,-1
31250.0,2020-02-13,"(581.0, 867.5]",10,14,-4
31250.0,2020-02-13,"(867.5, 1154.0]",6,27,-21
31251.0,2020-02-13,"(237.013, 484.75]",1,3,-2
31251.0,2020-02-13,"(484.75, 731.5]",10,18,-8
31251.0,2020-02-13,"(731.5, 978.25]",4,13,-9
31251.0,2020-02-13,"(978.25, 1225.0]",6,20,-14
31252.0,2020-02-13,"(480.229, 673.75]",11,12,-1
31252.0,2020-02-13,"(673.75, 866.5]",2,4,-2
31252.0,2020-02-13,"(866.5, 1059.25]",1,5,-4
31253.0,2020-02-13,"(321.75, 599.5]",6,1,5
31253.0,2020-02-13,"(599.5, 877.25]",5,6,-1
31253.0,2020-02-13,"(877.25, 1155.0]",8,6,2
31254.0,2020-02-13,"(372.061, 607.75]",11,13,-2
31254.0,2020-02-13,"(607.75, 842.5]",5,5,0
31254.0,2020-02-13,"(842.5, 1077.25]",3,17,-14
31254.0,2020-02-13,"(1077.25, 1312.0]",2,16,-14
31255.0,2020-02-13,"(391.084, 621.0]",7,12,-5
31255.0,2020-02-13,"(621.0, 850.0]",1,3,-2
31255.0,2020-02-13,"(850.0, 1079.0]",5,14,-9
31255.0,2020-02-13,"(1079.0, 1308.0]",3,11,-8
31256.0,2020-02-13,"(262.928, 532.0]",5,5,0
31256.0,2020-02-13,"(532.0, 800.0]",4,4,0
31256.0,2020-02-13,"(800.0, 1068.0]",3,9,-6
31256.0,2020-02-13,"(1068.0, 1336.0]",8,23,-15
31257.0,2020-02-13,"(337.945, 602.75]",9,13,-4
31257.0,2020-02-13,"(602.75, 866.5]",5,12,-7
31257.0,2020-02-13,"(866.5, 1130.25]",22,41,-19
31257.0,2020-02-13,"(1130.25, 1394.0]",10,23,-13
31258.0,2020-02-13,"(741.495, 868.25]",2,9,-7
31258.0,2020-02-13,"(868.25, 994.5]",2,2,0
31258.0,2020-02-13,"(994.5, 1120.75]",8,16,-8
31258.0,2020-02-13,"(1120.75, 1247.0]",1,2,-1
31259.0,2020-02-13,"(390.273, 572.75]",4,4,0
31259.0,2020-02-13,"(754.5, 936.25]",3,1,2
31259.0,2020-02-13,"(936.25, 1118.0]",2,5,-3
31260.0,2020-02-13,"(328.099, 554.25]",9,10,-1
31260.0,2020-02-13,"(554.25, 779.5]",1,2,-1
31260.0,2020-02-13,"(1004.75, 1230.0]",1,3,-2
31261.0,2020-02-13,"(389.338, 555.5]",3,3,0
31261.0,2020-02-13,"(555.5, 721.0]",1,1,0
31262.0,2020-02-13,"(113.861, 399.75]",1,1,0
31262.0,2020-02-13,"(399.75, 684.5]",5,7,-2
31262.0,2020-02-13,"(684.5, 969.25]",2,4,-2
31262.0,2020-02-13,"(969.25, 1254.0]",2,10,-8
31263.0,2020-02-13,"(366.018, 612.5]",8,10,-2
31263.0,2020-02-13,"(612.5, 858.0]",8,16,-8
31263.0,2020-02-13,"(858.0, 1103.5]",9,26,-17
31263.0,2020-02-13,"(1103.5, 1349.0]",7,18,-11
31264.0,2020-02-13,"(517.351, 680.25]",5,5,0
31264.0,2020-02-13,"(680.25, 842.5]",1,4,-3
31264.0,2020-02-13,"(842.5, 1004.75]",1,6,-5
31264.0,2020-02-13,"(1004.75, 1167.0]",4,11,-7
31265.0,2020-02-13,"(307.934, 575.5]",5,16,-11
31265.0,2020-02-13,"(575.5, 842.0]",1,3,-2
31265.0,2020-02-13,"(842.0, 1108.5]",15,31,-16
31265.0,2020-02-13,"(1108.5, 1375.0]",12,24,-12
31266.0,2020-02-13,"(290.859, 577.25]",3,14,-11
31266.0,2020-02-13,"(577.25, 862.5]",6,14,-8
31266.0,2020-02-13,"(862.5, 1147.75]",17,27,-10
31266.0,2020-02-13,"(1147.75, 1433.0]",14,24,-10
31267.0,2020-02-13,"(443.052, 681.0]",6,14,-8
31267.0,2020-02-13,"(681.0, 918.0]",7,11,-4
31267.0,2020-02-13,"(918.0, 1155.0]",17,35,-18
31267.0,2020-02-13,"(1155.0, 1392.0]",9,18,-9
31268.0,2020-02-13,"(326.9, 603.0]",16,24,-8
31268.0,2020-02-13,"(603.0, 878.0]",3,6,-3
31268.0,2020-02-13,"(878.0, 1153.0]",24,34,-10
31268.0,2020-02-13,"(1153.0, 1428.0]",8,13,-5
31269.0,2020-02-13,"(364.08, 595.0]",2,3,-1
31269.0,2020-02-13,"(595.0, 825.0]",2,3,-1
31269.0,2020-02-13,"(825.0, 1055.0]",2,3,-1
31269.0,2020-02-13,"(1055.0, 1285.0]",4,9,-5
31270.0,2020-02-13,"(266.003, 516.25]",3,5,-2
31270.0,2020-02-13,"(516.25, 765.5]",2,4,-2
31270.0,2020-02-13,"(765.5, 1014.75]",3,5,-2
31270.0,2020-02-13,"(1014.75, 1264.0]",6,12,-6
31271.0,2020-02-13,"(343.119, 564.25]",8,10,-2
31271.0,2020-02-13,"(784.5, 1004.75]",5,1,4
31271.0,2020-02-13,"(1004.75, 1225.0]",3,9,-6
31272.0,2020-02-13,"(320.067, 554.25]",9,10,-1
31272.0,2020-02-13,"(554.25, 787.5]",1,3,-2
31272.0,2020-02-13,"(787.5, 1020.75]",4,8,-4
31272.0,2020-02-13,"(1020.75, 1254.0]",3,20,-17
31273.0,2020-02-13,"(402.216, 599.0]",1,2,-1
31273.0,2020-02-13,"(795.0, 991.0]",2,2,0
31273.0,2020-02-13,"(991.0, 1187.0]",2,4,-2
31274.0,2020-02-13,"(621.286, 800.5]",4,6,-2
31274.0,2020-02-13,"(800.5, 979.0]",2,6,-4
31274.0,2020-02-13,"(979.0, 1157.5]",4,16,-12
31274.0,2020-02-13,"(1157.5, 1336.0]",2,3,-1
31275.0,2020-02-13,"(4.648, 344.0]",3,4,-1
31275.0,2020-02-13,"(344.0, 682.0]",9,14,-5
31275.0,2020-02-13,"(682.0, 1020.0]",10,16,-6
31275.0,2020-02-13,"(1020.0, 1358.0]",14,32,-18
31276.0,2020-02-13,"(396.156, 608.0]",6,9,-3
31276.0,2020-02-13,"(608.0, 819.0]",5,7,-2
31276.0,2020-02-13,"(819.0, 1030.0]",1,7,-6
31277.0,2020-02-13,"(276.057, 512.75]",8,9,-1
31277.0,2020-02-13,"(512.75, 748.5]",11,13,-2
31277.0,2020-02-13,"(748.5, 984.25]",3,12,-9
31277.0,2020-02-13,"(984.25, 1220.0]",4,26,-22
31278.0,2020-02-13,"(25.609, 374.75]",3,4,-1
31278.0,2020-02-13,"(374.75, 722.5]",3,13,-10
31278.0,2020-02-13,"(722.5, 1070.25]",12,19,-7
31278.0,2020-02-13,"(1070.25, 1418.0]",18,30,-12
31279.0,2020-02-13,"(455.329, 623.75]",9,9,0
31279.0,2020-02-13,"(791.5, 959.25]",3,2,1
31279.0,2020-02-13,"(959.25, 1127.0]",4,7,-3
31280.0,2020-02-13,"(371.099, 597.25]",2,8,-6
31280.0,2020-02-13,"(597.25, 822.5]",2,6,-4
31280.0,2020-02-13,"(822.5, 1047.75]",5,8,-3
31280.0,2020-02-13,"(1047.75, 1273.0]",17,23,-6
31000.0,2020-02-14,"(626.513, 748.75]",1,2,-1
31000.0,2020-02-14,"(992.25, 1114.0]",1,1,0
31001.0,2020-02-14,"(948.0, 1264.0]",3,1,2
31002.0,2020-02-14,"(534.465, 668.75]",1,4,-3
31002.0,2020-02-14,"(668.75, 802.5]",1,1,0
31002.0,2020-02-14,"(802.5, 936.25]",1,1,0
31002.0,2020-02-14,"(936.25, 1070.0]",2,3,-1
31003.0,2020-02-14,"(462.274, 644.5]",1,3,-2
31003.0,2020-02-14,"(644.5, 826.0]",1,1,0
31003.0,2020-02-14,"(1007.5, 1189.0]",1,1,0
31004.0,2020-02-14,"(1136.0, 1347.0]",2,1,1
31005.0,2020-02-14,"(423.08, 654.0]",4,6,-2
31005.0,2020-02-14,"(884.0, 1114.0]",3,7,-4
31006.0,2020-02-14,"(97.291, 275.25]",1,1,0
31006.0,2020-02-14,"(629.75, 807.0]",1,2,-1
31007.0,2020-02-14,"(441.198, 642.5]",6,13,-7
31007.0,2020-02-14,"(642.5, 843.0]",3,6,-3
31007.0,2020-02-14,"(843.0, 1043.5]",1,8,-7
31007.0,2020-02-14,"(1043.5, 1244.0]",3,11,-8
31009.0,2020-02-14,"(411.0, 548.0]",4,1,3
31010.0,2020-02-14,"(1060.828, 1104.0]",2,3,-1
31011.0,2020-02-14,"(414.312, 587.0]",5,7,-2
31011.0,2020-02-14,"(587.0, 759.0]",1,1,0
31011.0,2020-02-14,"(759.0, 931.0]",2,4,-2
31011.0,2020-02-14,"(931.0, 1103.0]",2,5,-3
31012.0,2020-02-14,"(467.415, 614.25]",2,2,0
31013.0,2020-02-14,"(798.5, 997.75]",2,2,0
31013.0,2020-02-14,"(997.75, 1197.0]",3,4,-1
31014.0,2020-02-14,"(235.962, 496.5]",3,7,-4
31014.0,2020-02-14,"(496.5, 756.0]",13,16,-3
31014.0,2020-02-14,"(756.0, 1015.5]",7,11,-4
31014.0,2020-02-14,"(1015.5, 1275.0]",5,9,-4
31015.0,2020-02-14,"(5.833, 298.75]",1,1,0
31015.0,2020-02-14,"(298.75, 590.5]",8,8,0
31015.0,2020-02-14,"(590.5, 882.25]",3,4,-1
31015.0,2020-02-14,"(882.25, 1174.0]",7,9,-2
31016.0,2020-02-14,"(343.009, 591.75]",3,5,-2
31016.0,2020-02-14,"(591.75, 839.5]",2,4,-2
31016.0,2020-02-14,"(839.5, 1087.25]",2,4,-2
31017.0,2020-02-14,"(518.282, 698.5]",4,5,-1
31018.0,2020-02-14,"(973.75, 1116.0]",2,2,0
31019.0,2020-02-14,"(837.0, 1028.0]",1,1,0
31019.0,2020-02-14,"(1028.0, 1219.0]",1,1,0
31020.0,2020-02-14,"(755.0, 873.5]",1,2,-1
31020.0,2020-02-14,"(873.5, 992.0]",1,1,0
31021.0,2020-02-14,"(1088.5, 1271.0]",1,2,-1
31022.0,2020-02-14,"(48.706, 373.5]",1,1,0
31022.0,2020-02-14,"(697.0, 1020.5]",3,3,0
31022.0,2020-02-14,"(1020.5, 1344.0]",5,9,-4
31023.0,2020-02-14,"(478.158, 689.5]",3,4,-1
31023.0,2020-02-14,"(689.5, 900.0]",1,1,0
31023.0,2020-02-14,"(900.0, 1110.5]",1,2,-1
31024.0,2020-02-14,"(465.375, 622.25]",5,9,-4
31024.0,2020-02-14,"(622.25, 778.5]",2,3,-1
31024.0,2020-02-14,"(778.5, 934.75]",2,3,-1
,,,,2.0,
31026.0,2020-02-14,"(811.0, 965.5]",1,2,-1
31026.0,2020-02-14,"(965.5, 1120.0]",2,2,0
31027.0,2020-02-14,"(400.487, 529.25]",1,1,0
31028.0,2020-02-14,"(1145.5, 1205.0]",1,1,0
31029.0,2020-02-14,"(610.0, 824.0]",1,3,-2
31029.0,2020-02-14,"(824.0, 1038.0]",2,1,1
31029.0,2020-02-14,"(1038.0, 1252.0]",2,3,-1
31030.0,2020-02-14,"(336.044, 576.0]",1,7,-6
31030.0,2020-02-14,"(576.0, 815.0]",1,3,-2
31030.0,2020-02-14,"(815.0, 1054.0]",3,8,-5
31030.0,2020-02-14,"(1054.0, 1293.0]",2,4,-2
31031.0,2020-02-14,"(473.469, 606.75]",1,4,-3
31031.0,2020-02-14,"(872.25, 1005.0]",1,2,-1
,,,,1.0,
,,,,1.0,
,,,,2.0,
31034.0,2020-02-14,"(471.0, 509.0]",1,1,0
31034.0,2020-02-14,"(547.0, 585.0]",2,1,1
31035.0,2020-02-14,"(447.399, 598.25]",1,3,-2
31036.0,2020-02-14,"(633.5, 773.0]",2,1,1
31036.0,2020-02-14,"(773.0, 912.5]",1,4,-3
31036.0,2020-02-14,"(912.5, 1052.0]",1,2,-1
31037.0,2020-02-14,"(416.001, 666.75]",10,14,-4
31037.0,2020-02-14,"(666.75, 916.5]",3,5,-2
31037.0,2020-02-14,"(916.5, 1166.25]",2,11,-9
31038.0,2020-02-14,"(672.25, 801.5]",1,2,-1
31038.0,2020-02-14,"(801.5, 930.75]",1,1,0
31038.0,2020-02-14,"(930.75, 1060.0]",1,1,0
31039.0,2020-02-14,"(480.076, 712.0]",2,6,-4
31039.0,2020-02-14,"(712.0, 943.0]",2,7,-5
31039.0,2020-02-14,"(943.0, 1174.0]",1,1,0
31040.0,2020-02-14,"(435.366, 594.5]",2,3,-1
31040.0,2020-02-14,"(594.5, 753.0]",2,2,0
31040.0,2020-02-14,"(911.5, 1070.0]",1,2,-1
31041.0,2020-02-14,"(530.472, 663.0]",1,1,0
31041.0,2020-02-14,"(663.0, 795.0]",1,1,0
31041.0,2020-02-14,"(927.0, 1059.0]",3,1,2
31042.0,2020-02-14,"(432.389, 585.75]",6,7,-1
31042.0,2020-02-14,"(585.75, 738.5]",1,1,0
31042.0,2020-02-14,"(738.5, 891.25]",1,2,-1
31042.0,2020-02-14,"(891.25, 1044.0]",1,7,-6
31043.0,2020-02-14,"(506.443, 646.25]",1,1,0
31044.0,2020-02-14,"(467.355, 629.25]",2,3,-1
31044.0,2020-02-14,"(629.25, 790.5]",1,1,0
31045.0,2020-02-14,"(435.495, 562.25]",1,2,-1
31045.0,2020-02-14,"(562.25, 688.5]",1,2,-1
31045.0,2020-02-14,"(814.75, 941.0]",1,1,0
31046.0,2020-02-14,"(398.365, 557.75]",1,4,-3
31046.0,2020-02-14,"(875.25, 1034.0]",1,1,0
31047.0,2020-02-14,"(404.219, 600.25]",8,11,-3
31047.0,2020-02-14,"(600.25, 795.5]",1,2,-1
31047.0,2020-02-14,"(795.5, 990.75]",1,6,-5
31047.0,2020-02-14,"(990.75, 1186.0]",3,8,-5
31048.0,2020-02-14,"(303.25, 589.5]",2,1,1
31048.0,2020-02-14,"(589.5, 875.75]",1,4,-3
31048.0,2020-02-14,"(875.75, 1162.0]",2,2,0
31049.0,2020-02-14,"(719.75, 832.5]",1,1,0
31050.0,2020-02-14,"(515.387, 669.25]",1,3,-2
31050.0,2020-02-14,"(975.75, 1129.0]",1,1,0
31051.0,2020-02-14,"(924.0, 1041.0]",4,1,3
31052.0,2020-02-14,"(540.401, 690.75]",2,3,-1
31052.0,2020-02-14,"(690.75, 840.5]",1,2,-1
31052.0,2020-02-14,"(990.25, 1140.0]",3,4,-1
31053.0,2020-02-14,"(937.5, 1145.75]",1,2,-1
31053.0,2020-02-14,"(1145.75, 1354.0]",1,1,0
31054.0,2020-02-14,"(886.25, 1031.0]",1,1,0
31055.0,2020-02-14,"(916.0, 1060.0]",2,1,1
31056.0,2020-02-14,"(70.673, 403.75]",1,1,0
31056.0,2020-02-14,"(735.5, 1067.25]",1,1,0
31056.0,2020-02-14,"(1067.25, 1399.0]",1,1,0
,,,,2.0,
31058.0,2020-02-14,"(849.75, 1133.0]",2,1,1
31059.0,2020-02-14,"(798.0, 1064.0]",2,1,1
31060.0,2020-02-14,"(390.75, 723.5]",2,1,1
31060.0,2020-02-14,"(723.5, 1056.25]",1,2,-1
31060.0,2020-02-14,"(1056.25, 1389.0]",1,1,0
31061.0,2020-02-14,"(466.5, 592.0]",1,2,-1
31061.0,2020-02-14,"(842.0, 967.0]",1,1,0
31062.0,2020-02-14,"(743.0, 791.0]",1,1,0
31063.0,2020-02-14,"(820.0, 827.0]",1,1,0
31064.0,2020-02-14,"(466.327, 635.25]",4,8,-4
31064.0,2020-02-14,"(635.25, 803.5]",1,2,-1
31064.0,2020-02-14,"(803.5, 971.75]",3,6,-3
31064.0,2020-02-14,"(971.75, 1140.0]",2,4,-2
,,,,1.0,
,,,,1.0,
31066.0,2020-02-14,"(612.5, 651.0]",2,1,1
31067.0,2020-02-14,"(525.458, 661.5]",1,3,-2
31067.0,2020-02-14,"(932.5, 1068.0]",1,2,-1
31068.0,2020-02-14,"(610.0, 716.5]",1,1,0
31068.0,2020-02-14,"(716.5, 823.0]",1,1,0
31069.0,2020-02-14,"(674.25, 919.5]",2,4,-2
31069.0,2020-02-14,"(919.5, 1164.75]",3,2,1
31069.0,2020-02-14,"(1164.75, 1410.0]",1,3,-2
31070.0,2020-02-14,"(1140.0, 1330.0]",2,1,1
31071.0,2020-02-14,"(431.126, 650.5]",1,6,-5
31071.0,2020-02-14,"(650.5, 869.0]",1,2,-1
31071.0,2020-02-14,"(869.0, 1087.5]",5,7,-2
31071.0,2020-02-14,"(1087.5, 1306.0]",2,6,-4
,,,,2.0,
31073.0,2020-02-14,"(445.632, 538.0]",1,2,-1
31074.0,2020-02-14,"(971.25, 1101.0]",2,1,1
31075.0,2020-02-14,"(1015.5, 1185.0]",1,2,-1
31076.0,2020-02-14,"(998.0, 1170.0]",2,1,1
31077.0,2020-02-14,"(546.117, 767.75]",1,2,-1
31077.0,2020-02-14,"(988.5, 1209.25]",1,1,0
31077.0,2020-02-14,"(1209.25, 1430.0]",1,2,-1
31078.0,2020-02-14,"(471.528, 590.0]",6,6,0
31078.0,2020-02-14,"(826.0, 944.0]",1,1,0
31079.0,2020-02-14,"(1059.0, 1255.0]",4,4,0
31080.0,2020-02-14,"(830.5, 1028.25]",1,9,-8
31080.0,2020-02-14,"(1028.25, 1226.0]",5,2,3
31081.0,2020-02-14,"(567.75, 775.5]",2,1,1
31081.0,2020-02-14,"(775.5, 983.25]",1,5,-4
31081.0,2020-02-14,"(983.25, 1191.0]",2,3,-1
31082.0,2020-02-14,"(442.358, 603.5]",2,2,0
31082.0,2020-02-14,"(603.5, 764.0]",2,3,-1
31082.0,2020-02-14,"(764.0, 924.5]",1,1,0
31082.0,2020-02-14,"(924.5, 1085.0]",1,2,-1
31083.0,2020-02-14,"(914.0, 1085.0]",3,1,2
31084.0,2020-02-14,"(22.788, 327.0]",1,1,0
31084.0,2020-02-14,"(327.0, 630.0]",1,1,0
31084.0,2020-02-14,"(630.0, 933.0]",2,3,-1
31084.0,2020-02-14,"(933.0, 1236.0]",2,7,-5
31085.0,2020-02-14,"(403.941, 418.75]",1,1,0
31085.0,2020-02-14,"(448.25, 463.0]",1,1,0
31086.0,2020-02-14,"(1027.723, 1097.25]",2,2,0
31087.0,2020-02-14,"(516.208, 715.0]",1,3,-2
31087.0,2020-02-14,"(715.0, 913.0]",1,1,0
31087.0,2020-02-14,"(913.0, 1111.0]",1,2,-1
31087.0,2020-02-14,"(1111.0, 1309.0]",2,2,0
31088.0,2020-02-14,"(864.0, 982.0]",3,3,0
31089.0,2020-02-14,"(477.138, 693.5]",4,7,-3
31089.0,2020-02-14,"(693.5, 909.0]",1,1,0
31089.0,2020-02-14,"(1124.5, 1340.0]",2,13,-11
31090.0,2020-02-14,"(807.75, 936.0]",1,1,0
31091.0,2020-02-14,"(407.069, 640.75]",1,7,-6
31091.0,2020-02-14,"(873.5, 1106.25]",2,2,0
31091.0,2020-02-14,"(1106.25, 1339.0]",1,2,-1
31092.0,2020-02-14,"(634.25, 775.5]",1,2,-1
31092.0,2020-02-14,"(916.75, 1058.0]",2,1,1
,,,,1.0,
,,,,1.0,
,,,,3.0,
31094.0,2020-02-14,"(928.0, 1067.0]",1,1,0
,,,,2.0,
31096.0,2020-02-14,"(1095.861, 1130.75]",1,1,0
,,,,1.0,
,,,,1.0,
31098.0,2020-02-14,"(439.302, 614.5]",1,7,-6
31098.0,2020-02-14,"(789.0, 963.5]",1,1,0
31098.0,2020-02-14,"(963.5, 1138.0]",7,8,-1
31099.0,2020-02-14,"(765.698, 841.5]",1,2,-1
31099.0,2020-02-14,"(992.5, 1068.0]",1,1,0
31100.0,2020-02-14,"(471.243, 661.25]",11,12,-1
31100.0,2020-02-14,"(661.25, 850.5]",3,5,-2
31100.0,2020-02-14,"(850.5, 1039.75]",2,4,-2
31101.0,2020-02-14,"(16.586, 371.5]",2,4,-2
31101.0,2020-02-14,"(371.5, 725.0]",15,42,-27
31101.0,2020-02-14,"(725.0, 1078.5]",38,55,-17
31101.0,2020-02-14,"(1078.5, 1432.0]",9,14,-5
31102.0,2020-02-14,"(343.989, 597.75]",1,10,-9
31102.0,2020-02-14,"(597.75, 850.5]",2,7,-5
31102.0,2020-02-14,"(850.5, 1103.25]",4,7,-3
31102.0,2020-02-14,"(1103.25, 1356.0]",3,5,-2
31103.0,2020-02-14,"(70.679, 402.25]",1,4,-3
31103.0,2020-02-14,"(402.25, 732.5]",2,30,-28
31103.0,2020-02-14,"(732.5, 1062.75]",6,14,-8
31103.0,2020-02-14,"(1062.75, 1393.0]",11,25,-14
31104.0,2020-02-14,"(328.75, 628.5]",5,3,2
31104.0,2020-02-14,"(628.5, 928.25]",11,17,-6
31104.0,2020-02-14,"(928.25, 1228.0]",12,17,-5
31105.0,2020-02-14,"(969.5, 1169.0]",3,3,0
31106.0,2020-02-14,"(801.0, 988.5]",1,3,-2
31106.0,2020-02-14,"(988.5, 1176.0]",3,1,2
31107.0,2020-02-14,"(85.656, 423.0]",1,3,-2
31107.0,2020-02-14,"(423.0, 759.0]",2,27,-25
31107.0,2020-02-14,"(759.0, 1095.0]",7,14,-7
31107.0,2020-02-14,"(1095.0, 1431.0]",6,12,-6
31108.0,2020-02-14,"(89.817, 386.75]",1,1,0
31108.0,2020-02-14,"(386.75, 682.5]",6,17,-11
31108.0,2020-02-14,"(682.5, 978.25]",18,31,-13
31108.0,2020-02-14,"(978.25, 1274.0]",22,29,-7
31109.0,2020-02-14,"(62.717, 384.75]",2,3,-1
31109.0,2020-02-14,"(384.75, 705.5]",8,18,-10
31109.0,2020-02-14,"(705.5, 1026.25]",10,18,-8
31109.0,2020-02-14,"(1026.25, 1347.0]",13,20,-7
31110.0,2020-02-14,"(341.994, 594.5]",13,31,-18
31110.0,2020-02-14,"(594.5, 846.0]",7,11,-4
31110.0,2020-02-14,"(846.0, 1097.5]",12,23,-11
31110.0,2020-02-14,"(1097.5, 1349.0]",8,16,-8
31111.0,2020-02-14,"(369.94, 636.0]",4,15,-11
31111.0,2020-02-14,"(636.0, 901.0]",5,8,-3
31111.0,2020-02-14,"(901.0, 1166.0]",11,16,-5
31111.0,2020-02-14,"(1166.0, 1431.0]",1,3,-2
31112.0,2020-02-14,"(521.375, 678.25]",1,2,-1
31112.0,2020-02-14,"(990.75, 1147.0]",1,2,-1
31113.0,2020-02-14,"(666.0, 976.5]",4,1,3
31113.0,2020-02-14,"(976.5, 1287.0]",12,26,-14
31114.0,2020-02-14,"(62.625, 407.75]",3,7,-4
31114.0,2020-02-14,"(751.5, 1095.25]",13,19,-6
31114.0,2020-02-14,"(1095.25, 1439.0]",14,19,-5
31115.0,2020-02-14,"(541.0, 833.0]",1,18,-17
31115.0,2020-02-14,"(833.0, 1125.0]",7,9,-2
31115.0,2020-02-14,"(1125.0, 1417.0]",4,13,-9
31116.0,2020-02-14,"(352.041, 592.75]",2,15,-13
31116.0,2020-02-14,"(592.75, 832.5]",6,13,-7
31116.0,2020-02-14,"(832.5, 1072.25]",16,21,-5
31116.0,2020-02-14,"(1072.25, 1312.0]",2,4,-2
31117.0,2020-02-14,"(308.885, 588.75]",2,20,-18
31117.0,2020-02-14,"(588.75, 867.5]",2,11,-9
31117.0,2020-02-14,"(867.5, 1146.25]",6,17,-11
31117.0,2020-02-14,"(1146.25, 1425.0]",7,8,-1
31118.0,2020-02-14,"(319.973, 577.75]",1,15,-14
31118.0,2020-02-14,"(577.75, 834.5]",2,4,-2
31118.0,2020-02-14,"(834.5, 1091.25]",4,7,-3
31118.0,2020-02-14,"(1091.25, 1348.0]",3,5,-2
31119.0,2020-02-14,"(378.18, 584.0]",5,22,-17
31119.0,2020-02-14,"(584.0, 789.0]",1,3,-2
31119.0,2020-02-14,"(789.0, 994.0]",1,6,-5
31119.0,2020-02-14,"(994.0, 1199.0]",12,20,-8
31120.0,2020-02-14,"(343.109, 566.75]",1,9,-8
31120.0,2020-02-14,"(566.75, 789.5]",4,8,-4
31120.0,2020-02-14,"(789.5, 1012.25]",5,7,-2
31120.0,2020-02-14,"(1012.25, 1235.0]",3,6,-3
31121.0,2020-02-14,"(376.113, 598.75]",16,20,-4
31121.0,2020-02-14,"(598.75, 820.5]",1,4,-3
31121.0,2020-02-14,"(820.5, 1042.25]",3,6,-3
31121.0,2020-02-14,"(1042.25, 1264.0]",7,14,-7
31122.0,2020-02-14,"(377.25, 725.5]",3,2,1
31122.0,2020-02-14,"(725.5, 1073.75]",6,8,-2
31122.0,2020-02-14,"(1073.75, 1422.0]",2,9,-7
31123.0,2020-02-14,"(367.231, 560.25]",1,15,-14
31123.0,2020-02-14,"(560.25, 752.5]",1,7,-6
31123.0,2020-02-14,"(752.5, 944.75]",2,4,-2
31123.0,2020-02-14,"(944.75, 1137.0]",6,6,0
31124.0,2020-02-14,"(35.674, 368.5]",4,6,-2
31124.0,2020-02-14,"(368.5, 700.0]",12,27,-15
31124.0,2020-02-14,"(700.0, 1031.5]",12,30,-18
31124.0,2020-02-14,"(1031.5, 1363.0]",13,28,-15
31125.0,2020-02-14,"(326.037, 567.75]",9,35,-26
31125.0,2020-02-14,"(567.75, 808.5]",2,5,-3
31125.0,2020-02-14,"(808.5, 1049.25]",10,17,-7
31125.0,2020-02-14,"(1049.25, 1290.0]",7,11,-4
31126.0,2020-02-14,"(310.933, 578.75]",4,24,-20
31126.0,2020-02-14,"(578.75, 845.5]",2,9,-7
31126.0,2020-02-14,"(845.5, 1112.25]",13,24,-11
31126.0,2020-02-14,"(1112.25, 1379.0]",7,12,-5
31127.0,2020-02-14,"(359.94, 626.0]",12,18,-6
31127.0,2020-02-14,"(626.0, 891.0]",4,9,-5
31127.0,2020-02-14,"(891.0, 1156.0]",8,20,-12
31128.0,2020-02-14,"(12.619, 359.25]",2,3,-1
31128.0,2020-02-14,"(359.25, 704.5]",29,42,-13
31128.0,2020-02-14,"(704.5, 1049.75]",18,30,-12
31128.0,2020-02-14,"(1049.75, 1395.0]",8,14,-6
31129.0,2020-02-14,"(339.159, 550.25]",6,8,-2
31129.0,2020-02-14,"(550.25, 760.5]",4,7,-3
31129.0,2020-02-14,"(760.5, 970.75]",4,4,0
31129.0,2020-02-14,"(970.75, 1181.0]",3,6,-3
31130.0,2020-02-14,"(430.252, 618.0]",2,7,-5
31130.0,2020-02-14,"(618.0, 805.0]",1,1,0
31130.0,2020-02-14,"(805.0, 992.0]",2,5,-3
31130.0,2020-02-14,"(992.0, 1179.0]",9,12,-3
31131.0,2020-02-14,"(10.815, 308.25]",1,1,0
31131.0,2020-02-14,"(308.25, 604.5]",2,14,-12
31131.0,2020-02-14,"(900.75, 1197.0]",5,4,1
31200.0,2020-02-14,"(365.75, 717.5]",30,1,29
31200.0,2020-02-14,"(717.5, 1069.25]",15,47,-32
31200.0,2020-02-14,"(1069.25, 1421.0]",14,32,-18
31201.0,2020-02-14,"(16.581, 372.75]",2,3,-1
31201.0,2020-02-14,"(372.75, 727.5]",20,49,-29
31201.0,2020-02-14,"(727.5, 1082.25]",35,61,-26
31201.0,2020-02-14,"(1082.25, 1437.0]",15,36,-21
,,,,2.0,
31203.0,2020-02-14,"(373.0, 722.0]",13,3,10
31203.0,2020-02-14,"(722.0, 1071.0]",23,32,-9
31203.0,2020-02-14,"(1071.0, 1420.0]",18,36,-18
31204.0,2020-02-14,"(35.598, 387.5]",4,4,0
31204.0,2020-02-14,"(387.5, 738.0]",14,22,-8
31204.0,2020-02-14,"(738.0, 1088.5]",7,15,-8
31204.0,2020-02-14,"(1088.5, 1439.0]",5,10,-5
31205.0,2020-02-14,"(408.075, 640.25]",16,18,-2
31205.0,2020-02-14,"(640.25, 871.5]",5,13,-8
31205.0,2020-02-14,"(871.5, 1102.75]",10,17,-7
31205.0,2020-02-14,"(1102.75, 1334.0]",1,7,-6
31206.0,2020-02-14,"(486.48, 617.0]",3,3,0
31206.0,2020-02-14,"(617.0, 747.0]",1,1,0
31206.0,2020-02-14,"(747.0, 877.0]",1,2,-1
31207.0,2020-02-14,"(753.0, 957.0]",1,2,-1
31207.0,2020-02-14,"(957.0, 1161.0]",2,2,0
31208.0,2020-02-14,"(393.082, 623.5]",8,10,-2
31208.0,2020-02-14,"(623.5, 853.0]",1,3,-2
31208.0,2020-02-14,"(853.0, 1082.5]",1,6,-5
31208.0,2020-02-14,"(1082.5, 1312.0]",3,5,-2
31209.0,2020-02-14,"(437.337, 603.75]",1,3,-2
31209.0,2020-02-14,"(769.5, 935.25]",1,1,0
31209.0,2020-02-14,"(935.25, 1101.0]",5,2,3
31211.0,2020-02-14,"(509.249, 697.75]",11,12,-1
31211.0,2020-02-14,"(697.75, 885.5]",1,3,-2
31211.0,2020-02-14,"(1073.25, 1261.0]",5,1,4
31212.0,2020-02-14,"(-1.337, 334.25]",1,5,-4
31212.0,2020-02-14,"(334.25, 668.5]",28,39,-11
31212.0,2020-02-14,"(668.5, 1002.75]",7,19,-12
31212.0,2020-02-14,"(1002.75, 1337.0]",7,18,-11
31213.0,2020-02-14,"(276.127, 495.25]",9,14,-5
31213.0,2020-02-14,"(495.25, 713.5]",21,30,-9
31213.0,2020-02-14,"(713.5, 931.75]",12,18,-6
31213.0,2020-02-14,"(931.75, 1150.0]",12,20,-8
31214.0,2020-02-14,"(307.93, 576.5]",5,28,-23
31214.0,2020-02-14,"(576.5, 844.0]",6,12,-6
31214.0,2020-02-14,"(844.0, 1111.5]",28,41,-13
31214.0,2020-02-14,"(1111.5, 1379.0]",9,15,-6
31215.0,2020-02-14,"(445.018, 691.5]",21,22,-1
31215.0,2020-02-14,"(691.5, 937.0]",1,4,-3
31215.0,2020-02-14,"(937.0, 1182.5]",3,7,-4
31215.0,2020-02-14,"(1182.5, 1428.0]",1,1,0
31216.0,2020-02-14,"(446.305, 620.75]",23,25,-2
31216.0,2020-02-14,"(620.75, 794.5]",4,11,-7
31216.0,2020-02-14,"(794.5, 968.25]",4,10,-6
31216.0,2020-02-14,"(968.25, 1142.0]",3,15,-12
31217.0,2020-02-14,"(344.253, 531.75]",5,6,-1
31217.0,2020-02-14,"(531.75, 718.5]",4,4,0
31217.0,2020-02-14,"(718.5, 905.25]",2,2,0
31218.0,2020-02-14,"(374.206, 573.5]",7,20,-13
31218.0,2020-02-14,"(573.5, 772.0]",4,5,-1
31218.0,2020-02-14,"(772.0, 970.5]",3,9,-6
31218.0,2020-02-14,"(970.5, 1169.0]",9,17,-8
31219.0,2020-02-14,"(357.281, 537.75]",5,5,0
31219.0,2020-02-14,"(537.75, 717.5]",3,5,-2
31219.0,2020-02-14,"(717.5, 897.25]",2,5,-3
31219.0,2020-02-14,"(897.25, 1077.0]",1,7,-6
31220.0,2020-02-14,"(293.147, 507.25]",10,11,-1
31220.0,2020-02-14,"(507.25, 720.5]",7,9,-2
31220.0,2020-02-14,"(720.5, 933.75]",1,10,-9
31221.0,2020-02-14,"(348.75, 635.5]",34,3,31
31221.0,2020-02-14,"(635.5, 922.25]",8,40,-32
31221.0,2020-02-14,"(922.25, 1209.0]",6,15,-9
31222.0,2020-02-14,"(378.096, 605.0]",14,16,-2
31222.0,2020-02-14,"(605.0, 831.0]",9,14,-5
31222.0,2020-02-14,"(831.0, 1057.0]",6,16,-10
31222.0,2020-02-14,"(1057.0, 1283.0]",1,6,-5
31223.0,2020-02-14,"(342.25, 647.5]",10,2,8
31223.0,2020-02-14,"(647.5, 952.75]",3,26,-23
31223.0,2020-02-14,"(952.75, 1258.0]",12,9,3
31224.0,2020-02-14,"(377.161, 587.75]",7,7,0
31224.0,2020-02-14,"(587.75, 797.5]",3,6,-3
31224.0,2020-02-14,"(797.5, 1007.25]",4,8,-4
31224.0,2020-02-14,"(1007.25, 1217.0]",7,18,-11
31225.0,2020-02-14,"(475.239, 666.25]",4,8,-4
31225.0,2020-02-14,"(666.25, 856.5]",2,2,0
31225.0,2020-02-14,"(856.5, 1046.75]",6,12,-6
31225.0,2020-02-14,"(1046.75, 1237.0]",5,7,-2
31226.0,2020-02-14,"(419.75, 720.5]",2,1,1
31226.0,2020-02-14,"(720.5, 1021.25]",7,3,4
31226.0,2020-02-14,"(1021.25, 1322.0]",3,12,-9
31227.0,2020-02-14,"(290.894, 568.5]",19,20,-1
31227.0,2020-02-14,"(568.5, 845.0]",11,17,-6
31227.0,2020-02-14,"(845.0, 1121.5]",4,17,-13
31227.0,2020-02-14,"(1121.5, 1398.0]",2,6,-4
31228.0,2020-02-14,"(4.615, 352.25]",3,5,-2
31228.0,2020-02-14,"(352.25, 698.5]",15,24,-9
31228.0,2020-02-14,"(698.5, 1044.75]",25,43,-18
31228.0,2020-02-14,"(1044.75, 1391.0]",14,24,-10
31229.0,2020-02-14,"(4.573, 362.75]",2,4,-2
31229.0,2020-02-14,"(362.75, 719.5]",12,56,-44
31229.0,2020-02-14,"(719.5, 1076.25]",22,37,-15
31229.0,2020-02-14,"(1076.25, 1433.0]",16,31,-15
31230.0,2020-02-14,"(376.945, 641.75]",39,48,-9
31230.0,2020-02-14,"(641.75, 905.5]",8,14,-6
31230.0,2020-02-14,"(905.5, 1169.25]",10,27,-17
31230.0,2020-02-14,"(1169.25, 1433.0]",1,4,-3
31231.0,2020-02-14,"(349.936, 617.0]",9,11,-2
31231.0,2020-02-14,"(617.0, 883.0]",5,9,-4
31231.0,2020-02-14,"(883.0, 1149.0]",7,18,-11
31232.0,2020-02-14,"(67.794, 370.5]",1,2,-1
31232.0,2020-02-14,"(370.5, 672.0]",16,21,-5
31232.0,2020-02-14,"(672.0, 973.5]",8,15,-7
31232.0,2020-02-14,"(973.5, 1275.0]",8,22,-14
31233.0,2020-02-14,"(333.046, 572.5]",23,26,-3
31233.0,2020-02-14,"(572.5, 811.0]",13,17,-4
31233.0,2020-02-14,"(811.0, 1049.5]",7,16,-9
31233.0,2020-02-14,"(1049.5, 1288.0]",4,15,-11
31234.0,2020-02-14,"(6.708, 331.0]",1,2,-1
31234.0,2020-02-14,"(331.0, 654.0]",15,27,-12
31234.0,2020-02-14,"(654.0, 977.0]",12,21,-9
31234.0,2020-02-14,"(977.0, 1300.0]",14,24,-10
31235.0,2020-02-14,"(498.424, 643.0]",3,3,0
31236.0,2020-02-14,"(524.189, 727.75]",11,14,-3
31236.0,2020-02-14,"(727.75, 930.5]",4,18,-14
31236.0,2020-02-14,"(930.5, 1133.25]",3,12,-9
31236.0,2020-02-14,"(1133.25, 1336.0]",3,6,-3
31237.0,2020-02-14,"(331.75, 652.5]",2,1,1
31237.0,2020-02-14,"(652.5, 973.25]",14,12,2
31237.0,2020-02-14,"(973.25, 1294.0]",14,27,-13
31238.0,2020-02-14,"(57.951, 321.25]",1,1,0
31238.0,2020-02-14,"(321.25, 583.5]",7,8,-1
31238.0,2020-02-14,"(583.5, 845.75]",8,16,-8
31238.0,2020-02-14,"(845.75, 1108.0]",8,23,-15
31239.0,2020-02-14,"(349.187, 553.25]",19,19,0
31239.0,2020-02-14,"(553.25, 756.5]",6,8,-2
31239.0,2020-02-14,"(756.5, 959.75]",5,9,-4
31239.0,2020-02-14,"(959.75, 1163.0]",5,17,-12
31240.0,2020-02-14,"(551.25, 735.0]",2,1,1
31241.0,2020-02-14,"(55.666, 390.5]",1,4,-3
31241.0,2020-02-14,"(390.5, 724.0]",18,39,-21
31241.0,2020-02-14,"(724.0, 1057.5]",17,37,-20
31241.0,2020-02-14,"(1057.5, 1391.0]",16,24,-8
31242.0,2020-02-14,"(440.144, 655.0]",24,24,0
31242.0,2020-02-14,"(655.0, 869.0]",9,20,-11
31242.0,2020-02-14,"(869.0, 1083.0]",3,14,-11
31242.0,2020-02-14,"(1083.0, 1297.0]",1,8,-7
31243.0,2020-02-14,"(375.995, 628.25]",12,18,-6
31243.0,2020-02-14,"(628.25, 879.5]",2,5,-3
31243.0,2020-02-14,"(1130.75, 1382.0]",2,8,-6
31244.0,2020-02-14,"(386.0, 725.0]",12,1,11
31244.0,2020-02-14,"(725.0, 1064.0]",5,20,-15
31244.0,2020-02-14,"(1064.0, 1403.0]",2,11,-9
31245.0,2020-02-14,"(447.311, 620.25]",2,8,-6
31245.0,2020-02-14,"(792.5, 964.75]",7,8,-1
31245.0,2020-02-14,"(964.75, 1137.0]",4,10,-6
31246.0,2020-02-14,"(0.657, 337.75]",2,3,-1
31246.0,2020-02-14,"(337.75, 673.5]",10,18,-8
31246.0,2020-02-14,"(673.5, 1009.25]",12,15,-3
31246.0,2020-02-14,"(1009.25, 1345.0]",11,20,-9
31247.0,2020-02-14,"(402.241, 592.75]",9,18,-9
31247.0,2020-02-14,"(592.75, 782.5]",12,18,-6
31247.0,2020-02-14,"(782.5, 972.25]",5,17,-12
31247.0,2020-02-14,"(972.25, 1162.0]",6,13,-7
31248.0,2020-02-14,"(402.275, 584.25]",6,10,-4
31248.0,2020-02-14,"(584.25, 765.5]",7,14,-7
31248.0,2020-02-14,"(765.5, 946.75]",12,16,-4
31248.0,2020-02-14,"(946.75, 1128.0]",18,35,-17
31249.0,2020-02-14,"(443.405, 592.75]",2,3,-1
31249.0,2020-02-14,"(741.5, 890.25]",1,1,0
31249.0,2020-02-14,"(890.25, 1039.0]",5,4,1
31250.0,2020-02-14,"(426.213, 623.75]",14,15,-1
31250.0,2020-02-14,"(623.75, 820.5]",7,11,-4
31250.0,2020-02-14,"(820.5, 1017.25]",3,9,-6
31250.0,2020-02-14,"(1017.25, 1214.0]",1,13,-12
31251.0,2020-02-14,"(2.62, 349.0]",1,1,0
31251.0,2020-02-14,"(349.0, 694.0]",12,20,-8
31251.0,2020-02-14,"(694.0, 1039.0]",5,13,-8
31251.0,2020-02-14,"(1039.0, 1384.0]",6,13,-7
31252.0,2020-02-14,"(326.75, 621.5]",21,1,20
31252.0,2020-02-14,"(621.5, 916.25]",6,23,-17
31252.0,2020-02-14,"(916.25, 1211.0]",4,10,-6
31253.0,2020-02-14,"(399.184, 604.0]",13,14,-1
31253.0,2020-02-14,"(604.0, 808.0]",4,5,-1
31253.0,2020-02-14,"(808.0, 1012.0]",2,5,-3
31253.0,2020-02-14,"(1012.0, 1216.0]",2,14,-12
31254.0,2020-02-14,"(429.042, 669.5]",21,22,-1
31254.0,2020-02-14,"(669.5, 909.0]",5,8,-3
31254.0,2020-02-14,"(909.0, 1148.5]",1,18,-17
31254.0,2020-02-14,"(1148.5, 1388.0]",1,7,-6
31255.0,2020-02-14,"(393.184, 598.0]",13,21,-8
31255.0,2020-02-14,"(598.0, 802.0]",4,4,0
31255.0,2020-02-14,"(802.0, 1006.0]",2,4,-2
31255.0,2020-02-14,"(1006.0, 1210.0]",3,12,-9
31256.0,2020-02-14,"(258.92, 530.0]",10,10,0
31256.0,2020-02-14,"(530.0, 800.0]",7,10,-3
31256.0,2020-02-14,"(800.0, 1070.0]",4,16,-12
31256.0,2020-02-14,"(1070.0, 1340.0]",5,10,-5
31257.0,2020-02-14,"(348.078, 579.5]",19,35,-16
31257.0,2020-02-14,"(579.5, 810.0]",6,11,-5
31257.0,2020-02-14,"(810.0, 1040.5]",13,24,-11
31257.0,2020-02-14,"(1040.5, 1271.0]",7,17,-10
31258.0,2020-02-14,"(5.58, 362.0]",2,3,-1
31258.0,2020-02-14,"(362.0, 717.0]",6,9,-3
31258.0,2020-02-14,"(717.0, 1072.0]",11,32,-21
31258.0,2020-02-14,"(1072.0, 1427.0]",3,6,-3
31259.0,2020-02-14,"(474.392, 627.0]",4,4,0
31259.0,2020-02-14,"(627.0, 779.0]",1,2,-1
31259.0,2020-02-14,"(779.0, 931.0]",1,2,-1
31260.0,2020-02-14,"(429.999, 681.25]",16,19,-3
31260.0,2020-02-14,"(681.25, 931.5]",1,6,-5
31260.0,2020-02-14,"(931.5, 1181.75]",5,18,-13
31260.0,2020-02-14,"(1181.75, 1432.0]",4,5,-1
31261.0,2020-02-14,"(388.312, 561.0]",6,6,0
31261.0,2020-02-14,"(561.0, 733.0]",4,4,0
31261.0,2020-02-14,"(733.0, 905.0]",1,1,0
31262.0,2020-02-14,"(419.239, 610.25]",6,6,0
31262.0,2020-02-14,"(610.25, 800.5]",2,6,-4
31262.0,2020-02-14,"(800.5, 990.75]",2,6,-4
31263.0,2020-02-14,"(4.806, 304.5]",1,2,-1
31263.0,2020-02-14,"(304.5, 603.0]",16,24,-8
31263.0,2020-02-14,"(603.0, 901.5]",5,9,-4
31263.0,2020-02-14,"(901.5, 1200.0]",6,20,-14
31264.0,2020-02-14,"(412.243, 602.25]",10,13,-3
31264.0,2020-02-14,"(602.25, 791.5]",2,4,-2
31264.0,2020-02-14,"(791.5, 980.75]",1,5,-4
31264.0,2020-02-14,"(980.75, 1170.0]",4,12,-8
31265.0,2020-02-14,"(106.681, 437.75]",4,8,-4
31265.0,2020-02-14,"(437.75, 767.5]",14,24,-10
31265.0,2020-02-14,"(767.5, 1097.25]",13,26,-13
31265.0,2020-02-14,"(1097.25, 1427.0]",7,13,-6
31266.0,2020-02-14,"(9.641, 350.75]",1,3,-2
31266.0,2020-02-14,"(350.75, 690.5]",4,30,-26
31266.0,2020-02-14,"(690.5, 1030.25]",7,17,-10
31266.0,2020-02-14,"(1030.25, 1370.0]",13,26,-13
31267.0,2020-02-14,"(136.733, 454.75]",1,2,-1
31267.0,2020-02-14,"(454.75, 771.5]",24,37,-13
31267.0,2020-02-14,"(771.5, 1088.25]",13,32,-19
31267.0,2020-02-14,"(1088.25, 1405.0]",8,14,-6
31268.0,2020-02-14,"(71.713, 394.75]",3,4,-1
31268.0,2020-02-14,"(394.75, 716.5]",20,41,-21
31268.0,2020-02-14,"(716.5, 1038.25]",10,16,-6
31268.0,2020-02-14,"(1038.25, 1360.0]",30,41,-11
31269.0,2020-02-14,"(118.689, 447.75]",2,4,-2
31269.0,2020-02-14,"(447.75, 775.5]",7,11,-4
31269.0,2020-02-14,"(775.5, 1103.25]",9,22,-13
31269.0,2020-02-14,"(1103.25, 1431.0]",1,6,-5
31270.0,2020-02-14,"(395.025, 639.75]",13,18,-5
31270.0,2020-02-14,"(639.75, 883.5]",9,16,-7
31270.0,2020-02-14,"(883.5, 1127.25]",4,9,-5
31270.0,2020-02-14,"(1127.25, 1371.0]",1,2,-1
31271.0,2020-02-14,"(380.976, 638.0]",16,17,-1
31271.0,2020-02-14,"(638.0, 894.0]",6,9,-3
31271.0,2020-02-14,"(894.0, 1150.0]",5,16,-11
31271.0,2020-02-14,"(1150.0, 1406.0]",1,5,-4
31272.0,2020-02-14,"(296.911, 570.25]",22,25,-3
31272.0,2020-02-14,"(570.25, 842.5]",9,13,-4
31272.0,2020-02-14,"(842.5, 1114.75]",1,15,-14
31272.0,2020-02-14,"(1114.75, 1387.0]",4,6,-2
31273.0,2020-02-14,"(538.434, 680.5]",1,6,-5
31273.0,2020-02-14,"(822.0, 963.5]",1,1,0
31273.0,2020-02-14,"(963.5, 1105.0]",2,2,0
31274.0,2020-02-14,"(450.309, 623.75]",14,16,-2
31274.0,2020-02-14,"(623.75, 796.5]",1,6,-5
31274.0,2020-02-14,"(796.5, 969.25]",2,3,-1
31274.0,2020-02-14,"(969.25, 1142.0]",5,9,-4
31275.0,2020-02-14,"(112.744, 428.0]",8,9,-1
31275.0,2020-02-14,"(428.0, 742.0]",13,32,-19
31275.0,2020-02-14,"(742.0, 1056.0]",12,21,-9
31275.0,2020-02-14,"(1056.0, 1370.0]",4,13,-9
31276.0,2020-02-14,"(473.181, 678.75]",19,19,0
31276.0,2020-02-14,"(678.75, 883.5]",9,17,-8
31276.0,2020-02-14,"(883.5, 1088.25]",2,11,-9
31277.0,2020-02-14,"(436.259, 622.25]",31,34,-3
31277.0,2020-02-14,"(622.25, 807.5]",8,10,-2
31277.0,2020-02-14,"(807.5, 992.75]",3,17,-14
31277.0,2020-02-14,"(992.75, 1178.0]",1,15,-14
31278.0,2020-02-14,"(426.207, 625.25]",11,22,-11
31278.0,2020-02-14,"(625.25, 823.5]",2,6,-4
31278.0,2020-02-14,"(823.5, 1021.75]",4,8,-4
31278.0,2020-02-14,"(1021.75, 1220.0]",14,19,-5
31279.0,2020-02-14,"(-1.217, 304.25]",1,1,0
31279.0,2020-02-14,"(304.25, 608.5]",21,24,-3
31279.0,2020-02-14,"(608.5, 912.75]",8,15,-7
31279.0,2020-02-14,"(912.75, 1217.0]",7,27,-20
31280.0,2020-02-14,"(22.589, 376.75]",3,5,-2
31280.0,2020-02-14,"(376.75, 729.5]",9,27,-18
31280.0,2020-02-14,"(729.5, 1082.25]",8,12,-4
31280.0,2020-02-14,"(1082.25, 1435.0]",8,13,-5
31000.0,2020-02-15,"(589.338, 755.5]",1,1,0
31001.0,2020-02-15,"(538.175, 745.25]",1,1,0
31001.0,2020-02-15,"(1157.75, 1364.0]",1,1,0
31002.0,2020-02-15,"(796.5, 1062.0]",1,1,0
31003.0,2020-02-15,"(812.5, 823.0]",1,1,0
,,,,1.0,
,,,,1.0,
,,,,1.0,
31005.0,2020-02-15,"(593.773, 650.75]",1,1,0
31005.0,2020-02-15,"(650.75, 707.5]",1,2,-1
31006.0,2020-02-15,"(528.41, 676.5]",1,3,-2
31006.0,2020-02-15,"(676.5, 824.0]",1,2,-1
31006.0,2020-02-15,"(824.0, 971.5]",1,2,-1
31006.0,2020-02-15,"(971.5, 1119.0]",1,2,-1
31007.0,2020-02-15,"(418.25, 693.5]",1,1,0
31007.0,2020-02-15,"(693.5, 968.75]",1,1,0
31007.0,2020-02-15,"(968.75, 1244.0]",2,4,-2
,,,,2.0,
31010.0,2020-02-15,"(836.0, 922.5]",2,1,1
31010.0,2020-02-15,"(922.5, 1009.0]",1,3,-2
31011.0,2020-02-15,"(415.144, 630.0]",1,1,0
31011.0,2020-02-15,"(1058.0, 1272.0]",3,1,2
31012.0,2020-02-15,"(336.0, 448.0]",1,1,0
31013.0,2020-02-15,"(563.322, 733.5]",3,4,-1
31013.0,2020-02-15,"(733.5, 903.0]",2,4,-2
31013.0,2020-02-15,"(1072.5, 1242.0]",1,1,0
31014.0,2020-02-15,"(32.699, 359.25]",1,1,0
31014.0,2020-02-15,"(359.25, 684.5]",2,2,0
31014.0,2020-02-15,"(684.5, 1009.75]",4,7,-3
31014.0,2020-02-15,"(1009.75, 1335.0]",3,3,0
31015.0,2020-02-15,"(336.005, 585.75]",1,1,0
31015.0,2020-02-15,"(585.75, 834.5]",4,5,-1
31015.0,2020-02-15,"(834.5, 1083.25]",1,6,-5
31015.0,2020-02-15,"(1083.25, 1332.0]",2,2,0
31016.0,2020-02-15,"(878.25, 1026.5]",1,1,0
31016.0,2020-02-15,"(1026.5, 1174.75]",1,1,0
31017.0,2020-02-15,"(661.644, 751.0]",2,3,-1
31017.0,2020-02-15,"(840.0, 929.0]",1,3,-2
31017.0,2020-02-15,"(929.0, 1018.0]",2,2,0
31018.0,2020-02-15,"(911.25, 989.0]",1,1,0
31019.0,2020-02-15,"(836.51, 959.5]",2,2,0
31019.0,2020-02-15,"(1204.5, 1327.0]",1,1,0
,,,,1.0,
,,,,1.0,
31021.0,2020-02-15,"(813.589, 916.75]",2,2,0
31021.0,2020-02-15,"(916.75, 1019.5]",1,3,-2
31022.0,2020-02-15,"(685.453, 822.75]",2,3,-1
31022.0,2020-02-15,"(822.75, 959.5]",1,3,-2
31023.0,2020-02-15,"(441.246, 630.5]",1,1,0
31023.0,2020-02-15,"(630.5, 819.0]",3,7,-4
31023.0,2020-02-15,"(819.0, 1007.5]",1,3,-2
31023.0,2020-02-15,"(1007.5, 1196.0]",1,2,-1
31024.0,2020-02-15,"(610.459, 746.25]",3,7,-4
31024.0,2020-02-15,"(746.25, 881.5]",3,8,-5
31024.0,2020-02-15,"(881.5, 1016.75]",3,3,0
31024.0,2020-02-15,"(1016.75, 1152.0]",1,2,-1
31025.0,2020-02-15,"(646.629, 739.75]",2,3,-1
31026.0,2020-02-15,"(473.278, 654.5]",1,3,-2
31026.0,2020-02-15,"(654.5, 835.0]",2,4,-2
31026.0,2020-02-15,"(835.0, 1015.5]",2,3,-1
31026.0,2020-02-15,"(1015.5, 1196.0]",1,1,0
,,,,2.0,
,,,,1.0,
,,,,1.0,
,,,,2.0,
31029.0,2020-02-15,"(677.773, 734.75]",1,2,-1
31029.0,2020-02-15,"(734.75, 791.5]",2,4,-2
31029.0,2020-02-15,"(848.25, 905.0]",1,1,0
31030.0,2020-02-15,"(988.75, 1143.0]",1,1,0
31031.0,2020-02-15,"(1070.5, 1229.0]",1,1,0
31032.0,2020-02-15,"(901.5, 1202.0]",1,1,0
31033.0,2020-02-15,"(534.464, 669.0]",1,2,-1
31033.0,2020-02-15,"(669.0, 803.0]",1,2,-1
31033.0,2020-02-15,"(803.0, 937.0]",1,1,0
31033.0,2020-02-15,"(937.0, 1071.0]",1,2,-1
31034.0,2020-02-15,"(613.423, 758.25]",1,2,-1
31034.0,2020-02-15,"(758.25, 902.5]",1,2,-1
31034.0,2020-02-15,"(902.5, 1046.75]",1,2,-1
31035.0,2020-02-15,"(35.942, 301.5]",1,1,0
31035.0,2020-02-15,"(566.0, 830.5]",1,2,-1
31035.0,2020-02-15,"(830.5, 1095.0]",3,6,-3
,,,,1.0,
,,,,2.0,
,,,,3.0,
31037.0,2020-02-15,"(579.308, 753.0]",1,2,-1
31037.0,2020-02-15,"(753.0, 926.0]",2,2,0
31037.0,2020-02-15,"(926.0, 1099.0]",2,2,0
31037.0,2020-02-15,"(1099.0, 1272.0]",2,5,-3
31038.0,2020-02-15,"(605.0, 893.5]",1,1,0
31039.0,2020-02-15,"(458.653, 545.75]",1,3,-2
31039.0,2020-02-15,"(632.5, 719.25]",2,3,-1
31039.0,2020-02-15,"(719.25, 806.0]",1,1,0
31040.0,2020-02-15,"(610.627, 704.25]",1,1,0
31040.0,2020-02-15,"(704.25, 797.5]",1,1,0
31040.0,2020-02-15,"(890.75, 984.0]",2,4,-2
31041.0,2020-02-15,"(698.25, 931.0]",2,1,1
31042.0,2020-02-15,"(676.744, 741.0]",1,3,-2
31042.0,2020-02-15,"(869.0, 933.0]",2,3,-1
31043.0,2020-02-15,"(544.626, 638.5]",1,2,-1
31043.0,2020-02-15,"(638.5, 732.0]",1,1,0
31043.0,2020-02-15,"(825.5, 919.0]",1,1,0
31044.0,2020-02-15,"(1092.75, 1206.0]",1,1,0
31045.0,2020-02-15,"(1050.5, 1190.0]",1,1,0
31046.0,2020-02-15,"(808.5, 861.75]",1,1,0
31047.0,2020-02-15,"(711.541, 826.75]",1,3,-2
31047.0,2020-02-15,"(826.75, 941.5]",1,1,0
31048.0,2020-02-15,"(797.5, 955.0]",1,1,0
31049.0,2020-02-15,"(648.534, 765.5]",1,2,-1
31049.0,2020-02-15,"(998.5, 1115.0]",1,2,-1
,,,,2.0,
31051.0,2020-02-15,"(1032.25, 1152.0]",1,1,0
31052.0,2020-02-15,"(576.399, 727.25]",1,2,-1
31052.0,2020-02-15,"(1027.75, 1178.0]",3,4,-1
31053.0,2020-02-15,"(1284.0, 1376.0]",1,1,0
31054.0,2020-02-15,"(705.0, 940.0]",1,1,0
31055.0,2020-02-15,"(566.635, 658.25]",1,2,-1
31055.0,2020-02-15,"(840.75, 932.0]",1,1,0
,,,,2.0,
,,,,2.0,
,,,,2.0,
31059.0,2020-02-15,"(919.644, 1009.0]",1,2,-1
31059.0,2020-02-15,"(1187.0, 1276.0]",1,2,-1
31060.0,2020-02-15,"(412.072, 645.0]",1,1,0
31060.0,2020-02-15,"(645.0, 877.0]",2,2,0
31060.0,2020-02-15,"(877.0, 1109.0]",1,2,-1
31061.0,2020-02-15,"(639.71, 712.5]",1,1,0
31062.0,2020-02-15,"(518.535, 635.25]",5,7,-2
31062.0,2020-02-15,"(635.25, 751.5]",1,2,-1
31062.0,2020-02-15,"(751.5, 867.75]",2,4,-2
31062.0,2020-02-15,"(867.75, 984.0]",1,9,-8
,,,,2.0,
31064.0,2020-02-15,"(942.0, 1024.0]",3,1,2
,,,,2.0,
,,,,2.0,
,,,,2.0,
,,,,1.0,
,,,,1.0,
,,,,1.0,
31069.0,2020-02-15,"(881.0, 921.0]",1,1,0
31070.0,2020-02-15,"(674.25, 714.0]",1,1,0
31071.0,2020-02-15,"(604.25, 798.5]",3,3,0
31071.0,2020-02-15,"(798.5, 992.75]",1,5,-4
,,,,1.0,
,,,,1.0,
,,,,2.0,
31074.0,2020-02-15,"(652.25, 725.0]",1,1,0
,,,,2.0,
31076.0,2020-02-15,"(824.25, 1099.0]",2,1,1
31077.0,2020-02-15,"(481.219, 677.25]",3,5,-2
31077.0,2020-02-15,"(677.25, 872.5]",2,6,-4
31077.0,2020-02-15,"(872.5, 1067.75]",6,12,-6
,,,,2.0,
31079.0,2020-02-15,"(1011.5, 1135.0]",1,2,-1
31080.0,2020-02-15,"(619.284, 799.0]",3,7,-4
31080.0,2020-02-15,"(799.0, 978.0]",1,3,-2
31080.0,2020-02-15,"(1157.0, 1336.0]",1,1,0
,,,,1.0,
,,,,2.0,
,,,,2.0,
,,,,2.0,
31084.0,2020-02-15,"(636.363, 796.25]",1,1,0
31084.0,2020-02-15,"(955.5, 1114.75]",1,1,0
31084.0,2020-02-15,"(1114.75, 1274.0]",1,1,0
31085.0,2020-02-15,"(698.96, 709.0]",1,3,-2
31085.0,2020-02-15,"(729.0, 739.0]",1,1,0
31086.0,2020-02-15,"(479.499, 605.25]",1,1,0
31086.0,2020-02-15,"(605.25, 730.5]",2,2,0
31086.0,2020-02-15,"(855.75, 981.0]",1,2,-1
31087.0,2020-02-15,"(575.25, 767.0]",1,1,0
31088.0,2020-02-15,"(115.5, 154.0]",1,1,0
31089.0,2020-02-15,"(542.393, 694.75]",2,3,-1
31089.0,2020-02-15,"(694.75, 846.5]",1,4,-3
31089.0,2020-02-15,"(846.5, 998.25]",1,2,-1
31089.0,2020-02-15,"(998.25, 1150.0]",1,3,-2
31090.0,2020-02-15,"(969.0, 982.0]",1,1,0
31091.0,2020-02-15,"(9.85, 298.5]",1,1,0
31091.0,2020-02-15,"(298.5, 586.0]",1,2,-1
31091.0,2020-02-15,"(873.5, 1161.0]",1,1,0
,,,,1.0,
,,,,1.0,
31093.0,2020-02-15,"(1001.25, 1137.0]",2,1,1
31094.0,2020-02-15,"(677.437, 818.75]",1,2,-1
31094.0,2020-02-15,"(1100.25, 1241.0]",2,2,0
,,,,2.0,
31096.0,2020-02-15,"(627.25, 652.0]",1,1,0
31097.0,2020-02-15,"(1127.25, 1200.0]",1,1,0
31098.0,2020-02-15,"(765.908, 789.0]",1,1,0
31099.0,2020-02-15,"(830.86, 866.0]",1,2,-1
31099.0,2020-02-15,"(866.0, 901.0]",1,2,-1
31100.0,2020-02-15,"(464.543, 579.25]",1,1,0
31100.0,2020-02-15,"(693.5, 807.75]",1,1,0
31100.0,2020-02-15,"(807.75, 922.0]",1,2,-1
31101.0,2020-02-15,"(67.654, 405.5]",1,4,-3
31101.0,2020-02-15,"(405.5, 742.0]",17,30,-13
31101.0,2020-02-15,"(742.0, 1078.5]",37,56,-19
31101.0,2020-02-15,"(1078.5, 1415.0]",14,24,-10
31102.0,2020-02-15,"(24.698, 351.5]",1,1,0
31102.0,2020-02-15,"(351.5, 677.0]",1,7,-6
31102.0,2020-02-15,"(677.0, 1002.5]",5,18,-13
31102.0,2020-02-15,"(1002.5, 1328.0]",8,13,-5
31103.0,2020-02-15,"(479.053, 716.75]",5,15,-10
31103.0,2020-02-15,"(716.75, 953.5]",2,12,-10
31103.0,2020-02-15,"(953.5, 1190.25]",6,11,-5
31103.0,2020-02-15,"(1190.25, 1427.0]",1,5,-4
31104.0,2020-02-15,"(392.25, 720.5]",7,5,2
31104.0,2020-02-15,"(720.5, 1048.75]",18,14,4
31104.0,2020-02-15,"(1048.75, 1377.0]",7,32,-25
31105.0,2020-02-15,"(360.25, 648.5]",1,1,0
31105.0,2020-02-15,"(648.5, 936.75]",1,2,-1
31105.0,2020-02-15,"(936.75, 1225.0]",4,7,-3
31106.0,2020-02-15,"(869.5, 987.0]",1,1,0
31107.0,2020-02-15,"(341.963, 602.25]",2,9,-7
31107.0,2020-02-15,"(602.25, 861.5]",2,7,-5
31107.0,2020-02-15,"(861.5, 1120.75]",11,26,-15
31107.0,2020-02-15,"(1120.75, 1380.0]",2,4,-2
31108.0,2020-02-15,"(389.054, 626.5]",3,7,-4
31108.0,2020-02-15,"(626.5, 863.0]",9,19,-10
31108.0,2020-02-15,"(863.0, 1099.5]",10,12,-2
31108.0,2020-02-15,"(1099.5, 1336.0]",8,14,-6
31109.0,2020-02-15,"(52.623, 398.25]",1,5,-4
31109.0,2020-02-15,"(398.25, 742.5]",4,8,-4
31109.0,2020-02-15,"(742.5, 1086.75]",13,23,-10
31109.0,2020-02-15,"(1086.75, 1431.0]",3,8,-5
31110.0,2020-02-15,"(314.005, 563.75]",6,8,-2
31110.0,2020-02-15,"(563.75, 812.5]",8,12,-4
31110.0,2020-02-15,"(812.5, 1061.25]",9,19,-10
31110.0,2020-02-15,"(1061.25, 1310.0]",5,10,-5
31111.0,2020-02-15,"(431.5, 753.0]",5,1,4
31111.0,2020-02-15,"(753.0, 1074.5]",8,10,-2
31111.0,2020-02-15,"(1074.5, 1396.0]",5,12,-7
31112.0,2020-02-15,"(162.984, 418.0]",1,1,0
31112.0,2020-02-15,"(672.0, 926.0]",3,2,1
31113.0,2020-02-15,"(316.987, 571.25]",2,9,-7
31113.0,2020-02-15,"(571.25, 824.5]",7,15,-8
31113.0,2020-02-15,"(824.5, 1077.75]",4,10,-6
31113.0,2020-02-15,"(1077.75, 1331.0]",4,6,-2
31114.0,2020-02-15,"(65.632, 409.0]",2,5,-3
31114.0,2020-02-15,"(409.0, 751.0]",6,19,-13
31114.0,2020-02-15,"(751.0, 1093.0]",9,26,-17
31114.0,2020-02-15,"(1093.0, 1435.0]",11,22,-11
31115.0,2020-02-15,"(100.681, 431.75]",1,6,-5
31115.0,2020-02-15,"(431.75, 761.5]",2,12,-10
31115.0,2020-02-15,"(761.5, 1091.25]",7,14,-7
31115.0,2020-02-15,"(1091.25, 1421.0]",5,13,-8
31116.0,2020-02-15,"(1.643, 342.25]",1,1,0
31116.0,2020-02-15,"(342.25, 681.5]",6,14,-8
31116.0,2020-02-15,"(681.5, 1020.75]",9,12,-3
31116.0,2020-02-15,"(1020.75, 1360.0]",10,14,-4
31117.0,2020-02-15,"(58.838, 350.5]",1,2,-1
31117.0,2020-02-15,"(350.5, 641.0]",1,11,-10
31117.0,2020-02-15,"(641.0, 931.5]",4,15,-11
31117.0,2020-02-15,"(931.5, 1222.0]",4,12,-8
31118.0,2020-02-15,"(36.756, 349.0]",1,1,0
31118.0,2020-02-15,"(349.0, 660.0]",2,7,-5
31118.0,2020-02-15,"(660.0, 971.0]",3,6,-3
31118.0,2020-02-15,"(971.0, 1282.0]",9,10,-1
31119.0,2020-02-15,"(322.0, 600.0]",4,1,3
31119.0,2020-02-15,"(600.0, 878.0]",8,11,-3
31119.0,2020-02-15,"(878.0, 1156.0]",5,24,-19
31120.0,2020-02-15,"(488.124, 708.0]",3,10,-7
31120.0,2020-02-15,"(708.0, 927.0]",3,6,-3
31120.0,2020-02-15,"(927.0, 1146.0]",3,5,-2
31120.0,2020-02-15,"(1146.0, 1365.0]",3,6,-3
31121.0,2020-02-15,"(355.011, 603.25]",5,6,-1
31121.0,2020-02-15,"(603.25, 850.5]",3,8,-5
31121.0,2020-02-15,"(850.5, 1097.75]",8,17,-9
31121.0,2020-02-15,"(1097.75, 1345.0]",4,6,-2
31122.0,2020-02-15,"(19.839, 311.25]",2,3,-1
31122.0,2020-02-15,"(311.25, 601.5]",1,2,-1
31122.0,2020-02-15,"(601.5, 891.75]",3,6,-3
31122.0,2020-02-15,"(891.75, 1182.0]",2,5,-3
31123.0,2020-02-15,"(381.01, 629.5]",1,6,-5
31123.0,2020-02-15,"(629.5, 877.0]",3,9,-6
31123.0,2020-02-15,"(877.0, 1124.5]",3,4,-1
31123.0,2020-02-15,"(1124.5, 1372.0]",1,5,-4
31124.0,2020-02-15,"(61.66, 398.0]",1,3,-2
31124.0,2020-02-15,"(398.0, 733.0]",16,35,-19
31124.0,2020-02-15,"(733.0, 1068.0]",11,32,-21
31124.0,2020-02-15,"(1068.0, 1403.0]",5,18,-13
31125.0,2020-02-15,"(5.626, 350.5]",1,1,0
31125.0,2020-02-15,"(350.5, 694.0]",4,15,-11
31125.0,2020-02-15,"(694.0, 1037.5]",12,30,-18
31125.0,2020-02-15,"(1037.5, 1381.0]",8,18,-10
31126.0,2020-02-15,"(483.213, 680.75]",3,15,-12
31126.0,2020-02-15,"(680.75, 877.5]",1,8,-7
31126.0,2020-02-15,"(877.5, 1074.25]",2,4,-2
31126.0,2020-02-15,"(1074.25, 1271.0]",3,5,-2
31127.0,2020-02-15,"(770.605, 869.75]",2,4,-2
31127.0,2020-02-15,"(869.75, 968.5]",2,3,-1
31127.0,2020-02-15,"(968.5, 1067.25]",3,6,-3
31127.0,2020-02-15,"(1067.25, 1166.0]",1,3,-2
31128.0,2020-02-15,"(375.25, 720.5]",11,2,9
31128.0,2020-02-15,"(720.5, 1065.75]",12,16,-4
31128.0,2020-02-15,"(1065.75, 1411.0]",4,21,-17
31129.0,2020-02-15,"(635.481, 765.75]",6,8,-2
31129.0,2020-02-15,"(765.75, 895.5]",2,7,-5
31129.0,2020-02-15,"(895.5, 1025.25]",5,6,-1
31129.0,2020-02-15,"(1025.25, 1155.0]",2,3,-1
31130.0,2020-02-15,"(688.367, 847.25]",6,10,-4
31130.0,2020-02-15,"(847.25, 1005.5]",4,4,0
31130.0,2020-02-15,"(1005.5, 1163.75]",1,2,-1
31130.0,2020-02-15,"(1163.75, 1322.0]",1,2,-1
31131.0,2020-02-15,"(15.82, 312.0]",2,2,0
31131.0,2020-02-15,"(312.0, 607.0]",2,4,-2
31131.0,2020-02-15,"(607.0, 902.0]",3,10,-7
31131.0,2020-02-15,"(902.0, 1197.0]",5,11,-6
31200.0,2020-02-15,"(130.806, 430.5]",1,1,0
31200.0,2020-02-15,"(430.5, 729.0]",6,13,-7
31200.0,2020-02-15,"(729.0, 1027.5]",15,22,-7
31200.0,2020-02-15,"(1027.5, 1326.0]",10,21,-11
31201.0,2020-02-15,"(70.73, 389.5]",1,1,0
31201.0,2020-02-15,"(389.5, 707.0]",15,27,-12
31201.0,2020-02-15,"(707.0, 1024.5]",27,51,-24
31201.0,2020-02-15,"(1024.5, 1342.0]",17,37,-20
,,,,2.0,
31203.0,2020-02-15,"(379.5, 732.0]",9,3,6
31203.0,2020-02-15,"(732.0, 1084.5]",15,18,-3
31203.0,2020-02-15,"(1084.5, 1437.0]",12,27,-15
31204.0,2020-02-15,"(571.134, 788.5]",1,3,-2
31204.0,2020-02-15,"(788.5, 1005.0]",2,2,0
31204.0,2020-02-15,"(1005.0, 1221.5]",3,7,-4
31204.0,2020-02-15,"(1221.5, 1438.0]",3,4,-1
31205.0,2020-02-15,"(358.067, 592.25]",2,2,0
31205.0,2020-02-15,"(592.25, 825.5]",3,11,-8
31205.0,2020-02-15,"(825.5, 1058.75]",4,5,-1
31205.0,2020-02-15,"(1058.75, 1292.0]",3,6,-3
,,,,2.0,
31207.0,2020-02-15,"(179.976, 437.0]",1,2,-1
31207.0,2020-02-15,"(693.0, 949.0]",5,13,-8
31207.0,2020-02-15,"(949.0, 1205.0]",5,7,-2
31208.0,2020-02-15,"(793.0, 898.0]",4,2,2
31208.0,2020-02-15,"(898.0, 1003.0]",3,1,2
31209.0,2020-02-15,"(613.447, 752.25]",1,2,-1
31209.0,2020-02-15,"(752.25, 890.5]",5,6,-1
31209.0,2020-02-15,"(1028.75, 1167.0]",1,2,-1
31211.0,2020-02-15,"(774.407, 923.25]",1,2,-1
31211.0,2020-02-15,"(1071.5, 1219.75]",1,1,0
31211.0,2020-02-15,"(1219.75, 1368.0]",1,4,-3
31212.0,2020-02-15,"(464.201, 664.75]",2,5,-3
31212.0,2020-02-15,"(664.75, 864.5]",1,3,-2
31212.0,2020-02-15,"(864.5, 1064.25]",4,10,-6
31212.0,2020-02-15,"(1064.25, 1264.0]",8,11,-3
31213.0,2020-02-15,"(95.964, 356.0]",1,2,-1
31213.0,2020-02-15,"(615.0, 874.0]",3,1,2
31213.0,2020-02-15,"(874.0, 1133.0]",2,6,-4
31214.0,2020-02-15,"(350.0, 695.0]",5,3,2
31214.0,2020-02-15,"(695.0, 1040.0]",14,16,-2
31214.0,2020-02-15,"(1040.0, 1385.0]",21,29,-8
31215.0,2020-02-15,"(738.683, 818.25]",4,6,-2
31215.0,2020-02-15,"(818.25, 897.5]",3,4,-1
31215.0,2020-02-15,"(897.5, 976.75]",2,5,-3
31216.0,2020-02-15,"(615.451, 753.25]",1,1,0
31216.0,2020-02-15,"(753.25, 890.5]",2,3,-1
31217.0,2020-02-15,"(684.0, 831.0]",2,1,1
31217.0,2020-02-15,"(978.0, 1125.0]",2,4,-2
31218.0,2020-02-15,"(662.75, 792.5]",3,1,2
31218.0,2020-02-15,"(792.5, 922.25]",3,3,0
31218.0,2020-02-15,"(922.25, 1052.0]",2,3,-1
31219.0,2020-02-15,"(736.519, 857.25]",10,12,-2
31219.0,2020-02-15,"(857.25, 977.5]",2,6,-4
31219.0,2020-02-15,"(977.5, 1097.75]",4,7,-3
31219.0,2020-02-15,"(1097.75, 1218.0]",2,2,0
31220.0,2020-02-15,"(427.0, 640.5]",2,1,1
31220.0,2020-02-15,"(640.5, 854.0]",1,2,-1
31221.0,2020-02-15,"(356.009, 604.75]",5,5,0
31221.0,2020-02-15,"(604.75, 852.5]",2,5,-3
31221.0,2020-02-15,"(852.5, 1100.25]",10,16,-6
31221.0,2020-02-15,"(1100.25, 1348.0]",2,5,-3
31222.0,2020-02-15,"(23.956, 286.0]",1,2,-1
31222.0,2020-02-15,"(547.0, 808.0]",2,2,0
31222.0,2020-02-15,"(808.0, 1069.0]",7,3,4
31223.0,2020-02-15,"(31.669, 365.75]",2,6,-4
31223.0,2020-02-15,"(365.75, 698.5]",3,7,-4
31223.0,2020-02-15,"(698.5, 1031.25]",14,27,-13
31223.0,2020-02-15,"(1031.25, 1364.0]",10,15,-5
31224.0,2020-02-15,"(109.106, 333.5]",1,1,0
31224.0,2020-02-15,"(557.0, 780.5]",2,4,-2
31224.0,2020-02-15,"(780.5, 1004.0]",4,8,-4
31225.0,2020-02-15,"(558.125, 777.75]",3,9,-6
31225.0,2020-02-15,"(777.75, 996.5]",5,9,-4
31225.0,2020-02-15,"(996.5, 1215.25]",3,4,-1
31225.0,2020-02-15,"(1215.25, 1434.0]",2,3,-1
31226.0,2020-02-15,"(642.75, 792.5]",1,2,-1
31226.0,2020-02-15,"(792.5, 942.25]",1,2,-1
31226.0,2020-02-15,"(942.25, 1092.0]",3,2,1
31227.0,2020-02-15,"(763.422, 908.5]",4,4,0
31227.0,2020-02-15,"(1053.0, 1197.5]",2,4,-2
31227.0,2020-02-15,"(1197.5, 1342.0]",5,2,3
31228.0,2020-02-15,"(31.597, 383.75]",2,3,-1
31228.0,2020-02-15,"(383.75, 734.5]",10,14,-4
31228.0,2020-02-15,"(734.5, 1085.25]",16,29,-13
31228.0,2020-02-15,"(1085.25, 1436.0]",11,16,-5
31229.0,2020-02-15,"(46.628, 391.0]",3,4,-1
31229.0,2020-02-15,"(391.0, 734.0]",13,26,-13
31229.0,2020-02-15,"(734.0, 1077.0]",18,42,-24
31229.0,2020-02-15,"(1077.0, 1420.0]",8,19,-11
31230.0,2020-02-15,"(469.143, 684.25]",2,3,-1
31230.0,2020-02-15,"(684.25, 898.5]",6,13,-7
31230.0,2020-02-15,"(898.5, 1112.75]",8,12,-4
31230.0,2020-02-15,"(1112.75, 1327.0]",4,6,-2
31231.0,2020-02-15,"(831.481, 961.75]",7,11,-4
31231.0,2020-02-15,"(961.75, 1091.5]",1,2,-1
31232.0,2020-02-15,"(319.903, 595.25]",2,5,-3
31232.0,2020-02-15,"(595.25, 869.5]",9,14,-5
31232.0,2020-02-15,"(869.5, 1143.75]",19,27,-8
31232.0,2020-02-15,"(1143.75, 1418.0]",3,7,-4
31233.0,2020-02-15,"(460.233, 652.75]",5,5,0
31233.0,2020-02-15,"(652.75, 844.5]",2,3,-1
31233.0,2020-02-15,"(844.5, 1036.25]",3,4,-1
31233.0,2020-02-15,"(1036.25, 1228.0]",2,13,-11
31234.0,2020-02-15,"(156.72, 478.0]",3,3,0
31234.0,2020-02-15,"(478.0, 798.0]",16,25,-9
31234.0,2020-02-15,"(798.0, 1118.0]",11,20,-9
31234.0,2020-02-15,"(1118.0, 1438.0]",5,5,0
31235.0,2020-02-15,"(925.863, 960.25]",1,6,-5
31235.0,2020-02-15,"(960.25, 994.5]",4,4,0
31236.0,2020-02-15,"(583.189, 786.75]",4,9,-5
31236.0,2020-02-15,"(786.75, 989.5]",6,9,-3
31236.0,2020-02-15,"(1192.25, 1395.0]",1,4,-3
31237.0,2020-02-15,"(354.943, 620.25]",1,6,-5
31237.0,2020-02-15,"(620.25, 884.5]",9,15,-6
31237.0,2020-02-15,"(884.5, 1148.75]",3,10,-7
31237.0,2020-02-15,"(1148.75, 1413.0]",7,12,-5
31238.0,2020-02-15,"(53.0, 304.0]",1,1,0
31238.0,2020-02-15,"(554.0, 804.0]",1,1,0
31238.0,2020-02-15,"(804.0, 1054.0]",5,7,-2
31239.0,2020-02-15,"(531.359, 692.25]",5,6,-1
31239.0,2020-02-15,"(692.25, 852.5]",7,9,-2
31239.0,2020-02-15,"(852.5, 1012.75]",3,7,-4
31239.0,2020-02-15,"(1012.75, 1173.0]",1,5,-4
31240.0,2020-02-15,"(680.674, 762.5]",3,7,-4
31240.0,2020-02-15,"(844.0, 925.5]",2,3,-1
31240.0,2020-02-15,"(925.5, 1007.0]",6,11,-5
31241.0,2020-02-15,"(100.733, 418.75]",1,1,0
31241.0,2020-02-15,"(418.75, 735.5]",6,14,-8
31241.0,2020-02-15,"(735.5, 1052.25]",11,28,-17
31241.0,2020-02-15,"(1052.25, 1369.0]",8,14,-6
31242.0,2020-02-15,"(687.56, 798.0]",4,12,-8
31243.0,2020-02-15,"(553.208, 752.0]",3,6,-3
31243.0,2020-02-15,"(752.0, 950.0]",2,2,0
31243.0,2020-02-15,"(950.0, 1148.0]",1,2,-1
31243.0,2020-02-15,"(1148.0, 1346.0]",1,3,-2
31244.0,2020-02-15,"(71.869, 355.75]",1,2,-1
31244.0,2020-02-15,"(355.75, 638.5]",2,6,-4
31244.0,2020-02-15,"(638.5, 921.25]",2,5,-3
31244.0,2020-02-15,"(921.25, 1204.0]",6,11,-5
31245.0,2020-02-15,"(412.0, 637.0]",7,1,6
31245.0,2020-02-15,"(637.0, 862.0]",5,10,-5
31245.0,2020-02-15,"(862.0, 1087.0]",10,7,3
31246.0,2020-02-15,"(167.761, 478.75]",1,2,-1
31246.0,2020-02-15,"(478.75, 788.5]",15,21,-6
31246.0,2020-02-15,"(788.5, 1098.25]",14,28,-14
31246.0,2020-02-15,"(1098.25, 1408.0]",7,15,-8
31247.0,2020-02-15,"(540.349, 703.75]",2,4,-2
31247.0,2020-02-15,"(703.75, 866.5]",22,35,-13
31247.0,2020-02-15,"(866.5, 1029.25]",27,59,-32
31247.0,2020-02-15,"(1029.25, 1192.0]",5,19,-14
31248.0,2020-02-15,"(468.05, 706.5]",7,23,-16
31248.0,2020-02-15,"(706.5, 944.0]",26,38,-12
31248.0,2020-02-15,"(944.0, 1181.5]",11,21,-10
31248.0,2020-02-15,"(1181.5, 1419.0]",2,4,-2
31249.0,2020-02-15,"(589.5, 715.0]",3,6,-3
31249.0,2020-02-15,"(715.0, 840.0]",3,4,-1
31249.0,2020-02-15,"(840.0, 965.0]",3,6,-3
31249.0,2020-02-15,"(965.0, 1090.0]",3,5,-2
31250.0,2020-02-15,"(527.518, 648.5]",2,2,0
31250.0,2020-02-15,"(769.0, 889.5]",2,3,-1
31250.0,2020-02-15,"(889.5, 1010.0]",3,6,-3
31251.0,2020-02-15,"(578.506, 702.5]",3,4,-1
31251.0,2020-02-15,"(702.5, 826.0]",3,3,0
31251.0,2020-02-15,"(826.0, 949.5]",2,3,-1
31251.0,2020-02-15,"(949.5, 1073.0]",4,9,-5
31252.0,2020-02-15,"(596.328, 765.0]",3,3,0
31252.0,2020-02-15,"(765.0, 933.0]",1,5,-4
31252.0,2020-02-15,"(1101.0, 1269.0]",1,2,-1
31253.0,2020-02-15,"(502.369, 660.75]",1,3,-2
31253.0,2020-02-15,"(660.75, 818.5]",1,3,-2
31253.0,2020-02-15,"(818.5, 976.25]",1,1,0
31253.0,2020-02-15,"(976.25, 1134.0]",1,1,0
31254.0,2020-02-15,"(417.159, 628.25]",2,4,-2
31254.0,2020-02-15,"(628.25, 838.5]",3,4,-1
31254.0,2020-02-15,"(838.5, 1048.75]",1,1,0
31254.0,2020-02-15,"(1048.75, 1259.0]",3,4,-1
31255.0,2020-02-15,"(692.635, 784.25]",2,2,0
31255.0,2020-02-15,"(784.25, 875.5]",2,3,-1
31256.0,2020-02-15,"(562.143, 777.25]",6,7,-1
31256.0,2020-02-15,"(777.25, 991.5]",3,7,-4
31256.0,2020-02-15,"(991.5, 1205.75]",9,9,0
31256.0,2020-02-15,"(1205.75, 1420.0]",2,7,-5
31257.0,2020-02-15,"(1.631, 345.25]",1,2,-1
31257.0,2020-02-15,"(345.25, 687.5]",3,4,-1
31257.0,2020-02-15,"(687.5, 1029.75]",8,17,-9
31257.0,2020-02-15,"(1029.75, 1372.0]",2,11,-9
31258.0,2020-02-15,"(477.333, 644.75]",4,8,-4
31258.0,2020-02-15,"(644.75, 811.5]",10,17,-7
31258.0,2020-02-15,"(811.5, 978.25]",28,57,-29
31258.0,2020-02-15,"(978.25, 1145.0]",10,19,-9
,,,,2.0,
31260.0,2020-02-15,"(167.776, 475.0]",1,1,0
31260.0,2020-02-15,"(1087.0, 1393.0]",4,1,3
31261.0,2020-02-15,"(1033.25, 1125.0]",4,5,-1
31262.0,2020-02-15,"(777.512, 900.0]",1,1,0
31262.0,2020-02-15,"(900.0, 1022.0]",2,3,-1
31262.0,2020-02-15,"(1022.0, 1144.0]",3,4,-1
31262.0,2020-02-15,"(1144.0, 1266.0]",2,5,-3
31263.0,2020-02-15,"(289.75, 517.5]",1,1,0
31263.0,2020-02-15,"(517.5, 745.25]",4,1,3
31263.0,2020-02-15,"(745.25, 973.0]",7,7,0
31264.0,2020-02-15,"(308.928, 578.0]",1,2,-1
31264.0,2020-02-15,"(846.0, 1114.0]",10,1,9
31264.0,2020-02-15,"(1114.0, 1382.0]",3,13,-10
31265.0,2020-02-15,"(43.685, 373.75]",2,4,-2
31265.0,2020-02-15,"(373.75, 702.5]",3,6,-3
31265.0,2020-02-15,"(702.5, 1031.25]",6,13,-7
31265.0,2020-02-15,"(1031.25, 1360.0]",4,8,-4
31266.0,2020-02-15,"(39.706, 364.5]",1,1,0
31266.0,2020-02-15,"(364.5, 688.0]",1,11,-10
31266.0,2020-02-15,"(688.0, 1011.5]",8,18,-10
31266.0,2020-02-15,"(1011.5, 1335.0]",7,17,-10
31267.0,2020-02-15,"(20.643, 361.25]",1,2,-1
31267.0,2020-02-15,"(361.25, 700.5]",9,14,-5
31267.0,2020-02-15,"(700.5, 1039.75]",7,19,-12
31267.0,2020-02-15,"(1039.75, 1379.0]",7,15,-8
31268.0,2020-02-15,"(75.743, 391.25]",1,2,-1
31268.0,2020-02-15,"(391.25, 705.5]",9,13,-4
31268.0,2020-02-15,"(705.5, 1019.75]",13,18,-5
31268.0,2020-02-15,"(1019.75, 1334.0]",5,9,-4
31269.0,2020-02-15,"(557.278, 738.5]",5,10,-5
31269.0,2020-02-15,"(738.5, 919.0]",9,20,-11
31269.0,2020-02-15,"(919.0, 1099.5]",6,12,-6
31269.0,2020-02-15,"(1099.5, 1280.0]",1,3,-2
31270.0,2020-02-15,"(491.35, 654.5]",3,4,-1
31270.0,2020-02-15,"(817.0, 979.5]",2,1,1
31270.0,2020-02-15,"(979.5, 1142.0]",3,3,0
31271.0,2020-02-15,"(600.606, 699.5]",5,5,0
31271.0,2020-02-15,"(699.5, 798.0]",6,8,-2
31271.0,2020-02-15,"(798.0, 896.5]",5,13,-8
31271.0,2020-02-15,"(896.5, 995.0]",2,21,-19
31272.0,2020-02-15,"(690.473, 822.75]",8,16,-8
31272.0,2020-02-15,"(822.75, 954.5]",4,4,0
31272.0,2020-02-15,"(954.5, 1086.25]",1,4,-3
31272.0,2020-02-15,"(1086.25, 1218.0]",4,9,-5
31273.0,2020-02-15,"(736.727, 805.25]",1,1,0
31273.0,2020-02-15,"(805.25, 873.5]",1,7,-6
31273.0,2020-02-15,"(941.75, 1010.0]",4,1,3
31274.0,2020-02-15,"(533.377, 689.75]",2,3,-1
31274.0,2020-02-15,"(689.75, 845.5]",3,3,0
31274.0,2020-02-15,"(1001.25, 1157.0]",6,1,5
31275.0,2020-02-15,"(331.991, 585.25]",2,4,-2
31275.0,2020-02-15,"(585.25, 837.5]",2,7,-5
31275.0,2020-02-15,"(837.5, 1089.75]",5,10,-5
31275.0,2020-02-15,"(1089.75, 1342.0]",5,7,-2
31276.0,2020-02-15,"(20.958, 282.5]",1,2,-1
31276.0,2020-02-15,"(282.5, 543.0]",3,4,-1
31276.0,2020-02-15,"(543.0, 803.5]",5,13,-8
31277.0,2020-02-15,"(552.328, 721.0]",2,3,-1
31277.0,2020-02-15,"(721.0, 889.0]",8,11,-3
31277.0,2020-02-15,"(889.0, 1057.0]",7,14,-7
31277.0,2020-02-15,"(1057.0, 1225.0]",4,6,-2
31278.0,2020-02-15,"(588.27, 771.5]",3,13,-10
31278.0,2020-02-15,"(771.5, 954.0]",8,12,-4
31278.0,2020-02-15,"(954.0, 1136.5]",3,7,-4
31278.0,2020-02-15,"(1136.5, 1319.0]",2,4,-2
31279.0,2020-02-15,"(465.282, 645.5]",2,4,-2
31279.0,2020-02-15,"(645.5, 825.0]",1,1,0
31279.0,2020-02-15,"(825.0, 1004.5]",1,1,0
31280.0,2020-02-15,"(44.609, 393.75]",1,1,0
31280.0,2020-02-15,"(393.75, 741.5]",10,15,-5
31280.0,2020-02-15,"(741.5, 1089.25]",8,15,-7
31280.0,2020-02-15,"(1089.25, 1437.0]",2,7,-5
31000.0,2020-02-16,"(928.761, 988.75]",1,2,-1
31000.0,2020-02-16,"(1108.25, 1168.0]",1,4,-3
31001.0,2020-02-16,"(536.171, 744.25]",1,3,-2
31001.0,2020-02-16,"(1158.75, 1366.0]",2,2,0
31002.0,2020-02-16,"(992.75, 1055.0]",3,1,2
31003.0,2020-02-16,"(456.457, 592.75]",1,3,-2
31003.0,2020-02-16,"(592.75, 728.5]",2,3,-1
31003.0,2020-02-16,"(728.5, 864.25]",1,2,-1
31003.0,2020-02-16,"(864.25, 1000.0]",2,4,-2
31004.0,2020-02-16,"(852.75, 939.0]",1,1,0
31005.0,2020-02-16,"(611.458, 747.5]",1,2,-1
31005.0,2020-02-16,"(747.5, 883.0]",2,5,-3
31005.0,2020-02-16,"(883.0, 1018.5]",6,9,-3
31005.0,2020-02-16,"(1018.5, 1154.0]",1,4,-3
31006.0,2020-02-16,"(529.169, 737.75]",1,4,-3
31006.0,2020-02-16,"(737.75, 945.5]",3,8,-5
31006.0,2020-02-16,"(945.5, 1153.25]",1,1,0
31007.0,2020-02-16,"(692.5, 1019.25]",5,1,4
31007.0,2020-02-16,"(1019.25, 1346.0]",4,1,3
31009.0,2020-02-16,"(833.458, 969.5]",1,2,-1
31009.0,2020-02-16,"(1105.0, 1240.5]",1,1,0
31009.0,2020-02-16,"(1240.5, 1376.0]",2,4,-2
31010.0,2020-02-16,"(829.771, 887.25]",2,3,-1
31010.0,2020-02-16,"(944.5, 1001.75]",4,6,-2
31010.0,2020-02-16,"(1001.75, 1059.0]",2,4,-2
31011.0,2020-02-16,"(975.5, 1148.0]",3,1,2
,,,,1.0,
,,,,1.0,
31013.0,2020-02-16,"(705.57, 813.5]",2,3,-1
31013.0,2020-02-16,"(921.0, 1028.5]",2,3,-1
31013.0,2020-02-16,"(1028.5, 1136.0]",2,2,0
31014.0,2020-02-16,"(521.219, 717.25]",4,4,0
31014.0,2020-02-16,"(717.25, 912.5]",3,5,-2
31014.0,2020-02-16,"(912.5, 1107.75]",6,12,-6
31014.0,2020-02-16,"(1107.75, 1303.0]",2,5,-3
31015.0,2020-02-16,"(151.993, 404.75]",2,2,0
31015.0,2020-02-16,"(404.75, 656.5]",1,4,-3
31015.0,2020-02-16,"(656.5, 908.25]",5,8,-3
31015.0,2020-02-16,"(908.25, 1160.0]",3,4,-1
31016.0,2020-02-16,"(741.5, 1033.25]",1,1,0
31016.0,2020-02-16,"(1033.25, 1325.0]",1,2,-1
31017.0,2020-02-16,"(880.794, 932.5]",1,1,0
31018.0,2020-02-16,"(657.5, 718.25]",1,2,-1
31019.0,2020-02-16,"(28.856, 316.0]",1,3,-2
31019.0,2020-02-16,"(602.0, 888.0]",2,3,-1
31019.0,2020-02-16,"(888.0, 1174.0]",2,6,-4
31020.0,2020-02-16,"(860.912, 883.0]",2,2,0
31021.0,2020-02-16,"(766.504, 891.0]",1,1,0
31021.0,2020-02-16,"(891.0, 1015.0]",2,5,-3
31021.0,2020-02-16,"(1015.0, 1139.0]",1,1,0
31021.0,2020-02-16,"(1139.0, 1263.0]",7,13,-6
31022.0,2020-02-16,"(13.702, 339.5]",1,1,0
31022.0,2020-02-16,"(339.5, 664.0]",1,2,-1
31022.0,2020-02-16,"(664.0, 988.5]",4,7,-3
31022.0,2020-02-16,"(988.5, 1313.0]",1,5,-4
31023.0,2020-02-16,"(349.0, 611.0]",2,1,1
31023.0,2020-02-16,"(611.0, 873.0]",1,2,-1
31023.0,2020-02-16,"(873.0, 1135.0]",2,3,-1
31024.0,2020-02-16,"(607.363, 767.25]",2,3,-1
31024.0,2020-02-16,"(1085.75, 1245.0]",3,3,0
31025.0,2020-02-16,"(826.585, 930.75]",1,2,-1
31025.0,2020-02-16,"(930.75, 1034.5]",2,2,0
31026.0,2020-02-16,"(885.0, 1043.0]",1,2,-1
31026.0,2020-02-16,"(1043.0, 1201.0]",1,1,0
31027.0,2020-02-16,"(1045.0, 1061.0]",1,1,0
31027.0,2020-02-16,"(1061.0, 1077.0]",1,1,0
31028.0,2020-02-16,"(1152.75, 1355.0]",1,1,0
31029.0,2020-02-16,"(572.199, 773.25]",2,6,-4
31029.0,2020-02-16,"(773.25, 973.5]",1,4,-3
31029.0,2020-02-16,"(973.5, 1173.75]",2,4,-2
31029.0,2020-02-16,"(1173.75, 1374.0]",2,3,-1
,,,,2.0,
,,,,1.0,
,,,,1.0,
,,,,2.0,
31032.0,2020-02-16,"(985.5, 1063.0]",1,2,-1
31033.0,2020-02-16,"(978.821, 1023.75]",1,2,-1
31033.0,2020-02-16,"(1113.25, 1158.0]",1,1,0
31034.0,2020-02-16,"(93.102, 318.5]",1,1,0
31034.0,2020-02-16,"(767.5, 992.0]",4,1,3
31035.0,2020-02-16,"(425.203, 625.25]",1,1,0
31035.0,2020-02-16,"(824.5, 1023.75]",2,4,-2
31035.0,2020-02-16,"(1023.75, 1223.0]",2,4,-2
31036.0,2020-02-16,"(704.311, 877.25]",1,2,-1
31036.0,2020-02-16,"(877.25, 1049.5]",3,5,-2
31036.0,2020-02-16,"(1049.5, 1221.75]",1,1,0
31036.0,2020-02-16,"(1221.75, 1394.0]",1,1,0
31037.0,2020-02-16,"(37.65, 376.5]",2,3,-1
31037.0,2020-02-16,"(376.5, 714.0]",1,2,-1
31037.0,2020-02-16,"(714.0, 1051.5]",1,7,-6
31037.0,2020-02-16,"(1051.5, 1389.0]",1,3,-2
31038.0,2020-02-16,"(792.0, 841.0]",1,1,0
31039.0,2020-02-16,"(578.37, 736.5]",1,4,-3
31039.0,2020-02-16,"(736.5, 894.0]",1,2,-1
31039.0,2020-02-16,"(894.0, 1051.5]",2,3,-1
31040.0,2020-02-16,"(653.5, 841.0]",1,1,0
31041.0,2020-02-16,"(531.56, 642.0]",1,1,0
31041.0,2020-02-16,"(752.0, 862.0]",2,1,1
31041.0,2020-02-16,"(862.0, 972.0]",1,2,-1
31042.0,2020-02-16,"(664.413, 811.75]",4,6,-2
31042.0,2020-02-16,"(811.75, 958.5]",2,4,-2
31042.0,2020-02-16,"(1105.25, 1252.0]",2,2,0
31043.0,2020-02-16,"(1083.0, 1139.0]",2,2,0
31044.0,2020-02-16,"(843.633, 935.75]",2,2,0
31044.0,2020-02-16,"(935.75, 1027.5]",1,1,0
31045.0,2020-02-16,"(725.694, 802.5]",1,4,-3
31045.0,2020-02-16,"(879.0, 955.5]",3,3,0
31046.0,2020-02-16,"(813.75, 1085.0]",3,1,2
31047.0,2020-02-16,"(483.168, 692.0]",1,1,0
31047.0,2020-02-16,"(692.0, 900.0]",1,3,-2
31047.0,2020-02-16,"(900.0, 1108.0]",3,4,-1
31047.0,2020-02-16,"(1108.0, 1316.0]",2,5,-3
31048.0,2020-02-16,"(945.25, 982.0]",1,1,0
31049.0,2020-02-16,"(575.524, 695.0]",1,2,-1
31049.0,2020-02-16,"(695.0, 814.0]",1,1,0
31050.0,2020-02-16,"(1150.0, 1250.0]",1,1,0
31051.0,2020-02-16,"(683.25, 777.0]",2,1,1
31052.0,2020-02-16,"(923.795, 975.25]",1,2,-1
31052.0,2020-02-16,"(975.25, 1026.5]",1,1,0
31053.0,2020-02-16,"(578.57, 686.5]",1,2,-1
31054.0,2020-02-16,"(751.5, 1002.0]",1,1,0
31055.0,2020-02-16,"(770.592, 873.0]",2,5,-3
31055.0,2020-02-16,"(975.0, 1077.0]",1,1,0
31055.0,2020-02-16,"(1077.0, 1179.0]",1,1,0
31056.0,2020-02-16,"(599.418, 745.5]",1,1,0
31056.0,2020-02-16,"(1036.5, 1182.0]",1,1,0
31057.0,2020-02-16,"(562.559, 673.25]",1,2,-1
31057.0,2020-02-16,"(893.75, 1004.0]",1,1,0
,,,,2.0,
31059.0,2020-02-16,"(779.632, 872.0]",3,6,-3
31059.0,2020-02-16,"(964.0, 1056.0]",1,1,0
31060.0,2020-02-16,"(722.287, 901.25]",2,2,0
31061.0,2020-02-16,"(443.25, 591.0]",1,1,0
31062.0,2020-02-16,"(888.85, 926.5]",1,1,0
31062.0,2020-02-16,"(926.5, 964.0]",1,2,-1
31062.0,2020-02-16,"(1001.5, 1039.0]",2,4,-2
31063.0,2020-02-16,"(839.25, 1119.0]",1,1,0
31064.0,2020-02-16,"(482.438, 623.5]",2,6,-4
31064.0,2020-02-16,"(623.5, 764.0]",1,4,-3
31064.0,2020-02-16,"(764.0, 904.5]",10,20,-10
31064.0,2020-02-16,"(904.5, 1045.0]",4,9,-5
,,,,2.0,
31066.0,2020-02-16,"(974.5, 1047.0]",2,1,1
,,,,1.0,
,,,,1.0,
,,,,2.0,
31068.0,2020-02-16,"(616.239, 807.25]",2,4,-2
31068.0,2020-02-16,"(1187.75, 1378.0]",1,1,0
31069.0,2020-02-16,"(810.0, 1080.0]",1,1,0
31070.0,2020-02-16,"(617.524, 737.0]",1,2,-1
31070.0,2020-02-16,"(975.0, 1094.0]",1,1,0
31071.0,2020-02-16,"(541.209, 739.75]",4,5,-1
31071.0,2020-02-16,"(739.75, 937.5]",5,8,-3
31071.0,2020-02-16,"(937.5, 1135.25]",1,7,-6
31071.0,2020-02-16,"(1135.25, 1333.0]",2,3,-1
,,,,1.0,
,,,,1.0,
31073.0,2020-02-16,"(719.0, 768.0]",1,1,0
31074.0,2020-02-16,"(595.372, 753.0]",1,2,-1
31074.0,2020-02-16,"(1067.0, 1224.0]",3,3,0
,,,,2.0,
31076.0,2020-02-16,"(798.809, 846.75]",1,1,0
31076.0,2020-02-16,"(942.25, 990.0]",2,3,-1
31077.0,2020-02-16,"(143.983, 399.25]",1,2,-1
31077.0,2020-02-16,"(399.25, 653.5]",1,4,-3
31077.0,2020-02-16,"(653.5, 907.75]",11,18,-7
31077.0,2020-02-16,"(907.75, 1162.0]",11,13,-2
31078.0,2020-02-16,"(593.49, 721.5]",1,1,0
31079.0,2020-02-16,"(1083.25, 1240.0]",3,2,1
31080.0,2020-02-16,"(653.301, 828.75]",1,7,-6
31080.0,2020-02-16,"(828.75, 1003.5]",2,5,-3
31080.0,2020-02-16,"(1178.25, 1353.0]",1,2,-1
31081.0,2020-02-16,"(918.0, 1017.0]",2,1,1
,,,,2.0,
31083.0,2020-02-16,"(1065.5, 1106.0]",1,1,0
31084.0,2020-02-16,"(744.559, 855.25]",1,2,-1
31084.0,2020-02-16,"(965.5, 1075.75]",1,2,-1
31085.0,2020-02-16,"(891.25, 939.0]",1,1,0
31086.0,2020-02-16,"(823.841, 863.75]",1,1,0
31087.0,2020-02-16,"(1039.75, 1100.5]",1,1,0
31087.0,2020-02-16,"(1161.25, 1222.0]",1,2,-1
31088.0,2020-02-16,"(801.25, 885.0]",1,1,0
31089.0,2020-02-16,"(677.309, 850.75]",4,5,-1
31089.0,2020-02-16,"(1196.25, 1369.0]",1,3,-2
31090.0,2020-02-16,"(610.648, 699.0]",1,1,0
31090.0,2020-02-16,"(699.0, 787.0]",4,4,0
31091.0,2020-02-16,"(1067.791, 1120.25]",1,2,-1
31092.0,2020-02-16,"(663.683, 743.25]",1,1,0
31092.0,2020-02-16,"(901.75, 981.0]",1,1,0
31093.0,2020-02-16,"(939.0, 1035.0]",1,2,-1
,,,,2.0,
,,,,2.0,
31096.0,2020-02-16,"(472.5, 708.75]",1,1,0
31096.0,2020-02-16,"(708.75, 945.0]",1,1,0
31097.0,2020-02-16,"(631.948, 645.0]",1,1,0
31098.0,2020-02-16,"(883.0, 908.0]",1,1,0
31099.0,2020-02-16,"(909.0, 1038.0]",1,1,0
31100.0,2020-02-16,"(612.0, 878.0]",6,1,5
31100.0,2020-02-16,"(878.0, 1144.0]",2,8,-6
31101.0,2020-02-16,"(18.593, 371.75]",2,6,-4
31101.0,2020-02-16,"(371.75, 723.5]",15,17,-2
31101.0,2020-02-16,"(723.5, 1075.25]",35,65,-30
31101.0,2020-02-16,"(1075.25, 1427.0]",17,31,-14
31102.0,2020-02-16,"(110.687, 440.25]",1,3,-2
31102.0,2020-02-16,"(440.25, 768.5]",2,5,-3
31102.0,2020-02-16,"(768.5, 1096.75]",5,10,-5
31102.0,2020-02-16,"(1096.75, 1425.0]",6,11,-5
31103.0,2020-02-16,"(171.862, 457.5]",1,5,-4
31103.0,2020-02-16,"(457.5, 742.0]",5,17,-12
31103.0,2020-02-16,"(742.0, 1026.5]",3,26,-23
31103.0,2020-02-16,"(1026.5, 1311.0]",4,11,-7
31104.0,2020-02-16,"(352.75, 691.5]",2,12,-10
31104.0,2020-02-16,"(691.5, 1030.25]",18,8,10
31104.0,2020-02-16,"(1030.25, 1369.0]",14,40,-26
31105.0,2020-02-16,"(677.243, 867.25]",4,7,-3
31105.0,2020-02-16,"(1056.5, 1245.75]",1,1,0
31105.0,2020-02-16,"(1245.75, 1435.0]",2,5,-3
31106.0,2020-02-16,"(367.5, 586.0]",1,1,0
31106.0,2020-02-16,"(586.0, 804.5]",1,1,0
31107.0,2020-02-16,"(274.851, 563.25]",1,1,0
31107.0,2020-02-16,"(563.25, 850.5]",4,16,-12
31107.0,2020-02-16,"(850.5, 1137.75]",9,19,-10
31107.0,2020-02-16,"(1137.75, 1425.0]",3,11,-8
31108.0,2020-02-16,"(495.118, 716.5]",2,8,-6
31108.0,2020-02-16,"(716.5, 937.0]",15,21,-6
31108.0,2020-02-16,"(937.0, 1157.5]",6,10,-4
31108.0,2020-02-16,"(1157.5, 1378.0]",4,10,-6
31109.0,2020-02-16,"(6.603, 357.25]",4,8,-4
31109.0,2020-02-16,"(357.25, 706.5]",6,10,-4
31109.0,2020-02-16,"(706.5, 1055.75]",10,22,-12
31109.0,2020-02-16,"(1055.75, 1405.0]",7,16,-9
31110.0,2020-02-16,"(498.069, 731.75]",8,19,-11
31110.0,2020-02-16,"(731.75, 964.5]",6,12,-6
31110.0,2020-02-16,"(964.5, 1197.25]",3,15,-12
31110.0,2020-02-16,"(1197.25, 1430.0]",4,4,0
31111.0,2020-02-16,"(357.0, 713.0]",4,3,1
31111.0,2020-02-16,"(713.0, 1069.0]",10,14,-4
31111.0,2020-02-16,"(1069.0, 1425.0]",11,21,-10
31112.0,2020-02-16,"(781.0, 874.0]",3,1,2
31112.0,2020-02-16,"(874.0, 967.0]",2,4,-2
31112.0,2020-02-16,"(967.0, 1060.0]",2,4,-2
31113.0,2020-02-16,"(40.72, 362.0]",1,4,-3
31113.0,2020-02-16,"(362.0, 682.0]",2,10,-8
31113.0,2020-02-16,"(682.0, 1002.0]",8,23,-15
31113.0,2020-02-16,"(1002.0, 1322.0]",3,13,-10
31114.0,2020-02-16,"(10.582, 366.5]",4,5,-1
31114.0,2020-02-16,"(721.0, 1075.5]",11,7,4
31114.0,2020-02-16,"(1075.5, 1430.0]",9,35,-26
31115.0,2020-02-16,"(468.05, 706.5]",2,10,-8
31115.0,2020-02-16,"(706.5, 944.0]",3,9,-6
31115.0,2020-02-16,"(944.0, 1181.5]",5,12,-7
31115.0,2020-02-16,"(1181.5, 1419.0]",5,8,-3
31116.0,2020-02-16,"(69.747, 384.25]",1,2,-1
31116.0,2020-02-16,"(384.25, 697.5]",8,15,-7
31116.0,2020-02-16,"(697.5, 1010.75]",12,29,-17
31116.0,2020-02-16,"(1010.75, 1324.0]",10,19,-9
31117.0,2020-02-16,"(463.071, 696.25]",1,6,-5
31117.0,2020-02-16,"(696.25, 928.5]",5,17,-12
31117.0,2020-02-16,"(928.5, 1160.75]",10,18,-8
31117.0,2020-02-16,"(1160.75, 1393.0]",3,5,-2
31118.0,2020-02-16,"(49.784, 355.0]",3,3,0
31118.0,2020-02-16,"(355.0, 659.0]",2,4,-2
31118.0,2020-02-16,"(659.0, 963.0]",3,8,-5
31118.0,2020-02-16,"(963.0, 1267.0]",3,7,-4
31119.0,2020-02-16,"(331.904, 607.0]",3,8,-5
31119.0,2020-02-16,"(607.0, 881.0]",7,21,-14
31119.0,2020-02-16,"(881.0, 1155.0]",3,17,-14
31119.0,2020-02-16,"(1155.0, 1429.0]",10,15,-5
31120.0,2020-02-16,"(254.898, 531.5]",1,1,0
31120.0,2020-02-16,"(531.5, 807.0]",1,5,-4
31120.0,2020-02-16,"(807.0, 1082.5]",10,20,-10
31120.0,2020-02-16,"(1082.5, 1358.0]",5,7,-2
31121.0,2020-02-16,"(169.731, 488.25]",1,1,0
31121.0,2020-02-16,"(488.25, 805.5]",7,10,-3
31121.0,2020-02-16,"(805.5, 1122.75]",3,6,-3
31121.0,2020-02-16,"(1122.75, 1440.0]",6,13,-7
31122.0,2020-02-16,"(46.627, 391.25]",1,2,-1
31122.0,2020-02-16,"(391.25, 734.5]",2,5,-3
31122.0,2020-02-16,"(734.5, 1077.75]",3,10,-7
31122.0,2020-02-16,"(1077.75, 1421.0]",5,8,-3
31123.0,2020-02-16,"(118.747, 433.25]",1,1,0
31123.0,2020-02-16,"(433.25, 746.5]",1,6,-5
31123.0,2020-02-16,"(746.5, 1059.75]",7,20,-13
31123.0,2020-02-16,"(1059.75, 1373.0]",5,9,-4
31124.0,2020-02-16,"(378.25, 721.5]",5,3,2
31124.0,2020-02-16,"(721.5, 1064.75]",15,17,-2
31124.0,2020-02-16,"(1064.75, 1408.0]",10,42,-32
31125.0,2020-02-16,"(64.628, 409.0]",1,2,-1
31125.0,2020-02-16,"(409.0, 752.0]",8,17,-9
31125.0,2020-02-16,"(752.0, 1095.0]",14,36,-22
31125.0,2020-02-16,"(1095.0, 1438.0]",10,14,-4
31126.0,2020-02-16,"(524.361, 684.75]",1,13,-12
31126.0,2020-02-16,"(684.75, 844.5]",2,11,-9
31126.0,2020-02-16,"(844.5, 1004.25]",6,9,-3
31126.0,2020-02-16,"(1004.25, 1164.0]",3,13,-10
31127.0,2020-02-16,"(628.424, 773.0]",3,3,0
31127.0,2020-02-16,"(773.0, 917.0]",1,2,-1
31127.0,2020-02-16,"(917.0, 1061.0]",7,15,-8
31127.0,2020-02-16,"(1061.0, 1205.0]",4,9,-5
31128.0,2020-02-16,"(25.752, 339.0]",2,2,0
31128.0,2020-02-16,"(339.0, 651.0]",8,19,-11
31128.0,2020-02-16,"(651.0, 963.0]",18,29,-11
31128.0,2020-02-16,"(963.0, 1275.0]",8,17,-9
31129.0,2020-02-16,"(419.982, 675.5]",2,5,-3
31129.0,2020-02-16,"(675.5, 930.0]",11,18,-7
31129.0,2020-02-16,"(930.0, 1184.5]",22,34,-12
31129.0,2020-02-16,"(1184.5, 1439.0]",2,2,0
31130.0,2020-02-16,"(456.75, 719.5]",4,5,-1
31130.0,2020-02-16,"(719.5, 982.25]",2,5,-3
31130.0,2020-02-16,"(982.25, 1245.0]",12,12,0
31131.0,2020-02-16,"(56.837, 348.75]",1,1,0
31131.0,2020-02-16,"(639.5, 930.25]",6,3,3
31131.0,2020-02-16,"(930.25, 1221.0]",7,22,-15
31200.0,2020-02-16,"(3.684, 334.0]",1,2,-1
31200.0,2020-02-16,"(334.0, 663.0]",10,18,-8
31200.0,2020-02-16,"(663.0, 992.0]",25,51,-26
31200.0,2020-02-16,"(992.0, 1321.0]",7,16,-9
31201.0,2020-02-16,"(44.613, 392.75]",3,4,-1
31201.0,2020-02-16,"(392.75, 739.5]",16,27,-11
31201.0,2020-02-16,"(739.5, 1086.25]",26,51,-25
31201.0,2020-02-16,"(1086.25, 1433.0]",7,18,-11
,,,,2.0,
31203.0,2020-02-16,"(4.574, 362.5]",1,9,-8
31203.0,2020-02-16,"(362.5, 719.0]",24,28,-4
31203.0,2020-02-16,"(719.0, 1075.5]",39,62,-23
31203.0,2020-02-16,"(1075.5, 1432.0]",21,33,-12
31204.0,2020-02-16,"(34.655, 372.25]",2,2,0
31204.0,2020-02-16,"(372.25, 708.5]",2,6,-4
31204.0,2020-02-16,"(708.5, 1044.75]",6,11,-5
31204.0,2020-02-16,"(1044.75, 1381.0]",10,23,-13
31205.0,2020-02-16,"(522.189, 725.75]",4,5,-1
31205.0,2020-02-16,"(725.75, 928.5]",4,5,-1
31205.0,2020-02-16,"(928.5, 1131.25]",2,8,-6
31205.0,2020-02-16,"(1131.25, 1334.0]",3,6,-3
31206.0,2020-02-16,"(798.5, 862.0]",2,2,0
31207.0,2020-02-16,"(545.123, 765.25]",1,5,-4
31207.0,2020-02-16,"(984.5, 1203.75]",1,2,-1
31207.0,2020-02-16,"(1203.75, 1423.0]",1,1,0
31208.0,2020-02-16,"(631.298, 807.5]",1,1,0
31208.0,2020-02-16,"(807.5, 983.0]",6,14,-8
31208.0,2020-02-16,"(983.0, 1158.5]",1,2,-1
31209.0,2020-02-16,"(585.206, 784.5]",4,5,-1
31209.0,2020-02-16,"(784.5, 983.0]",3,3,0
31209.0,2020-02-16,"(983.0, 1181.5]",2,5,-3
31209.0,2020-02-16,"(1181.5, 1380.0]",1,2,-1
31211.0,2020-02-16,"(674.647, 763.25]",4,12,-8
31211.0,2020-02-16,"(851.5, 939.75]",1,1,0
31211.0,2020-02-16,"(939.75, 1028.0]",3,5,-2
31212.0,2020-02-16,"(22.661, 358.75]",1,4,-3
31212.0,2020-02-16,"(358.75, 693.5]",2,7,-5
31212.0,2020-02-16,"(693.5, 1028.25]",5,10,-5
31212.0,2020-02-16,"(1028.25, 1363.0]",7,15,-8
31213.0,2020-02-16,"(5.812, 304.0]",1,2,-1
31213.0,2020-02-16,"(304.0, 601.0]",2,3,-1
31213.0,2020-02-16,"(601.0, 898.0]",9,12,-3
31213.0,2020-02-16,"(898.0, 1195.0]",7,18,-11
31214.0,2020-02-16,"(12.579, 369.25]",1,1,0
31214.0,2020-02-16,"(369.25, 724.5]",7,14,-7
31214.0,2020-02-16,"(724.5, 1079.75]",16,37,-21
31214.0,2020-02-16,"(1079.75, 1435.0]",9,13,-4
31215.0,2020-02-16,"(628.497, 754.75]",1,4,-3
31215.0,2020-02-16,"(754.75, 880.5]",6,8,-2
31215.0,2020-02-16,"(880.5, 1006.25]",6,7,-1
31215.0,2020-02-16,"(1006.25, 1132.0]",7,9,-2
31216.0,2020-02-16,"(658.438, 799.5]",1,7,-6
31216.0,2020-02-16,"(940.0, 1080.5]",1,1,0
31216.0,2020-02-16,"(1080.5, 1221.0]",2,1,1
31217.0,2020-02-16,"(747.75, 850.5]",3,1,2
31217.0,2020-02-16,"(953.25, 1056.0]",5,4,1
31218.0,2020-02-16,"(413.26, 599.0]",1,4,-3
31218.0,2020-02-16,"(599.0, 784.0]",2,6,-4
31218.0,2020-02-16,"(784.0, 969.0]",9,9,0
31218.0,2020-02-16,"(969.0, 1154.0]",5,13,-8
31219.0,2020-02-16,"(606.436, 748.0]",6,9,-3
31219.0,2020-02-16,"(748.0, 889.0]",10,22,-12
31219.0,2020-02-16,"(889.0, 1030.0]",9,25,-16
31220.0,2020-02-16,"(932.5, 1004.0]",2,3,-1
31221.0,2020-02-16,"(2.726, 322.5]",1,2,-1
31221.0,2020-02-16,"(322.5, 641.0]",2,3,-1
31221.0,2020-02-16,"(641.0, 959.5]",6,9,-3
31221.0,2020-02-16,"(959.5, 1278.0]",7,16,-9
31222.0,2020-02-16,"(398.214, 595.5]",1,3,-2
31222.0,2020-02-16,"(595.5, 792.0]",8,13,-5
31222.0,2020-02-16,"(792.0, 988.5]",14,26,-12
31222.0,2020-02-16,"(988.5, 1185.0]",7,13,-6
31223.0,2020-02-16,"(51.697, 378.75]",4,8,-4
31223.0,2020-02-16,"(378.75, 704.5]",7,12,-5
31223.0,2020-02-16,"(704.5, 1030.25]",12,24,-12
31223.0,2020-02-16,"(1030.25, 1356.0]",6,13,-7
31224.0,2020-02-16,"(630.262, 815.5]",2,4,-2
31224.0,2020-02-16,"(815.5, 1000.0]",4,6,-2
31224.0,2020-02-16,"(1000.0, 1184.5]",2,5,-3
31225.0,2020-02-16,"(546.463, 681.25]",4,5,-1
31225.0,2020-02-16,"(681.25, 815.5]",2,4,-2
31225.0,2020-02-16,"(815.5, 949.75]",4,7,-3
31225.0,2020-02-16,"(949.75, 1084.0]",13,14,-1
31226.0,2020-02-16,"(659.522, 779.5]",2,4,-2
31226.0,2020-02-16,"(899.0, 1018.5]",3,2,1
31226.0,2020-02-16,"(1018.5, 1138.0]",1,4,-3
31227.0,2020-02-16,"(164.131, 382.25]",1,3,-2
31227.0,2020-02-16,"(382.25, 599.5]",2,3,-1
31227.0,2020-02-16,"(599.5, 816.75]",5,8,-3
31227.0,2020-02-16,"(816.75, 1034.0]",6,14,-8
31228.0,2020-02-16,"(55.669, 389.75]",1,3,-2
31228.0,2020-02-16,"(389.75, 722.5]",4,5,-1
31228.0,2020-02-16,"(722.5, 1055.25]",15,20,-5
31228.0,2020-02-16,"(1055.25, 1388.0]",8,14,-6
31229.0,2020-02-16,"(43.612, 392.0]",3,6,-3
31229.0,2020-02-16,"(392.0, 739.0]",13,28,-15
31229.0,2020-02-16,"(739.0, 1086.0]",24,44,-20
31229.0,2020-02-16,"(1086.0, 1433.0]",12,24,-12
31230.0,2020-02-16,"(326.5, 605.0]",4,2,2
31230.0,2020-02-16,"(605.0, 883.5]",13,4,9
31230.0,2020-02-16,"(883.5, 1162.0]",12,14,-2
31231.0,2020-02-16,"(739.678, 820.5]",2,4,-2
31231.0,2020-02-16,"(820.5, 901.0]",1,8,-7
31231.0,2020-02-16,"(981.5, 1062.0]",2,2,0
31232.0,2020-02-16,"(14.67, 348.5]",2,5,-3
31232.0,2020-02-16,"(348.5, 681.0]",2,4,-2
31232.0,2020-02-16,"(681.0, 1013.5]",19,34,-15
31232.0,2020-02-16,"(1013.5, 1346.0]",14,24,-10
31233.0,2020-02-16,"(610.242, 800.5]",4,6,-2
31233.0,2020-02-16,"(800.5, 990.0]",14,17,-3
31233.0,2020-02-16,"(990.0, 1179.5]",2,4,-2
31234.0,2020-02-16,"(239.861, 525.75]",3,3,0
31234.0,2020-02-16,"(525.75, 810.5]",25,35,-10
31234.0,2020-02-16,"(810.5, 1095.25]",12,19,-7
31234.0,2020-02-16,"(1095.25, 1380.0]",2,4,-2
31235.0,2020-02-16,"(798.25, 880.5]",3,3,0
31235.0,2020-02-16,"(880.5, 962.75]",3,6,-3
31235.0,2020-02-16,"(962.75, 1045.0]",5,7,-2
31236.0,2020-02-16,"(19.65, 358.5]",2,2,0
31236.0,2020-02-16,"(358.5, 696.0]",7,10,-3
31236.0,2020-02-16,"(696.0, 1033.5]",18,36,-18
31236.0,2020-02-16,"(1033.5, 1371.0]",7,18,-11
31237.0,2020-02-16,"(18.717, 340.75]",1,1,0
31237.0,2020-02-16,"(340.75, 661.5]",3,7,-4
31237.0,2020-02-16,"(661.5, 982.25]",8,21,-13
31237.0,2020-02-16,"(982.25, 1303.0]",12,21,-9
31238.0,2020-02-16,"(60.753, 373.75]",1,1,0
31238.0,2020-02-16,"(373.75, 685.5]",2,4,-2
31238.0,2020-02-16,"(685.5, 997.25]",9,16,-7
31238.0,2020-02-16,"(997.25, 1309.0]",6,9,-3
31239.0,2020-02-16,"(449.75, 686.5]",9,1,8
31239.0,2020-02-16,"(686.5, 923.25]",9,12,-3
31239.0,2020-02-16,"(923.25, 1160.0]",13,19,-6
31240.0,2020-02-16,"(531.204, 731.0]",10,15,-5
31240.0,2020-02-16,"(731.0, 930.0]",23,50,-27
31240.0,2020-02-16,"(930.0, 1129.0]",16,23,-7
31240.0,2020-02-16,"(1129.0, 1328.0]",6,12,-6
31241.0,2020-02-16,"(29.611, 378.25]",1,3,-2
31241.0,2020-02-16,"(378.25, 725.5]",8,10,-2
31241.0,2020-02-16,"(725.5, 1072.75]",5,21,-16
31241.0,2020-02-16,"(1072.75, 1420.0]",9,16,-7
31242.0,2020-02-16,"(464.75, 756.5]",9,1,8
31242.0,2020-02-16,"(756.5, 1048.25]",3,11,-8
31242.0,2020-02-16,"(1048.25, 1340.0]",2,9,-7
31243.0,2020-02-16,"(638.507, 762.25]",1,1,0
31243.0,2020-02-16,"(762.25, 885.5]",1,1,0
31243.0,2020-02-16,"(885.5, 1008.75]",6,6,0
31243.0,2020-02-16,"(1008.75, 1132.0]",3,12,-9
31244.0,2020-02-16,"(5.736, 323.0]",2,2,0
31244.0,2020-02-16,"(639.0, 955.0]",1,1,0
31244.0,2020-02-16,"(955.0, 1271.0]",6,3,3
31245.0,2020-02-16,"(248.849, 537.75]",1,2,-1
31245.0,2020-02-16,"(537.75, 825.5]",3,10,-7
31245.0,2020-02-16,"(825.5, 1113.25]",9,18,-9
31245.0,2020-02-16,"(1113.25, 1401.0]",9,18,-9
31246.0,2020-02-16,"(9.692, 338.0]",2,2,0
31246.0,2020-02-16,"(338.0, 665.0]",5,5,0
31246.0,2020-02-16,"(665.0, 992.0]",15,31,-16
31246.0,2020-02-16,"(992.0, 1319.0]",20,36,-16
31247.0,2020-02-16,"(140.765, 450.75]",1,1,0
31247.0,2020-02-16,"(450.75, 759.5]",30,40,-10
31247.0,2020-02-16,"(759.5, 1068.25]",45,97,-52
31247.0,2020-02-16,"(1068.25, 1377.0]",12,19,-7
31248.0,2020-02-16,"(451.146, 665.5]",1,5,-4
31248.0,2020-02-16,"(665.5, 879.0]",33,57,-24
31248.0,2020-02-16,"(879.0, 1092.5]",49,112,-63
31248.0,2020-02-16,"(1092.5, 1306.0]",4,13,-9
31249.0,2020-02-16,"(253.048, 492.0]",1,5,-4
31249.0,2020-02-16,"(730.0, 968.0]",34,4,30
31249.0,2020-02-16,"(968.0, 1206.0]",14,68,-54
31250.0,2020-02-16,"(623.406, 772.5]",1,4,-3
31250.0,2020-02-16,"(772.5, 921.0]",6,7,-1
31251.0,2020-02-16,"(414.0, 665.0]",1,4,-3
31251.0,2020-02-16,"(665.0, 915.0]",1,7,-6
31251.0,2020-02-16,"(915.0, 1165.0]",7,10,-3
31251.0,2020-02-16,"(1165.0, 1415.0]",3,4,-1
31252.0,2020-02-16,"(620.248, 809.0]",2,2,0
31252.0,2020-02-16,"(997.0, 1185.0]",2,3,-1
31252.0,2020-02-16,"(1185.0, 1373.0]",2,2,0
31253.0,2020-02-16,"(553.355, 715.25]",1,2,-1
31253.0,2020-02-16,"(1037.75, 1199.0]",2,1,1
31254.0,2020-02-16,"(245.034, 487.5]",1,2,-1
31254.0,2020-02-16,"(487.5, 729.0]",1,3,-2
31254.0,2020-02-16,"(729.0, 970.5]",4,9,-5
31254.0,2020-02-16,"(970.5, 1212.0]",5,10,-5
31255.0,2020-02-16,"(676.351, 839.25]",1,5,-4
31255.0,2020-02-16,"(839.25, 1001.5]",4,5,-1
31255.0,2020-02-16,"(1001.5, 1163.75]",1,5,-4
31255.0,2020-02-16,"(1163.75, 1326.0]",2,4,-2
31256.0,2020-02-16,"(636.0, 897.0]",12,2,10
31256.0,2020-02-16,"(897.0, 1158.0]",11,23,-12
31256.0,2020-02-16,"(1158.0, 1419.0]",2,17,-15
31257.0,2020-02-16,"(532.167, 741.25]",4,11,-7
31257.0,2020-02-16,"(741.25, 949.5]",9,15,-6
31257.0,2020-02-16,"(949.5, 1157.75]",9,16,-7
31257.0,2020-02-16,"(1157.75, 1366.0]",1,10,-9
31258.0,2020-02-16,"(440.137, 656.75]",13,28,-15
31258.0,2020-02-16,"(656.75, 872.5]",37,89,-52
31258.0,2020-02-16,"(872.5, 1088.25]",48,86,-38
31258.0,2020-02-16,"(1088.25, 1304.0]",13,25,-12
,,,,1.0,
,,,,1.0,
31260.0,2020-02-16,"(105.738, 422.5]",1,2,-1
31260.0,2020-02-16,"(738.0, 1053.5]",4,8,-4
31260.0,2020-02-16,"(1053.5, 1369.0]",2,3,-1
31261.0,2020-02-16,"(812.414, 959.5]",2,3,-1
31261.0,2020-02-16,"(959.5, 1106.0]",4,7,-3
31261.0,2020-02-16,"(1252.5, 1399.0]",4,6,-2
31262.0,2020-02-16,"(341.0, 658.0]",3,1,2
31262.0,2020-02-16,"(658.0, 975.0]",2,3,-1
31262.0,2020-02-16,"(975.0, 1292.0]",4,2,2
31263.0,2020-02-16,"(342.006, 591.5]",5,5,0
31263.0,2020-02-16,"(591.5, 840.0]",4,14,-10
31263.0,2020-02-16,"(840.0, 1088.5]",8,8,0
31263.0,2020-02-16,"(1088.5, 1337.0]",2,5,-3
31264.0,2020-02-16,"(733.484, 863.0]",5,14,-9
31264.0,2020-02-16,"(863.0, 992.0]",6,10,-4
31264.0,2020-02-16,"(992.0, 1121.0]",11,16,-5
31265.0,2020-02-16,"(57.642, 398.5]",1,2,-1
31265.0,2020-02-16,"(398.5, 738.0]",9,22,-13
31265.0,2020-02-16,"(738.0, 1077.5]",18,29,-11
31265.0,2020-02-16,"(1077.5, 1417.0]",9,12,-3
31266.0,2020-02-16,"(1.609, 350.75]",2,2,0
31266.0,2020-02-16,"(350.75, 698.5]",7,19,-12
31266.0,2020-02-16,"(698.5, 1046.25]",17,33,-16
31266.0,2020-02-16,"(1046.25, 1394.0]",12,23,-11
31267.0,2020-02-16,"(7.679, 339.25]",2,4,-2
31267.0,2020-02-16,"(669.5, 999.75]",12,2,10
31267.0,2020-02-16,"(999.75, 1330.0]",8,19,-11
31268.0,2020-02-16,"(42.62, 389.0]",1,5,-4
31268.0,2020-02-16,"(389.0, 734.0]",6,10,-4
31268.0,2020-02-16,"(734.0, 1079.0]",6,15,-9
31268.0,2020-02-16,"(1079.0, 1424.0]",8,13,-5
31269.0,2020-02-16,"(104.787, 409.25]",1,1,0
31269.0,2020-02-16,"(409.25, 712.5]",4,6,-2
31269.0,2020-02-16,"(712.5, 1015.75]",4,12,-8
31269.0,2020-02-16,"(1015.75, 1319.0]",7,12,-5
31270.0,2020-02-16,"(400.16, 611.0]",1,2,-1
31270.0,2020-02-16,"(611.0, 821.0]",6,14,-8
31270.0,2020-02-16,"(821.0, 1031.0]",7,8,-1
31270.0,2020-02-16,"(1031.0, 1241.0]",4,8,-4
31271.0,2020-02-16,"(651.451, 789.25]",5,6,-1
31271.0,2020-02-16,"(789.25, 926.5]",12,27,-15
31271.0,2020-02-16,"(926.5, 1063.75]",9,18,-9
31271.0,2020-02-16,"(1063.75, 1201.0]",3,6,-3
31272.0,2020-02-16,"(207.806, 507.5]",1,1,0
31272.0,2020-02-16,"(507.5, 806.0]",3,6,-3
31272.0,2020-02-16,"(806.0, 1104.5]",15,33,-18
31272.0,2020-02-16,"(1104.5, 1403.0]",8,10,-2
31273.0,2020-02-16,"(562.421, 707.75]",2,6,-4
31273.0,2020-02-16,"(707.75, 852.5]",1,1,0
31273.0,2020-02-16,"(852.5, 997.25]",5,9,-4
31273.0,2020-02-16,"(997.25, 1142.0]",2,7,-5
31274.0,2020-02-16,"(619.34, 785.0]",8,8,0
31274.0,2020-02-16,"(785.0, 950.0]",1,4,-3
31274.0,2020-02-16,"(950.0, 1115.0]",8,10,-2
31274.0,2020-02-16,"(1115.0, 1280.0]",3,7,-4
31275.0,2020-02-16,"(92.776, 400.0]",1,3,-2
31275.0,2020-02-16,"(400.0, 706.0]",2,6,-4
31275.0,2020-02-16,"(706.0, 1012.0]",8,19,-11
31275.0,2020-02-16,"(1012.0, 1318.0]",8,11,-3
31276.0,2020-02-16,"(452.359, 613.25]",5,6,-1
31276.0,2020-02-16,"(613.25, 773.5]",2,4,-2
31276.0,2020-02-16,"(773.5, 933.75]",1,1,0
31276.0,2020-02-16,"(933.75, 1094.0]",3,8,-5
31277.0,2020-02-16,"(555.298, 731.5]",2,8,-6
31277.0,2020-02-16,"(731.5, 907.0]",10,19,-9
31277.0,2020-02-16,"(907.0, 1082.5]",16,27,-11
31277.0,2020-02-16,"(1082.5, 1258.0]",4,5,-1
31278.0,2020-02-16,"(181.804, 482.0]",3,3,0
31278.0,2020-02-16,"(482.0, 781.0]",3,6,-3
31278.0,2020-02-16,"(781.0, 1080.0]",12,26,-14
31278.0,2020-02-16,"(1080.0, 1379.0]",6,10,-4
31279.0,2020-02-16,"(879.0, 972.0]",3,1,2
31279.0,2020-02-16,"(1065.0, 1158.0]",1,3,-2
31280.0,2020-02-16,"(167.946, 432.5]",1,3,-2
31280.0,2020-02-16,"(696.0, 959.5]",7,2,5
31280.0,2020-02-16,"(959.5, 1223.0]",8,16,-8
31000.0,2020-02-17,"(1052.75, 1187.0]",1,1,0
31001.0,2020-02-17,"(806.25, 809.0]",1,1,0
31002.0,2020-02-17,"(575.407, 724.25]",2,5,-3
31002.0,2020-02-17,"(724.25, 872.5]",3,8,-5
31002.0,2020-02-17,"(872.5, 1020.75]",5,9,-4
31002.0,2020-02-17,"(1020.75, 1169.0]",2,3,-1
31003.0,2020-02-17,"(576.519, 697.25]",3,3,0
31003.0,2020-02-17,"(817.5, 937.75]",2,1,1
31003.0,2020-02-17,"(937.75, 1058.0]",3,4,-1
31004.0,2020-02-17,"(501.333, 668.75]",1,2,-1
31004.0,2020-02-17,"(1002.25, 1169.0]",3,4,-1
31005.0,2020-02-17,"(443.349, 606.75]",1,2,-1
31005.0,2020-02-17,"(769.5, 932.25]",5,3,2
31005.0,2020-02-17,"(932.25, 1095.0]",2,8,-6
31006.0,2020-02-17,"(621.378, 777.5]",1,2,-1
31006.0,2020-02-17,"(777.5, 933.0]",1,2,-1
31006.0,2020-02-17,"(933.0, 1088.5]",3,3,0
31006.0,2020-02-17,"(1088.5, 1244.0]",1,2,-1
31007.0,2020-02-17,"(509.356, 671.0]",4,6,-2
31007.0,2020-02-17,"(671.0, 832.0]",4,5,-1
31007.0,2020-02-17,"(832.0, 993.0]",2,3,-1
31007.0,2020-02-17,"(993.0, 1154.0]",1,7,-6
,,,,2.0,
31010.0,2020-02-17,"(812.0, 1020.0]",3,3,0
31011.0,2020-02-17,"(418.204, 618.0]",2,3,-1
31011.0,2020-02-17,"(618.0, 817.0]",2,5,-3
31011.0,2020-02-17,"(817.0, 1016.0]",3,4,-1
31011.0,2020-02-17,"(1016.0, 1215.0]",1,3,-2
31012.0,2020-02-17,"(533.637, 624.75]",1,1,0
31013.0,2020-02-17,"(551.47, 684.5]",2,4,-2
31013.0,2020-02-17,"(684.5, 817.0]",1,2,-1
31013.0,2020-02-17,"(949.5, 1082.0]",1,2,-1
31014.0,2020-02-17,"(323.004, 573.0]",8,10,-2
31014.0,2020-02-17,"(573.0, 822.0]",6,11,-5
31014.0,2020-02-17,"(822.0, 1071.0]",15,29,-14
31014.0,2020-02-17,"(1071.0, 1320.0]",5,13,-8
31015.0,2020-02-17,"(302.075, 534.25]",2,3,-1
31015.0,2020-02-17,"(534.25, 765.5]",2,2,0
31015.0,2020-02-17,"(765.5, 996.75]",4,4,0
31015.0,2020-02-17,"(996.75, 1228.0]",5,7,-2
31016.0,2020-02-17,"(508.342, 673.5]",1,1,0
31016.0,2020-02-17,"(673.5, 838.0]",2,2,0
31016.0,2020-02-17,"(838.0, 1002.5]",2,5,-3
31016.0,2020-02-17,"(1002.5, 1167.0]",2,4,-2
31017.0,2020-02-17,"(743.0, 1083.5]",1,2,-1
31017.0,2020-02-17,"(1083.5, 1424.0]",1,5,-4
31018.0,2020-02-17,"(507.339, 673.25]",2,3,-1
31018.0,2020-02-17,"(673.25, 838.5]",1,1,0
31018.0,2020-02-17,"(838.5, 1003.75]",1,5,-4
31018.0,2020-02-17,"(1003.75, 1169.0]",2,2,0
31019.0,2020-02-17,"(731.535, 848.25]",2,4,-2
31019.0,2020-02-17,"(964.5, 1080.75]",1,2,-1
31020.0,2020-02-17,"(759.54, 875.0]",1,3,-2
31020.0,2020-02-17,"(875.0, 990.0]",1,3,-2
31020.0,2020-02-17,"(990.0, 1105.0]",3,3,0
31021.0,2020-02-17,"(476.312, 649.0]",2,3,-1
31021.0,2020-02-17,"(649.0, 821.0]",1,1,0
31021.0,2020-02-17,"(993.0, 1165.0]",2,1,1
31022.0,2020-02-17,"(687.421, 832.75]",1,7,-6
31022.0,2020-02-17,"(832.75, 977.5]",5,11,-6
31022.0,2020-02-17,"(977.5, 1122.25]",2,5,-3
31023.0,2020-02-17,"(1002.0, 1166.5]",2,2,0
31024.0,2020-02-17,"(548.216, 745.0]",1,3,-2
31024.0,2020-02-17,"(745.0, 941.0]",1,1,0
31024.0,2020-02-17,"(941.0, 1137.0]",1,3,-2
31024.0,2020-02-17,"(1137.0, 1333.0]",1,2,-1
31025.0,2020-02-17,"(705.439, 846.25]",3,4,-1
31025.0,2020-02-17,"(1126.75, 1267.0]",1,1,0
31026.0,2020-02-17,"(33.712, 357.0]",1,2,-1
31026.0,2020-02-17,"(1001.0, 1323.0]",3,2,1
31027.0,2020-02-17,"(865.75, 914.0]",1,1,0
31028.0,2020-02-17,"(747.25, 851.5]",1,1,0
31028.0,2020-02-17,"(851.5, 955.75]",1,1,0
31029.0,2020-02-17,"(672.25, 882.5]",3,4,-1
31029.0,2020-02-17,"(882.5, 1092.75]",2,5,-3
31029.0,2020-02-17,"(1092.75, 1303.0]",1,3,-2
31030.0,2020-02-17,"(623.439, 764.25]",1,3,-2
31030.0,2020-02-17,"(764.25, 904.5]",1,4,-3
31030.0,2020-02-17,"(904.5, 1044.75]",2,2,0
31030.0,2020-02-17,"(1044.75, 1185.0]",3,3,0
31031.0,2020-02-17,"(1072.75, 1254.0]",4,2,2
,,,,1.0,
,,,,2.0,
31033.0,2020-02-17,"(804.5, 846.0]",1,1,0
31034.0,2020-02-17,"(842.729, 910.75]",1,1,0
31034.0,2020-02-17,"(1046.25, 1114.0]",1,1,0
31035.0,2020-02-17,"(127.695, 455.25]",1,1,0
31035.0,2020-02-17,"(781.5, 1107.75]",2,4,-2
31035.0,2020-02-17,"(1107.75, 1434.0]",2,4,-2
31036.0,2020-02-17,"(758.75, 932.0]",1,3,-2
31037.0,2020-02-17,"(267.167, 476.25]",3,3,0
31037.0,2020-02-17,"(476.25, 684.5]",2,2,0
31037.0,2020-02-17,"(684.5, 892.75]",4,7,-3
31037.0,2020-02-17,"(892.75, 1101.0]",3,7,-4
31038.0,2020-02-17,"(676.553, 788.75]",1,2,-1
31038.0,2020-02-17,"(1012.25, 1124.0]",2,2,0
31039.0,2020-02-17,"(532.242, 722.5]",2,4,-2
31039.0,2020-02-17,"(912.0, 1101.5]",2,2,0
31040.0,2020-02-17,"(467.439, 608.25]",2,2,0
31041.0,2020-02-17,"(743.25, 958.5]",9,2,7
31042.0,2020-02-17,"(438.246, 627.5]",4,5,-1
31042.0,2020-02-17,"(627.5, 816.0]",3,3,0
31042.0,2020-02-17,"(816.0, 1004.5]",4,10,-6
31042.0,2020-02-17,"(1004.5, 1193.0]",2,4,-2
31043.0,2020-02-17,"(451.255, 638.25]",2,2,0
31043.0,2020-02-17,"(824.5, 1010.75]",4,9,-5
31043.0,2020-02-17,"(1010.75, 1197.0]",1,2,-1
31044.0,2020-02-17,"(452.373, 609.75]",2,3,-1
31044.0,2020-02-17,"(766.5, 923.25]",1,1,0
31044.0,2020-02-17,"(923.25, 1080.0]",1,1,0
31045.0,2020-02-17,"(537.255, 724.25]",2,5,-3
31045.0,2020-02-17,"(724.25, 910.5]",1,3,-2
31045.0,2020-02-17,"(910.5, 1096.75]",2,3,-1
31045.0,2020-02-17,"(1096.75, 1283.0]",1,1,0
31046.0,2020-02-17,"(933.25, 1070.0]",2,1,1
31047.0,2020-02-17,"(447.318, 618.5]",2,6,-4
31047.0,2020-02-17,"(789.0, 959.5]",2,3,-1
31047.0,2020-02-17,"(959.5, 1130.0]",1,3,-2
31048.0,2020-02-17,"(655.226, 849.5]",1,1,0
31048.0,2020-02-17,"(849.5, 1043.0]",3,3,0
31049.0,2020-02-17,"(476.665, 560.75]",1,1,0
31049.0,2020-02-17,"(728.25, 812.0]",2,1,1
31050.0,2020-02-17,"(783.25, 910.5]",1,2,-1
31050.0,2020-02-17,"(1037.75, 1165.0]",1,1,0
31051.0,2020-02-17,"(746.0, 969.5]",2,1,1
31051.0,2020-02-17,"(969.5, 1193.0]",2,2,0
31052.0,2020-02-17,"(514.363, 674.25]",2,3,-1
31052.0,2020-02-17,"(992.75, 1152.0]",1,2,-1
31053.0,2020-02-17,"(578.589, 681.75]",1,1,0
,,,,2.0,
31055.0,2020-02-17,"(813.5, 927.25]",2,2,0
31055.0,2020-02-17,"(927.25, 1041.0]",1,2,-1
31056.0,2020-02-17,"(4.579, 361.25]",1,1,0
31056.0,2020-02-17,"(716.5, 1071.75]",2,1,1
31056.0,2020-02-17,"(1071.75, 1427.0]",3,6,-3
31057.0,2020-02-17,"(514.535, 631.25]",1,1,0
31057.0,2020-02-17,"(863.75, 980.0]",2,4,-2
31058.0,2020-02-17,"(838.443, 978.25]",1,1,0
31059.0,2020-02-17,"(540.504, 665.0]",1,1,0
31059.0,2020-02-17,"(665.0, 789.0]",2,3,-1
31059.0,2020-02-17,"(913.0, 1037.0]",2,4,-2
31060.0,2020-02-17,"(865.45, 1003.5]",5,9,-4
,,,,1.0,
,,,,1.0,
31062.0,2020-02-17,"(565.539, 681.25]",2,4,-2
31062.0,2020-02-17,"(681.25, 796.5]",6,10,-4
31062.0,2020-02-17,"(796.5, 911.75]",8,12,-4
31062.0,2020-02-17,"(911.75, 1027.0]",5,8,-3
31063.0,2020-02-17,"(964.25, 1028.0]",2,2,0
31064.0,2020-02-17,"(91.928, 361.0]",1,2,-1
31064.0,2020-02-17,"(361.0, 629.0]",3,5,-2
31064.0,2020-02-17,"(629.0, 897.0]",13,26,-13
31064.0,2020-02-17,"(897.0, 1165.0]",22,50,-28
31065.0,2020-02-17,"(938.75, 993.0]",1,1,0
31066.0,2020-02-17,"(598.265, 782.75]",2,2,0
31066.0,2020-02-17,"(782.75, 966.5]",2,6,-4
31066.0,2020-02-17,"(966.5, 1150.25]",2,4,-2
31066.0,2020-02-17,"(1150.25, 1334.0]",2,2,0
31067.0,2020-02-17,"(647.5, 740.0]",1,1,0
31067.0,2020-02-17,"(832.5, 925.0]",1,2,-1
31068.0,2020-02-17,"(927.5, 1133.25]",2,1,1
31068.0,2020-02-17,"(1133.25, 1339.0]",1,4,-3
31069.0,2020-02-17,"(783.5, 821.25]",1,1,0
31069.0,2020-02-17,"(821.25, 859.0]",1,1,0
31070.0,2020-02-17,"(851.25, 1135.0]",1,1,0
31071.0,2020-02-17,"(633.449, 771.75]",4,6,-2
31071.0,2020-02-17,"(771.75, 909.5]",2,6,-4
31071.0,2020-02-17,"(1047.25, 1185.0]",5,1,4
,,,,1.0,
,,,,3.0,
31073.0,2020-02-17,"(1102.25, 1279.0]",1,1,0
31074.0,2020-02-17,"(569.403, 719.25]",1,4,-3
31074.0,2020-02-17,"(719.25, 868.5]",1,1,0
31074.0,2020-02-17,"(1017.75, 1167.0]",1,2,-1
,,,,2.0,
31076.0,2020-02-17,"(716.629, 809.75]",1,2,-1
31076.0,2020-02-17,"(995.25, 1088.0]",2,3,-1
31077.0,2020-02-17,"(766.25, 881.5]",9,4,5
31077.0,2020-02-17,"(881.5, 996.75]",3,13,-10
31077.0,2020-02-17,"(996.75, 1112.0]",4,9,-5
,,,,2.0,
31079.0,2020-02-17,"(642.5, 798.0]",1,2,-1
31079.0,2020-02-17,"(953.5, 1109.0]",4,2,2
31080.0,2020-02-17,"(691.0, 864.0]",1,2,-1
31080.0,2020-02-17,"(1037.0, 1210.0]",2,3,-1
31081.0,2020-02-17,"(827.25, 909.5]",1,1,0
31081.0,2020-02-17,"(909.5, 991.75]",3,2,1
31082.0,2020-02-17,"(609.638, 700.5]",1,2,-1
31082.0,2020-02-17,"(881.5, 972.0]",1,2,-1
31083.0,2020-02-17,"(1046.0, 1049.0]",1,1,0
31084.0,2020-02-17,"(123.691, 452.25]",1,1,0
31084.0,2020-02-17,"(452.25, 779.5]",2,2,0
31084.0,2020-02-17,"(779.5, 1106.75]",1,3,-2
31084.0,2020-02-17,"(1106.75, 1434.0]",1,2,-1
31085.0,2020-02-17,"(672.25, 851.5]",2,1,1
31085.0,2020-02-17,"(1030.75, 1210.0]",2,2,0
31086.0,2020-02-17,"(891.5, 914.0]",1,1,0
,,,,2.0,
31088.0,2020-02-17,"(840.0, 1120.0]",2,1,1
31089.0,2020-02-17,"(490.194, 692.5]",2,3,-1
31090.0,2020-02-17,"(573.562, 683.5]",1,2,-1
31090.0,2020-02-17,"(683.5, 793.0]",2,2,0
31090.0,2020-02-17,"(793.0, 902.5]",2,4,-2
31090.0,2020-02-17,"(902.5, 1012.0]",2,2,0
31091.0,2020-02-17,"(410.164, 620.0]",1,3,-2
31091.0,2020-02-17,"(620.0, 829.0]",1,1,0
31091.0,2020-02-17,"(829.0, 1038.0]",1,3,-2
31091.0,2020-02-17,"(1038.0, 1247.0]",1,1,0
31092.0,2020-02-17,"(963.5, 1099.0]",2,2,0
31092.0,2020-02-17,"(1234.5, 1370.0]",1,2,-1
,,,,1.0,
,,,,5.0,
31094.0,2020-02-17,"(832.677, 913.75]",3,5,-2
31094.0,2020-02-17,"(1075.25, 1156.0]",2,2,0
,,,,1.0,
,,,,1.0,
31096.0,2020-02-17,"(589.0, 660.0]",1,1,0
31097.0,2020-02-17,"(609.54, 725.0]",1,1,0
31097.0,2020-02-17,"(955.0, 1070.0]",2,1,1
31098.0,2020-02-17,"(762.5, 928.25]",1,3,-2
31098.0,2020-02-17,"(928.25, 1094.0]",4,1,3
31099.0,2020-02-17,"(1050.0, 1400.0]",1,1,0
31100.0,2020-02-17,"(504.75, 660.0]",2,1,1
31101.0,2020-02-17,"(13.638, 355.5]",1,3,-2
31101.0,2020-02-17,"(355.5, 696.0]",18,29,-11
31101.0,2020-02-17,"(696.0, 1036.5]",36,61,-25
31101.0,2020-02-17,"(1036.5, 1377.0]",5,12,-7
31102.0,2020-02-17,"(520.113, 742.75]",2,9,-7
31102.0,2020-02-17,"(742.75, 964.5]",3,9,-6
31102.0,2020-02-17,"(964.5, 1186.25]",6,10,-4
31102.0,2020-02-17,"(1186.25, 1408.0]",5,6,-1
31103.0,2020-02-17,"(399.013, 646.75]",4,13,-9
31103.0,2020-02-17,"(646.75, 893.5]",3,15,-12
31103.0,2020-02-17,"(893.5, 1140.25]",5,14,-9
31103.0,2020-02-17,"(1140.25, 1387.0]",6,12,-6
31104.0,2020-02-17,"(386.5, 731.0]",10,3,7
31104.0,2020-02-17,"(731.0, 1075.5]",14,27,-13
31104.0,2020-02-17,"(1075.5, 1420.0]",18,30,-12
31105.0,2020-02-17,"(595.0, 866.0]",4,5,-1
31105.0,2020-02-17,"(866.0, 1137.0]",1,8,-7
31105.0,2020-02-17,"(1137.0, 1408.0]",2,13,-11
31106.0,2020-02-17,"(13.707, 338.25]",1,1,0
31106.0,2020-02-17,"(984.75, 1308.0]",4,1,3
31107.0,2020-02-17,"(4.568, 364.0]",4,5,-1
31107.0,2020-02-17,"(364.0, 722.0]",7,23,-16
31107.0,2020-02-17,"(722.0, 1080.0]",13,36,-23
31107.0,2020-02-17,"(1080.0, 1438.0]",10,17,-7
31108.0,2020-02-17,"(604.0, 776.0]",8,2,6
31108.0,2020-02-17,"(776.0, 948.0]",12,12,0
31108.0,2020-02-17,"(948.0, 1120.0]",16,16,0
31109.0,2020-02-17,"(12.662, 348.5]",4,9,-5
31109.0,2020-02-17,"(348.5, 683.0]",9,15,-6
31109.0,2020-02-17,"(683.0, 1017.5]",15,32,-17
31109.0,2020-02-17,"(1017.5, 1352.0]",12,23,-11
31110.0,2020-02-17,"(55.729, 374.75]",3,3,0
31110.0,2020-02-17,"(374.75, 692.5]",14,30,-16
31110.0,2020-02-17,"(692.5, 1010.25]",18,36,-18
31110.0,2020-02-17,"(1010.25, 1328.0]",13,25,-12
31111.0,2020-02-17,"(378.005, 627.75]",5,6,-1
31111.0,2020-02-17,"(627.75, 876.5]",8,21,-13
31111.0,2020-02-17,"(876.5, 1125.25]",5,11,-6
31111.0,2020-02-17,"(1125.25, 1374.0]",9,11,-2
31112.0,2020-02-17,"(761.523, 881.25]",2,5,-3
31112.0,2020-02-17,"(881.25, 1000.5]",2,5,-3
31112.0,2020-02-17,"(1000.5, 1119.75]",2,3,-1
31112.0,2020-02-17,"(1119.75, 1239.0]",1,1,0
31113.0,2020-02-17,"(344.75, 685.5]",3,4,-1
31113.0,2020-02-17,"(685.5, 1026.25]",12,19,-7
31113.0,2020-02-17,"(1026.25, 1367.0]",4,30,-26
31114.0,2020-02-17,"(139.725, 459.75]",1,3,-2
31114.0,2020-02-17,"(459.75, 778.5]",5,17,-12
31114.0,2020-02-17,"(778.5, 1097.25]",15,27,-12
31114.0,2020-02-17,"(1097.25, 1416.0]",12,20,-8
31115.0,2020-02-17,"(58.665, 393.75]",1,1,0
31115.0,2020-02-17,"(393.75, 727.5]",7,13,-6
31115.0,2020-02-17,"(727.5, 1061.25]",4,20,-16
31115.0,2020-02-17,"(1061.25, 1395.0]",13,22,-9
31116.0,2020-02-17,"(495.124, 715.0]",6,15,-9
31116.0,2020-02-17,"(715.0, 934.0]",10,17,-7
31116.0,2020-02-17,"(934.0, 1153.0]",10,18,-8
31116.0,2020-02-17,"(1153.0, 1372.0]",4,7,-3
31117.0,2020-02-17,"(657.5, 914.0]",7,19,-12
31117.0,2020-02-17,"(914.0, 1170.5]",14,21,-7
31117.0,2020-02-17,"(1170.5, 1427.0]",5,30,-25
31118.0,2020-02-17,"(1.694, 329.5]",2,3,-1
31118.0,2020-02-17,"(329.5, 656.0]",2,10,-8
31118.0,2020-02-17,"(656.0, 982.5]",8,18,-10
31118.0,2020-02-17,"(982.5, 1309.0]",13,18,-5
31119.0,2020-02-17,"(16.639, 358.25]",2,3,-1
31119.0,2020-02-17,"(358.25, 698.5]",10,27,-17
31119.0,2020-02-17,"(698.5, 1038.75]",15,27,-12
31119.0,2020-02-17,"(1038.75, 1379.0]",12,21,-9
31120.0,2020-02-17,"(436.025, 680.75]",1,9,-8
31120.0,2020-02-17,"(680.75, 924.5]",4,11,-7
31120.0,2020-02-17,"(924.5, 1168.25]",3,10,-7
31120.0,2020-02-17,"(1168.25, 1412.0]",5,5,0
31121.0,2020-02-17,"(426.012, 674.0]",10,14,-4
31121.0,2020-02-17,"(674.0, 921.0]",7,13,-6
31121.0,2020-02-17,"(921.0, 1168.0]",10,18,-8
31121.0,2020-02-17,"(1168.0, 1415.0]",1,7,-6
31122.0,2020-02-17,"(0.572, 359.0]",1,3,-2
31122.0,2020-02-17,"(359.0, 716.0]",3,12,-9
31122.0,2020-02-17,"(716.0, 1073.0]",5,15,-10
31122.0,2020-02-17,"(1073.0, 1430.0]",3,8,-5
31123.0,2020-02-17,"(358.941, 624.75]",1,9,-8
31123.0,2020-02-17,"(624.75, 889.5]",5,8,-3
31123.0,2020-02-17,"(1154.25, 1419.0]",3,7,-4
31124.0,2020-02-17,"(2.612, 351.0]",2,3,-1
31124.0,2020-02-17,"(351.0, 698.0]",10,23,-13
31124.0,2020-02-17,"(698.0, 1045.0]",16,43,-27
31124.0,2020-02-17,"(1045.0, 1392.0]",10,28,-18
31125.0,2020-02-17,"(27.642, 368.5]",1,4,-3
31125.0,2020-02-17,"(368.5, 708.0]",11,22,-11
31125.0,2020-02-17,"(708.0, 1047.5]",27,49,-22
31125.0,2020-02-17,"(1047.5, 1387.0]",20,32,-12
31126.0,2020-02-17,"(1284.75, 1307.0]",1,1,0
31127.0,2020-02-17,"(546.16, 757.0]",4,4,0
31127.0,2020-02-17,"(757.0, 967.0]",2,5,-3
31127.0,2020-02-17,"(967.0, 1177.0]",4,11,-7
31127.0,2020-02-17,"(1177.0, 1387.0]",2,3,-1
31128.0,2020-02-17,"(395.027, 639.25]",9,15,-6
31128.0,2020-02-17,"(639.25, 882.5]",7,18,-11
31128.0,2020-02-17,"(882.5, 1125.75]",19,26,-7
31128.0,2020-02-17,"(1125.75, 1369.0]",10,15,-5
31129.0,2020-02-17,"(515.352, 678.0]",3,6,-3
31129.0,2020-02-17,"(678.0, 840.0]",12,24,-12
31129.0,2020-02-17,"(840.0, 1002.0]",15,25,-10
31129.0,2020-02-17,"(1002.0, 1164.0]",12,21,-9
31130.0,2020-02-17,"(420.119, 641.25]",1,7,-6
31130.0,2020-02-17,"(641.25, 861.5]",7,14,-7
31130.0,2020-02-17,"(861.5, 1081.75]",1,5,-4
31130.0,2020-02-17,"(1081.75, 1302.0]",4,7,-3
31131.0,2020-02-17,"(366.956, 629.0]",2,9,-7
31131.0,2020-02-17,"(629.0, 890.0]",1,8,-7
31131.0,2020-02-17,"(890.0, 1151.0]",4,13,-9
31131.0,2020-02-17,"(1151.0, 1412.0]",1,2,-1
31200.0,2020-02-17,"(411.034, 653.5]",12,17,-5
31200.0,2020-02-17,"(653.5, 895.0]",14,31,-17
31200.0,2020-02-17,"(895.0, 1136.5]",16,31,-15
31200.0,2020-02-17,"(1136.5, 1378.0]",7,15,-8
31201.0,2020-02-17,"(28.647, 368.25]",4,6,-2
31201.0,2020-02-17,"(368.25, 706.5]",23,34,-11
31201.0,2020-02-17,"(706.5, 1044.75]",45,79,-34
31201.0,2020-02-17,"(1044.75, 1383.0]",23,49,-26
,,,,2.0,
31203.0,2020-02-17,"(420.75, 753.5]",19,5,14
31203.0,2020-02-17,"(753.5, 1086.25]",28,34,-6
31203.0,2020-02-17,"(1086.25, 1419.0]",8,48,-40
31204.0,2020-02-17,"(519.086, 748.5]",4,10,-6
31204.0,2020-02-17,"(748.5, 977.0]",9,10,-1
31204.0,2020-02-17,"(977.0, 1205.5]",7,10,-3
31204.0,2020-02-17,"(1205.5, 1434.0]",3,7,-4
31205.0,2020-02-17,"(502.134, 719.5]",7,8,-1
31205.0,2020-02-17,"(719.5, 936.0]",5,7,-2
31205.0,2020-02-17,"(936.0, 1152.5]",6,12,-6
31205.0,2020-02-17,"(1152.5, 1369.0]",2,10,-8
31206.0,2020-02-17,"(763.25, 764.0]",2,2,0
31207.0,2020-02-17,"(621.25, 779.5]",2,1,1
31207.0,2020-02-17,"(779.5, 937.75]",2,2,0
31207.0,2020-02-17,"(937.75, 1096.0]",2,7,-5
31208.0,2020-02-17,"(505.287, 684.25]",1,1,0
31208.0,2020-02-17,"(684.25, 862.5]",3,6,-3
31208.0,2020-02-17,"(862.5, 1040.75]",4,6,-2
31208.0,2020-02-17,"(1040.75, 1219.0]",5,6,-1
31209.0,2020-02-17,"(693.647, 782.25]",2,4,-2
31209.0,2020-02-17,"(782.25, 870.5]",2,4,-2
31211.0,2020-02-17,"(579.259, 765.25]",4,5,-1
31211.0,2020-02-17,"(765.25, 950.5]",11,14,-3
31211.0,2020-02-17,"(950.5, 1135.75]",6,9,-3
31211.0,2020-02-17,"(1135.75, 1321.0]",1,4,-3
31212.0,2020-02-17,"(404.054, 641.5]",17,23,-6
31212.0,2020-02-17,"(641.5, 878.0]",4,16,-12
31212.0,2020-02-17,"(878.0, 1114.5]",3,6,-3
31212.0,2020-02-17,"(1114.5, 1351.0]",6,9,-3
31213.0,2020-02-17,"(269.876, 552.0]",7,11,-4
31213.0,2020-02-17,"(552.0, 833.0]",13,20,-7
31213.0,2020-02-17,"(833.0, 1114.0]",4,17,-13
31213.0,2020-02-17,"(1114.0, 1395.0]",8,11,-3
31214.0,2020-02-17,"(335.25, 662.5]",5,4,1
31214.0,2020-02-17,"(662.5, 989.75]",16,15,1
31214.0,2020-02-17,"(989.75, 1317.0]",33,30,3
31215.0,2020-02-17,"(516.214, 713.5]",8,11,-3
31215.0,2020-02-17,"(713.5, 910.0]",14,16,-2
31215.0,2020-02-17,"(910.0, 1106.5]",6,13,-7
31215.0,2020-02-17,"(1106.5, 1303.0]",1,2,-1
31216.0,2020-02-17,"(417.13, 635.5]",1,2,-1
31216.0,2020-02-17,"(635.5, 853.0]",2,2,0
31216.0,2020-02-17,"(853.0, 1070.5]",5,6,-1
31216.0,2020-02-17,"(1070.5, 1288.0]",2,6,-4
31217.0,2020-02-17,"(550.435, 692.25]",2,3,-1
31217.0,2020-02-17,"(692.25, 833.5]",3,5,-2
31217.0,2020-02-17,"(833.5, 974.75]",10,22,-12
31217.0,2020-02-17,"(974.75, 1116.0]",1,2,-1
31218.0,2020-02-17,"(541.473, 673.75]",3,3,0
31218.0,2020-02-17,"(673.75, 805.5]",11,19,-8
31218.0,2020-02-17,"(805.5, 937.25]",3,15,-12
31218.0,2020-02-17,"(937.25, 1069.0]",3,5,-2
31219.0,2020-02-17,"(560.0, 833.0]",13,1,12
31219.0,2020-02-17,"(833.0, 1106.0]",15,23,-8
31220.0,2020-02-17,"(368.012, 616.0]",2,3,-1
31220.0,2020-02-17,"(616.0, 863.0]",2,5,-3
31220.0,2020-02-17,"(1110.0, 1357.0]",1,2,-1
31221.0,2020-02-17,"(194.926, 464.5]",1,2,-1
31221.0,2020-02-17,"(464.5, 733.0]",9,14,-5
31221.0,2020-02-17,"(733.0, 1001.5]",7,13,-6
31221.0,2020-02-17,"(1001.5, 1270.0]",6,9,-3
31222.0,2020-02-17,"(359.0, 642.0]",9,1,8
31222.0,2020-02-17,"(642.0, 925.0]",19,14,5
31222.0,2020-02-17,"(925.0, 1208.0]",3,28,-25
31223.0,2020-02-17,"(374.25, 694.5]",12,1,11
31223.0,2020-02-17,"(694.5, 1014.75]",10,15,-5
31223.0,2020-02-17,"(1014.75, 1335.0]",8,21,-13
31224.0,2020-02-17,"(466.174, 673.5]",4,4,0
31224.0,2020-02-17,"(673.5, 880.0]",4,4,0
31224.0,2020-02-17,"(880.0, 1086.5]",6,10,-4
31224.0,2020-02-17,"(1086.5, 1293.0]",2,7,-5
31225.0,2020-02-17,"(420.16, 631.0]",4,8,-4
31225.0,2020-02-17,"(631.0, 841.0]",8,10,-2
31225.0,2020-02-17,"(841.0, 1051.0]",10,21,-11
31225.0,2020-02-17,"(1051.0, 1261.0]",1,3,-2
31226.0,2020-02-17,"(321.102, 546.5]",1,4,-3
31226.0,2020-02-17,"(546.5, 771.0]",4,5,-1
31226.0,2020-02-17,"(771.0, 995.5]",3,7,-4
31226.0,2020-02-17,"(995.5, 1220.0]",5,8,-3
31227.0,2020-02-17,"(422.2, 623.0]",5,6,-1
31227.0,2020-02-17,"(623.0, 823.0]",2,3,-1
31227.0,2020-02-17,"(823.0, 1023.0]",6,9,-3
31227.0,2020-02-17,"(1023.0, 1223.0]",2,6,-4
31228.0,2020-02-17,"(-0.379, 345.75]",1,1,0
31228.0,2020-02-17,"(345.75, 690.5]",15,19,-4
31228.0,2020-02-17,"(690.5, 1035.25]",21,40,-19
31228.0,2020-02-17,"(1035.25, 1380.0]",15,33,-18
31229.0,2020-02-17,"(10.582, 366.5]",8,10,-2
31229.0,2020-02-17,"(366.5, 721.0]",16,42,-26
31229.0,2020-02-17,"(721.0, 1075.5]",29,57,-28
31229.0,2020-02-17,"(1075.5, 1430.0]",22,39,-17
31230.0,2020-02-17,"(347.25, 674.5]",16,1,15
31230.0,2020-02-17,"(674.5, 1001.75]",10,20,-10
31230.0,2020-02-17,"(1001.75, 1329.0]",16,28,-12
31231.0,2020-02-17,"(381.062, 616.5]",1,2,-1
31231.0,2020-02-17,"(616.5, 851.0]",9,11,-2
31231.0,2020-02-17,"(851.0, 1085.5]",8,14,-6
31231.0,2020-02-17,"(1085.5, 1320.0]",1,2,-1
31232.0,2020-02-17,"(262.907, 537.25]",2,5,-3
31232.0,2020-02-17,"(537.25, 810.5]",15,24,-9
31232.0,2020-02-17,"(810.5, 1083.75]",23,40,-17
31232.0,2020-02-17,"(1083.75, 1357.0]",4,10,-6
31233.0,2020-02-17,"(329.048, 568.0]",8,10,-2
31233.0,2020-02-17,"(568.0, 806.0]",7,9,-2
31233.0,2020-02-17,"(806.0, 1044.0]",8,15,-7
31233.0,2020-02-17,"(1044.0, 1282.0]",7,15,-8
31234.0,2020-02-17,"(479.091, 707.25]",14,20,-6
31234.0,2020-02-17,"(707.25, 934.5]",23,40,-17
31234.0,2020-02-17,"(934.5, 1161.75]",12,28,-16
31234.0,2020-02-17,"(1161.75, 1389.0]",4,12,-8
31235.0,2020-02-17,"(552.593, 654.75]",2,3,-1
31235.0,2020-02-17,"(858.25, 960.0]",1,1,0
31236.0,2020-02-17,"(420.75, 759.5]",8,1,7
31236.0,2020-02-17,"(759.5, 1098.25]",21,13,8
31236.0,2020-02-17,"(1098.25, 1437.0]",8,38,-30
31237.0,2020-02-17,"(9.604, 360.0]",3,4,-1
31237.0,2020-02-17,"(360.0, 709.0]",2,13,-11
31237.0,2020-02-17,"(709.0, 1058.0]",15,22,-7
31237.0,2020-02-17,"(1058.0, 1407.0]",13,24,-11
31238.0,2020-02-17,"(60.792, 364.0]",1,1,0
31238.0,2020-02-17,"(364.0, 666.0]",9,10,-1
31238.0,2020-02-17,"(666.0, 968.0]",11,16,-5
31238.0,2020-02-17,"(968.0, 1270.0]",3,18,-15
31239.0,2020-02-17,"(374.072, 607.0]",6,10,-4
31239.0,2020-02-17,"(607.0, 839.0]",9,14,-5
31239.0,2020-02-17,"(839.0, 1071.0]",4,10,-6
31239.0,2020-02-17,"(1071.0, 1303.0]",3,15,-12
31240.0,2020-02-17,"(591.222, 786.5]",12,23,-11
31240.0,2020-02-17,"(786.5, 981.0]",18,38,-20
31240.0,2020-02-17,"(981.0, 1175.5]",10,17,-7
31240.0,2020-02-17,"(1175.5, 1370.0]",2,2,0
31241.0,2020-02-17,"(18.743, 334.25]",1,1,0
31241.0,2020-02-17,"(334.25, 648.5]",13,22,-9
31241.0,2020-02-17,"(648.5, 962.75]",10,27,-17
31241.0,2020-02-17,"(962.75, 1277.0]",30,47,-17
31242.0,2020-02-17,"(68.665, 403.75]",1,2,-1
31242.0,2020-02-17,"(403.75, 737.5]",4,5,-1
31242.0,2020-02-17,"(737.5, 1071.25]",9,20,-11
31242.0,2020-02-17,"(1071.25, 1405.0]",1,9,-8
31243.0,2020-02-17,"(449.108, 673.0]",4,4,0
31243.0,2020-02-17,"(673.0, 896.0]",4,8,-4
31243.0,2020-02-17,"(896.0, 1119.0]",3,6,-3
31243.0,2020-02-17,"(1119.0, 1342.0]",5,8,-3
31244.0,2020-02-17,"(428.062, 663.5]",1,5,-4
31244.0,2020-02-17,"(663.5, 898.0]",2,10,-8
31244.0,2020-02-17,"(898.0, 1132.5]",15,15,0
31244.0,2020-02-17,"(1132.5, 1367.0]",2,5,-3
31245.0,2020-02-17,"(415.039, 656.25]",4,8,-4
31245.0,2020-02-17,"(656.25, 896.5]",7,17,-10
31245.0,2020-02-17,"(896.5, 1136.75]",10,24,-14
31245.0,2020-02-17,"(1136.75, 1377.0]",7,12,-5
31246.0,2020-02-17,"(107.877, 389.75]",1,1,0
31246.0,2020-02-17,"(389.75, 670.5]",12,17,-5
31246.0,2020-02-17,"(670.5, 951.25]",23,36,-13
31246.0,2020-02-17,"(951.25, 1232.0]",14,29,-15
31247.0,2020-02-17,"(46.925, 316.75]",3,5,-2
31247.0,2020-02-17,"(316.75, 585.5]",1,1,0
31247.0,2020-02-17,"(585.5, 854.25]",30,52,-22
31247.0,2020-02-17,"(854.25, 1123.0]",27,73,-46
31248.0,2020-02-17,"(497.152, 710.0]",11,18,-7
31248.0,2020-02-17,"(710.0, 922.0]",31,62,-31
31248.0,2020-02-17,"(922.0, 1134.0]",33,56,-23
31248.0,2020-02-17,"(1134.0, 1346.0]",2,5,-3
31249.0,2020-02-17,"(657.593, 759.75]",4,9,-5
31249.0,2020-02-17,"(759.75, 861.5]",5,10,-5
31249.0,2020-02-17,"(861.5, 963.25]",9,17,-8
31249.0,2020-02-17,"(963.25, 1065.0]",9,22,-13
31250.0,2020-02-17,"(125.805, 425.75]",1,1,0
31250.0,2020-02-17,"(425.75, 724.5]",15,23,-8
31250.0,2020-02-17,"(724.5, 1023.25]",5,15,-10
31250.0,2020-02-17,"(1023.25, 1322.0]",2,16,-14
31251.0,2020-02-17,"(383.25, 717.5]",4,3,1
31251.0,2020-02-17,"(717.5, 1051.75]",13,16,-3
31251.0,2020-02-17,"(1051.75, 1386.0]",7,24,-17
31252.0,2020-02-17,"(482.208, 681.0]",5,7,-2
31252.0,2020-02-17,"(681.0, 879.0]",5,8,-3
31252.0,2020-02-17,"(879.0, 1077.0]",4,9,-5
31252.0,2020-02-17,"(1077.0, 1275.0]",2,7,-5
31253.0,2020-02-17,"(403.134, 620.5]",5,6,-1
31253.0,2020-02-17,"(620.5, 837.0]",4,9,-5
31253.0,2020-02-17,"(837.0, 1053.5]",3,4,-1
31253.0,2020-02-17,"(1053.5, 1270.0]",1,4,-3
31254.0,2020-02-17,"(411.986, 666.5]",3,3,0
31254.0,2020-02-17,"(666.5, 920.0]",5,8,-3
31254.0,2020-02-17,"(920.0, 1173.5]",2,11,-9
31255.0,2020-02-17,"(394.0, 731.0]",3,1,2
31255.0,2020-02-17,"(731.0, 1068.0]",7,5,2
31255.0,2020-02-17,"(1068.0, 1405.0]",3,10,-7
31256.0,2020-02-17,"(508.35, 671.5]",9,13,-4
31256.0,2020-02-17,"(671.5, 834.0]",8,9,-1
31256.0,2020-02-17,"(996.5, 1159.0]",2,1,1
31257.0,2020-02-17,"(355.979, 612.25]",5,5,0
31257.0,2020-02-17,"(612.25, 867.5]",4,12,-8
31257.0,2020-02-17,"(867.5, 1122.75]",6,12,-6
31257.0,2020-02-17,"(1122.75, 1378.0]",5,13,-8
31258.0,2020-02-17,"(387.963, 648.25]",4,12,-8
31258.0,2020-02-17,"(648.25, 907.5]",22,45,-23
31258.0,2020-02-17,"(907.5, 1166.75]",47,92,-45
31258.0,2020-02-17,"(1166.75, 1426.0]",10,15,-5
31259.0,2020-02-17,"(837.742, 902.5]",2,4,-2
31259.0,2020-02-17,"(902.5, 967.0]",2,3,-1
31260.0,2020-02-17,"(712.449, 850.75]",4,10,-6
31260.0,2020-02-17,"(850.75, 988.5]",3,4,-1
31260.0,2020-02-17,"(988.5, 1126.25]",3,3,0
31260.0,2020-02-17,"(1126.25, 1264.0]",3,4,-1
31261.0,2020-02-17,"(867.5, 975.25]",3,3,0
31261.0,2020-02-17,"(975.25, 1083.0]",5,9,-4
31262.0,2020-02-17,"(447.298, 623.5]",3,3,0
31262.0,2020-02-17,"(623.5, 799.0]",1,2,-1
31262.0,2020-02-17,"(799.0, 974.5]",4,7,-3
31262.0,2020-02-17,"(974.5, 1150.0]",3,8,-5
31263.0,2020-02-17,"(313.5, 626.0]",6,3,3
31263.0,2020-02-17,"(626.0, 938.5]",6,10,-4
31263.0,2020-02-17,"(938.5, 1251.0]",8,13,-5
31264.0,2020-02-17,"(358.172, 566.0]",1,2,-1
31264.0,2020-02-17,"(566.0, 773.0]",3,3,0
31264.0,2020-02-17,"(773.0, 980.0]",2,4,-2
31264.0,2020-02-17,"(980.0, 1187.0]",1,2,-1
31265.0,2020-02-17,"(406.048, 645.0]",5,11,-6
31265.0,2020-02-17,"(645.0, 883.0]",5,14,-9
31265.0,2020-02-17,"(883.0, 1121.0]",12,15,-3
31265.0,2020-02-17,"(1121.0, 1359.0]",3,7,-4
31266.0,2020-02-17,"(57.689, 386.75]",5,7,-2
31266.0,2020-02-17,"(386.75, 714.5]",6,30,-24
31266.0,2020-02-17,"(714.5, 1042.25]",22,46,-24
31266.0,2020-02-17,"(1042.25, 1370.0]",13,22,-9
31267.0,2020-02-17,"(359.0, 702.0]",7,2,5
31267.0,2020-02-17,"(702.0, 1045.0]",15,12,3
31267.0,2020-02-17,"(1045.0, 1388.0]",16,30,-14
31268.0,2020-02-17,"(21.612, 370.0]",2,7,-5
31268.0,2020-02-17,"(370.0, 717.0]",6,21,-15
31268.0,2020-02-17,"(717.0, 1064.0]",11,21,-10
31268.0,2020-02-17,"(1064.0, 1411.0]",17,25,-8
31269.0,2020-02-17,"(9.848, 299.0]",1,1,0
31269.0,2020-02-17,"(299.0, 587.0]",2,4,-2
31269.0,2020-02-17,"(587.0, 875.0]",5,13,-8
31269.0,2020-02-17,"(875.0, 1163.0]",7,12,-5
31270.0,2020-02-17,"(488.224, 683.0]",9,10,-1
31270.0,2020-02-17,"(683.0, 877.0]",11,18,-7
31270.0,2020-02-17,"(877.0, 1071.0]",5,13,-8
31270.0,2020-02-17,"(1071.0, 1265.0]",1,2,-1
31271.0,2020-02-17,"(517.255, 704.25]",13,13,0
31271.0,2020-02-17,"(704.25, 890.5]",10,16,-6
31271.0,2020-02-17,"(890.5, 1076.75]",13,32,-19
31271.0,2020-02-17,"(1076.75, 1263.0]",7,9,-2
31272.0,2020-02-17,"(69.748, 384.0]",1,2,-1
31272.0,2020-02-17,"(384.0, 697.0]",5,7,-2
31272.0,2020-02-17,"(697.0, 1010.0]",20,33,-13
31272.0,2020-02-17,"(1010.0, 1323.0]",3,6,-3
31273.0,2020-02-17,"(399.412, 547.0]",1,1,0
31273.0,2020-02-17,"(694.0, 841.0]",4,11,-7
31273.0,2020-02-17,"(841.0, 988.0]",2,5,-3
31274.0,2020-02-17,"(18.772, 327.0]",1,1,0
31274.0,2020-02-17,"(327.0, 634.0]",7,7,0
31274.0,2020-02-17,"(634.0, 941.0]",8,12,-4
31274.0,2020-02-17,"(941.0, 1248.0]",4,9,-5
31275.0,2020-02-17,"(122.853, 410.75]",2,3,-1
31275.0,2020-02-17,"(410.75, 697.5]",2,11,-9
31275.0,2020-02-17,"(697.5, 984.25]",4,9,-5
31275.0,2020-02-17,"(984.25, 1271.0]",8,11,-3
31276.0,2020-02-17,"(99.859, 386.25]",2,3,-1
31276.0,2020-02-17,"(386.25, 671.5]",8,16,-8
31276.0,2020-02-17,"(671.5, 956.75]",13,19,-6
31276.0,2020-02-17,"(956.75, 1242.0]",4,8,-4
31277.0,2020-02-17,"(483.26, 669.0]",6,9,-3
31277.0,2020-02-17,"(669.0, 854.0]",14,25,-11
31277.0,2020-02-17,"(854.0, 1039.0]",7,17,-10
31277.0,2020-02-17,"(1039.0, 1224.0]",3,12,-9
31278.0,2020-02-17,"(38.722, 359.5]",1,1,0
31278.0,2020-02-17,"(359.5, 679.0]",6,13,-7
31278.0,2020-02-17,"(679.0, 998.5]",15,26,-11
31278.0,2020-02-17,"(998.5, 1318.0]",6,15,-9
31279.0,2020-02-17,"(658.656, 745.0]",1,2,-1
31279.0,2020-02-17,"(831.0, 917.0]",1,1,0
31279.0,2020-02-17,"(917.0, 1003.0]",1,1,0
31280.0,2020-02-17,"(122.688, 452.0]",2,5,-3
31280.0,2020-02-17,"(452.0, 780.0]",5,13,-8
31280.0,2020-02-17,"(780.0, 1108.0]",9,19,-10
31280.0,2020-02-17,"(1108.0, 1436.0]",5,10,-5
31000.0,2020-02-18,"(918.5, 1132.75]",1,1,0
31000.0,2020-02-18,"(1132.75, 1347.0]",1,2,-1
31001.0,2020-02-18,"(615.25, 799.5]",1,1,0
31001.0,2020-02-18,"(983.75, 1168.0]",3,1,2
31002.0,2020-02-18,"(417.314, 589.5]",5,7,-2
31002.0,2020-02-18,"(761.0, 932.5]",1,3,-2
31002.0,2020-02-18,"(932.5, 1104.0]",2,7,-5
31003.0,2020-02-18,"(404.273, 586.75]",2,4,-2
31003.0,2020-02-18,"(586.75, 768.5]",1,3,-2
31003.0,2020-02-18,"(768.5, 950.25]",1,1,0
31003.0,2020-02-18,"(950.25, 1132.0]",5,8,-3
31004.0,2020-02-18,"(765.5, 908.25]",1,1,0
31004.0,2020-02-18,"(908.25, 1051.0]",1,1,0
31005.0,2020-02-18,"(419.218, 615.5]",4,5,-1
31005.0,2020-02-18,"(615.5, 811.0]",1,1,0
31005.0,2020-02-18,"(811.0, 1006.5]",1,2,-1
31005.0,2020-02-18,"(1006.5, 1202.0]",2,7,-5
31006.0,2020-02-18,"(976.815, 1023.25]",3,3,0
31007.0,2020-02-18,"(362.07, 595.5]",8,20,-12
31007.0,2020-02-18,"(595.5, 828.0]",1,2,-1
31007.0,2020-02-18,"(828.0, 1060.5]",7,17,-10
31007.0,2020-02-18,"(1060.5, 1293.0]",7,15,-8
31009.0,2020-02-18,"(454.358, 615.5]",4,5,-1
31010.0,2020-02-18,"(2.603, 353.25]",1,1,0
31010.0,2020-02-18,"(353.25, 702.5]",2,2,0
31010.0,2020-02-18,"(1051.75, 1401.0]",2,3,-1
31011.0,2020-02-18,"(329.001, 579.75]",6,8,-2
31011.0,2020-02-18,"(579.75, 829.5]",3,4,-1
31012.0,2020-02-18,"(366.238, 557.5]",3,3,0
31012.0,2020-02-18,"(748.0, 938.5]",1,1,0
31013.0,2020-02-18,"(393.246, 582.5]",1,4,-3
31013.0,2020-02-18,"(582.5, 771.0]",1,1,0
31013.0,2020-02-18,"(771.0, 959.5]",1,3,-2
31013.0,2020-02-18,"(959.5, 1148.0]",4,9,-5
31014.0,2020-02-18,"(338.019, 584.25]",22,29,-7
31014.0,2020-02-18,"(584.25, 829.5]",9,16,-7
31014.0,2020-02-18,"(829.5, 1074.75]",9,17,-8
31014.0,2020-02-18,"(1074.75, 1320.0]",13,22,-9
31015.0,2020-02-18,"(56.8, 358.0]",2,3,-1
31015.0,2020-02-18,"(358.0, 658.0]",12,14,-2
31015.0,2020-02-18,"(658.0, 958.0]",5,11,-6
31015.0,2020-02-18,"(958.0, 1258.0]",9,15,-6
31016.0,2020-02-18,"(428.138, 644.5]",5,10,-5
31016.0,2020-02-18,"(644.5, 860.0]",3,6,-3
31016.0,2020-02-18,"(860.0, 1075.5]",3,7,-4
31016.0,2020-02-18,"(1075.5, 1291.0]",4,8,-4
31017.0,2020-02-18,"(490.423, 635.25]",4,5,-1
31017.0,2020-02-18,"(635.25, 779.5]",1,1,0
31017.0,2020-02-18,"(779.5, 923.75]",1,3,-2
31018.0,2020-02-18,"(637.75, 836.5]",1,7,-6
31018.0,2020-02-18,"(1035.25, 1234.0]",3,1,2
31019.0,2020-02-18,"(447.26, 633.0]",1,2,-1
31019.0,2020-02-18,"(633.0, 818.0]",1,2,-1
31019.0,2020-02-18,"(818.0, 1003.0]",1,1,0
31019.0,2020-02-18,"(1003.0, 1188.0]",1,6,-5
31020.0,2020-02-18,"(1046.75, 1384.0]",1,1,0
31021.0,2020-02-18,"(461.12, 682.0]",1,2,-1
31021.0,2020-02-18,"(682.0, 902.0]",3,6,-3
31021.0,2020-02-18,"(902.0, 1122.0]",3,6,-3
31021.0,2020-02-18,"(1122.0, 1342.0]",3,9,-6
31022.0,2020-02-18,"(508.237, 699.75]",1,5,-4
31022.0,2020-02-18,"(699.75, 890.5]",2,2,0
31022.0,2020-02-18,"(890.5, 1081.25]",4,6,-2
31022.0,2020-02-18,"(1081.25, 1272.0]",3,8,-5
31023.0,2020-02-18,"(496.279, 677.25]",1,2,-1
31024.0,2020-02-18,"(413.057, 649.75]",6,10,-4
31024.0,2020-02-18,"(649.75, 885.5]",2,2,0
31024.0,2020-02-18,"(885.5, 1121.25]",3,11,-8
31024.0,2020-02-18,"(1121.25, 1357.0]",1,5,-4
31025.0,2020-02-18,"(1052.5, 1207.0]",2,1,1
31026.0,2020-02-18,"(409.074, 641.5]",1,3,-2
31026.0,2020-02-18,"(1104.5, 1336.0]",2,6,-4
31027.0,2020-02-18,"(1010.0, 1154.0]",2,2,0
31028.0,2020-02-18,"(893.689, 971.75]",1,1,0
31028.0,2020-02-18,"(971.75, 1049.5]",1,1,0
31029.0,2020-02-18,"(858.5, 1078.75]",1,9,-8
31029.0,2020-02-18,"(1078.75, 1299.0]",3,1,2
31030.0,2020-02-18,"(676.5, 893.0]",1,8,-7
31030.0,2020-02-18,"(893.0, 1109.5]",4,2,2
31030.0,2020-02-18,"(1109.5, 1326.0]",2,4,-2
31031.0,2020-02-18,"(1008.25, 1205.0]",4,2,2
31032.0,2020-02-18,"(1196.868, 1230.0]",1,1,0
31032.0,2020-02-18,"(1230.0, 1263.0]",1,1,0
31033.0,2020-02-18,"(1057.0, 1087.0]",1,1,0
31034.0,2020-02-18,"(402.008, 651.0]",2,5,-3
31034.0,2020-02-18,"(899.0, 1147.0]",2,1,1
31034.0,2020-02-18,"(1147.0, 1395.0]",4,7,-3
31035.0,2020-02-18,"(441.069, 674.75]",1,2,-1
31035.0,2020-02-18,"(907.5, 1140.25]",2,3,-1
31035.0,2020-02-18,"(1140.25, 1373.0]",1,3,-2
31036.0,2020-02-18,"(448.061, 683.75]",1,4,-3
31036.0,2020-02-18,"(918.5, 1153.25]",4,4,0
31036.0,2020-02-18,"(1153.25, 1388.0]",1,2,-1
31037.0,2020-02-18,"(400.024, 645.0]",11,16,-5
31037.0,2020-02-18,"(645.0, 889.0]",3,3,0
31037.0,2020-02-18,"(889.0, 1133.0]",4,15,-11
31037.0,2020-02-18,"(1133.0, 1377.0]",1,5,-4
31038.0,2020-02-18,"(429.227, 623.25]",1,5,-4
31039.0,2020-02-18,"(397.148, 611.0]",3,5,-2
31039.0,2020-02-18,"(824.0, 1037.0]",3,2,1
31039.0,2020-02-18,"(1037.0, 1250.0]",3,5,-2
31040.0,2020-02-18,"(416.11, 639.5]",2,2,0
31040.0,2020-02-18,"(1084.5, 1307.0]",1,2,-1
31041.0,2020-02-18,"(512.986, 516.5]",1,2,-1
31041.0,2020-02-18,"(523.5, 527.0]",1,1,0
31042.0,2020-02-18,"(441.033, 683.75]",3,4,-1
31042.0,2020-02-18,"(683.75, 925.5]",1,3,-2
31042.0,2020-02-18,"(925.5, 1167.25]",1,6,-5
31042.0,2020-02-18,"(1167.25, 1409.0]",1,2,-1
31043.0,2020-02-18,"(453.196, 655.0]",3,3,0
31043.0,2020-02-18,"(1057.0, 1258.0]",3,1,2
31044.0,2020-02-18,"(590.299, 766.25]",3,3,0
31044.0,2020-02-18,"(1116.75, 1292.0]",2,1,1
31045.0,2020-02-18,"(518.573, 625.75]",1,2,-1
31046.0,2020-02-18,"(396.319, 567.25]",1,2,-1
31046.0,2020-02-18,"(907.75, 1078.0]",1,1,0
31047.0,2020-02-18,"(371.99, 625.5]",9,14,-5
31047.0,2020-02-18,"(625.5, 878.0]",1,2,-1
31047.0,2020-02-18,"(878.0, 1130.5]",4,14,-10
31047.0,2020-02-18,"(1130.5, 1383.0]",4,8,-4
31048.0,2020-02-18,"(482.422, 627.5]",1,4,-3
31048.0,2020-02-18,"(772.0, 916.5]",1,1,0
31048.0,2020-02-18,"(916.5, 1061.0]",1,3,-2
31049.0,2020-02-18,"(445.223, 640.25]",1,3,-2
31049.0,2020-02-18,"(640.25, 834.5]",1,1,0
31049.0,2020-02-18,"(834.5, 1028.75]",1,1,0
31049.0,2020-02-18,"(1028.75, 1223.0]",1,2,-1
31050.0,2020-02-18,"(924.0, 1061.0]",2,2,0
31051.0,2020-02-18,"(525.75, 752.5]",3,3,0
31051.0,2020-02-18,"(752.5, 979.25]",1,6,-5
31051.0,2020-02-18,"(979.25, 1206.0]",7,2,5
31052.0,2020-02-18,"(390.981, 646.75]",2,4,-2
31052.0,2020-02-18,"(901.5, 1156.25]",2,5,-3
31052.0,2020-02-18,"(1156.25, 1411.0]",3,3,0
31053.0,2020-02-18,"(952.833, 994.75]",1,1,0
31053.0,2020-02-18,"(1078.25, 1120.0]",1,2,-1
31054.0,2020-02-18,"(774.75, 850.5]",2,2,0
31054.0,2020-02-18,"(926.25, 1002.0]",1,3,-2
31055.0,2020-02-18,"(405.313, 577.75]",1,3,-2
31055.0,2020-02-18,"(921.25, 1093.0]",4,5,-1
31056.0,2020-02-18,"(997.0, 1153.0]",1,1,0
31057.0,2020-02-18,"(543.0, 724.0]",1,1,0
31058.0,2020-02-18,"(786.0, 1048.0]",1,1,0
31059.0,2020-02-18,"(567.5, 851.25]",1,1,0
31059.0,2020-02-18,"(851.25, 1135.0]",3,1,2
31060.0,2020-02-18,"(869.436, 1011.0]",2,3,-1
31061.0,2020-02-18,"(1135.0, 1349.0]",1,2,-1
31062.0,2020-02-18,"(486.378, 642.5]",3,7,-4
31062.0,2020-02-18,"(642.5, 798.0]",3,6,-3
31062.0,2020-02-18,"(798.0, 953.5]",1,1,0
31062.0,2020-02-18,"(953.5, 1109.0]",3,10,-7
31063.0,2020-02-18,"(1435.0, 1438.0]",1,1,0
31064.0,2020-02-18,"(485.317, 656.75]",1,2,-1
31064.0,2020-02-18,"(656.75, 827.5]",1,2,-1
31064.0,2020-02-18,"(827.5, 998.25]",1,2,-1
31064.0,2020-02-18,"(998.25, 1169.0]",3,6,-3
31065.0,2020-02-18,"(70.047, 309.25]",1,1,0
31065.0,2020-02-18,"(547.5, 785.75]",1,1,0
31065.0,2020-02-18,"(785.75, 1024.0]",2,2,0
31066.0,2020-02-18,"(648.0, 794.0]",3,2,1
31066.0,2020-02-18,"(940.0, 1086.0]",1,3,-2
31067.0,2020-02-18,"(656.0, 812.0]",1,3,-2
31067.0,2020-02-18,"(968.0, 1124.0]",2,1,1
31068.0,2020-02-18,"(560.208, 759.0]",1,2,-1
31068.0,2020-02-18,"(759.0, 957.0]",1,1,0
31068.0,2020-02-18,"(1155.0, 1353.0]",2,2,0
31069.0,2020-02-18,"(795.0, 981.0]",2,6,-4
31069.0,2020-02-18,"(981.0, 1167.0]",3,2,1
31070.0,2020-02-18,"(471.129, 689.75]",3,7,-4
31070.0,2020-02-18,"(1125.25, 1343.0]",4,1,3
31071.0,2020-02-18,"(323.125, 542.75]",2,6,-4
31071.0,2020-02-18,"(761.5, 980.25]",5,3,2
31071.0,2020-02-18,"(980.25, 1199.0]",2,7,-5
,,,,2.0,
31073.0,2020-02-18,"(415.637, 506.75]",2,3,-1
31073.0,2020-02-18,"(506.75, 597.5]",1,1,0
31073.0,2020-02-18,"(597.5, 688.25]",3,7,-4
31073.0,2020-02-18,"(688.25, 779.0]",1,3,-2
31074.0,2020-02-18,"(794.5, 963.25]",2,2,0
31074.0,2020-02-18,"(963.25, 1132.0]",2,2,0
31075.0,2020-02-18,"(826.5, 1102.0]",1,1,0
31076.0,2020-02-18,"(1056.833, 1098.75]",2,2,0
31076.0,2020-02-18,"(1182.25, 1224.0]",1,1,0
31077.0,2020-02-18,"(468.261, 653.75]",8,19,-11
31077.0,2020-02-18,"(653.75, 838.5]",3,6,-3
31077.0,2020-02-18,"(838.5, 1023.25]",3,3,0
31077.0,2020-02-18,"(1023.25, 1208.0]",4,4,0
31078.0,2020-02-18,"(472.395, 624.25]",7,7,0
31078.0,2020-02-18,"(926.75, 1078.0]",1,1,0
31079.0,2020-02-18,"(490.155, 702.25]",1,5,-4
31079.0,2020-02-18,"(913.5, 1124.75]",1,3,-2
31079.0,2020-02-18,"(1124.75, 1336.0]",3,2,1
31080.0,2020-02-18,"(400.014, 647.5]",2,9,-7
31080.0,2020-02-18,"(647.5, 894.0]",1,1,0
31080.0,2020-02-18,"(894.0, 1140.5]",7,9,-2
31080.0,2020-02-18,"(1140.5, 1387.0]",5,5,0
31081.0,2020-02-18,"(484.3, 660.0]",2,4,-2
31081.0,2020-02-18,"(835.0, 1010.0]",2,1,1
31081.0,2020-02-18,"(1010.0, 1185.0]",1,3,-2
31082.0,2020-02-18,"(496.242, 686.5]",1,1,0
31083.0,2020-02-18,"(932.0, 1109.0]",5,2,3
31084.0,2020-02-18,"(523.185, 727.75]",5,6,-1
31084.0,2020-02-18,"(727.75, 931.5]",1,2,-1
31085.0,2020-02-18,"(401.239, 592.25]",1,5,-4
31085.0,2020-02-18,"(972.75, 1163.0]",4,4,0
31086.0,2020-02-18,"(612.481, 742.75]",1,1,0
31086.0,2020-02-18,"(1002.25, 1132.0]",1,1,0
,,,,2.0,
31088.0,2020-02-18,"(89.019, 335.25]",1,1,0
31088.0,2020-02-18,"(825.75, 1071.0]",5,2,3
31089.0,2020-02-18,"(447.101, 672.75]",6,9,-3
31089.0,2020-02-18,"(672.75, 897.5]",3,9,-6
31089.0,2020-02-18,"(897.5, 1122.25]",7,20,-13
31089.0,2020-02-18,"(1122.25, 1347.0]",6,18,-12
31090.0,2020-02-18,"(621.0, 717.5]",1,1,0
31090.0,2020-02-18,"(717.5, 814.0]",1,1,0
31091.0,2020-02-18,"(970.0, 1154.0]",6,4,2
31092.0,2020-02-18,"(921.0, 1138.5]",1,2,-1
31092.0,2020-02-18,"(1138.5, 1356.0]",1,1,0
31093.0,2020-02-18,"(624.5, 852.0]",1,3,-2
31093.0,2020-02-18,"(1079.5, 1307.0]",1,1,0
,,,,1.0,
,,,,1.0,
,,,,3.0,
,,,,1.0,
,,,,2.0,
31096.0,2020-02-18,"(1186.25, 1274.0]",1,1,0
31097.0,2020-02-18,"(477.064, 712.0]",2,4,-2
31097.0,2020-02-18,"(712.0, 946.0]",1,1,0
31097.0,2020-02-18,"(946.0, 1180.0]",1,2,-1
31097.0,2020-02-18,"(1180.0, 1414.0]",3,5,-2
31098.0,2020-02-18,"(433.117, 654.75]",3,6,-3
31098.0,2020-02-18,"(875.5, 1096.25]",6,7,-1
31099.0,2020-02-18,"(1061.87, 1094.5]",1,1,0
31099.0,2020-02-18,"(1159.5, 1192.0]",1,1,0
31100.0,2020-02-18,"(817.683, 897.25]",2,4,-2
31100.0,2020-02-18,"(897.25, 976.5]",1,2,-1
31101.0,2020-02-18,"(10.59, 364.5]",2,4,-2
31101.0,2020-02-18,"(364.5, 717.0]",14,54,-40
31101.0,2020-02-18,"(717.0, 1069.5]",19,29,-10
31101.0,2020-02-18,"(1069.5, 1422.0]",31,50,-19
31102.0,2020-02-18,"(-1.274, 318.5]",1,1,0
31102.0,2020-02-18,"(318.5, 637.0]",1,19,-18
31102.0,2020-02-18,"(637.0, 955.5]",2,3,-1
31102.0,2020-02-18,"(955.5, 1274.0]",12,19,-7
31103.0,2020-02-18,"(649.5, 892.0]",2,24,-22
31103.0,2020-02-18,"(892.0, 1134.5]",8,7,1
31103.0,2020-02-18,"(1134.5, 1377.0]",6,18,-12
31104.0,2020-02-18,"(315.889, 594.75]",5,21,-16
31104.0,2020-02-18,"(594.75, 872.5]",7,12,-5
31104.0,2020-02-18,"(872.5, 1150.25]",20,31,-11
31104.0,2020-02-18,"(1150.25, 1428.0]",9,17,-8
31105.0,2020-02-18,"(332.028, 576.0]",2,5,-3
31105.0,2020-02-18,"(576.0, 819.0]",1,1,0
31105.0,2020-02-18,"(819.0, 1062.0]",2,5,-3
31105.0,2020-02-18,"(1062.0, 1305.0]",3,10,-7
31106.0,2020-02-18,"(595.5, 832.0]",3,5,-2
31106.0,2020-02-18,"(832.0, 1068.5]",2,4,-2
31106.0,2020-02-18,"(1068.5, 1305.0]",5,4,1
31107.0,2020-02-18,"(335.955, 598.25]",4,21,-17
31107.0,2020-02-18,"(598.25, 859.5]",4,5,-1
31107.0,2020-02-18,"(859.5, 1120.75]",12,22,-10
31107.0,2020-02-18,"(1120.75, 1382.0]",7,13,-6
31108.0,2020-02-18,"(368.126, 587.5]",7,35,-28
31108.0,2020-02-18,"(587.5, 806.0]",4,8,-4
31108.0,2020-02-18,"(806.0, 1024.5]",11,22,-11
31108.0,2020-02-18,"(1024.5, 1243.0]",30,39,-9
31109.0,2020-02-18,"(443.181, 648.75]",5,19,-14
31109.0,2020-02-18,"(648.75, 853.5]",6,10,-4
31109.0,2020-02-18,"(853.5, 1058.25]",4,10,-6
31109.0,2020-02-18,"(1058.25, 1263.0]",18,24,-6
31110.0,2020-02-18,"(329.906, 604.5]",19,38,-19
31110.0,2020-02-18,"(604.5, 878.0]",5,14,-9
31110.0,2020-02-18,"(878.0, 1151.5]",22,35,-13
31110.0,2020-02-18,"(1151.5, 1425.0]",9,19,-10
31111.0,2020-02-18,"(128.731, 447.25]",6,8,-2
31111.0,2020-02-18,"(447.25, 764.5]",3,21,-18
31111.0,2020-02-18,"(764.5, 1081.75]",6,13,-7
31111.0,2020-02-18,"(1081.75, 1399.0]",14,20,-6
31112.0,2020-02-18,"(410.102, 635.5]",1,3,-2
31112.0,2020-02-18,"(860.0, 1084.5]",4,4,0
31112.0,2020-02-18,"(1084.5, 1309.0]",3,4,-1
31113.0,2020-02-18,"(39.677, 371.75]",1,4,-3
31113.0,2020-02-18,"(702.5, 1033.25]",5,16,-11
31113.0,2020-02-18,"(1033.25, 1364.0]",16,16,0
31114.0,2020-02-18,"(17.693, 345.75]",1,1,0
31114.0,2020-02-18,"(345.75, 672.5]",3,27,-24
31114.0,2020-02-18,"(672.5, 999.25]",7,15,-8
31114.0,2020-02-18,"(999.25, 1326.0]",22,36,-14
31115.0,2020-02-18,"(469.75, 692.5]",1,5,-4
31115.0,2020-02-18,"(692.5, 915.25]",1,16,-15
31115.0,2020-02-18,"(915.25, 1138.0]",10,4,6
31116.0,2020-02-18,"(346.921, 617.75]",7,25,-18
31116.0,2020-02-18,"(617.75, 887.5]",2,4,-2
31116.0,2020-02-18,"(887.5, 1157.25]",16,21,-5
31116.0,2020-02-18,"(1157.25, 1427.0]",5,10,-5
31117.0,2020-02-18,"(64.7, 391.0]",2,4,-2
31117.0,2020-02-18,"(391.0, 716.0]",2,12,-10
31117.0,2020-02-18,"(716.0, 1041.0]",9,23,-14
31117.0,2020-02-18,"(1041.0, 1366.0]",16,29,-13
31118.0,2020-02-18,"(362.0, 678.0]",2,2,0
31118.0,2020-02-18,"(678.0, 994.0]",2,13,-11
31118.0,2020-02-18,"(994.0, 1310.0]",15,3,12
31119.0,2020-02-18,"(167.832, 461.0]",3,8,-5
31119.0,2020-02-18,"(461.0, 753.0]",2,11,-9
31119.0,2020-02-18,"(753.0, 1045.0]",8,10,-2
31119.0,2020-02-18,"(1045.0, 1337.0]",18,31,-13
31120.0,2020-02-18,"(163.742, 479.5]",1,5,-4
31120.0,2020-02-18,"(479.5, 794.0]",2,16,-14
31120.0,2020-02-18,"(794.0, 1108.5]",11,12,-1
31120.0,2020-02-18,"(1108.5, 1423.0]",11,14,-3
31121.0,2020-02-18,"(376.064, 611.0]",15,22,-7
31121.0,2020-02-18,"(611.0, 845.0]",1,5,-4
31121.0,2020-02-18,"(845.0, 1079.0]",4,15,-11
31121.0,2020-02-18,"(1079.0, 1313.0]",5,11,-6
31122.0,2020-02-18,"(426.03, 669.5]",1,11,-10
31122.0,2020-02-18,"(669.5, 912.0]",2,4,-2
31122.0,2020-02-18,"(912.0, 1154.5]",9,17,-8
31122.0,2020-02-18,"(1154.5, 1397.0]",10,17,-7
31123.0,2020-02-18,"(303.897, 580.75]",3,18,-15
31123.0,2020-02-18,"(580.75, 856.5]",2,10,-8
31123.0,2020-02-18,"(856.5, 1132.25]",3,7,-4
31123.0,2020-02-18,"(1132.25, 1408.0]",2,4,-2
31124.0,2020-02-18,"(20.598, 372.5]",3,4,-1
31124.0,2020-02-18,"(372.5, 723.0]",11,47,-36
31124.0,2020-02-18,"(723.0, 1073.5]",18,44,-26
31124.0,2020-02-18,"(1073.5, 1424.0]",21,50,-29
31125.0,2020-02-18,"(340.043, 580.25]",7,32,-25
31125.0,2020-02-18,"(580.25, 819.5]",3,6,-3
31125.0,2020-02-18,"(819.5, 1058.75]",14,19,-5
31125.0,2020-02-18,"(1058.75, 1298.0]",16,23,-7
31126.0,2020-02-18,"(334.948, 599.0]",3,25,-22
31126.0,2020-02-18,"(599.0, 862.0]",1,6,-5
31126.0,2020-02-18,"(862.0, 1125.0]",16,22,-6
31126.0,2020-02-18,"(1125.0, 1388.0]",11,20,-9
31127.0,2020-02-18,"(464.063, 699.25]",19,22,-3
31127.0,2020-02-18,"(699.25, 933.5]",4,8,-4
31127.0,2020-02-18,"(933.5, 1167.75]",13,36,-23
31127.0,2020-02-18,"(1167.75, 1402.0]",3,11,-8
31128.0,2020-02-18,"(403.5, 747.0]",29,2,27
31128.0,2020-02-18,"(747.0, 1090.5]",17,42,-25
31128.0,2020-02-18,"(1090.5, 1434.0]",9,35,-26
31129.0,2020-02-18,"(366.054, 603.5]",11,17,-6
31129.0,2020-02-18,"(603.5, 840.0]",4,6,-2
31129.0,2020-02-18,"(840.0, 1076.5]",11,25,-14
31129.0,2020-02-18,"(1076.5, 1313.0]",11,17,-6
31130.0,2020-02-18,"(26.613, 374.75]",2,2,0
31130.0,2020-02-18,"(374.75, 721.5]",4,22,-18
31130.0,2020-02-18,"(721.5, 1068.25]",5,12,-7
31130.0,2020-02-18,"(1068.25, 1415.0]",14,15,-1
31131.0,2020-02-18,"(367.942, 633.5]",1,7,-6
31131.0,2020-02-18,"(633.5, 898.0]",1,4,-3
31131.0,2020-02-18,"(898.0, 1162.5]",3,9,-6
31131.0,2020-02-18,"(1162.5, 1427.0]",3,4,-1
31200.0,2020-02-18,"(14.641, 355.75]",1,3,-2
31200.0,2020-02-18,"(355.75, 695.5]",13,24,-11
31200.0,2020-02-18,"(695.5, 1035.25]",17,32,-15
31200.0,2020-02-18,"(1035.25, 1375.0]",22,44,-22
31201.0,2020-02-18,"(116.736, 434.0]",10,14,-4
31201.0,2020-02-18,"(434.0, 750.0]",15,40,-25
31201.0,2020-02-18,"(750.0, 1066.0]",26,41,-15
31201.0,2020-02-18,"(1066.0, 1382.0]",33,70,-37
,,,,2.0,
31203.0,2020-02-18,"(352.94, 619.0]",13,34,-21
31203.0,2020-02-18,"(619.0, 884.0]",14,23,-9
31203.0,2020-02-18,"(884.0, 1149.0]",23,32,-9
31203.0,2020-02-18,"(1149.0, 1414.0]",6,15,-9
31204.0,2020-02-18,"(405.006, 654.5]",27,33,-6
31204.0,2020-02-18,"(654.5, 903.0]",10,15,-5
31204.0,2020-02-18,"(903.0, 1151.5]",6,16,-10
31204.0,2020-02-18,"(1151.5, 1400.0]",1,3,-2
31205.0,2020-02-18,"(372.5, 717.0]",46,4,42
31205.0,2020-02-18,"(717.0, 1061.5]",26,54,-28
31205.0,2020-02-18,"(1061.5, 1406.0]",14,46,-32
31206.0,2020-02-18,"(455.281, 635.75]",3,3,0
31206.0,2020-02-18,"(815.5, 995.25]",1,3,-2
31206.0,2020-02-18,"(995.25, 1175.0]",5,12,-7
31207.0,2020-02-18,"(615.25, 880.5]",3,2,1
31207.0,2020-02-18,"(880.5, 1145.75]",6,4,2
31207.0,2020-02-18,"(1145.75, 1411.0]",7,7,0
31208.0,2020-02-18,"(393.063, 628.25]",6,9,-3
31208.0,2020-02-18,"(628.25, 862.5]",1,2,-1
31208.0,2020-02-18,"(862.5, 1096.75]",4,18,-14
31208.0,2020-02-18,"(1096.75, 1331.0]",6,8,-2
31209.0,2020-02-18,"(461.131, 679.25]",4,4,0
31209.0,2020-02-18,"(679.25, 896.5]",1,2,-1
31209.0,2020-02-18,"(896.5, 1113.75]",6,9,-3
31209.0,2020-02-18,"(1113.75, 1331.0]",4,4,0
31211.0,2020-02-18,"(437.149, 650.75]",13,17,-4
31211.0,2020-02-18,"(650.75, 863.5]",1,2,-1
31211.0,2020-02-18,"(863.5, 1076.25]",4,7,-3
31211.0,2020-02-18,"(1076.25, 1289.0]",2,6,-4
31212.0,2020-02-18,"(8.581, 364.75]",1,2,-1
31212.0,2020-02-18,"(364.75, 719.5]",37,57,-20
31212.0,2020-02-18,"(719.5, 1074.25]",24,50,-26
31212.0,2020-02-18,"(1074.25, 1429.0]",10,24,-14
31213.0,2020-02-18,"(265.84, 557.0]",24,38,-14
31213.0,2020-02-18,"(557.0, 847.0]",7,15,-8
31213.0,2020-02-18,"(847.0, 1137.0]",13,31,-18
31213.0,2020-02-18,"(1137.0, 1427.0]",7,14,-7
31214.0,2020-02-18,"(368.75, 695.5]",11,3,8
31214.0,2020-02-18,"(695.5, 1022.25]",20,32,-12
31214.0,2020-02-18,"(1022.25, 1349.0]",24,32,-8
31215.0,2020-02-18,"(444.062, 679.5]",22,27,-5
31215.0,2020-02-18,"(679.5, 914.0]",9,10,-1
31215.0,2020-02-18,"(914.0, 1148.5]",7,17,-10
31216.0,2020-02-18,"(443.234, 635.5]",19,23,-4
31216.0,2020-02-18,"(635.5, 827.0]",4,7,-3
31216.0,2020-02-18,"(827.0, 1018.5]",2,8,-6
31216.0,2020-02-18,"(1018.5, 1210.0]",1,21,-20
31217.0,2020-02-18,"(397.15, 610.5]",10,12,-2
31217.0,2020-02-18,"(610.5, 823.0]",2,6,-4
31217.0,2020-02-18,"(1035.5, 1248.0]",2,9,-7
31218.0,2020-02-18,"(310.064, 545.0]",14,23,-9
31218.0,2020-02-18,"(545.0, 779.0]",8,10,-2
31218.0,2020-02-18,"(779.0, 1013.0]",3,4,-1
31218.0,2020-02-18,"(1013.0, 1247.0]",8,23,-15
31219.0,2020-02-18,"(362.26, 548.0]",7,7,0
31219.0,2020-02-18,"(548.0, 733.0]",7,9,-2
31219.0,2020-02-18,"(733.0, 918.0]",3,6,-3
31219.0,2020-02-18,"(918.0, 1103.0]",6,17,-11
31220.0,2020-02-18,"(380.138, 596.5]",7,14,-7
31220.0,2020-02-18,"(596.5, 812.0]",1,2,-1
31220.0,2020-02-18,"(812.0, 1027.5]",2,9,-7
31220.0,2020-02-18,"(1027.5, 1243.0]",2,13,-11
31221.0,2020-02-18,"(96.727, 416.25]",1,2,-1
31221.0,2020-02-18,"(416.25, 734.5]",24,27,-3
31221.0,2020-02-18,"(734.5, 1052.75]",11,27,-16
31221.0,2020-02-18,"(1052.75, 1371.0]",8,27,-19
31222.0,2020-02-18,"(315.938, 582.5]",16,18,-2
31222.0,2020-02-18,"(582.5, 848.0]",11,13,-2
31222.0,2020-02-18,"(848.0, 1113.5]",4,16,-12
31222.0,2020-02-18,"(1113.5, 1379.0]",1,2,-1
31223.0,2020-02-18,"(7.573, 365.75]",3,4,-1
31223.0,2020-02-18,"(365.75, 722.5]",11,40,-29
31223.0,2020-02-18,"(722.5, 1079.25]",10,22,-12
31223.0,2020-02-18,"(1079.25, 1436.0]",9,19,-10
31224.0,2020-02-18,"(466.235, 658.25]",17,18,-1
31224.0,2020-02-18,"(658.25, 849.5]",6,15,-9
31224.0,2020-02-18,"(849.5, 1040.75]",4,12,-8
31224.0,2020-02-18,"(1040.75, 1232.0]",2,11,-9
31225.0,2020-02-18,"(426.018, 672.5]",6,11,-5
31225.0,2020-02-18,"(672.5, 918.0]",1,2,-1
31225.0,2020-02-18,"(918.0, 1163.5]",7,17,-10
31225.0,2020-02-18,"(1163.5, 1409.0]",2,5,-3
31226.0,2020-02-18,"(318.024, 563.0]",2,6,-4
31226.0,2020-02-18,"(563.0, 807.0]",4,9,-5
31226.0,2020-02-18,"(807.0, 1051.0]",4,12,-8
31226.0,2020-02-18,"(1051.0, 1295.0]",6,10,-4
31227.0,2020-02-18,"(70.741, 386.75]",2,3,-1
31227.0,2020-02-18,"(386.75, 701.5]",19,21,-2
31227.0,2020-02-18,"(701.5, 1016.25]",3,11,-8
31227.0,2020-02-18,"(1016.25, 1331.0]",8,30,-22
31228.0,2020-02-18,"(377.006, 626.5]",16,18,-2
31228.0,2020-02-18,"(626.5, 875.0]",11,23,-12
31228.0,2020-02-18,"(875.0, 1123.5]",23,39,-16
31228.0,2020-02-18,"(1123.5, 1372.0]",9,29,-20
31229.0,2020-02-18,"(42.631, 386.25]",3,7,-4
31229.0,2020-02-18,"(386.25, 728.5]",14,49,-35
31229.0,2020-02-18,"(728.5, 1070.75]",27,58,-31
31229.0,2020-02-18,"(1070.75, 1413.0]",31,50,-19
31230.0,2020-02-18,"(365.25, 709.5]",46,1,45
31230.0,2020-02-18,"(709.5, 1053.75]",10,50,-40
31230.0,2020-02-18,"(1053.75, 1398.0]",8,23,-15
31231.0,2020-02-18,"(327.17, 535.5]",12,15,-3
31231.0,2020-02-18,"(535.5, 743.0]",9,15,-6
31231.0,2020-02-18,"(743.0, 950.5]",8,11,-3
31231.0,2020-02-18,"(950.5, 1158.0]",8,25,-17
31232.0,2020-02-18,"(257.902, 533.5]",17,25,-8
31232.0,2020-02-18,"(533.5, 808.0]",5,5,0
31232.0,2020-02-18,"(808.0, 1082.5]",10,29,-19
31232.0,2020-02-18,"(1082.5, 1357.0]",11,24,-13
31233.0,2020-02-18,"(384.166, 593.5]",36,41,-5
31233.0,2020-02-18,"(593.5, 802.0]",8,11,-3
31233.0,2020-02-18,"(802.0, 1010.5]",8,15,-7
31233.0,2020-02-18,"(1010.5, 1219.0]",8,32,-24
31234.0,2020-02-18,"(361.75, 706.5]",28,1,27
31234.0,2020-02-18,"(706.5, 1051.25]",15,49,-34
31234.0,2020-02-18,"(1051.25, 1396.0]",17,24,-7
31235.0,2020-02-18,"(422.34, 588.0]",16,16,0
31235.0,2020-02-18,"(588.0, 753.0]",7,10,-3
31235.0,2020-02-18,"(753.0, 918.0]",2,2,0
31235.0,2020-02-18,"(918.0, 1083.0]",1,4,-3
31236.0,2020-02-18,"(325.25, 649.5]",22,3,19
31236.0,2020-02-18,"(649.5, 973.75]",15,25,-10
31236.0,2020-02-18,"(973.75, 1298.0]",12,32,-20
31237.0,2020-02-18,"(280.871, 564.25]",4,13,-9
31237.0,2020-02-18,"(564.25, 846.5]",11,14,-3
31237.0,2020-02-18,"(846.5, 1128.75]",10,21,-11
31237.0,2020-02-18,"(1128.75, 1411.0]",8,16,-8
31238.0,2020-02-18,"(69.659, 406.25]",1,2,-1
31238.0,2020-02-18,"(406.25, 741.5]",14,17,-3
31238.0,2020-02-18,"(741.5, 1076.75]",4,18,-14
31238.0,2020-02-18,"(1076.75, 1412.0]",6,21,-15
31239.0,2020-02-18,"(348.031, 591.25]",25,27,-2
31239.0,2020-02-18,"(591.25, 833.5]",15,23,-8
31239.0,2020-02-18,"(833.5, 1075.75]",13,24,-11
31239.0,2020-02-18,"(1075.75, 1318.0]",5,27,-22
31240.0,2020-02-18,"(453.236, 645.0]",1,2,-1
31240.0,2020-02-18,"(1027.0, 1218.0]",5,9,-4
31241.0,2020-02-18,"(282.862, 568.5]",24,47,-23
31241.0,2020-02-18,"(568.5, 853.0]",18,33,-15
31241.0,2020-02-18,"(853.0, 1137.5]",13,39,-26
31241.0,2020-02-18,"(1137.5, 1422.0]",28,41,-13
31242.0,2020-02-18,"(296.19, 499.5]",13,15,-2
31242.0,2020-02-18,"(499.5, 702.0]",14,17,-3
31242.0,2020-02-18,"(702.0, 904.5]",7,15,-8
31242.0,2020-02-18,"(904.5, 1107.0]",4,33,-29
31243.0,2020-02-18,"(376.107, 600.25]",23,28,-5
31243.0,2020-02-18,"(600.25, 823.5]",10,12,-2
31243.0,2020-02-18,"(823.5, 1046.75]",8,23,-15
31243.0,2020-02-18,"(1046.75, 1270.0]",4,15,-11
31244.0,2020-02-18,"(415.085, 644.75]",9,16,-7
31244.0,2020-02-18,"(873.5, 1102.25]",9,1,8
31244.0,2020-02-18,"(1102.25, 1331.0]",5,24,-19
31245.0,2020-02-18,"(411.998, 663.5]",16,34,-18
31245.0,2020-02-18,"(663.5, 914.0]",4,7,-3
31245.0,2020-02-18,"(914.0, 1164.5]",8,19,-11
31245.0,2020-02-18,"(1164.5, 1415.0]",9,11,-2
31246.0,2020-02-18,"(83.702, 409.5]",2,2,0
31246.0,2020-02-18,"(409.5, 734.0]",15,25,-10
31246.0,2020-02-18,"(734.0, 1058.5]",5,13,-8
31246.0,2020-02-18,"(1058.5, 1383.0]",16,34,-18
31247.0,2020-02-18,"(370.989, 624.75]",15,19,-4
31247.0,2020-02-18,"(624.75, 877.5]",18,25,-7
31247.0,2020-02-18,"(877.5, 1130.25]",15,41,-26
31247.0,2020-02-18,"(1130.25, 1383.0]",11,27,-16
31248.0,2020-02-18,"(348.089, 576.75]",10,19,-9
31248.0,2020-02-18,"(576.75, 804.5]",11,23,-12
31248.0,2020-02-18,"(804.5, 1032.25]",17,38,-21
31248.0,2020-02-18,"(1032.25, 1260.0]",12,24,-12
31249.0,2020-02-18,"(369.176, 576.0]",10,19,-9
31249.0,2020-02-18,"(576.0, 782.0]",1,2,-1
31249.0,2020-02-18,"(782.0, 988.0]",7,12,-5
31249.0,2020-02-18,"(988.0, 1194.0]",9,17,-8
31250.0,2020-02-18,"(420.029, 663.75]",17,22,-5
31250.0,2020-02-18,"(663.75, 906.5]",3,7,-4
31250.0,2020-02-18,"(906.5, 1149.25]",4,23,-19
31250.0,2020-02-18,"(1149.25, 1392.0]",1,2,-1
31251.0,2020-02-18,"(23.714, 346.5]",2,3,-1
31251.0,2020-02-18,"(346.5, 668.0]",20,36,-16
31251.0,2020-02-18,"(668.0, 989.5]",8,16,-8
31251.0,2020-02-18,"(989.5, 1311.0]",13,30,-17
31252.0,2020-02-18,"(459.116, 681.0]",13,14,-1
31252.0,2020-02-18,"(681.0, 902.0]",3,6,-3
31252.0,2020-02-18,"(902.0, 1123.0]",3,13,-10
31252.0,2020-02-18,"(1123.0, 1344.0]",2,9,-7
31253.0,2020-02-18,"(410.061, 645.75]",24,26,-2
31253.0,2020-02-18,"(645.75, 880.5]",3,4,-1
31253.0,2020-02-18,"(880.5, 1115.25]",5,19,-14
31254.0,2020-02-18,"(376.048, 615.0]",18,22,-4
31254.0,2020-02-18,"(615.0, 853.0]",9,13,-4
31254.0,2020-02-18,"(853.0, 1091.0]",8,21,-13
31254.0,2020-02-18,"(1091.0, 1329.0]",3,8,-5
31255.0,2020-02-18,"(362.096, 589.0]",15,20,-5
31255.0,2020-02-18,"(589.0, 815.0]",2,5,-3
31255.0,2020-02-18,"(815.0, 1041.0]",2,13,-11
31255.0,2020-02-18,"(1041.0, 1267.0]",7,14,-7
31256.0,2020-02-18,"(270.005, 519.75]",8,8,0
31256.0,2020-02-18,"(519.75, 768.5]",1,1,0
31256.0,2020-02-18,"(768.5, 1017.25]",4,8,-4
31256.0,2020-02-18,"(1017.25, 1266.0]",3,18,-15
31257.0,2020-02-18,"(336.949, 600.75]",28,44,-16
31257.0,2020-02-18,"(600.75, 863.5]",6,11,-5
31257.0,2020-02-18,"(863.5, 1126.25]",17,37,-20
31257.0,2020-02-18,"(1126.25, 1389.0]",8,25,-17
31258.0,2020-02-18,"(445.218, 641.5]",10,22,-12
31258.0,2020-02-18,"(641.5, 837.0]",15,26,-11
31258.0,2020-02-18,"(837.0, 1032.5]",12,21,-9
31258.0,2020-02-18,"(1032.5, 1228.0]",10,22,-12
31259.0,2020-02-18,"(294.122, 514.5]",4,4,0
31259.0,2020-02-18,"(953.5, 1173.0]",1,10,-9
31260.0,2020-02-18,"(390.996, 643.0]",14,17,-3
31260.0,2020-02-18,"(643.0, 894.0]",4,14,-10
31260.0,2020-02-18,"(894.0, 1145.0]",5,21,-16
31260.0,2020-02-18,"(1145.0, 1396.0]",2,3,-1
31261.0,2020-02-18,"(387.99, 641.5]",5,5,0
31261.0,2020-02-18,"(641.5, 894.0]",1,5,-4
31261.0,2020-02-18,"(894.0, 1146.5]",2,9,-7
31262.0,2020-02-18,"(326.991, 580.25]",8,8,0
31262.0,2020-02-18,"(580.25, 832.5]",2,6,-4
31262.0,2020-02-18,"(832.5, 1084.75]",4,10,-6
31262.0,2020-02-18,"(1084.75, 1337.0]",1,6,-5
31263.0,2020-02-18,"(37.624, 383.0]",1,2,-1
31263.0,2020-02-18,"(383.0, 727.0]",27,34,-7
31263.0,2020-02-18,"(727.0, 1071.0]",17,34,-17
31263.0,2020-02-18,"(1071.0, 1415.0]",5,21,-16
31264.0,2020-02-18,"(442.054, 679.5]",14,18,-4
31264.0,2020-02-18,"(679.5, 916.0]",2,5,-3
31264.0,2020-02-18,"(916.0, 1152.5]",4,17,-13
31265.0,2020-02-18,"(44.644, 385.0]",1,3,-2
31265.0,2020-02-18,"(385.0, 724.0]",17,33,-16
31265.0,2020-02-18,"(724.0, 1063.0]",12,29,-17
31265.0,2020-02-18,"(1063.0, 1402.0]",21,37,-16
31266.0,2020-02-18,"(217.918, 489.5]",1,16,-15
31266.0,2020-02-18,"(489.5, 760.0]",11,29,-18
31266.0,2020-02-18,"(760.0, 1030.5]",10,22,-12
31266.0,2020-02-18,"(1030.5, 1301.0]",25,39,-14
31267.0,2020-02-18,"(12.584, 368.0]",1,1,0
31267.0,2020-02-18,"(368.0, 722.0]",13,27,-14
31267.0,2020-02-18,"(722.0, 1076.0]",12,27,-15
31267.0,2020-02-18,"(1076.0, 1430.0]",21,45,-24
31268.0,2020-02-18,"(369.94, 636.0]",11,36,-25
31268.0,2020-02-18,"(636.0, 901.0]",5,8,-3
31268.0,2020-02-18,"(901.0, 1166.0]",34,43,-9
31268.0,2020-02-18,"(1166.0, 1431.0]",7,11,-4
31269.0,2020-02-18,"(361.045, 600.75]",6,17,-11
31269.0,2020-02-18,"(600.75, 839.5]",7,14,-7
31269.0,2020-02-18,"(839.5, 1078.25]",6,13,-7
31269.0,2020-02-18,"(1078.25, 1317.0]",8,18,-10
31270.0,2020-02-18,"(322.177, 528.75]",7,12,-5
31270.0,2020-02-18,"(528.75, 734.5]",7,9,-2
31270.0,2020-02-18,"(734.5, 940.25]",7,13,-6
31270.0,2020-02-18,"(940.25, 1146.0]",11,16,-5
31271.0,2020-02-18,"(407.243, 597.25]",10,12,-2
31271.0,2020-02-18,"(597.25, 786.5]",2,8,-6
31271.0,2020-02-18,"(786.5, 975.75]",11,18,-7
31271.0,2020-02-18,"(975.75, 1165.0]",6,16,-10
31272.0,2020-02-18,"(296.159, 507.25]",8,9,-1
31272.0,2020-02-18,"(507.25, 717.5]",16,17,-1
31272.0,2020-02-18,"(717.5, 927.75]",7,11,-4
31272.0,2020-02-18,"(927.75, 1138.0]",8,32,-24
31273.0,2020-02-18,"(419.345, 583.75]",1,3,-2
31273.0,2020-02-18,"(583.75, 747.5]",3,3,0
31273.0,2020-02-18,"(747.5, 911.25]",2,4,-2
31273.0,2020-02-18,"(911.25, 1075.0]",4,6,-2
31274.0,2020-02-18,"(439.193, 641.75]",12,16,-4
31274.0,2020-02-18,"(641.75, 843.5]",5,8,-3
31274.0,2020-02-18,"(843.5, 1045.25]",1,6,-5
31274.0,2020-02-18,"(1045.25, 1247.0]",3,13,-10
31275.0,2020-02-18,"(218.834, 511.5]",13,17,-4
31275.0,2020-02-18,"(511.5, 803.0]",8,14,-6
31275.0,2020-02-18,"(803.0, 1094.5]",19,39,-20
31275.0,2020-02-18,"(1094.5, 1386.0]",3,13,-10
31276.0,2020-02-18,"(386.959, 648.25]",22,26,-4
31276.0,2020-02-18,"(648.25, 908.5]",3,10,-7
31276.0,2020-02-18,"(908.5, 1168.75]",7,30,-23
31276.0,2020-02-18,"(1168.75, 1429.0]",1,2,-1
31277.0,2020-02-18,"(418.243, 608.25]",33,37,-4
31277.0,2020-02-18,"(608.25, 797.5]",10,12,-2
31277.0,2020-02-18,"(797.5, 986.75]",4,11,-7
31277.0,2020-02-18,"(986.75, 1176.0]",10,34,-24
31278.0,2020-02-18,"(37.792, 341.0]",1,1,0
31278.0,2020-02-18,"(341.0, 643.0]",8,26,-18
31278.0,2020-02-18,"(643.0, 945.0]",9,18,-9
31278.0,2020-02-18,"(945.0, 1247.0]",26,35,-9
31279.0,2020-02-18,"(374.265, 558.75]",17,20,-3
31279.0,2020-02-18,"(558.75, 742.5]",1,3,-2
31279.0,2020-02-18,"(742.5, 926.25]",8,17,-9
31279.0,2020-02-18,"(926.25, 1110.0]",9,38,-29
31280.0,2020-02-18,"(356.923, 627.25]",9,28,-19
31280.0,2020-02-18,"(627.25, 896.5]",4,7,-3
31280.0,2020-02-18,"(896.5, 1165.75]",14,16,-2
31280.0,2020-02-18,"(1165.75, 1435.0]",6,7,-1
31000.0,2020-02-19,"(921.25, 1104.0]",2,2,0
31001.0,2020-02-19,"(860.0, 1081.5]",1,1,0
31001.0,2020-02-19,"(1081.5, 1303.0]",2,1,1
31002.0,2020-02-19,"(364.306, 538.5]",3,8,-5
31002.0,2020-02-19,"(538.5, 712.0]",3,4,-1
31002.0,2020-02-19,"(712.0, 885.5]",1,2,-1
31002.0,2020-02-19,"(885.5, 1059.0]",3,6,-3
31003.0,2020-02-19,"(381.149, 594.75]",3,5,-2
31003.0,2020-02-19,"(807.5, 1020.25]",4,1,3
31003.0,2020-02-19,"(1020.25, 1233.0]",1,7,-6
31004.0,2020-02-19,"(896.5, 1090.25]",1,1,0
31004.0,2020-02-19,"(1090.25, 1284.0]",1,1,0
31005.0,2020-02-19,"(381.077, 612.75]",3,5,-2
31005.0,2020-02-19,"(612.75, 843.5]",1,1,0
31005.0,2020-02-19,"(1074.25, 1305.0]",4,1,3
31006.0,2020-02-19,"(81.66, 418.0]",1,1,0
31006.0,2020-02-19,"(753.0, 1088.0]",4,2,2
31007.0,2020-02-19,"(411.062, 646.5]",7,14,-7
31007.0,2020-02-19,"(646.5, 881.0]",3,5,-2
31007.0,2020-02-19,"(881.0, 1115.5]",6,18,-12
31007.0,2020-02-19,"(1115.5, 1350.0]",3,10,-7
31009.0,2020-02-19,"(511.416, 658.0]",2,2,0
31010.0,2020-02-19,"(737.5, 843.25]",2,1,1
31010.0,2020-02-19,"(843.25, 949.0]",1,1,0
31011.0,2020-02-19,"(366.145, 580.75]",4,5,-1
31011.0,2020-02-19,"(794.5, 1008.25]",2,1,1
31011.0,2020-02-19,"(1008.25, 1222.0]",4,5,-1
31012.0,2020-02-19,"(385.096, 612.0]",5,5,0
31012.0,2020-02-19,"(838.0, 1064.0]",1,1,0
31012.0,2020-02-19,"(1064.0, 1290.0]",2,4,-2
31013.0,2020-02-19,"(386.075, 618.25]",1,3,-2
31013.0,2020-02-19,"(849.5, 1080.75]",2,2,0
31013.0,2020-02-19,"(1080.75, 1312.0]",3,5,-2
31014.0,2020-02-19,"(194.789, 498.75]",5,8,-3
31014.0,2020-02-19,"(498.75, 801.5]",17,25,-8
31014.0,2020-02-19,"(801.5, 1104.25]",14,30,-16
31014.0,2020-02-19,"(1104.25, 1407.0]",6,13,-7
31015.0,2020-02-19,"(370.968, 630.0]",13,16,-3
31015.0,2020-02-19,"(630.0, 888.0]",1,3,-2
31015.0,2020-02-19,"(888.0, 1146.0]",3,11,-8
31015.0,2020-02-19,"(1146.0, 1404.0]",2,2,0
31016.0,2020-02-19,"(342.051, 580.25]",6,12,-6
31016.0,2020-02-19,"(580.25, 817.5]",2,3,-1
31016.0,2020-02-19,"(817.5, 1054.75]",4,7,-3
31016.0,2020-02-19,"(1054.75, 1292.0]",3,6,-3
31017.0,2020-02-19,"(490.282, 670.5]",4,6,-2
31017.0,2020-02-19,"(1029.5, 1209.0]",3,13,-10
31018.0,2020-02-19,"(807.5, 988.75]",1,3,-2
31018.0,2020-02-19,"(988.75, 1170.0]",4,1,3
31019.0,2020-02-19,"(894.75, 1193.0]",1,1,0
31020.0,2020-02-19,"(715.75, 922.5]",2,1,1
31020.0,2020-02-19,"(922.5, 1129.25]",1,2,-1
31020.0,2020-02-19,"(1129.25, 1336.0]",1,2,-1
31021.0,2020-02-19,"(137.848, 427.0]",1,3,-2
31021.0,2020-02-19,"(427.0, 715.0]",2,4,-2
31021.0,2020-02-19,"(715.0, 1003.0]",2,4,-2
31021.0,2020-02-19,"(1003.0, 1291.0]",4,7,-3
31022.0,2020-02-19,"(549.231, 742.25]",1,3,-2
31022.0,2020-02-19,"(742.25, 934.5]",2,6,-4
31022.0,2020-02-19,"(934.5, 1126.75]",2,8,-6
31023.0,2020-02-19,"(869.75, 1157.0]",2,1,1
31024.0,2020-02-19,"(410.244, 600.0]",8,10,-2
31024.0,2020-02-19,"(789.0, 978.0]",2,3,-1
31024.0,2020-02-19,"(978.0, 1167.0]",4,4,0
31025.0,2020-02-19,"(1117.25, 1123.0]",1,1,0
31026.0,2020-02-19,"(966.0, 1156.0]",3,4,-1
31027.0,2020-02-19,"(1043.5, 1208.0]",2,1,1
31028.0,2020-02-19,"(451.163, 661.25]",2,2,0
31028.0,2020-02-19,"(870.5, 1079.75]",1,2,-1
,,,,2.0,
31030.0,2020-02-19,"(814.0, 1053.0]",3,8,-5
31030.0,2020-02-19,"(1053.0, 1292.0]",7,1,6
31031.0,2020-02-19,"(578.75, 755.5]",1,3,-2
31031.0,2020-02-19,"(932.25, 1109.0]",2,1,1
31032.0,2020-02-19,"(656.75, 840.5]",1,1,0
31032.0,2020-02-19,"(1024.25, 1208.0]",2,1,1
,,,,2.0,
31034.0,2020-02-19,"(466.077, 697.75]",2,4,-2
31034.0,2020-02-19,"(697.75, 928.5]",2,3,-1
31034.0,2020-02-19,"(928.5, 1159.25]",1,6,-5
31035.0,2020-02-19,"(20.93, 289.5]",1,1,0
31035.0,2020-02-19,"(557.0, 824.5]",1,1,0
31035.0,2020-02-19,"(824.5, 1092.0]",4,1,3
31036.0,2020-02-19,"(480.405, 629.75]",1,3,-2
31036.0,2020-02-19,"(778.5, 927.25]",1,1,0
31036.0,2020-02-19,"(927.25, 1076.0]",1,2,-1
31037.0,2020-02-19,"(322.084, 552.0]",6,11,-5
31037.0,2020-02-19,"(552.0, 781.0]",4,5,-1
31037.0,2020-02-19,"(781.0, 1010.0]",5,10,-5
31037.0,2020-02-19,"(1010.0, 1239.0]",4,14,-10
31038.0,2020-02-19,"(390.235, 582.25]",1,2,-1
31038.0,2020-02-19,"(582.25, 773.5]",1,2,-1
31038.0,2020-02-19,"(964.75, 1156.0]",3,4,-1
31039.0,2020-02-19,"(466.236, 658.0]",3,5,-2
31039.0,2020-02-19,"(658.0, 849.0]",1,1,0
31039.0,2020-02-19,"(849.0, 1040.0]",6,9,-3
31039.0,2020-02-19,"(1040.0, 1231.0]",2,4,-2
31040.0,2020-02-19,"(449.417, 595.75]",2,2,0
31040.0,2020-02-19,"(887.25, 1033.0]",1,4,-3
31041.0,2020-02-19,"(429.351, 592.25]",1,1,0
31041.0,2020-02-19,"(916.75, 1079.0]",2,2,0
31042.0,2020-02-19,"(439.187, 643.25]",4,4,0
31042.0,2020-02-19,"(846.5, 1049.75]",1,8,-7
31042.0,2020-02-19,"(1049.75, 1253.0]",2,3,-1
31043.0,2020-02-19,"(416.178, 622.5]",1,2,-1
31043.0,2020-02-19,"(622.5, 828.0]",3,3,0
31043.0,2020-02-19,"(1033.5, 1239.0]",3,1,2
31044.0,2020-02-19,"(519.414, 666.5]",1,1,0
31044.0,2020-02-19,"(813.0, 959.5]",2,1,1
31044.0,2020-02-19,"(959.5, 1106.0]",2,4,-2
31045.0,2020-02-19,"(507.24, 698.0]",3,5,-2
31045.0,2020-02-19,"(698.0, 888.0]",1,1,0
31045.0,2020-02-19,"(888.0, 1078.0]",1,1,0
31045.0,2020-02-19,"(1078.0, 1268.0]",3,5,-2
31046.0,2020-02-19,"(13.838, 305.5]",1,2,-1
31046.0,2020-02-19,"(305.5, 596.0]",1,3,-2
31046.0,2020-02-19,"(596.0, 886.5]",1,1,0
31046.0,2020-02-19,"(886.5, 1177.0]",2,4,-2
31047.0,2020-02-19,"(346.926, 616.5]",10,20,-10
31047.0,2020-02-19,"(616.5, 885.0]",3,6,-3
31047.0,2020-02-19,"(885.0, 1153.5]",5,25,-20
31047.0,2020-02-19,"(1153.5, 1422.0]",2,4,-2
31048.0,2020-02-19,"(405.115, 627.25]",2,4,-2
31048.0,2020-02-19,"(627.25, 848.5]",1,1,0
31048.0,2020-02-19,"(848.5, 1069.75]",3,4,-1
31048.0,2020-02-19,"(1069.75, 1291.0]",3,5,-2
31049.0,2020-02-19,"(637.25, 836.5]",1,1,0
31049.0,2020-02-19,"(1035.75, 1235.0]",2,1,1
31050.0,2020-02-19,"(893.5, 1024.0]",2,2,0
31051.0,2020-02-19,"(905.75, 1059.0]",3,1,2
31052.0,2020-02-19,"(505.28, 686.0]",4,8,-4
31052.0,2020-02-19,"(686.0, 866.0]",1,2,-1
31052.0,2020-02-19,"(866.0, 1046.0]",5,7,-2
31052.0,2020-02-19,"(1046.0, 1226.0]",3,5,-2
31053.0,2020-02-19,"(1001.5, 1137.0]",1,1,0
31054.0,2020-02-19,"(753.0, 896.5]",1,2,-1
31054.0,2020-02-19,"(896.5, 1040.0]",2,2,0
31055.0,2020-02-19,"(899.5, 1113.25]",1,2,-1
31055.0,2020-02-19,"(1113.25, 1327.0]",3,1,2
31056.0,2020-02-19,"(4.568, 364.0]",1,1,0
31056.0,2020-02-19,"(722.0, 1080.0]",3,4,-1
31056.0,2020-02-19,"(1080.0, 1438.0]",1,1,0
31057.0,2020-02-19,"(573.506, 697.5]",1,2,-1
31058.0,2020-02-19,"(709.5, 946.0]",1,1,0
31059.0,2020-02-19,"(797.25, 1063.0]",2,1,1
31060.0,2020-02-19,"(548.604, 648.0]",1,1,0
31060.0,2020-02-19,"(648.0, 747.0]",2,2,0
31061.0,2020-02-19,"(459.366, 618.5]",1,2,-1
31061.0,2020-02-19,"(935.5, 1094.0]",2,2,0
31062.0,2020-02-19,"(429.119, 650.25]",1,2,-1
31062.0,2020-02-19,"(870.5, 1090.75]",3,5,-2
31062.0,2020-02-19,"(1090.75, 1311.0]",2,4,-2
31063.0,2020-02-19,"(994.5, 1136.75]",1,1,0
31064.0,2020-02-19,"(408.082, 638.5]",3,7,-4
31064.0,2020-02-19,"(868.0, 1097.5]",2,7,-5
31064.0,2020-02-19,"(1097.5, 1327.0]",5,10,-5
31065.0,2020-02-19,"(1008.25, 1221.0]",2,2,0
31066.0,2020-02-19,"(948.25, 1102.0]",4,2,2
31067.0,2020-02-19,"(62.863, 348.25]",1,1,0
31067.0,2020-02-19,"(348.25, 632.5]",1,3,-2
31067.0,2020-02-19,"(632.5, 916.75]",1,2,-1
31067.0,2020-02-19,"(916.75, 1201.0]",3,5,-2
31068.0,2020-02-19,"(561.224, 756.0]",1,4,-3
31068.0,2020-02-19,"(756.0, 950.0]",2,2,0
31068.0,2020-02-19,"(950.0, 1144.0]",1,2,-1
31068.0,2020-02-19,"(1144.0, 1338.0]",1,2,-1
31069.0,2020-02-19,"(849.25, 976.0]",2,4,-2
31070.0,2020-02-19,"(1006.5, 1106.25]",2,2,0
31070.0,2020-02-19,"(1106.25, 1206.0]",1,1,0
31071.0,2020-02-19,"(374.146, 588.5]",1,4,-3
31071.0,2020-02-19,"(588.5, 802.0]",1,1,0
31071.0,2020-02-19,"(802.0, 1015.5]",3,5,-2
31071.0,2020-02-19,"(1015.5, 1229.0]",4,7,-3
,,,,2.0,
31073.0,2020-02-19,"(472.41, 620.5]",1,1,0
31073.0,2020-02-19,"(620.5, 768.0]",1,1,0
31073.0,2020-02-19,"(915.5, 1063.0]",4,8,-4
31074.0,2020-02-19,"(820.0, 976.0]",1,3,-2
31074.0,2020-02-19,"(976.0, 1132.0]",4,2,2
31075.0,2020-02-19,"(834.0, 1112.0]",1,1,0
31076.0,2020-02-19,"(660.25, 836.5]",1,1,0
31076.0,2020-02-19,"(836.5, 1012.75]",1,2,-1
31076.0,2020-02-19,"(1012.75, 1189.0]",2,1,1
31077.0,2020-02-19,"(481.304, 656.0]",1,6,-5
31077.0,2020-02-19,"(830.0, 1004.0]",1,1,0
31077.0,2020-02-19,"(1004.0, 1178.0]",4,6,-2
31078.0,2020-02-19,"(479.402, 629.5]",7,8,-1
31078.0,2020-02-19,"(928.5, 1078.0]",1,10,-9
31079.0,2020-02-19,"(11.717, 333.75]",1,1,0
31079.0,2020-02-19,"(333.75, 654.5]",1,6,-5
31079.0,2020-02-19,"(654.5, 975.25]",1,3,-2
31079.0,2020-02-19,"(975.25, 1296.0]",3,5,-2
31080.0,2020-02-19,"(800.0, 1007.0]",2,11,-9
31080.0,2020-02-19,"(1007.0, 1214.0]",7,2,5
31081.0,2020-02-19,"(483.299, 659.25]",1,1,0
31081.0,2020-02-19,"(659.25, 834.5]",1,1,0
31081.0,2020-02-19,"(834.5, 1009.75]",2,2,0
31082.0,2020-02-19,"(995.0, 1190.0]",1,1,0
31083.0,2020-02-19,"(398.243, 588.25]",2,5,-3
31083.0,2020-02-19,"(588.25, 777.5]",1,1,0
31083.0,2020-02-19,"(966.75, 1156.0]",4,1,3
31084.0,2020-02-19,"(33.772, 342.0]",1,1,0
31084.0,2020-02-19,"(342.0, 649.0]",6,7,-1
31084.0,2020-02-19,"(649.0, 956.0]",1,1,0
31084.0,2020-02-19,"(956.0, 1263.0]",3,13,-10
31085.0,2020-02-19,"(402.328, 571.0]",1,4,-3
31085.0,2020-02-19,"(907.0, 1075.0]",1,1,0
,,,,1.0,
,,,,1.0,
31087.0,2020-02-19,"(999.5, 1174.0]",2,2,0
31088.0,2020-02-19,"(804.0, 1010.5]",1,2,-1
31088.0,2020-02-19,"(1010.5, 1217.0]",4,1,3
31089.0,2020-02-19,"(441.335, 608.25]",5,8,-3
31089.0,2020-02-19,"(940.75, 1107.0]",3,2,1
31090.0,2020-02-19,"(728.5, 881.75]",1,1,0
31090.0,2020-02-19,"(881.75, 1035.0]",4,2,2
31091.0,2020-02-19,"(838.5, 1013.25]",1,4,-3
31091.0,2020-02-19,"(1013.25, 1188.0]",4,1,3
31092.0,2020-02-19,"(871.0, 1079.5]",3,2,1
31092.0,2020-02-19,"(1079.5, 1288.0]",2,3,-1
31093.0,2020-02-19,"(824.0, 1040.0]",1,4,-3
31093.0,2020-02-19,"(1040.0, 1256.0]",1,3,-2
31094.0,2020-02-19,"(535.196, 737.0]",1,3,-2
31094.0,2020-02-19,"(938.0, 1139.0]",2,3,-1
31094.0,2020-02-19,"(1139.0, 1340.0]",1,1,0
31095.0,2020-02-19,"(919.5, 1035.0]",1,1,0
31096.0,2020-02-19,"(533.474, 665.5]",1,1,0
31096.0,2020-02-19,"(928.5, 1060.0]",1,1,0
31097.0,2020-02-19,"(293.5, 584.0]",3,1,2
31097.0,2020-02-19,"(874.5, 1165.0]",1,3,-2
31098.0,2020-02-19,"(432.202, 632.5]",6,12,-6
31098.0,2020-02-19,"(632.5, 832.0]",1,3,-2
31098.0,2020-02-19,"(832.0, 1031.5]",2,4,-2
31098.0,2020-02-19,"(1031.5, 1231.0]",6,10,-4
31099.0,2020-02-19,"(961.0, 1126.0]",3,1,2
31100.0,2020-02-19,"(430.2, 631.0]",16,18,-2
31100.0,2020-02-19,"(631.0, 831.0]",1,2,-1
31100.0,2020-02-19,"(831.0, 1031.0]",2,5,-3
31100.0,2020-02-19,"(1031.0, 1231.0]",3,18,-15
31101.0,2020-02-19,"(348.953, 611.75]",10,43,-33
31101.0,2020-02-19,"(611.75, 873.5]",5,9,-4
31101.0,2020-02-19,"(873.5, 1135.25]",34,46,-12
31101.0,2020-02-19,"(1135.25, 1397.0]",14,25,-11
31102.0,2020-02-19,"(367.991, 621.25]",1,16,-15
31102.0,2020-02-19,"(621.25, 873.5]",1,3,-2
31102.0,2020-02-19,"(873.5, 1125.75]",4,9,-5
31102.0,2020-02-19,"(1125.75, 1378.0]",7,11,-4
31103.0,2020-02-19,"(353.961, 614.75]",2,20,-18
31103.0,2020-02-19,"(614.75, 874.5]",1,8,-7
31103.0,2020-02-19,"(874.5, 1134.25]",8,15,-7
31103.0,2020-02-19,"(1134.25, 1394.0]",4,14,-10
31104.0,2020-02-19,"(16.601, 367.75]",1,5,-4
31104.0,2020-02-19,"(367.75, 717.5]",5,19,-14
31104.0,2020-02-19,"(717.5, 1067.25]",14,24,-10
31104.0,2020-02-19,"(1067.25, 1417.0]",20,38,-18
31105.0,2020-02-19,"(331.952, 595.0]",2,10,-8
31105.0,2020-02-19,"(857.0, 1119.0]",5,5,0
31105.0,2020-02-19,"(1119.0, 1381.0]",3,10,-7
31106.0,2020-02-19,"(677.25, 909.5]",1,5,-4
31106.0,2020-02-19,"(909.5, 1141.75]",2,1,1
31106.0,2020-02-19,"(1141.75, 1374.0]",1,3,-2
31107.0,2020-02-19,"(338.934, 606.5]",2,24,-22
31107.0,2020-02-19,"(606.5, 873.0]",3,11,-8
31107.0,2020-02-19,"(873.0, 1139.5]",14,28,-14
31107.0,2020-02-19,"(1139.5, 1406.0]",11,15,-4
31108.0,2020-02-19,"(369.113, 591.75]",5,32,-27
31108.0,2020-02-19,"(591.75, 813.5]",9,15,-6
31108.0,2020-02-19,"(813.5, 1035.25]",14,26,-12
31108.0,2020-02-19,"(1035.25, 1257.0]",24,32,-8
31109.0,2020-02-19,"(349.985, 604.75]",5,24,-19
31109.0,2020-02-19,"(604.75, 858.5]",2,5,-3
31109.0,2020-02-19,"(858.5, 1112.25]",15,18,-3
31109.0,2020-02-19,"(1112.25, 1366.0]",14,27,-13
31110.0,2020-02-19,"(19.596, 372.0]",4,5,-1
31110.0,2020-02-19,"(372.0, 723.0]",16,42,-26
31110.0,2020-02-19,"(723.0, 1074.0]",13,27,-14
31110.0,2020-02-19,"(1074.0, 1425.0]",20,30,-10
31111.0,2020-02-19,"(19.634, 362.5]",2,2,0
31111.0,2020-02-19,"(362.5, 704.0]",4,16,-12
31111.0,2020-02-19,"(704.0, 1045.5]",8,15,-7
31111.0,2020-02-19,"(1045.5, 1387.0]",17,27,-10
31112.0,2020-02-19,"(412.103, 637.25]",2,5,-3
31112.0,2020-02-19,"(861.5, 1085.75]",6,1,5
31112.0,2020-02-19,"(1085.75, 1310.0]",3,7,-4
31113.0,2020-02-19,"(19.645, 359.75]",1,1,0
31113.0,2020-02-19,"(698.5, 1037.25]",3,31,-28
31113.0,2020-02-19,"(1037.25, 1376.0]",18,9,9
31114.0,2020-02-19,"(382.036, 624.0]",3,28,-25
31114.0,2020-02-19,"(624.0, 865.0]",2,8,-6
31114.0,2020-02-19,"(865.0, 1106.0]",16,22,-6
31114.0,2020-02-19,"(1106.0, 1347.0]",13,22,-9
31115.0,2020-02-19,"(884.0, 1144.0]",8,19,-11
31115.0,2020-02-19,"(1144.0, 1404.0]",6,7,-1
31116.0,2020-02-19,"(652.25, 897.5]",3,18,-15
31116.0,2020-02-19,"(897.5, 1142.75]",19,5,14
31116.0,2020-02-19,"(1142.75, 1388.0]",5,21,-16
31117.0,2020-02-19,"(302.897, 579.75]",3,15,-12
31117.0,2020-02-19,"(579.75, 855.5]",4,18,-14
31117.0,2020-02-19,"(855.5, 1131.25]",12,26,-14
31117.0,2020-02-19,"(1131.25, 1407.0]",11,21,-10
31118.0,2020-02-19,"(234.017, 480.75]",1,8,-7
31118.0,2020-02-19,"(480.75, 726.5]",1,10,-9
31118.0,2020-02-19,"(726.5, 972.25]",1,2,-1
31118.0,2020-02-19,"(972.25, 1218.0]",19,23,-4
31119.0,2020-02-19,"(380.961, 641.75]",4,19,-15
31119.0,2020-02-19,"(641.75, 901.5]",6,11,-5
31119.0,2020-02-19,"(901.5, 1161.25]",16,22,-6
31119.0,2020-02-19,"(1161.25, 1421.0]",6,11,-5
31120.0,2020-02-19,"(111.715, 434.25]",1,3,-2
31120.0,2020-02-19,"(434.25, 755.5]",4,21,-17
31120.0,2020-02-19,"(755.5, 1076.75]",8,11,-3
31120.0,2020-02-19,"(1076.75, 1398.0]",15,21,-6
31121.0,2020-02-19,"(48.746, 363.5]",2,2,0
31121.0,2020-02-19,"(363.5, 677.0]",21,30,-9
31121.0,2020-02-19,"(677.0, 990.5]",5,11,-6
31121.0,2020-02-19,"(990.5, 1304.0]",3,10,-7
31122.0,2020-02-19,"(431.028, 675.0]",4,15,-11
31122.0,2020-02-19,"(675.0, 918.0]",3,4,-1
31122.0,2020-02-19,"(918.0, 1161.0]",6,9,-3
31122.0,2020-02-19,"(1161.0, 1404.0]",11,18,-7
31123.0,2020-02-19,"(615.75, 889.5]",1,17,-16
31123.0,2020-02-19,"(889.5, 1163.25]",6,5,1
31123.0,2020-02-19,"(1163.25, 1437.0]",4,10,-6
31124.0,2020-02-19,"(302.879, 584.25]",16,29,-13
31124.0,2020-02-19,"(584.25, 864.5]",3,15,-12
31124.0,2020-02-19,"(864.5, 1144.75]",14,41,-27
31124.0,2020-02-19,"(1144.75, 1425.0]",4,11,-7
31125.0,2020-02-19,"(362.971, 621.25]",5,37,-32
31125.0,2020-02-19,"(621.25, 878.5]",4,8,-4
31125.0,2020-02-19,"(878.5, 1135.75]",25,35,-10
31125.0,2020-02-19,"(1135.75, 1393.0]",9,17,-8
31126.0,2020-02-19,"(297.907, 572.25]",2,21,-19
31126.0,2020-02-19,"(572.25, 845.5]",2,5,-3
31126.0,2020-02-19,"(845.5, 1118.75]",11,17,-6
31126.0,2020-02-19,"(1118.75, 1392.0]",14,19,-5
31127.0,2020-02-19,"(459.06, 695.0]",15,22,-7
31127.0,2020-02-19,"(695.0, 930.0]",11,16,-5
31127.0,2020-02-19,"(930.0, 1165.0]",7,25,-18
31127.0,2020-02-19,"(1165.0, 1400.0]",2,11,-9
31128.0,2020-02-19,"(98.667, 433.25]",5,8,-3
31128.0,2020-02-19,"(433.25, 766.5]",25,37,-12
31128.0,2020-02-19,"(766.5, 1099.75]",25,38,-13
31128.0,2020-02-19,"(1099.75, 1433.0]",11,23,-12
31129.0,2020-02-19,"(469.224, 664.0]",9,10,-1
31129.0,2020-02-19,"(664.0, 858.0]",3,7,-4
31129.0,2020-02-19,"(858.0, 1052.0]",8,20,-12
31129.0,2020-02-19,"(1052.0, 1246.0]",3,6,-3
31130.0,2020-02-19,"(377.058, 613.5]",1,9,-8
31130.0,2020-02-19,"(613.5, 849.0]",3,6,-3
31130.0,2020-02-19,"(849.0, 1084.5]",8,16,-8
31130.0,2020-02-19,"(1084.5, 1320.0]",14,16,-2
31131.0,2020-02-19,"(350.078, 581.5]",1,18,-17
31131.0,2020-02-19,"(812.0, 1042.5]",2,2,0
31131.0,2020-02-19,"(1042.5, 1273.0]",5,3,2
31200.0,2020-02-19,"(369.998, 621.5]",21,31,-10
31200.0,2020-02-19,"(621.5, 872.0]",10,15,-5
31200.0,2020-02-19,"(872.0, 1122.5]",15,32,-17
31200.0,2020-02-19,"(1122.5, 1373.0]",13,29,-16
31201.0,2020-02-19,"(317.94, 584.0]",12,34,-22
31201.0,2020-02-19,"(584.0, 849.0]",13,25,-12
31201.0,2020-02-19,"(849.0, 1114.0]",37,64,-27
31201.0,2020-02-19,"(1114.0, 1379.0]",14,30,-16
,,,,2.0,
31203.0,2020-02-19,"(365.5, 711.0]",11,3,8
31203.0,2020-02-19,"(711.0, 1056.5]",21,33,-12
31203.0,2020-02-19,"(1056.5, 1402.0]",25,36,-11
31204.0,2020-02-19,"(392.005, 641.75]",15,17,-2
31204.0,2020-02-19,"(641.75, 890.5]",8,18,-10
31204.0,2020-02-19,"(890.5, 1139.25]",7,19,-12
31204.0,2020-02-19,"(1139.25, 1388.0]",10,17,-7
31205.0,2020-02-19,"(413.975, 671.25]",29,31,-2
31205.0,2020-02-19,"(671.25, 927.5]",12,25,-13
31205.0,2020-02-19,"(927.5, 1183.75]",18,33,-15
31205.0,2020-02-19,"(1183.75, 1440.0]",3,27,-24
31206.0,2020-02-19,"(290.75, 543.5]",3,1,2
31206.0,2020-02-19,"(543.5, 796.25]",1,4,-3
31206.0,2020-02-19,"(796.25, 1049.0]",2,1,1
31207.0,2020-02-19,"(438.143, 653.25]",2,11,-9
31207.0,2020-02-19,"(867.5, 1081.75]",3,1,2
31207.0,2020-02-19,"(1081.75, 1296.0]",2,4,-2
31208.0,2020-02-19,"(394.104, 619.0]",9,12,-3
31208.0,2020-02-19,"(843.0, 1067.0]",2,19,-17
31208.0,2020-02-19,"(1067.0, 1291.0]",6,9,-3
31209.0,2020-02-19,"(462.138, 678.5]",9,9,0
31209.0,2020-02-19,"(678.5, 894.0]",2,3,-1
31209.0,2020-02-19,"(894.0, 1109.5]",2,5,-3
31209.0,2020-02-19,"(1109.5, 1325.0]",2,3,-1
31211.0,2020-02-19,"(391.014, 638.5]",14,18,-4
31211.0,2020-02-19,"(638.5, 885.0]",5,9,-4
31211.0,2020-02-19,"(885.0, 1131.5]",6,10,-4
31211.0,2020-02-19,"(1131.5, 1378.0]",2,6,-4
31212.0,2020-02-19,"(40.616, 388.0]",2,2,0
31212.0,2020-02-19,"(388.0, 734.0]",21,31,-10
31212.0,2020-02-19,"(734.0, 1080.0]",18,31,-13
31212.0,2020-02-19,"(1080.0, 1426.0]",6,25,-19
31213.0,2020-02-19,"(274.871, 558.25]",25,36,-11
31213.0,2020-02-19,"(558.25, 840.5]",13,24,-11
31213.0,2020-02-19,"(840.5, 1122.75]",13,29,-16
31213.0,2020-02-19,"(1122.75, 1405.0]",8,16,-8
31214.0,2020-02-19,"(13.628, 358.0]",1,3,-2
31214.0,2020-02-19,"(358.0, 701.0]",10,34,-24
31214.0,2020-02-19,"(701.0, 1044.0]",18,32,-14
31214.0,2020-02-19,"(1044.0, 1387.0]",20,28,-8
31215.0,2020-02-19,"(12.58, 369.0]",2,2,0
31215.0,2020-02-19,"(369.0, 724.0]",22,25,-3
31215.0,2020-02-19,"(724.0, 1079.0]",7,19,-12
31215.0,2020-02-19,"(1079.0, 1434.0]",4,21,-17
31216.0,2020-02-19,"(459.2, 660.0]",24,26,-2
31216.0,2020-02-19,"(660.0, 860.0]",4,7,-3
31216.0,2020-02-19,"(860.0, 1060.0]",2,5,-3
31216.0,2020-02-19,"(1060.0, 1260.0]",2,21,-19
31217.0,2020-02-19,"(322.173, 529.75]",9,10,-1
31217.0,2020-02-19,"(529.75, 736.5]",5,7,-2
31217.0,2020-02-19,"(736.5, 943.25]",1,4,-3
31218.0,2020-02-19,"(376.149, 589.75]",17,31,-14
31218.0,2020-02-19,"(589.75, 802.5]",3,3,0
31218.0,2020-02-19,"(802.5, 1015.25]",5,11,-6
31218.0,2020-02-19,"(1015.25, 1228.0]",9,19,-10
31219.0,2020-02-19,"(439.275, 621.25]",12,14,-2
31219.0,2020-02-19,"(621.25, 802.5]",5,6,-1
31219.0,2020-02-19,"(802.5, 983.75]",2,9,-7
31219.0,2020-02-19,"(983.75, 1165.0]",1,10,-9
31220.0,2020-02-19,"(286.198, 487.5]",9,12,-3
31220.0,2020-02-19,"(487.5, 688.0]",9,10,-1
31220.0,2020-02-19,"(688.0, 888.5]",3,8,-5
31220.0,2020-02-19,"(888.5, 1089.0]",3,18,-15
31221.0,2020-02-19,"(226.938, 493.5]",14,15,-1
31221.0,2020-02-19,"(493.5, 759.0]",32,36,-4
31221.0,2020-02-19,"(759.0, 1024.5]",8,19,-11
31221.0,2020-02-19,"(1024.5, 1290.0]",14,38,-24
31222.0,2020-02-19,"(315.901, 591.75]",19,20,-1
31222.0,2020-02-19,"(591.75, 866.5]",2,4,-2
31222.0,2020-02-19,"(866.5, 1141.25]",3,19,-16
31222.0,2020-02-19,"(1141.25, 1416.0]",5,11,-6
31223.0,2020-02-19,"(10.603, 361.25]",3,7,-4
31223.0,2020-02-19,"(361.25, 710.5]",20,42,-22
31223.0,2020-02-19,"(710.5, 1059.75]",11,26,-15
31223.0,2020-02-19,"(1059.75, 1409.0]",21,30,-9
31224.0,2020-02-19,"(408.154, 620.5]",14,15,-1
31224.0,2020-02-19,"(620.5, 832.0]",2,3,-1
31224.0,2020-02-19,"(832.0, 1043.5]",5,14,-9
31224.0,2020-02-19,"(1043.5, 1255.0]",4,16,-12
31225.0,2020-02-19,"(395.157, 606.75]",8,12,-4
31225.0,2020-02-19,"(606.75, 817.5]",5,9,-4
31225.0,2020-02-19,"(817.5, 1028.25]",4,11,-7
31225.0,2020-02-19,"(1028.25, 1239.0]",6,16,-10
31226.0,2020-02-19,"(319.055, 556.25]",3,6,-3
31226.0,2020-02-19,"(792.5, 1028.75]",2,5,-3
31226.0,2020-02-19,"(1028.75, 1265.0]",6,4,2
31227.0,2020-02-19,"(290.015, 537.25]",20,22,-2
31227.0,2020-02-19,"(537.25, 783.5]",7,15,-8
31227.0,2020-02-19,"(783.5, 1029.75]",8,15,-7
31227.0,2020-02-19,"(1029.75, 1276.0]",3,20,-17
31228.0,2020-02-19,"(350.96, 612.0]",23,29,-6
31228.0,2020-02-19,"(612.0, 872.0]",11,19,-8
31228.0,2020-02-19,"(872.0, 1132.0]",17,32,-15
31228.0,2020-02-19,"(1132.0, 1392.0]",9,27,-18
31229.0,2020-02-19,"(345.922, 616.5]",15,51,-36
31229.0,2020-02-19,"(616.5, 886.0]",11,30,-19
31229.0,2020-02-19,"(886.0, 1155.5]",28,39,-11
31229.0,2020-02-19,"(1155.5, 1425.0]",8,17,-9
31230.0,2020-02-19,"(390.039, 631.25]",44,50,-6
31230.0,2020-02-19,"(631.25, 871.5]",13,19,-6
31230.0,2020-02-19,"(871.5, 1111.75]",13,36,-23
31230.0,2020-02-19,"(1111.75, 1352.0]",3,14,-11
31231.0,2020-02-19,"(411.08, 642.0]",24,29,-5
31231.0,2020-02-19,"(642.0, 872.0]",6,11,-5
31231.0,2020-02-19,"(872.0, 1102.0]",15,34,-19
31232.0,2020-02-19,"(266.906, 541.5]",13,19,-6
31232.0,2020-02-19,"(541.5, 815.0]",11,13,-2
31232.0,2020-02-19,"(815.0, 1088.5]",19,39,-20
31232.0,2020-02-19,"(1088.5, 1362.0]",15,29,-14
31233.0,2020-02-19,"(366.934, 634.5]",48,51,-3
31233.0,2020-02-19,"(634.5, 901.0]",14,24,-10
31233.0,2020-02-19,"(901.0, 1167.5]",10,32,-22
31233.0,2020-02-19,"(1167.5, 1434.0]",5,12,-7
31234.0,2020-02-19,"(329.75, 653.5]",23,1,22
31234.0,2020-02-19,"(653.5, 977.25]",12,39,-27
31234.0,2020-02-19,"(977.25, 1301.0]",23,17,6
31235.0,2020-02-19,"(462.241, 652.75]",12,12,0
31235.0,2020-02-19,"(652.75, 842.5]",4,7,-3
31235.0,2020-02-19,"(842.5, 1032.25]",1,2,-1
31235.0,2020-02-19,"(1032.25, 1222.0]",2,10,-8
31236.0,2020-02-19,"(355.75, 701.5]",25,1,24
31236.0,2020-02-19,"(701.5, 1047.25]",19,31,-12
31236.0,2020-02-19,"(1047.25, 1393.0]",8,45,-37
31237.0,2020-02-19,"(9.574, 367.5]",1,1,0
31237.0,2020-02-19,"(367.5, 724.0]",5,18,-13
31237.0,2020-02-19,"(724.0, 1080.5]",13,22,-9
31237.0,2020-02-19,"(1080.5, 1437.0]",12,20,-8
31238.0,2020-02-19,"(57.8, 359.0]",1,2,-1
31238.0,2020-02-19,"(359.0, 659.0]",20,24,-4
31238.0,2020-02-19,"(659.0, 959.0]",6,12,-6
31238.0,2020-02-19,"(959.0, 1259.0]",6,30,-24
31239.0,2020-02-19,"(350.975, 608.25]",23,23,0
31239.0,2020-02-19,"(608.25, 864.5]",1,2,-1
31239.0,2020-02-19,"(864.5, 1120.75]",4,23,-19
31239.0,2020-02-19,"(1120.75, 1377.0]",8,22,-14
31240.0,2020-02-19,"(717.0, 860.0]",1,1,0
31240.0,2020-02-19,"(860.0, 1003.0]",2,1,1
31241.0,2020-02-19,"(362.25, 720.5]",37,3,34
31241.0,2020-02-19,"(720.5, 1078.75]",16,67,-51
31241.0,2020-02-19,"(1078.75, 1437.0]",22,39,-17
31242.0,2020-02-19,"(402.109, 625.75]",30,34,-4
31242.0,2020-02-19,"(625.75, 848.5]",6,12,-6
31242.0,2020-02-19,"(848.5, 1071.25]",4,12,-8
31242.0,2020-02-19,"(1071.25, 1294.0]",2,22,-20
31243.0,2020-02-19,"(383.75, 731.5]",23,3,20
31243.0,2020-02-19,"(731.5, 1079.25]",7,29,-22
31243.0,2020-02-19,"(1079.25, 1427.0]",3,25,-22
31244.0,2020-02-19,"(33.704, 359.0]",1,3,-2
31244.0,2020-02-19,"(359.0, 683.0]",12,23,-11
31244.0,2020-02-19,"(683.0, 1007.0]",10,17,-7
31244.0,2020-02-19,"(1007.0, 1331.0]",16,31,-15
31245.0,2020-02-19,"(28.633, 371.75]",1,1,0
31245.0,2020-02-19,"(371.75, 713.5]",16,29,-13
31245.0,2020-02-19,"(713.5, 1055.25]",7,12,-5
31245.0,2020-02-19,"(1055.25, 1397.0]",9,17,-8
31246.0,2020-02-19,"(350.009, 598.75]",11,17,-6
31246.0,2020-02-19,"(598.75, 846.5]",11,16,-5
31246.0,2020-02-19,"(846.5, 1094.25]",13,24,-11
31246.0,2020-02-19,"(1094.25, 1342.0]",9,13,-4
31247.0,2020-02-19,"(427.308, 601.0]",14,19,-5
31247.0,2020-02-19,"(601.0, 774.0]",8,13,-5
31247.0,2020-02-19,"(774.0, 947.0]",9,19,-10
31247.0,2020-02-19,"(947.0, 1120.0]",13,26,-13
31248.0,2020-02-19,"(358.028, 602.0]",11,19,-8
31248.0,2020-02-19,"(602.0, 845.0]",3,16,-13
31248.0,2020-02-19,"(845.0, 1088.0]",12,26,-14
31248.0,2020-02-19,"(1088.0, 1331.0]",2,5,-3
31249.0,2020-02-19,"(423.172, 631.0]",7,14,-7
31249.0,2020-02-19,"(631.0, 838.0]",1,2,-1
31249.0,2020-02-19,"(838.0, 1045.0]",6,12,-6
31249.0,2020-02-19,"(1045.0, 1252.0]",3,6,-3
31250.0,2020-02-19,"(406.03, 649.5]",20,24,-4
31250.0,2020-02-19,"(649.5, 892.0]",6,12,-6
31250.0,2020-02-19,"(892.0, 1134.5]",1,16,-15
31250.0,2020-02-19,"(1134.5, 1377.0]",5,9,-4
31251.0,2020-02-19,"(391.967, 651.25]",12,23,-11
31251.0,2020-02-19,"(651.25, 909.5]",6,14,-8
31251.0,2020-02-19,"(909.5, 1167.75]",9,30,-21
31251.0,2020-02-19,"(1167.75, 1426.0]",11,17,-6
31252.0,2020-02-19,"(461.322, 631.5]",26,30,-4
31252.0,2020-02-19,"(631.5, 801.0]",3,5,-2
31252.0,2020-02-19,"(801.0, 970.5]",1,3,-2
31252.0,2020-02-19,"(970.5, 1140.0]",1,18,-17
31253.0,2020-02-19,"(426.13, 644.5]",25,29,-4
31253.0,2020-02-19,"(644.5, 862.0]",2,4,-2
31253.0,2020-02-19,"(862.0, 1079.5]",4,17,-13
31253.0,2020-02-19,"(1079.5, 1297.0]",1,13,-12
31254.0,2020-02-19,"(371.977, 628.75]",27,28,-1
31254.0,2020-02-19,"(628.75, 884.5]",8,11,-3
31254.0,2020-02-19,"(884.5, 1140.25]",3,24,-21
31254.0,2020-02-19,"(1140.25, 1396.0]",3,6,-3
31255.0,2020-02-19,"(364.5, 721.0]",19,1,18
31255.0,2020-02-19,"(721.0, 1077.5]",6,28,-22
31255.0,2020-02-19,"(1077.5, 1434.0]",6,17,-11
31256.0,2020-02-19,"(264.981, 520.75]",9,10,-1
31256.0,2020-02-19,"(520.75, 775.5]",5,8,-3
31256.0,2020-02-19,"(775.5, 1030.25]",3,6,-3
31256.0,2020-02-19,"(1030.25, 1285.0]",4,19,-15
31257.0,2020-02-19,"(10.616, 358.0]",1,2,-1
31257.0,2020-02-19,"(358.0, 704.0]",22,37,-15
31257.0,2020-02-19,"(704.0, 1050.0]",17,32,-15
31257.0,2020-02-19,"(1050.0, 1396.0]",9,27,-18
31258.0,2020-02-19,"(54.914, 327.5]",2,3,-1
31258.0,2020-02-19,"(327.5, 599.0]",14,25,-11
31258.0,2020-02-19,"(599.0, 870.5]",8,16,-8
31258.0,2020-02-19,"(870.5, 1142.0]",21,43,-22
31259.0,2020-02-19,"(387.154, 599.5]",8,9,-1
31259.0,2020-02-19,"(811.0, 1022.5]",2,6,-4
31259.0,2020-02-19,"(1022.5, 1234.0]",1,7,-6
31260.0,2020-02-19,"(394.033, 636.75]",16,18,-2
31260.0,2020-02-19,"(636.75, 878.5]",1,5,-4
31260.0,2020-02-19,"(878.5, 1120.25]",4,18,-14
31260.0,2020-02-19,"(1120.25, 1362.0]",3,7,-4
31261.0,2020-02-19,"(423.14, 639.0]",8,8,0
31261.0,2020-02-19,"(854.0, 1069.0]",3,13,-10
31262.0,2020-02-19,"(388.75, 717.5]",10,1,9
31262.0,2020-02-19,"(717.5, 1046.25]",2,11,-9
31262.0,2020-02-19,"(1046.25, 1375.0]",3,7,-4
31263.0,2020-02-19,"(363.998, 615.5]",26,36,-10
31263.0,2020-02-19,"(615.5, 866.0]",10,18,-8
31263.0,2020-02-19,"(866.0, 1116.5]",16,36,-20
31263.0,2020-02-19,"(1116.5, 1367.0]",4,14,-10
31264.0,2020-02-19,"(321.93, 590.5]",8,9,-1
31264.0,2020-02-19,"(590.5, 858.0]",7,9,-2
31264.0,2020-02-19,"(858.0, 1125.5]",7,18,-11
31264.0,2020-02-19,"(1125.5, 1393.0]",1,4,-3
31265.0,2020-02-19,"(366.974, 624.5]",15,38,-23
31265.0,2020-02-19,"(624.5, 881.0]",4,10,-6
31265.0,2020-02-19,"(881.0, 1137.5]",23,36,-13
31265.0,2020-02-19,"(1137.5, 1394.0]",15,29,-14
31266.0,2020-02-19,"(312.929, 581.75]",3,27,-24
31266.0,2020-02-19,"(581.75, 849.5]",7,18,-11
31266.0,2020-02-19,"(849.5, 1117.25]",18,34,-16
31266.0,2020-02-19,"(1117.25, 1385.0]",16,22,-6
31267.0,2020-02-19,"(364.973, 622.75]",22,36,-14
31267.0,2020-02-19,"(622.75, 879.5]",7,13,-6
31267.0,2020-02-19,"(879.5, 1136.25]",18,36,-18
31267.0,2020-02-19,"(1136.25, 1393.0]",8,20,-12
31268.0,2020-02-19,"(382.045, 621.75]",14,44,-30
31268.0,2020-02-19,"(621.75, 860.5]",3,5,-2
31268.0,2020-02-19,"(860.5, 1099.25]",15,18,-3
31268.0,2020-02-19,"(1099.25, 1338.0]",24,32,-8
31269.0,2020-02-19,"(350.022, 595.5]",12,18,-6
31269.0,2020-02-19,"(595.5, 840.0]",9,16,-7
31269.0,2020-02-19,"(840.0, 1084.5]",2,10,-8
31269.0,2020-02-19,"(1084.5, 1329.0]",6,18,-12
31270.0,2020-02-19,"(417.046, 656.5]",17,25,-8
31270.0,2020-02-19,"(656.5, 895.0]",6,13,-7
31270.0,2020-02-19,"(895.0, 1133.5]",5,12,-7
31270.0,2020-02-19,"(1133.5, 1372.0]",3,5,-2
31271.0,2020-02-19,"(385.11, 608.5]",9,14,-5
31271.0,2020-02-19,"(608.5, 831.0]",4,6,-2
31271.0,2020-02-19,"(831.0, 1053.5]",7,17,-10
31271.0,2020-02-19,"(1053.5, 1276.0]",6,17,-11
31272.0,2020-02-19,"(8.77, 317.5]",1,2,-1
31272.0,2020-02-19,"(317.5, 625.0]",26,28,-2
31272.0,2020-02-19,"(625.0, 932.5]",7,17,-10
31272.0,2020-02-19,"(932.5, 1240.0]",10,33,-23
31273.0,2020-02-19,"(414.321, 584.75]",3,7,-4
31273.0,2020-02-19,"(754.5, 924.25]",2,2,0
31273.0,2020-02-19,"(924.25, 1094.0]",4,2,2
31274.0,2020-02-19,"(396.978, 653.5]",11,11,0
31274.0,2020-02-19,"(653.5, 909.0]",5,13,-8
31274.0,2020-02-19,"(909.0, 1164.5]",8,24,-16
31274.0,2020-02-19,"(1164.5, 1420.0]",1,3,-2
31275.0,2020-02-19,"(8.61, 357.5]",1,1,0
31275.0,2020-02-19,"(357.5, 705.0]",18,31,-13
31275.0,2020-02-19,"(705.0, 1052.5]",14,26,-12
31275.0,2020-02-19,"(1052.5, 1400.0]",13,30,-17
31276.0,2020-02-19,"(314.25, 593.5]",24,1,23
31276.0,2020-02-19,"(593.5, 872.75]",3,25,-22
31276.0,2020-02-19,"(872.75, 1152.0]",4,6,-2
31277.0,2020-02-19,"(407.141, 622.75]",40,42,-2
31277.0,2020-02-19,"(622.75, 837.5]",3,8,-5
31277.0,2020-02-19,"(837.5, 1052.25]",9,26,-17
31277.0,2020-02-19,"(1052.25, 1267.0]",11,30,-19
31278.0,2020-02-19,"(373.947, 638.25]",10,34,-24
31278.0,2020-02-19,"(638.25, 901.5]",3,8,-5
31278.0,2020-02-19,"(901.5, 1164.75]",15,30,-15
31278.0,2020-02-19,"(1164.75, 1428.0]",17,23,-6
31279.0,2020-02-19,"(382.196, 584.0]",23,25,-2
31279.0,2020-02-19,"(584.0, 785.0]",5,9,-4
31279.0,2020-02-19,"(785.0, 986.0]",3,8,-5
31279.0,2020-02-19,"(986.0, 1187.0]",6,32,-26
31280.0,2020-02-19,"(370.973, 628.75]",4,25,-21
31280.0,2020-02-19,"(628.75, 885.5]",5,10,-5
31280.0,2020-02-19,"(885.5, 1142.25]",13,17,-4
31280.0,2020-02-19,"(1142.25, 1399.0]",4,8,-4
31000.0,2020-02-20,"(975.5, 1149.0]",1,1,0
31001.0,2020-02-20,"(1062.701, 1137.75]",1,2,-1
31001.0,2020-02-20,"(1287.25, 1362.0]",1,1,0
31002.0,2020-02-20,"(385.5, 710.0]",5,1,4
31002.0,2020-02-20,"(710.0, 1034.5]",2,8,-6
31002.0,2020-02-20,"(1034.5, 1359.0]",2,2,0
31003.0,2020-02-20,"(481.143, 696.25]",4,7,-3
31003.0,2020-02-20,"(910.5, 1124.75]",1,2,-1
31003.0,2020-02-20,"(1124.75, 1339.0]",3,3,0
31004.0,2020-02-20,"(947.0, 1155.5]",5,2,3
31004.0,2020-02-20,"(1155.5, 1364.0]",1,1,0
31005.0,2020-02-20,"(539.385, 693.75]",3,3,0
31005.0,2020-02-20,"(847.5, 1001.25]",1,2,-1
31005.0,2020-02-20,"(1001.25, 1155.0]",4,1,3
31006.0,2020-02-20,"(985.627, 1079.25]",3,5,-2
31007.0,2020-02-20,"(444.217, 640.75]",5,17,-12
31007.0,2020-02-20,"(640.75, 836.5]",1,5,-4
31007.0,2020-02-20,"(836.5, 1032.25]",3,9,-6
31007.0,2020-02-20,"(1032.25, 1228.0]",6,17,-11
31009.0,2020-02-20,"(524.498, 650.5]",2,2,0
31009.0,2020-02-20,"(776.0, 901.5]",2,1,1
31010.0,2020-02-20,"(844.474, 976.5]",2,3,-1
31011.0,2020-02-20,"(484.356, 646.0]",8,8,0
31011.0,2020-02-20,"(646.0, 807.0]",1,1,0
31011.0,2020-02-20,"(807.0, 968.0]",2,2,0
31011.0,2020-02-20,"(968.0, 1129.0]",2,6,-4
31012.0,2020-02-20,"(93.989, 347.75]",1,1,0
31013.0,2020-02-20,"(387.186, 591.5]",1,6,-5
31013.0,2020-02-20,"(795.0, 998.5]",3,4,-1
31013.0,2020-02-20,"(998.5, 1202.0]",6,10,-4
31014.0,2020-02-20,"(72.776, 380.0]",2,2,0
31014.0,2020-02-20,"(380.0, 686.0]",13,15,-2
31014.0,2020-02-20,"(686.0, 992.0]",9,12,-3
31014.0,2020-02-20,"(992.0, 1298.0]",9,22,-13
31015.0,2020-02-20,"(89.73, 408.5]",3,3,0
31015.0,2020-02-20,"(408.5, 726.0]",15,17,-2
31015.0,2020-02-20,"(726.0, 1043.5]",3,8,-5
31015.0,2020-02-20,"(1043.5, 1361.0]",3,6,-3
31016.0,2020-02-20,"(343.064, 578.0]",4,9,-5
31016.0,2020-02-20,"(578.0, 812.0]",2,4,-2
31016.0,2020-02-20,"(812.0, 1046.0]",4,5,-1
31016.0,2020-02-20,"(1046.0, 1280.0]",4,5,-1
31017.0,2020-02-20,"(487.425, 631.75]",4,5,-1
31017.0,2020-02-20,"(919.25, 1063.0]",3,9,-6
31018.0,2020-02-20,"(1039.5, 1243.0]",1,3,-2
31019.0,2020-02-20,"(1040.0, 1237.0]",3,1,2
31020.0,2020-02-20,"(508.09, 736.5]",1,2,-1
31021.0,2020-02-20,"(699.25, 927.5]",2,2,0
31021.0,2020-02-20,"(927.5, 1155.75]",2,2,0
31021.0,2020-02-20,"(1155.75, 1384.0]",1,3,-2
31022.0,2020-02-20,"(696.5, 900.0]",1,1,0
31022.0,2020-02-20,"(900.0, 1103.5]",3,2,1
31022.0,2020-02-20,"(1103.5, 1307.0]",2,6,-4
,,,,2.0,
31024.0,2020-02-20,"(414.022, 659.5]",5,10,-5
31024.0,2020-02-20,"(659.5, 904.0]",1,2,-1
31024.0,2020-02-20,"(904.0, 1148.5]",5,16,-11
31024.0,2020-02-20,"(1148.5, 1393.0]",1,1,0
31025.0,2020-02-20,"(1002.625, 1096.75]",1,2,-1
31026.0,2020-02-20,"(455.215, 652.25]",2,3,-1
31026.0,2020-02-20,"(1044.75, 1241.0]",2,1,1
31027.0,2020-02-20,"(1007.5, 1166.0]",1,1,0
31028.0,2020-02-20,"(300.0, 593.0]",1,1,0
31028.0,2020-02-20,"(886.0, 1179.0]",1,1,0
31029.0,2020-02-20,"(914.75, 1073.5]",1,2,-1
31029.0,2020-02-20,"(1232.25, 1391.0]",2,2,0
31030.0,2020-02-20,"(879.5, 1150.75]",4,11,-7
31030.0,2020-02-20,"(1150.75, 1422.0]",2,2,0
31031.0,2020-02-20,"(943.25, 1114.0]",2,1,1
,,,,1.0,
,,,,3.0,
,,,,2.0,
31034.0,2020-02-20,"(413.328, 582.0]",3,6,-3
31034.0,2020-02-20,"(918.0, 1086.0]",1,4,-3
31035.0,2020-02-20,"(439.383, 594.25]",1,2,-1
31035.0,2020-02-20,"(902.75, 1057.0]",1,1,0
31036.0,2020-02-20,"(920.5, 1072.0]",3,2,1
31037.0,2020-02-20,"(381.157, 592.75]",8,11,-3
31037.0,2020-02-20,"(592.75, 803.5]",3,5,-2
31037.0,2020-02-20,"(803.5, 1014.25]",1,3,-2
31037.0,2020-02-20,"(1014.25, 1225.0]",4,14,-10
31038.0,2020-02-20,"(540.5, 589.75]",1,1,0
31038.0,2020-02-20,"(589.75, 639.0]",1,1,0
31039.0,2020-02-20,"(488.235, 680.25]",2,5,-3
31039.0,2020-02-20,"(680.25, 871.5]",3,6,-3
31039.0,2020-02-20,"(871.5, 1062.75]",1,4,-3
31040.0,2020-02-20,"(451.269, 634.75]",2,2,0
31040.0,2020-02-20,"(634.75, 817.5]",2,3,-1
31041.0,2020-02-20,"(540.75, 721.0]",1,1,0
31042.0,2020-02-20,"(437.307, 611.25]",8,11,-3
31042.0,2020-02-20,"(611.25, 784.5]",1,1,0
31043.0,2020-02-20,"(413.241, 603.75]",3,5,-2
31043.0,2020-02-20,"(983.25, 1173.0]",2,1,1
31044.0,2020-02-20,"(590.509, 713.75]",1,1,0
31044.0,2020-02-20,"(959.25, 1082.0]",1,2,-1
31045.0,2020-02-20,"(620.26, 806.0]",3,4,-1
31045.0,2020-02-20,"(991.0, 1176.0]",1,1,0
31045.0,2020-02-20,"(1176.0, 1361.0]",2,1,1
,,,,1.0,
,,,,1.0,
31047.0,2020-02-20,"(347.053, 584.75]",10,18,-8
31047.0,2020-02-20,"(584.75, 821.5]",2,3,-1
31047.0,2020-02-20,"(821.5, 1058.25]",6,14,-8
31047.0,2020-02-20,"(1058.25, 1295.0]",3,15,-12
31048.0,2020-02-20,"(524.367, 683.25]",1,5,-4
31048.0,2020-02-20,"(841.5, 999.75]",1,1,0
31048.0,2020-02-20,"(999.75, 1158.0]",2,4,-2
31049.0,2020-02-20,"(676.419, 822.25]",1,1,0
31049.0,2020-02-20,"(1112.75, 1258.0]",1,1,0
31050.0,2020-02-20,"(914.0, 1113.5]",2,2,0
31050.0,2020-02-20,"(1113.5, 1313.0]",1,3,-2
31051.0,2020-02-20,"(593.5, 812.0]",1,2,-1
31051.0,2020-02-20,"(812.0, 1030.5]",1,1,0
31051.0,2020-02-20,"(1030.5, 1249.0]",2,1,1
31052.0,2020-02-20,"(464.231, 657.25]",4,4,0
31052.0,2020-02-20,"(849.5, 1041.75]",1,1,0
31052.0,2020-02-20,"(1041.75, 1234.0]",3,6,-3
,,,,1.0,
,,,,1.0,
,,,,1.0,
31054.0,2020-02-20,"(613.5, 759.0]",1,1,0
31054.0,2020-02-20,"(904.5, 1050.0]",1,1,0
31055.0,2020-02-20,"(399.283, 579.25]",1,2,-1
31055.0,2020-02-20,"(937.75, 1117.0]",2,3,-1
31056.0,2020-02-20,"(907.25, 1037.0]",2,1,1
,,,,1.0,
,,,,1.0,
31058.0,2020-02-20,"(167.75, 186.0]",1,1,0
31059.0,2020-02-20,"(1066.929, 1084.75]",2,3,-1
31059.0,2020-02-20,"(1120.25, 1138.0]",1,1,0
31060.0,2020-02-20,"(1024.0, 1054.0]",1,1,0
,,,,1.0,
,,,,1.0,
31062.0,2020-02-20,"(548.419, 694.25]",1,1,0
31062.0,2020-02-20,"(839.5, 984.75]",3,7,-4
31062.0,2020-02-20,"(984.75, 1130.0]",4,8,-4
,,,,2.0,
31064.0,2020-02-20,"(481.254, 668.5]",2,4,-2
31064.0,2020-02-20,"(668.5, 855.0]",2,5,-3
31064.0,2020-02-20,"(855.0, 1041.5]",3,6,-3
31064.0,2020-02-20,"(1041.5, 1228.0]",3,6,-3
31065.0,2020-02-20,"(610.75, 775.5]",1,1,0
31065.0,2020-02-20,"(775.5, 940.25]",1,2,-1
31065.0,2020-02-20,"(940.25, 1105.0]",3,1,2
31066.0,2020-02-20,"(513.0, 534.0]",1,1,0
31067.0,2020-02-20,"(14.625, 359.75]",2,3,-1
31067.0,2020-02-20,"(703.5, 1047.25]",1,2,-1
31067.0,2020-02-20,"(1047.25, 1391.0]",1,1,0
31068.0,2020-02-20,"(915.5, 1085.75]",1,1,0
31069.0,2020-02-20,"(633.25, 819.5]",2,4,-2
31069.0,2020-02-20,"(819.5, 1005.75]",1,4,-3
31069.0,2020-02-20,"(1005.75, 1192.0]",3,1,2
31070.0,2020-02-20,"(567.322, 737.5]",1,2,-1
31070.0,2020-02-20,"(907.0, 1076.5]",2,1,1
31070.0,2020-02-20,"(1076.5, 1246.0]",2,4,-2
31071.0,2020-02-20,"(441.284, 621.0]",2,7,-5
31071.0,2020-02-20,"(621.0, 800.0]",1,2,-1
31071.0,2020-02-20,"(800.0, 979.0]",2,3,-1
31071.0,2020-02-20,"(979.0, 1158.0]",6,7,-1
,,,,2.0,
31073.0,2020-02-20,"(427.383, 582.25]",2,3,-1
31074.0,2020-02-20,"(428.227, 622.25]",1,1,0
31074.0,2020-02-20,"(815.5, 1008.75]",1,1,0
31074.0,2020-02-20,"(1008.75, 1202.0]",3,1,2
31075.0,2020-02-20,"(988.25, 1108.0]",1,1,0
31076.0,2020-02-20,"(865.5, 1059.75]",1,1,0
31076.0,2020-02-20,"(1059.75, 1254.0]",1,1,0
31077.0,2020-02-20,"(526.147, 740.25]",3,6,-3
31077.0,2020-02-20,"(740.25, 953.5]",4,6,-2
31077.0,2020-02-20,"(953.5, 1166.75]",4,5,-1
31077.0,2020-02-20,"(1166.75, 1380.0]",2,2,0
31078.0,2020-02-20,"(469.392, 622.0]",6,6,0
31078.0,2020-02-20,"(622.0, 774.0]",2,7,-5
31078.0,2020-02-20,"(774.0, 926.0]",1,2,-1
31078.0,2020-02-20,"(926.0, 1078.0]",1,4,-3
31079.0,2020-02-20,"(9.598, 361.5]",1,1,0
31079.0,2020-02-20,"(361.5, 712.0]",1,9,-8
31079.0,2020-02-20,"(712.0, 1062.5]",1,3,-2
31079.0,2020-02-20,"(1062.5, 1413.0]",3,3,0
31080.0,2020-02-20,"(862.5, 1119.75]",3,8,-5
31080.0,2020-02-20,"(1119.75, 1377.0]",3,7,-4
31081.0,2020-02-20,"(477.401, 627.75]",1,1,0
31081.0,2020-02-20,"(627.75, 777.5]",1,2,-1
,,,,2.0,
31083.0,2020-02-20,"(689.0, 931.0]",1,2,-1
31083.0,2020-02-20,"(931.0, 1173.0]",2,2,0
31083.0,2020-02-20,"(1173.0, 1415.0]",1,2,-1
31084.0,2020-02-20,"(459.072, 692.0]",5,5,0
31084.0,2020-02-20,"(692.0, 924.0]",4,6,-2
31084.0,2020-02-20,"(924.0, 1156.0]",1,3,-2
31085.0,2020-02-20,"(401.137, 617.75]",1,5,-4
31085.0,2020-02-20,"(833.5, 1049.25]",2,3,-1
31085.0,2020-02-20,"(1049.25, 1265.0]",1,2,-1
31086.0,2020-02-20,"(928.5, 1165.25]",3,1,2
31086.0,2020-02-20,"(1165.25, 1402.0]",1,5,-4
31087.0,2020-02-20,"(1001.25, 1169.0]",2,1,1
31088.0,2020-02-20,"(688.0, 849.0]",1,2,-1
31088.0,2020-02-20,"(1010.0, 1171.0]",4,2,2
31089.0,2020-02-20,"(466.389, 619.75]",4,8,-4
31089.0,2020-02-20,"(619.75, 772.5]",1,2,-1
31089.0,2020-02-20,"(772.5, 925.25]",3,3,0
31089.0,2020-02-20,"(925.25, 1078.0]",1,17,-16
31090.0,2020-02-20,"(1024.25, 1223.0]",1,1,0
31091.0,2020-02-20,"(817.0, 990.5]",1,3,-2
31091.0,2020-02-20,"(990.5, 1164.0]",2,1,1
31092.0,2020-02-20,"(873.0, 1082.5]",1,3,-2
31092.0,2020-02-20,"(1082.5, 1292.0]",6,1,5
31093.0,2020-02-20,"(1078.75, 1300.0]",2,2,0
31094.0,2020-02-20,"(374.25, 499.0]",1,1,0
,,,,1.0,
,,,,1.0,
31096.0,2020-02-20,"(815.25, 1087.0]",2,1,1
31097.0,2020-02-20,"(402.113, 624.75]",4,5,-1
31097.0,2020-02-20,"(1068.25, 1290.0]",3,1,2
31098.0,2020-02-20,"(430.088, 659.0]",2,7,-5
31098.0,2020-02-20,"(887.0, 1115.0]",5,7,-2
31098.0,2020-02-20,"(1115.0, 1343.0]",1,2,-1
31099.0,2020-02-20,"(882.0, 1083.0]",1,1,0
31100.0,2020-02-20,"(406.191, 609.25]",13,13,0
31100.0,2020-02-20,"(609.25, 811.5]",2,5,-3
31100.0,2020-02-20,"(1013.75, 1216.0]",3,3,0
31101.0,2020-02-20,"(392.019, 638.25]",8,33,-25
31101.0,2020-02-20,"(638.25, 883.5]",8,21,-13
31101.0,2020-02-20,"(883.5, 1128.75]",28,42,-14
31101.0,2020-02-20,"(1128.75, 1374.0]",24,39,-15
31102.0,2020-02-20,"(317.888, 597.0]",1,14,-13
31102.0,2020-02-20,"(875.0, 1153.0]",3,10,-7
31102.0,2020-02-20,"(1153.0, 1431.0]",5,5,0
31103.0,2020-02-20,"(585.25, 831.5]",3,21,-18
31103.0,2020-02-20,"(831.5, 1077.75]",6,20,-14
31103.0,2020-02-20,"(1077.75, 1324.0]",11,13,-2
31104.0,2020-02-20,"(463.75, 771.5]",6,7,-1
31104.0,2020-02-20,"(771.5, 1079.25]",9,25,-16
31104.0,2020-02-20,"(1079.25, 1387.0]",18,17,1
31105.0,2020-02-20,"(16.692, 345.0]",1,1,0
31105.0,2020-02-20,"(345.0, 672.0]",2,7,-5
31105.0,2020-02-20,"(999.0, 1326.0]",2,2,0
31106.0,2020-02-20,"(507.38, 663.0]",1,2,-1
31106.0,2020-02-20,"(973.0, 1128.0]",3,3,0
31107.0,2020-02-20,"(333.909, 607.75]",3,23,-20
31107.0,2020-02-20,"(880.5, 1153.25]",12,18,-6
31107.0,2020-02-20,"(1153.25, 1426.0]",4,9,-5
31108.0,2020-02-20,"(333.5, 647.0]",4,1,3
31108.0,2020-02-20,"(647.0, 960.5]",9,23,-14
31108.0,2020-02-20,"(960.5, 1274.0]",24,16,8
31109.0,2020-02-20,"(73.785, 378.75]",3,4,-1
31109.0,2020-02-20,"(378.75, 682.5]",3,15,-12
31109.0,2020-02-20,"(682.5, 986.25]",9,12,-3
31109.0,2020-02-20,"(986.25, 1290.0]",16,25,-9
31110.0,2020-02-20,"(334.988, 589.0]",16,35,-19
31110.0,2020-02-20,"(589.0, 842.0]",5,9,-4
31110.0,2020-02-20,"(842.0, 1095.0]",15,31,-16
31110.0,2020-02-20,"(1095.0, 1348.0]",17,29,-12
31111.0,2020-02-20,"(366.25, 671.5]",7,2,5
31111.0,2020-02-20,"(671.5, 976.75]",6,20,-14
31111.0,2020-02-20,"(976.75, 1282.0]",18,15,3
31112.0,2020-02-20,"(923.75, 1059.0]",2,2,0
31113.0,2020-02-20,"(414.25, 749.5]",1,6,-5
31113.0,2020-02-20,"(749.5, 1084.75]",4,17,-13
31113.0,2020-02-20,"(1084.75, 1420.0]",7,10,-3
31114.0,2020-02-20,"(390.25, 732.5]",4,2,2
31114.0,2020-02-20,"(732.5, 1074.75]",8,27,-19
31114.0,2020-02-20,"(1074.75, 1417.0]",12,14,-2
31115.0,2020-02-20,"(245.889, 524.75]",1,16,-15
31115.0,2020-02-20,"(524.75, 802.5]",1,10,-9
31115.0,2020-02-20,"(802.5, 1080.25]",4,9,-5
31115.0,2020-02-20,"(1080.25, 1358.0]",12,18,-6
31116.0,2020-02-20,"(324.95, 588.5]",6,26,-20
31116.0,2020-02-20,"(588.5, 851.0]",6,13,-7
31116.0,2020-02-20,"(851.0, 1113.5]",5,8,-3
31116.0,2020-02-20,"(1113.5, 1376.0]",21,28,-7
31117.0,2020-02-20,"(318.022, 563.5]",3,17,-14
31117.0,2020-02-20,"(563.5, 808.0]",3,8,-5
31117.0,2020-02-20,"(808.0, 1052.5]",5,15,-10
31117.0,2020-02-20,"(1052.5, 1297.0]",12,25,-13
31118.0,2020-02-20,"(321.961, 582.75]",3,19,-16
31118.0,2020-02-20,"(582.75, 842.5]",1,4,-3
31118.0,2020-02-20,"(842.5, 1102.25]",4,4,0
31118.0,2020-02-20,"(1102.25, 1362.0]",11,11,0
31119.0,2020-02-20,"(14.63, 358.5]",5,8,-3
31119.0,2020-02-20,"(358.5, 701.0]",4,19,-15
31119.0,2020-02-20,"(701.0, 1043.5]",9,13,-4
31119.0,2020-02-20,"(1043.5, 1386.0]",17,27,-10
31120.0,2020-02-20,"(345.25, 677.5]",1,1,0
31120.0,2020-02-20,"(677.5, 1009.75]",6,17,-11
31120.0,2020-02-20,"(1009.75, 1342.0]",5,8,-3
31121.0,2020-02-20,"(319.963, 580.25]",13,20,-7
31121.0,2020-02-20,"(580.25, 839.5]",3,8,-5
31121.0,2020-02-20,"(839.5, 1098.75]",5,16,-11
31121.0,2020-02-20,"(1098.75, 1358.0]",7,20,-13
31122.0,2020-02-20,"(697.0, 1037.5]",5,1,4
31122.0,2020-02-20,"(1037.5, 1378.0]",10,11,-1
31123.0,2020-02-20,"(367.998, 619.5]",1,27,-26
31123.0,2020-02-20,"(870.0, 1120.5]",1,2,-1
31123.0,2020-02-20,"(1120.5, 1371.0]",5,8,-3
31124.0,2020-02-20,"(84.698, 411.5]",3,5,-2
31124.0,2020-02-20,"(411.5, 737.0]",12,47,-35
31124.0,2020-02-20,"(737.0, 1062.5]",8,25,-17
31124.0,2020-02-20,"(1062.5, 1388.0]",13,45,-32
31125.0,2020-02-20,"(362.0, 690.0]",6,1,5
31125.0,2020-02-20,"(690.0, 1018.0]",4,27,-23
31125.0,2020-02-20,"(1018.0, 1346.0]",25,7,18
31126.0,2020-02-20,"(308.009, 556.75]",4,21,-17
31126.0,2020-02-20,"(556.75, 804.5]",2,4,-2
31126.0,2020-02-20,"(804.5, 1052.25]",2,5,-3
31126.0,2020-02-20,"(1052.25, 1300.0]",22,27,-5
31127.0,2020-02-20,"(366.75, 711.5]",15,1,14
31127.0,2020-02-20,"(711.5, 1056.25]",10,21,-11
31127.0,2020-02-20,"(1056.25, 1401.0]",13,28,-15
31128.0,2020-02-20,"(40.644, 381.0]",3,5,-2
31128.0,2020-02-20,"(381.0, 720.0]",27,38,-11
31128.0,2020-02-20,"(720.0, 1059.0]",15,26,-11
31128.0,2020-02-20,"(1059.0, 1398.0]",16,32,-16
31129.0,2020-02-20,"(424.106, 648.5]",5,8,-3
31129.0,2020-02-20,"(872.0, 1095.5]",10,18,-8
31129.0,2020-02-20,"(1095.5, 1319.0]",1,3,-2
31130.0,2020-02-20,"(41.734, 359.5]",2,2,0
31130.0,2020-02-20,"(359.5, 676.0]",5,17,-12
31130.0,2020-02-20,"(676.0, 992.5]",4,7,-3
31130.0,2020-02-20,"(992.5, 1309.0]",5,10,-5
31131.0,2020-02-20,"(36.744, 352.0]",1,1,0
31131.0,2020-02-20,"(666.0, 980.0]",1,13,-12
31131.0,2020-02-20,"(980.0, 1294.0]",4,5,-1
31200.0,2020-02-20,"(364.018, 610.5]",27,34,-7
31200.0,2020-02-20,"(610.5, 856.0]",7,14,-7
31200.0,2020-02-20,"(856.0, 1101.5]",14,27,-13
31200.0,2020-02-20,"(1101.5, 1347.0]",13,34,-21
31201.0,2020-02-20,"(65.694, 393.5]",4,5,-1
31201.0,2020-02-20,"(393.5, 720.0]",15,40,-25
31201.0,2020-02-20,"(720.0, 1046.5]",17,31,-14
31201.0,2020-02-20,"(1046.5, 1373.0]",33,58,-25
,,,,2.0,
31203.0,2020-02-20,"(26.593, 379.75]",2,4,-2
31203.0,2020-02-20,"(379.75, 731.5]",9,25,-16
31203.0,2020-02-20,"(731.5, 1083.25]",24,40,-16
31203.0,2020-02-20,"(1083.25, 1435.0]",17,34,-17
31204.0,2020-02-20,"(404.979, 661.25]",10,14,-4
31204.0,2020-02-20,"(661.25, 916.5]",5,12,-7
31204.0,2020-02-20,"(916.5, 1171.75]",10,26,-16
31204.0,2020-02-20,"(1171.75, 1427.0]",1,7,-6
31205.0,2020-02-20,"(414.089, 642.75]",24,27,-3
31205.0,2020-02-20,"(642.75, 870.5]",17,26,-9
31205.0,2020-02-20,"(870.5, 1098.25]",10,24,-14
31205.0,2020-02-20,"(1098.25, 1326.0]",1,15,-14
31206.0,2020-02-20,"(386.333, 553.75]",4,5,-1
31206.0,2020-02-20,"(553.75, 720.5]",2,3,-1
31206.0,2020-02-20,"(887.25, 1054.0]",1,1,0
31207.0,2020-02-20,"(590.0, 822.0]",1,7,-6
31207.0,2020-02-20,"(822.0, 1054.0]",1,2,-1
31207.0,2020-02-20,"(1054.0, 1286.0]",4,2,2
31208.0,2020-02-20,"(363.081, 593.75]",16,19,-3
31208.0,2020-02-20,"(823.5, 1053.25]",4,15,-11
31208.0,2020-02-20,"(1053.25, 1283.0]",2,3,-1
31209.0,2020-02-20,"(439.131, 657.25]",2,2,0
31209.0,2020-02-20,"(874.5, 1091.75]",1,1,0
31209.0,2020-02-20,"(1091.75, 1309.0]",1,3,-2
31211.0,2020-02-20,"(451.159, 662.25]",9,9,0
31211.0,2020-02-20,"(662.25, 872.5]",2,2,0
31211.0,2020-02-20,"(872.5, 1082.75]",2,4,-2
31211.0,2020-02-20,"(1082.75, 1293.0]",7,14,-7
31212.0,2020-02-20,"(39.637, 381.75]",1,2,-1
31212.0,2020-02-20,"(381.75, 722.5]",36,49,-13
31212.0,2020-02-20,"(722.5, 1063.25]",16,29,-13
31212.0,2020-02-20,"(1063.25, 1404.0]",14,28,-14
31213.0,2020-02-20,"(32.625, 377.75]",2,4,-2
31213.0,2020-02-20,"(377.75, 721.5]",33,48,-15
31213.0,2020-02-20,"(721.5, 1065.25]",16,30,-14
31213.0,2020-02-20,"(1065.25, 1409.0]",8,16,-8
31214.0,2020-02-20,"(19.611, 368.25]",1,2,-1
31214.0,2020-02-20,"(368.25, 715.5]",10,32,-22
31214.0,2020-02-20,"(715.5, 1062.75]",16,26,-10
31214.0,2020-02-20,"(1062.75, 1410.0]",16,26,-10
31215.0,2020-02-20,"(505.179, 711.25]",18,19,-1
31215.0,2020-02-20,"(711.25, 916.5]",1,3,-2
31215.0,2020-02-20,"(916.5, 1121.75]",11,22,-11
31215.0,2020-02-20,"(1121.75, 1327.0]",1,5,-4
31216.0,2020-02-20,"(383.25, 708.5]",28,2,26
31216.0,2020-02-20,"(708.5, 1033.75]",6,31,-25
31216.0,2020-02-20,"(1033.75, 1359.0]",5,11,-6
31217.0,2020-02-20,"(321.224, 516.0]",8,10,-2
31217.0,2020-02-20,"(904.0, 1098.0]",2,9,-7
31218.0,2020-02-20,"(326.141, 541.75]",13,27,-14
31218.0,2020-02-20,"(541.75, 756.5]",9,14,-5
31218.0,2020-02-20,"(756.5, 971.25]",6,9,-3
31218.0,2020-02-20,"(971.25, 1186.0]",8,16,-8
31219.0,2020-02-20,"(371.279, 552.25]",9,9,0
31219.0,2020-02-20,"(552.25, 732.5]",6,6,0
31219.0,2020-02-20,"(732.5, 912.75]",1,5,-4
31219.0,2020-02-20,"(912.75, 1093.0]",4,9,-5
31220.0,2020-02-20,"(290.188, 494.0]",8,11,-3
31220.0,2020-02-20,"(494.0, 697.0]",9,11,-2
31220.0,2020-02-20,"(697.0, 900.0]",3,7,-4
31220.0,2020-02-20,"(900.0, 1103.0]",2,16,-14
31221.0,2020-02-20,"(353.0, 696.0]",39,1,38
31221.0,2020-02-20,"(696.0, 1039.0]",6,46,-40
31221.0,2020-02-20,"(1039.0, 1382.0]",10,16,-6
31222.0,2020-02-20,"(463.154, 675.5]",17,20,-3
31222.0,2020-02-20,"(675.5, 887.0]",10,13,-3
31222.0,2020-02-20,"(887.0, 1098.5]",2,14,-12
31222.0,2020-02-20,"(1098.5, 1310.0]",2,7,-5
31223.0,2020-02-20,"(39.602, 390.5]",1,2,-1
31223.0,2020-02-20,"(390.5, 740.0]",9,36,-27
31223.0,2020-02-20,"(740.0, 1089.5]",10,22,-12
31223.0,2020-02-20,"(1089.5, 1439.0]",15,23,-8
31224.0,2020-02-20,"(377.007, 626.25]",13,15,-2
31224.0,2020-02-20,"(626.25, 874.5]",2,4,-2
31224.0,2020-02-20,"(874.5, 1122.75]",2,16,-14
31224.0,2020-02-20,"(1122.75, 1371.0]",2,7,-5
31225.0,2020-02-20,"(420.087, 649.25]",7,9,-2
31225.0,2020-02-20,"(649.25, 877.5]",4,11,-7
31225.0,2020-02-20,"(877.5, 1105.75]",13,21,-8
31225.0,2020-02-20,"(1105.75, 1334.0]",6,12,-6
31226.0,2020-02-20,"(291.002, 541.5]",2,4,-2
31226.0,2020-02-20,"(541.5, 791.0]",1,4,-3
31226.0,2020-02-20,"(791.0, 1040.5]",1,6,-5
31226.0,2020-02-20,"(1040.5, 1290.0]",8,12,-4
31227.0,2020-02-20,"(299.141, 514.75]",9,11,-2
31227.0,2020-02-20,"(514.75, 729.5]",11,13,-2
31227.0,2020-02-20,"(729.5, 944.25]",2,6,-4
31227.0,2020-02-20,"(944.25, 1159.0]",5,23,-18
31228.0,2020-02-20,"(368.935, 636.25]",13,18,-5
31228.0,2020-02-20,"(636.25, 902.5]",13,18,-5
31228.0,2020-02-20,"(902.5, 1168.75]",10,19,-9
31228.0,2020-02-20,"(1168.75, 1435.0]",2,7,-5
31229.0,2020-02-20,"(60.643, 401.25]",1,9,-8
31229.0,2020-02-20,"(401.25, 740.5]",11,69,-58
31229.0,2020-02-20,"(740.5, 1079.75]",17,27,-10
31229.0,2020-02-20,"(1079.75, 1419.0]",24,40,-16
31230.0,2020-02-20,"(268.912, 542.0]",33,38,-5
31230.0,2020-02-20,"(542.0, 814.0]",17,22,-5
31230.0,2020-02-20,"(814.0, 1086.0]",15,32,-17
31230.0,2020-02-20,"(1086.0, 1358.0]",7,26,-19
31231.0,2020-02-20,"(324.077, 555.75]",11,13,-2
31231.0,2020-02-20,"(555.75, 786.5]",9,18,-9
31231.0,2020-02-20,"(786.5, 1017.25]",14,20,-6
31231.0,2020-02-20,"(1017.25, 1248.0]",1,10,-9
31232.0,2020-02-20,"(111.7, 438.0]",5,9,-4
31232.0,2020-02-20,"(438.0, 763.0]",20,28,-8
31232.0,2020-02-20,"(763.0, 1088.0]",15,30,-15
31232.0,2020-02-20,"(1088.0, 1413.0]",5,19,-14
31233.0,2020-02-20,"(437.136, 654.0]",42,45,-3
31233.0,2020-02-20,"(654.0, 870.0]",11,14,-3
31233.0,2020-02-20,"(870.0, 1086.0]",15,30,-15
31233.0,2020-02-20,"(1086.0, 1302.0]",9,19,-10
31234.0,2020-02-20,"(375.991, 629.25]",18,25,-7
31234.0,2020-02-20,"(629.25, 881.5]",10,17,-7
31234.0,2020-02-20,"(881.5, 1133.75]",14,25,-11
31234.0,2020-02-20,"(1133.75, 1386.0]",6,14,-8
31235.0,2020-02-20,"(528.324, 698.0]",7,7,0
31235.0,2020-02-20,"(698.0, 867.0]",5,6,-1
31235.0,2020-02-20,"(867.0, 1036.0]",3,6,-3
31235.0,2020-02-20,"(1036.0, 1205.0]",2,4,-2
31236.0,2020-02-20,"(447.178, 653.5]",19,27,-8
31236.0,2020-02-20,"(653.5, 859.0]",6,13,-7
31236.0,2020-02-20,"(859.0, 1064.5]",9,24,-15
31236.0,2020-02-20,"(1064.5, 1270.0]",6,16,-10
31237.0,2020-02-20,"(1.614, 349.5]",1,1,0
31237.0,2020-02-20,"(349.5, 696.0]",4,13,-9
31237.0,2020-02-20,"(696.0, 1042.5]",11,19,-8
31237.0,2020-02-20,"(1042.5, 1389.0]",12,22,-10
31238.0,2020-02-20,"(45.774, 353.5]",2,2,0
31238.0,2020-02-20,"(353.5, 660.0]",14,17,-3
31238.0,2020-02-20,"(660.0, 966.5]",12,20,-8
31238.0,2020-02-20,"(966.5, 1273.0]",10,31,-21
31239.0,2020-02-20,"(53.814, 351.5]",3,4,-1
31239.0,2020-02-20,"(351.5, 648.0]",19,20,-1
31239.0,2020-02-20,"(648.0, 944.5]",11,16,-5
31239.0,2020-02-20,"(944.5, 1241.0]",9,37,-28
31240.0,2020-02-20,"(722.632, 815.0]",1,1,0
31240.0,2020-02-20,"(999.0, 1091.0]",3,4,-1
31241.0,2020-02-20,"(29.597, 381.75]",2,5,-3
31241.0,2020-02-20,"(381.75, 732.5]",35,65,-30
31241.0,2020-02-20,"(732.5, 1083.25]",3,18,-15
31241.0,2020-02-20,"(1083.25, 1434.0]",17,33,-16
31242.0,2020-02-20,"(189.916, 462.0]",2,3,-1
31242.0,2020-02-20,"(462.0, 733.0]",31,40,-9
31242.0,2020-02-20,"(733.0, 1004.0]",9,19,-10
31242.0,2020-02-20,"(1004.0, 1275.0]",2,27,-25
31243.0,2020-02-20,"(376.045, 615.75]",21,26,-5
31243.0,2020-02-20,"(615.75, 854.5]",6,12,-6
31243.0,2020-02-20,"(854.5, 1093.25]",8,22,-14
31243.0,2020-02-20,"(1093.25, 1332.0]",2,7,-5
31244.0,2020-02-20,"(356.061, 591.75]",18,28,-10
31244.0,2020-02-20,"(591.75, 826.5]",3,10,-7
31244.0,2020-02-20,"(826.5, 1061.25]",12,33,-21
31244.0,2020-02-20,"(1061.25, 1296.0]",8,14,-6
31245.0,2020-02-20,"(412.043, 652.25]",10,22,-12
31245.0,2020-02-20,"(652.25, 891.5]",2,7,-5
31245.0,2020-02-20,"(891.5, 1130.75]",7,14,-7
31245.0,2020-02-20,"(1130.75, 1370.0]",5,12,-7
31246.0,2020-02-20,"(397.007, 646.25]",10,16,-6
31246.0,2020-02-20,"(646.25, 894.5]",11,20,-9
31246.0,2020-02-20,"(894.5, 1142.75]",5,16,-11
31246.0,2020-02-20,"(1142.75, 1391.0]",12,23,-11
31247.0,2020-02-20,"(78.989, 332.75]",1,1,0
31247.0,2020-02-20,"(332.75, 585.5]",8,13,-5
31247.0,2020-02-20,"(585.5, 838.25]",8,14,-6
31247.0,2020-02-20,"(838.25, 1091.0]",11,32,-21
31248.0,2020-02-20,"(357.123, 577.25]",12,19,-7
31248.0,2020-02-20,"(577.25, 796.5]",7,11,-4
31248.0,2020-02-20,"(796.5, 1015.75]",14,34,-20
31248.0,2020-02-20,"(1015.75, 1235.0]",8,18,-10
31249.0,2020-02-20,"(436.032, 679.0]",6,10,-4
31249.0,2020-02-20,"(679.0, 921.0]",1,4,-3
31249.0,2020-02-20,"(921.0, 1163.0]",6,11,-5
31249.0,2020-02-20,"(1163.0, 1405.0]",1,3,-2
31250.0,2020-02-20,"(421.136, 638.0]",18,21,-3
31250.0,2020-02-20,"(638.0, 854.0]",4,9,-5
31250.0,2020-02-20,"(854.0, 1070.0]",5,11,-6
31250.0,2020-02-20,"(1070.0, 1286.0]",4,19,-15
31251.0,2020-02-20,"(37.626, 382.5]",1,3,-2
31251.0,2020-02-20,"(382.5, 726.0]",20,34,-14
31251.0,2020-02-20,"(726.0, 1069.5]",10,24,-14
31251.0,2020-02-20,"(1069.5, 1413.0]",16,31,-15
31252.0,2020-02-20,"(42.715, 365.25]",1,1,0
31252.0,2020-02-20,"(365.25, 686.5]",19,20,-1
31252.0,2020-02-20,"(686.5, 1007.75]",1,5,-4
31252.0,2020-02-20,"(1007.75, 1329.0]",7,22,-15
31253.0,2020-02-20,"(381.0, 660.0]",8,1,7
31253.0,2020-02-20,"(660.0, 939.0]",3,8,-5
31253.0,2020-02-20,"(939.0, 1218.0]",7,6,1
31254.0,2020-02-20,"(407.031, 650.25]",27,29,-2
31254.0,2020-02-20,"(650.25, 892.5]",4,7,-3
31254.0,2020-02-20,"(892.5, 1134.75]",2,26,-24
31254.0,2020-02-20,"(1134.75, 1377.0]",1,6,-5
31255.0,2020-02-20,"(429.198, 630.5]",16,24,-8
31255.0,2020-02-20,"(630.5, 831.0]",4,6,-2
31255.0,2020-02-20,"(831.0, 1031.5]",6,15,-9
31255.0,2020-02-20,"(1031.5, 1232.0]",5,13,-8
31256.0,2020-02-20,"(275.015, 522.25]",7,7,0
31256.0,2020-02-20,"(522.25, 768.5]",7,8,-1
31256.0,2020-02-20,"(768.5, 1014.75]",2,6,-4
31256.0,2020-02-20,"(1014.75, 1261.0]",4,9,-5
31257.0,2020-02-20,"(44.646, 384.5]",2,2,0
31257.0,2020-02-20,"(384.5, 723.0]",20,32,-12
31257.0,2020-02-20,"(723.0, 1061.5]",17,36,-19
31257.0,2020-02-20,"(1061.5, 1400.0]",7,20,-13
31258.0,2020-02-20,"(2.752, 316.0]",3,3,0
31258.0,2020-02-20,"(316.0, 628.0]",2,5,-3
31258.0,2020-02-20,"(628.0, 940.0]",7,27,-20
31258.0,2020-02-20,"(940.0, 1252.0]",13,26,-13
31259.0,2020-02-20,"(456.262, 641.5]",9,10,-1
31259.0,2020-02-20,"(1010.5, 1195.0]",1,2,-1
31260.0,2020-02-20,"(387.002, 637.5]",16,21,-5
31260.0,2020-02-20,"(637.5, 887.0]",4,4,0
31260.0,2020-02-20,"(887.0, 1136.5]",2,15,-13
31260.0,2020-02-20,"(1136.5, 1386.0]",2,3,-1
31261.0,2020-02-20,"(387.107, 611.25]",9,9,0
31262.0,2020-02-20,"(327.107, 551.25]",11,11,0
31262.0,2020-02-20,"(551.25, 774.5]",7,11,-4
31262.0,2020-02-20,"(774.5, 997.75]",4,8,-4
31262.0,2020-02-20,"(997.75, 1221.0]",1,6,-5
31263.0,2020-02-20,"(369.049, 607.75]",16,22,-6
31263.0,2020-02-20,"(607.75, 845.5]",8,13,-5
31263.0,2020-02-20,"(845.5, 1083.25]",10,20,-10
31263.0,2020-02-20,"(1083.25, 1321.0]",5,8,-3
31264.0,2020-02-20,"(440.043, 680.25]",12,19,-7
31264.0,2020-02-20,"(680.25, 919.5]",3,4,-1
31264.0,2020-02-20,"(919.5, 1158.75]",10,19,-9
31265.0,2020-02-20,"(408.025, 652.75]",11,26,-15
31265.0,2020-02-20,"(652.75, 896.5]",11,21,-10
31265.0,2020-02-20,"(896.5, 1140.25]",25,42,-17
31265.0,2020-02-20,"(1140.25, 1384.0]",7,17,-10
31266.0,2020-02-20,"(86.811, 385.25]",1,4,-3
31266.0,2020-02-20,"(385.25, 682.5]",7,36,-29
31266.0,2020-02-20,"(682.5, 979.75]",16,24,-8
31266.0,2020-02-20,"(979.75, 1277.0]",21,35,-14
31267.0,2020-02-20,"(405.5, 742.0]",26,1,25
31267.0,2020-02-20,"(742.0, 1078.5]",8,45,-37
31267.0,2020-02-20,"(1078.5, 1415.0]",6,16,-10
31268.0,2020-02-20,"(42.712, 366.0]",1,2,-1
31268.0,2020-02-20,"(366.0, 688.0]",11,42,-31
31268.0,2020-02-20,"(688.0, 1010.0]",11,13,-2
31268.0,2020-02-20,"(1010.0, 1332.0]",21,30,-9
31269.0,2020-02-20,"(323.97, 582.5]",4,7,-3
31269.0,2020-02-20,"(582.5, 840.0]",7,10,-3
31269.0,2020-02-20,"(840.0, 1097.5]",6,11,-5
31269.0,2020-02-20,"(1097.5, 1355.0]",1,9,-8
31270.0,2020-02-20,"(439.107, 663.25]",13,18,-5
31270.0,2020-02-20,"(663.25, 886.5]",2,4,-2
31270.0,2020-02-20,"(886.5, 1109.75]",3,10,-7
31270.0,2020-02-20,"(1109.75, 1333.0]",3,5,-2
31271.0,2020-02-20,"(383.136, 600.0]",13,15,-2
31271.0,2020-02-20,"(600.0, 816.0]",4,5,-1
31271.0,2020-02-20,"(816.0, 1032.0]",3,9,-6
31271.0,2020-02-20,"(1032.0, 1248.0]",4,14,-10
31272.0,2020-02-20,"(302.004, 552.0]",18,20,-2
31272.0,2020-02-20,"(552.0, 801.0]",10,13,-3
31272.0,2020-02-20,"(801.0, 1050.0]",3,12,-9
31272.0,2020-02-20,"(1050.0, 1299.0]",1,4,-3
31273.0,2020-02-20,"(411.24, 602.0]",1,4,-3
31273.0,2020-02-20,"(602.0, 792.0]",1,3,-2
31273.0,2020-02-20,"(792.0, 982.0]",2,3,-1
31273.0,2020-02-20,"(982.0, 1172.0]",3,3,0
31274.0,2020-02-20,"(395.036, 637.0]",24,24,0
31274.0,2020-02-20,"(637.0, 878.0]",1,3,-2
31274.0,2020-02-20,"(878.0, 1119.0]",6,15,-9
31274.0,2020-02-20,"(1119.0, 1360.0]",3,6,-3
31275.0,2020-02-20,"(2.649, 341.75]",2,3,-1
31275.0,2020-02-20,"(341.75, 679.5]",16,26,-10
31275.0,2020-02-20,"(679.5, 1017.25]",11,26,-15
31275.0,2020-02-20,"(1017.25, 1355.0]",20,35,-15
31276.0,2020-02-20,"(406.154, 618.5]",24,25,-1
31276.0,2020-02-20,"(618.5, 830.0]",1,2,-1
31276.0,2020-02-20,"(830.0, 1041.5]",1,9,-8
31277.0,2020-02-20,"(292.018, 538.5]",28,32,-4
31277.0,2020-02-20,"(538.5, 784.0]",9,16,-7
31277.0,2020-02-20,"(784.0, 1029.5]",5,14,-9
31277.0,2020-02-20,"(1029.5, 1275.0]",11,29,-18
31278.0,2020-02-20,"(305.895, 583.25]",12,29,-17
31278.0,2020-02-20,"(583.25, 859.5]",7,16,-9
31278.0,2020-02-20,"(859.5, 1135.75]",17,28,-11
31278.0,2020-02-20,"(1135.75, 1412.0]",12,17,-5
31279.0,2020-02-20,"(416.053, 653.75]",22,22,0
31279.0,2020-02-20,"(653.75, 890.5]",4,10,-6
31279.0,2020-02-20,"(890.5, 1127.25]",6,19,-13
31280.0,2020-02-20,"(353.016, 600.0]",3,17,-14
31280.0,2020-02-20,"(846.0, 1092.0]",13,20,-7
31280.0,2020-02-20,"(1092.0, 1338.0]",12,14,-2
31000.0,2020-02-21,"(1062.25, 1069.0]",1,1,0
31001.0,2020-02-21,"(674.25, 899.0]",1,1,0
31002.0,2020-02-21,"(373.174, 580.5]",2,2,0
31002.0,2020-02-21,"(580.5, 787.0]",1,1,0
31003.0,2020-02-21,"(504.415, 651.25]",1,2,-1
31003.0,2020-02-21,"(797.5, 943.75]",1,2,-1
31004.0,2020-02-21,"(1074.0, 1265.0]",2,1,1
31005.0,2020-02-21,"(502.241, 692.75]",1,2,-1
31005.0,2020-02-21,"(882.5, 1072.25]",1,1,0
31005.0,2020-02-21,"(1072.25, 1262.0]",1,3,-2
31006.0,2020-02-21,"(979.781, 1034.75]",1,1,0
31006.0,2020-02-21,"(1034.75, 1089.5]",1,1,0
31007.0,2020-02-21,"(482.073, 714.75]",6,12,-6
31007.0,2020-02-21,"(714.75, 946.5]",3,6,-3
31007.0,2020-02-21,"(946.5, 1178.25]",3,13,-10
31007.0,2020-02-21,"(1178.25, 1410.0]",1,2,-1
,,,,2.0,
31010.0,2020-02-21,"(842.5, 846.0]",1,1,0
31011.0,2020-02-21,"(418.377, 574.75]",4,5,-1
31011.0,2020-02-21,"(574.75, 730.5]",1,1,0
31011.0,2020-02-21,"(886.25, 1042.0]",2,6,-4
31012.0,2020-02-21,"(541.242, 731.5]",1,1,0
31013.0,2020-02-21,"(949.5, 1094.0]",2,2,0
31014.0,2020-02-21,"(374.113, 596.75]",14,16,-2
31014.0,2020-02-21,"(596.75, 818.5]",2,3,-1
31014.0,2020-02-21,"(818.5, 1040.25]",4,7,-3
31014.0,2020-02-21,"(1040.25, 1262.0]",5,9,-4
31015.0,2020-02-21,"(433.07, 666.5]",10,11,-1
31015.0,2020-02-21,"(666.5, 899.0]",1,4,-3
31015.0,2020-02-21,"(899.0, 1131.5]",8,13,-5
31015.0,2020-02-21,"(1131.5, 1364.0]",3,5,-2
31016.0,2020-02-21,"(431.16, 642.0]",2,8,-6
31016.0,2020-02-21,"(642.0, 852.0]",2,4,-2
31016.0,2020-02-21,"(852.0, 1062.0]",3,3,0
31016.0,2020-02-21,"(1062.0, 1272.0]",2,6,-4
31017.0,2020-02-21,"(503.184, 708.0]",3,4,-1
31017.0,2020-02-21,"(708.0, 912.0]",1,3,-2
31017.0,2020-02-21,"(912.0, 1116.0]",1,3,-2
31017.0,2020-02-21,"(1116.0, 1320.0]",1,2,-1
31018.0,2020-02-21,"(801.0, 983.0]",1,3,-2
31019.0,2020-02-21,"(730.324, 900.0]",2,2,0
31019.0,2020-02-21,"(900.0, 1069.0]",1,1,0
31019.0,2020-02-21,"(1069.0, 1238.0]",2,2,0
31020.0,2020-02-21,"(489.248, 678.0]",1,2,-1
31020.0,2020-02-21,"(1054.0, 1242.0]",2,6,-4
31021.0,2020-02-21,"(388.221, 583.75]",1,4,-3
31021.0,2020-02-21,"(973.25, 1168.0]",3,3,0
31022.0,2020-02-21,"(517.099, 743.25]",1,3,-2
31022.0,2020-02-21,"(743.25, 968.5]",1,8,-7
31022.0,2020-02-21,"(968.5, 1193.75]",2,7,-5
31022.0,2020-02-21,"(1193.75, 1419.0]",1,2,-1
31023.0,2020-02-21,"(550.24, 741.0]",1,1,0
31023.0,2020-02-21,"(931.0, 1121.0]",1,1,0
31023.0,2020-02-21,"(1121.0, 1311.0]",1,1,0
31024.0,2020-02-21,"(479.21, 677.5]",3,6,-3
31024.0,2020-02-21,"(875.0, 1072.5]",1,1,0
31024.0,2020-02-21,"(1072.5, 1270.0]",2,1,1
31025.0,2020-02-21,"(407.219, 603.25]",1,4,-3
31025.0,2020-02-21,"(603.25, 798.5]",1,3,-2
31025.0,2020-02-21,"(993.75, 1189.0]",1,1,0
31026.0,2020-02-21,"(389.31, 562.5]",1,4,-3
31026.0,2020-02-21,"(735.0, 907.5]",1,2,-1
31026.0,2020-02-21,"(907.5, 1080.0]",2,5,-3
31027.0,2020-02-21,"(886.25, 1043.0]",2,2,0
31028.0,2020-02-21,"(1035.907, 1059.25]",1,2,-1
31028.0,2020-02-21,"(1105.75, 1129.0]",1,2,-1
31029.0,2020-02-21,"(631.25, 824.5]",1,8,-7
31029.0,2020-02-21,"(1017.75, 1211.0]",3,3,0
31030.0,2020-02-21,"(675.25, 833.5]",1,5,-4
31030.0,2020-02-21,"(991.75, 1150.0]",4,2,2
31031.0,2020-02-21,"(419.3, 595.0]",1,1,0
31031.0,2020-02-21,"(945.0, 1120.0]",1,3,-2
31032.0,2020-02-21,"(1001.25, 1335.0]",3,1,2
31033.0,2020-02-21,"(531.263, 716.25]",1,2,-1
31033.0,2020-02-21,"(900.5, 1084.75]",1,1,0
31033.0,2020-02-21,"(1084.75, 1269.0]",1,2,-1
31034.0,2020-02-21,"(402.273, 584.75]",1,2,-1
31034.0,2020-02-21,"(584.75, 766.5]",3,4,-1
31034.0,2020-02-21,"(948.25, 1130.0]",1,1,0
31035.0,2020-02-21,"(548.0, 822.0]",1,1,0
31035.0,2020-02-21,"(822.0, 1096.0]",1,1,0
31036.0,2020-02-21,"(1014.0, 1201.0]",2,2,0
31037.0,2020-02-21,"(324.899, 601.25]",10,12,-2
31037.0,2020-02-21,"(601.25, 876.5]",2,3,-1
31037.0,2020-02-21,"(876.5, 1151.75]",3,13,-10
31037.0,2020-02-21,"(1151.75, 1427.0]",1,2,-1
31038.0,2020-02-21,"(494.496, 621.0]",1,3,-2
31039.0,2020-02-21,"(891.648, 980.0]",1,1,0
31039.0,2020-02-21,"(980.0, 1068.0]",1,2,-1
31039.0,2020-02-21,"(1156.0, 1244.0]",2,4,-2
31040.0,2020-02-21,"(412.16, 623.0]",4,4,0
31040.0,2020-02-21,"(833.0, 1043.0]",2,4,-2
31041.0,2020-02-21,"(564.324, 734.0]",1,1,0
31041.0,2020-02-21,"(903.0, 1072.0]",1,1,0
31041.0,2020-02-21,"(1072.0, 1241.0]",1,3,-2
31042.0,2020-02-21,"(428.311, 601.25]",7,7,0
31042.0,2020-02-21,"(945.75, 1118.0]",2,1,1
31043.0,2020-02-21,"(453.107, 677.25]",1,1,0
31043.0,2020-02-21,"(900.5, 1123.75]",1,3,-2
31043.0,2020-02-21,"(1123.75, 1347.0]",2,2,0
31044.0,2020-02-21,"(593.495, 720.25]",2,2,0
31044.0,2020-02-21,"(720.25, 846.5]",1,1,0
31044.0,2020-02-21,"(972.75, 1099.0]",3,4,-1
31045.0,2020-02-21,"(556.231, 749.25]",1,3,-2
31045.0,2020-02-21,"(1133.75, 1326.0]",1,1,0
31046.0,2020-02-21,"(395.375, 552.25]",1,3,-2
31046.0,2020-02-21,"(864.75, 1021.0]",1,1,0
31047.0,2020-02-21,"(348.008, 597.0]",7,11,-4
31047.0,2020-02-21,"(845.0, 1093.0]",5,2,3
31047.0,2020-02-21,"(1093.0, 1341.0]",1,7,-6
31048.0,2020-02-21,"(674.5, 874.0]",1,4,-3
31048.0,2020-02-21,"(874.0, 1073.5]",2,1,1
31048.0,2020-02-21,"(1073.5, 1273.0]",2,8,-6
31049.0,2020-02-21,"(581.396, 733.0]",1,2,-1
31049.0,2020-02-21,"(1035.0, 1186.0]",1,2,-1
31050.0,2020-02-21,"(655.5, 835.0]",1,2,-1
31050.0,2020-02-21,"(1014.5, 1194.0]",3,2,1
31051.0,2020-02-21,"(931.5, 1242.0]",4,1,3
31052.0,2020-02-21,"(522.475, 654.25]",1,1,0
31052.0,2020-02-21,"(916.75, 1048.0]",1,2,-1
,,,,1.0,
,,,,2.0,
,,,,1.0,
,,,,2.0,
31055.0,2020-02-21,"(696.343, 861.25]",1,2,-1
31055.0,2020-02-21,"(861.25, 1025.5]",1,1,0
31055.0,2020-02-21,"(1025.5, 1189.75]",1,1,0
31055.0,2020-02-21,"(1189.75, 1354.0]",1,1,0
31056.0,2020-02-21,"(1055.75, 1214.0]",1,1,0
,,,,2.0,
,,,,2.0,
31059.0,2020-02-21,"(809.782, 864.5]",2,4,-2
31059.0,2020-02-21,"(973.5, 1028.0]",1,1,0
31060.0,2020-02-21,"(592.256, 779.0]",1,1,0
31060.0,2020-02-21,"(965.0, 1151.0]",1,2,-1
31061.0,2020-02-21,"(517.5, 690.0]",1,1,0
31062.0,2020-02-21,"(842.775, 899.25]",2,6,-4
31062.0,2020-02-21,"(955.5, 1011.75]",2,2,0
31062.0,2020-02-21,"(1011.75, 1068.0]",3,6,-3
,,,,2.0,
31064.0,2020-02-21,"(811.0, 962.5]",1,1,0
31064.0,2020-02-21,"(962.5, 1114.0]",3,6,-3
,,,,1.0,
,,,,1.0,
,,,,1.0,
31066.0,2020-02-21,"(440.671, 523.25]",1,1,0
31066.0,2020-02-21,"(687.75, 770.0]",1,2,-1
31067.0,2020-02-21,"(501.311, 674.25]",2,5,-3
31067.0,2020-02-21,"(1018.75, 1191.0]",1,2,-1
,,,,2.0,
31069.0,2020-02-21,"(744.5, 899.75]",2,5,-3
31069.0,2020-02-21,"(899.75, 1055.0]",2,2,0
31070.0,2020-02-21,"(643.5, 869.0]",1,1,0
31070.0,2020-02-21,"(869.0, 1094.5]",1,2,-1
31070.0,2020-02-21,"(1094.5, 1320.0]",2,2,0
31071.0,2020-02-21,"(750.0, 897.0]",1,1,0
31071.0,2020-02-21,"(897.0, 1044.0]",4,2,2
31072.0,2020-02-21,"(807.0, 1076.0]",1,1,0
31073.0,2020-02-21,"(432.999, 433.25]",1,1,0
31074.0,2020-02-21,"(886.5, 1082.25]",2,2,0
31074.0,2020-02-21,"(1082.25, 1278.0]",1,1,0
31075.0,2020-02-21,"(817.5, 1090.0]",1,1,0
,,,,2.0,
31077.0,2020-02-21,"(888.0, 1058.0]",6,4,2
31077.0,2020-02-21,"(1058.0, 1228.0]",2,8,-6
31078.0,2020-02-21,"(486.446, 625.5]",6,6,0
31079.0,2020-02-21,"(750.5, 942.25]",1,4,-3
31079.0,2020-02-21,"(942.25, 1134.0]",2,2,0
31080.0,2020-02-21,"(476.132, 694.0]",1,7,-6
31080.0,2020-02-21,"(911.0, 1128.0]",2,2,0
31080.0,2020-02-21,"(1128.0, 1345.0]",1,3,-2
31081.0,2020-02-21,"(1210.5, 1323.0]",2,2,0
31082.0,2020-02-21,"(1079.988, 1083.0]",1,1,0
31083.0,2020-02-21,"(720.5, 767.0]",1,1,0
31084.0,2020-02-21,"(477.167, 686.25]",2,2,0
31084.0,2020-02-21,"(894.5, 1102.75]",3,1,2
31084.0,2020-02-21,"(1102.75, 1311.0]",2,6,-4
31085.0,2020-02-21,"(401.307, 575.25]",1,2,-1
31085.0,2020-02-21,"(921.75, 1095.0]",1,1,0
31086.0,2020-02-21,"(535.5, 653.0]",1,2,-1
31086.0,2020-02-21,"(770.5, 888.0]",1,2,-1
31087.0,2020-02-21,"(602.5, 626.0]",1,1,0
31088.0,2020-02-21,"(1002.5, 1213.25]",2,1,1
31088.0,2020-02-21,"(1213.25, 1424.0]",2,2,0
31089.0,2020-02-21,"(478.07, 711.5]",6,7,-1
31089.0,2020-02-21,"(711.5, 944.0]",5,9,-4
31089.0,2020-02-21,"(944.0, 1176.5]",2,16,-14
31089.0,2020-02-21,"(1176.5, 1409.0]",1,3,-2
31090.0,2020-02-21,"(604.0, 647.0]",1,1,0
31091.0,2020-02-21,"(410.425, 554.75]",1,4,-3
31091.0,2020-02-21,"(554.75, 698.5]",1,3,-2
31091.0,2020-02-21,"(842.25, 986.0]",1,1,0
31092.0,2020-02-21,"(817.5, 1029.75]",1,1,0
,,,,1.0,
,,,,1.0,
31094.0,2020-02-21,"(392.25, 523.0]",1,1,0
,,,,2.0,
31096.0,2020-02-21,"(512.346, 676.5]",1,2,-1
31096.0,2020-02-21,"(840.0, 1003.5]",1,2,-1
31096.0,2020-02-21,"(1003.5, 1167.0]",3,3,0
31097.0,2020-02-21,"(461.308, 635.0]",1,2,-1
31097.0,2020-02-21,"(808.0, 981.0]",1,2,-1
31098.0,2020-02-21,"(406.156, 618.0]",4,9,-5
31098.0,2020-02-21,"(829.0, 1040.0]",2,1,1
31098.0,2020-02-21,"(1040.0, 1251.0]",4,4,0
31099.0,2020-02-21,"(888.5, 1031.0]",2,1,1
31100.0,2020-02-21,"(480.36, 641.0]",8,8,0
31100.0,2020-02-21,"(641.0, 801.0]",3,4,-1
31100.0,2020-02-21,"(801.0, 961.0]",4,10,-6
31100.0,2020-02-21,"(961.0, 1121.0]",1,11,-10
31101.0,2020-02-21,"(0.564, 361.0]",2,3,-1
31101.0,2020-02-21,"(361.0, 720.0]",12,32,-20
31101.0,2020-02-21,"(720.0, 1079.0]",27,49,-22
31101.0,2020-02-21,"(1079.0, 1438.0]",14,26,-12
31102.0,2020-02-21,"(344.028, 588.0]",1,20,-19
31102.0,2020-02-21,"(588.0, 831.0]",1,6,-5
31102.0,2020-02-21,"(831.0, 1074.0]",3,12,-9
31102.0,2020-02-21,"(1074.0, 1317.0]",5,8,-3
31103.0,2020-02-21,"(597.25, 866.5]",2,15,-13
31103.0,2020-02-21,"(866.5, 1135.75]",7,13,-6
31103.0,2020-02-21,"(1135.75, 1405.0]",4,16,-12
31104.0,2020-02-21,"(334.916, 607.0]",4,17,-13
31104.0,2020-02-21,"(607.0, 878.0]",3,7,-4
31104.0,2020-02-21,"(878.0, 1149.0]",18,29,-11
31104.0,2020-02-21,"(1149.0, 1420.0]",6,11,-5
31105.0,2020-02-21,"(336.101, 561.75]",1,6,-5
31105.0,2020-02-21,"(786.5, 1011.25]",1,3,-2
31105.0,2020-02-21,"(1011.25, 1236.0]",4,2,2
31106.0,2020-02-21,"(925.0, 1140.0]",2,4,-2
31106.0,2020-02-21,"(1140.0, 1355.0]",2,2,0
31107.0,2020-02-21,"(1.685, 331.75]",1,1,0
31107.0,2020-02-21,"(331.75, 660.5]",2,21,-19
31107.0,2020-02-21,"(660.5, 989.25]",5,14,-9
31107.0,2020-02-21,"(989.25, 1318.0]",9,15,-6
31108.0,2020-02-21,"(343.014, 590.5]",3,16,-13
31108.0,2020-02-21,"(590.5, 837.0]",4,6,-2
31108.0,2020-02-21,"(837.0, 1083.5]",18,29,-11
31108.0,2020-02-21,"(1083.5, 1330.0]",6,10,-4
31109.0,2020-02-21,"(356.951, 620.25]",4,12,-8
31109.0,2020-02-21,"(620.25, 882.5]",10,13,-3
31109.0,2020-02-21,"(882.5, 1144.75]",9,14,-5
31109.0,2020-02-21,"(1144.75, 1407.0]",6,12,-6
31110.0,2020-02-21,"(332.913, 605.75]",8,25,-17
31110.0,2020-02-21,"(605.75, 877.5]",15,24,-9
31110.0,2020-02-21,"(877.5, 1149.25]",11,25,-14
31110.0,2020-02-21,"(1149.25, 1421.0]",9,14,-5
31111.0,2020-02-21,"(342.983, 598.25]",4,12,-8
31111.0,2020-02-21,"(598.25, 852.5]",3,7,-4
31111.0,2020-02-21,"(852.5, 1106.75]",11,17,-6
31111.0,2020-02-21,"(1106.75, 1361.0]",5,9,-4
31112.0,2020-02-21,"(691.25, 921.5]",2,3,-1
31112.0,2020-02-21,"(921.5, 1151.75]",2,4,-2
31112.0,2020-02-21,"(1151.75, 1382.0]",1,4,-3
31113.0,2020-02-21,"(349.919, 621.25]",1,11,-10
31113.0,2020-02-21,"(621.25, 891.5]",2,8,-6
31113.0,2020-02-21,"(891.5, 1161.75]",7,15,-8
31113.0,2020-02-21,"(1161.75, 1432.0]",5,8,-3
31114.0,2020-02-21,"(370.0, 723.0]",2,1,1
31114.0,2020-02-21,"(723.0, 1076.0]",11,29,-18
31114.0,2020-02-21,"(1076.0, 1429.0]",15,27,-12
31115.0,2020-02-21,"(16.584, 372.0]",2,2,0
31115.0,2020-02-21,"(372.0, 726.0]",2,20,-18
31115.0,2020-02-21,"(726.0, 1080.0]",7,13,-6
31115.0,2020-02-21,"(1080.0, 1434.0]",5,10,-5
31116.0,2020-02-21,"(9.681, 340.75]",1,2,-1
31116.0,2020-02-21,"(340.75, 670.5]",8,25,-17
31116.0,2020-02-21,"(670.5, 1000.25]",4,8,-4
31116.0,2020-02-21,"(1000.25, 1330.0]",17,27,-10
31117.0,2020-02-21,"(324.916, 597.0]",1,17,-16
31117.0,2020-02-21,"(597.0, 868.0]",1,13,-12
31117.0,2020-02-21,"(868.0, 1139.0]",6,15,-9
31117.0,2020-02-21,"(1139.0, 1410.0]",5,11,-6
31118.0,2020-02-21,"(414.007, 663.25]",2,15,-13
31118.0,2020-02-21,"(911.5, 1159.75]",9,3,6
31118.0,2020-02-21,"(1159.75, 1408.0]",5,13,-8
31119.0,2020-02-21,"(327.99, 581.5]",3,18,-15
31119.0,2020-02-21,"(581.5, 834.0]",5,11,-6
31119.0,2020-02-21,"(834.0, 1086.5]",10,18,-8
31119.0,2020-02-21,"(1086.5, 1339.0]",13,18,-5
31120.0,2020-02-21,"(49.635, 392.25]",2,2,0
31120.0,2020-02-21,"(392.25, 733.5]",4,13,-9
31120.0,2020-02-21,"(733.5, 1074.75]",4,11,-7
31120.0,2020-02-21,"(1074.75, 1416.0]",9,13,-4
31121.0,2020-02-21,"(342.928, 612.0]",15,20,-5
31121.0,2020-02-21,"(612.0, 880.0]",2,5,-3
31121.0,2020-02-21,"(880.0, 1148.0]",7,19,-12
31121.0,2020-02-21,"(1148.0, 1416.0]",2,6,-4
31122.0,2020-02-21,"(434.02, 680.0]",2,12,-10
31122.0,2020-02-21,"(680.0, 925.0]",1,1,0
31122.0,2020-02-21,"(925.0, 1170.0]",3,6,-3
31122.0,2020-02-21,"(1170.0, 1415.0]",4,6,-2
31123.0,2020-02-21,"(67.678, 399.5]",1,1,0
31123.0,2020-02-21,"(399.5, 730.0]",2,19,-17
31123.0,2020-02-21,"(730.0, 1060.5]",3,5,-2
31123.0,2020-02-21,"(1060.5, 1391.0]",3,6,-3
31124.0,2020-02-21,"(375.94, 642.0]",17,31,-14
31124.0,2020-02-21,"(642.0, 907.0]",4,18,-14
31124.0,2020-02-21,"(907.0, 1172.0]",13,44,-31
31124.0,2020-02-21,"(1172.0, 1437.0]",8,19,-11
31125.0,2020-02-21,"(353.977, 610.75]",5,29,-24
31125.0,2020-02-21,"(610.75, 866.5]",2,2,0
31125.0,2020-02-21,"(866.5, 1122.25]",20,28,-8
31125.0,2020-02-21,"(1122.25, 1378.0]",10,16,-6
31126.0,2020-02-21,"(50.651, 389.25]",1,2,-1
31126.0,2020-02-21,"(389.25, 726.5]",5,27,-22
31126.0,2020-02-21,"(726.5, 1063.75]",5,9,-4
31126.0,2020-02-21,"(1063.75, 1401.0]",13,17,-4
31127.0,2020-02-21,"(17.607, 367.25]",2,2,0
31127.0,2020-02-21,"(367.25, 715.5]",8,15,-7
31127.0,2020-02-21,"(715.5, 1063.75]",15,37,-22
31127.0,2020-02-21,"(1063.75, 1412.0]",5,8,-3
31128.0,2020-02-21,"(76.7, 403.0]",2,3,-1
31128.0,2020-02-21,"(403.0, 728.0]",17,29,-12
31128.0,2020-02-21,"(728.0, 1053.0]",12,24,-12
31128.0,2020-02-21,"(1053.0, 1378.0]",12,17,-5
31129.0,2020-02-21,"(420.325, 589.75]",9,10,-1
31129.0,2020-02-21,"(589.75, 758.5]",5,10,-5
31129.0,2020-02-21,"(758.5, 927.25]",6,7,-1
31129.0,2020-02-21,"(927.25, 1096.0]",2,9,-7
31130.0,2020-02-21,"(420.066, 654.5]",4,9,-5
31130.0,2020-02-21,"(654.5, 888.0]",1,5,-4
31130.0,2020-02-21,"(888.0, 1121.5]",10,15,-5
31130.0,2020-02-21,"(1121.5, 1355.0]",6,9,-3
31131.0,2020-02-21,"(567.0, 789.0]",1,10,-9
31131.0,2020-02-21,"(789.0, 1011.0]",3,2,1
31131.0,2020-02-21,"(1011.0, 1233.0]",5,6,-1
31200.0,2020-02-21,"(350.0, 700.0]",24,1,23
31200.0,2020-02-21,"(700.0, 1050.0]",12,39,-27
31200.0,2020-02-21,"(1050.0, 1400.0]",17,27,-10
31201.0,2020-02-21,"(353.5, 697.0]",14,2,12
31201.0,2020-02-21,"(697.0, 1040.5]",29,37,-8
31201.0,2020-02-21,"(1040.5, 1384.0]",23,52,-29
,,,,2.0,
31203.0,2020-02-21,"(100.798, 402.5]",1,4,-3
31203.0,2020-02-21,"(402.5, 703.0]",6,18,-12
31203.0,2020-02-21,"(703.0, 1003.5]",13,22,-9
31203.0,2020-02-21,"(1003.5, 1304.0]",21,32,-11
31204.0,2020-02-21,"(4.6, 356.0]",4,4,0
31204.0,2020-02-21,"(356.0, 706.0]",10,15,-5
31204.0,2020-02-21,"(706.0, 1056.0]",5,17,-12
31204.0,2020-02-21,"(1056.0, 1406.0]",5,11,-6
31205.0,2020-02-21,"(412.179, 618.25]",14,17,-3
31205.0,2020-02-21,"(618.25, 823.5]",16,22,-6
31205.0,2020-02-21,"(823.5, 1028.75]",9,17,-8
31205.0,2020-02-21,"(1028.75, 1234.0]",7,16,-9
31206.0,2020-02-21,"(449.389, 602.75]",4,4,0
31206.0,2020-02-21,"(908.25, 1061.0]",1,2,-1
31207.0,2020-02-21,"(393.161, 603.75]",1,3,-2
31207.0,2020-02-21,"(813.5, 1023.25]",2,3,-1
31207.0,2020-02-21,"(1023.25, 1233.0]",1,3,-2
31208.0,2020-02-21,"(386.081, 616.75]",9,13,-4
31208.0,2020-02-21,"(846.5, 1076.25]",3,4,-1
31208.0,2020-02-21,"(1076.25, 1306.0]",2,11,-9
31209.0,2020-02-21,"(566.386, 720.5]",5,5,0
31209.0,2020-02-21,"(1027.5, 1181.0]",2,2,0
31211.0,2020-02-21,"(394.052, 632.0]",7,11,-4
31211.0,2020-02-21,"(632.0, 869.0]",1,2,-1
31211.0,2020-02-21,"(869.0, 1106.0]",4,7,-3
31211.0,2020-02-21,"(1106.0, 1343.0]",6,10,-4
31212.0,2020-02-21,"(349.932, 618.0]",22,34,-12
31212.0,2020-02-21,"(618.0, 885.0]",5,10,-5
31212.0,2020-02-21,"(885.0, 1152.0]",13,29,-16
31212.0,2020-02-21,"(1152.0, 1419.0]",6,13,-7
31213.0,2020-02-21,"(269.033, 511.75]",3,5,-2
31213.0,2020-02-21,"(511.75, 753.5]",7,14,-7
31213.0,2020-02-21,"(753.5, 995.25]",3,7,-4
31213.0,2020-02-21,"(995.25, 1237.0]",7,13,-6
31214.0,2020-02-21,"(13.676, 346.0]",1,2,-1
31214.0,2020-02-21,"(346.0, 677.0]",8,27,-19
31214.0,2020-02-21,"(677.0, 1008.0]",20,35,-15
31214.0,2020-02-21,"(1008.0, 1339.0]",22,37,-15
31215.0,2020-02-21,"(443.238, 634.5]",5,5,0
31215.0,2020-02-21,"(634.5, 825.0]",2,4,-2
31215.0,2020-02-21,"(1015.5, 1206.0]",4,2,2
31216.0,2020-02-21,"(213.909, 487.75]",2,3,-1
31216.0,2020-02-21,"(487.75, 760.5]",19,22,-3
31216.0,2020-02-21,"(760.5, 1033.25]",3,9,-6
31216.0,2020-02-21,"(1033.25, 1306.0]",4,15,-11
31217.0,2020-02-21,"(334.234, 526.5]",4,5,-1
31217.0,2020-02-21,"(526.5, 718.0]",2,3,-1
31217.0,2020-02-21,"(718.0, 909.5]",3,6,-3
31217.0,2020-02-21,"(909.5, 1101.0]",1,8,-7
31218.0,2020-02-21,"(372.045, 611.75]",6,19,-13
31218.0,2020-02-21,"(611.75, 850.5]",1,3,-2
31218.0,2020-02-21,"(850.5, 1089.25]",10,14,-4
31218.0,2020-02-21,"(1089.25, 1328.0]",3,4,-1
31219.0,2020-02-21,"(406.131, 624.25]",5,6,-1
31219.0,2020-02-21,"(624.25, 841.5]",4,4,0
31219.0,2020-02-21,"(841.5, 1058.75]",8,13,-5
31219.0,2020-02-21,"(1058.75, 1276.0]",2,4,-2
31220.0,2020-02-21,"(361.139, 577.25]",15,16,-1
31220.0,2020-02-21,"(577.25, 792.5]",2,4,-2
31220.0,2020-02-21,"(792.5, 1007.75]",3,8,-5
31220.0,2020-02-21,"(1007.75, 1223.0]",2,15,-13
31221.0,2020-02-21,"(34.644, 375.0]",1,2,-1
31221.0,2020-02-21,"(375.0, 714.0]",27,34,-7
31221.0,2020-02-21,"(714.0, 1053.0]",7,17,-10
31221.0,2020-02-21,"(1053.0, 1392.0]",15,39,-24
31222.0,2020-02-21,"(479.061, 714.75]",13,13,0
31222.0,2020-02-21,"(714.75, 949.5]",1,1,0
31222.0,2020-02-21,"(949.5, 1184.25]",1,11,-10
31222.0,2020-02-21,"(1184.25, 1419.0]",2,3,-1
31223.0,2020-02-21,"(58.625, 403.75]",2,5,-3
31223.0,2020-02-21,"(403.75, 747.5]",9,22,-13
31223.0,2020-02-21,"(747.5, 1091.25]",16,28,-12
31223.0,2020-02-21,"(1091.25, 1435.0]",8,15,-7
31224.0,2020-02-21,"(478.225, 672.75]",15,16,-1
31224.0,2020-02-21,"(672.75, 866.5]",5,8,-3
31224.0,2020-02-21,"(866.5, 1060.25]",5,15,-10
31224.0,2020-02-21,"(1060.25, 1254.0]",1,6,-5
31225.0,2020-02-21,"(432.078, 663.5]",6,11,-5
31225.0,2020-02-21,"(663.5, 894.0]",1,2,-1
31225.0,2020-02-21,"(894.0, 1124.5]",6,12,-6
31226.0,2020-02-21,"(318.995, 571.25]",3,6,-3
31226.0,2020-02-21,"(571.25, 822.5]",2,3,-1
31226.0,2020-02-21,"(822.5, 1073.75]",5,12,-7
31226.0,2020-02-21,"(1073.75, 1325.0]",2,5,-3
31227.0,2020-02-21,"(297.125, 516.75]",7,8,-1
31227.0,2020-02-21,"(516.75, 735.5]",12,16,-4
31227.0,2020-02-21,"(735.5, 954.25]",8,15,-7
31227.0,2020-02-21,"(954.25, 1173.0]",6,16,-10
31228.0,2020-02-21,"(382.962, 643.5]",9,14,-5
31228.0,2020-02-21,"(643.5, 903.0]",13,20,-7
31228.0,2020-02-21,"(903.0, 1162.5]",12,22,-10
31228.0,2020-02-21,"(1162.5, 1422.0]",7,15,-8
31229.0,2020-02-21,"(312.914, 585.5]",11,39,-28
31229.0,2020-02-21,"(585.5, 857.0]",13,32,-19
31229.0,2020-02-21,"(857.0, 1128.5]",24,39,-15
31229.0,2020-02-21,"(1128.5, 1400.0]",10,25,-15
31230.0,2020-02-21,"(394.097, 620.75]",38,42,-4
31230.0,2020-02-21,"(620.75, 846.5]",15,23,-8
31230.0,2020-02-21,"(846.5, 1072.25]",14,30,-16
31230.0,2020-02-21,"(1072.25, 1298.0]",4,15,-11
31231.0,2020-02-21,"(335.922, 606.5]",11,12,-1
31231.0,2020-02-21,"(606.5, 876.0]",8,10,-2
31231.0,2020-02-21,"(876.0, 1145.5]",7,15,-8
31232.0,2020-02-21,"(9.593, 362.75]",2,4,-2
31232.0,2020-02-21,"(362.75, 714.5]",19,25,-6
31232.0,2020-02-21,"(714.5, 1066.25]",14,20,-6
31232.0,2020-02-21,"(1066.25, 1418.0]",8,14,-6
31233.0,2020-02-21,"(328.943, 594.25]",29,35,-6
31233.0,2020-02-21,"(594.25, 858.5]",13,17,-4
31233.0,2020-02-21,"(858.5, 1122.75]",17,31,-14
31233.0,2020-02-21,"(1122.75, 1387.0]",5,10,-5
31234.0,2020-02-21,"(112.683, 443.25]",4,4,0
31234.0,2020-02-21,"(443.25, 772.5]",1,3,-2
31234.0,2020-02-21,"(772.5, 1101.75]",9,17,-8
31234.0,2020-02-21,"(1101.75, 1431.0]",5,9,-4
31235.0,2020-02-21,"(506.444, 646.0]",2,2,0
31235.0,2020-02-21,"(646.0, 785.0]",1,1,0
31235.0,2020-02-21,"(785.0, 924.0]",2,5,-3
31235.0,2020-02-21,"(924.0, 1063.0]",1,3,-2
31236.0,2020-02-21,"(528.281, 708.75]",16,18,-2
31236.0,2020-02-21,"(708.75, 888.5]",3,9,-6
31236.0,2020-02-21,"(888.5, 1068.25]",4,20,-16
31236.0,2020-02-21,"(1068.25, 1248.0]",3,6,-3
31237.0,2020-02-21,"(320.959, 582.25]",3,11,-8
31237.0,2020-02-21,"(582.25, 842.5]",7,11,-4
31237.0,2020-02-21,"(842.5, 1102.75]",11,17,-6
31237.0,2020-02-21,"(1102.75, 1363.0]",2,5,-3
31238.0,2020-02-21,"(64.839, 356.25]",1,1,0
31238.0,2020-02-21,"(356.25, 646.5]",15,20,-5
31238.0,2020-02-21,"(646.5, 936.75]",3,7,-4
31238.0,2020-02-21,"(936.75, 1227.0]",7,22,-15
31239.0,2020-02-21,"(335.095, 562.25]",17,19,-2
31239.0,2020-02-21,"(562.25, 788.5]",10,15,-5
31239.0,2020-02-21,"(788.5, 1014.75]",3,5,-2
31239.0,2020-02-21,"(1014.75, 1241.0]",11,26,-15
31240.0,2020-02-21,"(160.137, 376.75]",4,12,-8
31240.0,2020-02-21,"(592.5, 808.25]",1,4,-3
31240.0,2020-02-21,"(808.25, 1024.0]",3,5,-2
31241.0,2020-02-21,"(82.658, 419.5]",3,4,-1
31241.0,2020-02-21,"(419.5, 755.0]",17,45,-28
31241.0,2020-02-21,"(755.0, 1090.5]",16,26,-10
31241.0,2020-02-21,"(1090.5, 1426.0]",22,34,-12
31242.0,2020-02-21,"(454.104, 679.0]",27,29,-2
31242.0,2020-02-21,"(679.0, 903.0]",10,19,-9
31242.0,2020-02-21,"(903.0, 1127.0]",7,25,-18
31242.0,2020-02-21,"(1127.0, 1351.0]",2,8,-6
31243.0,2020-02-21,"(376.24, 567.0]",8,11,-3
31243.0,2020-02-21,"(567.0, 757.0]",6,8,-2
31243.0,2020-02-21,"(757.0, 947.0]",4,8,-4
31243.0,2020-02-21,"(947.0, 1137.0]",6,17,-11
31244.0,2020-02-21,"(422.059, 658.25]",12,18,-6
31244.0,2020-02-21,"(658.25, 893.5]",5,9,-4
31244.0,2020-02-21,"(893.5, 1128.75]",4,17,-13
31244.0,2020-02-21,"(1128.75, 1364.0]",5,6,-1
31245.0,2020-02-21,"(393.99, 647.5]",9,14,-5
31245.0,2020-02-21,"(647.5, 900.0]",3,8,-5
31245.0,2020-02-21,"(900.0, 1152.5]",12,20,-8
31245.0,2020-02-21,"(1152.5, 1405.0]",1,4,-3
31246.0,2020-02-21,"(379.956, 642.0]",8,17,-9
31246.0,2020-02-21,"(642.0, 903.0]",7,11,-4
31246.0,2020-02-21,"(903.0, 1164.0]",15,28,-13
31246.0,2020-02-21,"(1164.0, 1425.0]",6,10,-4
31247.0,2020-02-21,"(414.188, 618.0]",10,14,-4
31247.0,2020-02-21,"(618.0, 821.0]",8,14,-6
31247.0,2020-02-21,"(821.0, 1024.0]",20,34,-14
31247.0,2020-02-21,"(1024.0, 1227.0]",5,13,-8
31248.0,2020-02-21,"(363.94, 630.0]",9,15,-6
31248.0,2020-02-21,"(630.0, 895.0]",14,26,-12
31248.0,2020-02-21,"(895.0, 1160.0]",22,51,-29
31248.0,2020-02-21,"(1160.0, 1425.0]",11,13,-2
31249.0,2020-02-21,"(177.069, 410.75]",4,8,-4
31249.0,2020-02-21,"(410.75, 643.5]",2,5,-3
31249.0,2020-02-21,"(643.5, 876.25]",2,3,-1
31249.0,2020-02-21,"(876.25, 1109.0]",4,8,-4
31250.0,2020-02-21,"(397.184, 602.0]",15,17,-2
31250.0,2020-02-21,"(602.0, 806.0]",1,5,-4
31250.0,2020-02-21,"(806.0, 1010.0]",10,17,-7
31250.0,2020-02-21,"(1010.0, 1214.0]",2,11,-9
31251.0,2020-02-21,"(467.079, 698.25]",19,32,-13
31251.0,2020-02-21,"(698.25, 928.5]",6,12,-6
31251.0,2020-02-21,"(928.5, 1158.75]",10,24,-14
31251.0,2020-02-21,"(1158.75, 1389.0]",7,8,-1
31252.0,2020-02-21,"(511.306, 685.5]",11,12,-1
31252.0,2020-02-21,"(685.5, 859.0]",4,7,-3
31252.0,2020-02-21,"(859.0, 1032.5]",1,5,-4
31252.0,2020-02-21,"(1032.5, 1206.0]",4,24,-20
31253.0,2020-02-21,"(423.197, 624.75]",13,13,0
31253.0,2020-02-21,"(624.75, 825.5]",8,11,-3
31253.0,2020-02-21,"(825.5, 1026.25]",9,16,-7
31253.0,2020-02-21,"(1026.25, 1227.0]",1,14,-13
31254.0,2020-02-21,"(410.028, 654.0]",25,28,-3
31254.0,2020-02-21,"(654.0, 897.0]",7,11,-4
31254.0,2020-02-21,"(897.0, 1140.0]",2,23,-21
31255.0,2020-02-21,"(357.935, 625.25]",12,17,-5
31255.0,2020-02-21,"(625.25, 891.5]",3,5,-2
31255.0,2020-02-21,"(891.5, 1157.75]",3,10,-7
31255.0,2020-02-21,"(1157.75, 1424.0]",3,4,-1
31256.0,2020-02-21,"(34.718, 356.5]",2,2,0
31256.0,2020-02-21,"(356.5, 677.0]",1,1,0
31256.0,2020-02-21,"(677.0, 997.5]",1,2,-1
31256.0,2020-02-21,"(997.5, 1318.0]",4,10,-6
31257.0,2020-02-21,"(39.666, 374.5]",1,2,-1
31257.0,2020-02-21,"(374.5, 708.0]",18,30,-12
31257.0,2020-02-21,"(708.0, 1041.5]",18,35,-17
31257.0,2020-02-21,"(1041.5, 1375.0]",18,34,-16
31258.0,2020-02-21,"(222.888, 502.0]",4,4,0
31258.0,2020-02-21,"(502.0, 780.0]",9,13,-4
31258.0,2020-02-21,"(780.0, 1058.0]",7,23,-16
31258.0,2020-02-21,"(1058.0, 1336.0]",3,8,-5
31259.0,2020-02-21,"(466.327, 635.25]",8,9,-1
31260.0,2020-02-21,"(386.109, 609.75]",14,17,-3
31260.0,2020-02-21,"(609.75, 832.5]",2,5,-3
31260.0,2020-02-21,"(832.5, 1055.25]",2,12,-10
31260.0,2020-02-21,"(1055.25, 1278.0]",2,7,-5
31261.0,2020-02-21,"(388.057, 624.75]",6,6,0
31261.0,2020-02-21,"(624.75, 860.5]",1,8,-7
31261.0,2020-02-21,"(860.5, 1096.25]",1,7,-6
31261.0,2020-02-21,"(1096.25, 1332.0]",1,5,-4
31262.0,2020-02-21,"(456.147, 670.25]",6,7,-1
31262.0,2020-02-21,"(670.25, 883.5]",1,3,-2
31262.0,2020-02-21,"(883.5, 1096.75]",1,4,-3
31262.0,2020-02-21,"(1096.75, 1310.0]",1,4,-3
31263.0,2020-02-21,"(421.077, 652.75]",2,4,-2
31263.0,2020-02-21,"(652.75, 883.5]",1,5,-4
31263.0,2020-02-21,"(883.5, 1114.25]",9,17,-8
31263.0,2020-02-21,"(1114.25, 1345.0]",4,7,-3
31264.0,2020-02-21,"(354.962, 615.5]",8,11,-3
31264.0,2020-02-21,"(615.5, 875.0]",5,7,-2
31264.0,2020-02-21,"(875.0, 1134.5]",4,15,-11
31264.0,2020-02-21,"(1134.5, 1394.0]",1,4,-3
31265.0,2020-02-21,"(-0.39, 348.5]",3,5,-2
31265.0,2020-02-21,"(348.5, 696.0]",11,29,-18
31265.0,2020-02-21,"(696.0, 1043.5]",11,22,-11
31265.0,2020-02-21,"(1043.5, 1391.0]",19,28,-9
31266.0,2020-02-21,"(291.855, 579.25]",2,18,-16
31266.0,2020-02-21,"(579.25, 865.5]",7,14,-7
31266.0,2020-02-21,"(865.5, 1151.75]",20,29,-9
31266.0,2020-02-21,"(1151.75, 1438.0]",10,22,-12
31267.0,2020-02-21,"(359.963, 620.25]",14,24,-10
31267.0,2020-02-21,"(620.25, 879.5]",12,21,-9
31267.0,2020-02-21,"(879.5, 1138.75]",10,25,-15
31267.0,2020-02-21,"(1138.75, 1398.0]",10,13,-3
31268.0,2020-02-21,"(316.011, 564.25]",8,26,-18
31268.0,2020-02-21,"(564.25, 811.5]",3,6,-3
31268.0,2020-02-21,"(811.5, 1058.75]",8,16,-8
31268.0,2020-02-21,"(1058.75, 1306.0]",13,15,-2
31269.0,2020-02-21,"(349.75, 672.5]",12,1,11
31269.0,2020-02-21,"(672.5, 995.25]",6,19,-13
31269.0,2020-02-21,"(995.25, 1318.0]",7,15,-8
31270.0,2020-02-21,"(348.5, 655.0]",8,1,7
31270.0,2020-02-21,"(655.0, 961.5]",4,12,-8
31270.0,2020-02-21,"(961.5, 1268.0]",7,11,-4
31271.0,2020-02-21,"(461.079, 692.25]",14,21,-7
31271.0,2020-02-21,"(692.25, 922.5]",9,16,-7
31271.0,2020-02-21,"(922.5, 1152.75]",12,30,-18
31271.0,2020-02-21,"(1152.75, 1383.0]",4,5,-1
31272.0,2020-02-21,"(303.088, 532.0]",9,11,-2
31272.0,2020-02-21,"(532.0, 760.0]",11,16,-5
31272.0,2020-02-21,"(760.0, 988.0]",4,9,-5
31272.0,2020-02-21,"(988.0, 1216.0]",2,11,-9
31273.0,2020-02-21,"(930.75, 1046.0]",3,1,2
31274.0,2020-02-21,"(341.924, 612.0]",7,10,-3
31274.0,2020-02-21,"(612.0, 881.0]",1,1,0
31274.0,2020-02-21,"(881.0, 1150.0]",4,12,-8
31274.0,2020-02-21,"(1150.0, 1419.0]",2,3,-1
31275.0,2020-02-21,"(29.652, 368.0]",2,4,-2
31275.0,2020-02-21,"(368.0, 705.0]",9,19,-10
31275.0,2020-02-21,"(705.0, 1042.0]",15,27,-12
31275.0,2020-02-21,"(1042.0, 1379.0]",13,30,-17
31276.0,2020-02-21,"(382.133, 599.75]",18,19,-1
31276.0,2020-02-21,"(816.5, 1033.25]",4,1,3
31276.0,2020-02-21,"(1033.25, 1250.0]",2,11,-9
31277.0,2020-02-21,"(402.138, 618.5]",31,34,-3
31277.0,2020-02-21,"(618.5, 834.0]",7,12,-5
31277.0,2020-02-21,"(834.0, 1049.5]",7,16,-9
31277.0,2020-02-21,"(1049.5, 1265.0]",5,13,-8
31278.0,2020-02-21,"(342.946, 607.5]",13,26,-13
31278.0,2020-02-21,"(607.5, 871.0]",4,8,-4
31278.0,2020-02-21,"(871.0, 1134.5]",11,22,-11
31278.0,2020-02-21,"(1134.5, 1398.0]",3,6,-3
31279.0,2020-02-21,"(355.041, 595.75]",13,15,-2
31279.0,2020-02-21,"(595.75, 835.5]",4,11,-7
31279.0,2020-02-21,"(835.5, 1075.25]",6,27,-21
31279.0,2020-02-21,"(1075.25, 1315.0]",1,8,-7
31280.0,2020-02-21,"(357.042, 597.5]",5,18,-13
31280.0,2020-02-21,"(597.5, 837.0]",2,6,-4
31280.0,2020-02-21,"(837.0, 1076.5]",10,15,-5
31280.0,2020-02-21,"(1076.5, 1316.0]",9,12,-3
31000.0,2020-02-22,"(730.0, 824.0]",1,1,0
31000.0,2020-02-22,"(918.0, 1012.0]",2,1,1
31001.0,2020-02-22,"(856.5, 924.75]",2,1,1
31002.0,2020-02-22,"(1002.25, 1136.0]",2,1,1
31003.0,2020-02-22,"(107.075, 339.25]",1,1,0
31003.0,2020-02-22,"(801.75, 1033.0]",3,1,2
31004.0,2020-02-22,"(916.5, 1064.25]",1,1,0
31004.0,2020-02-22,"(1064.25, 1212.0]",1,2,-1
31005.0,2020-02-22,"(725.312, 898.0]",5,8,-3
31005.0,2020-02-22,"(898.0, 1070.0]",1,3,-2
31005.0,2020-02-22,"(1070.0, 1242.0]",1,2,-1
31005.0,2020-02-22,"(1242.0, 1414.0]",1,1,0
31006.0,2020-02-22,"(557.334, 724.5]",3,5,-2
31006.0,2020-02-22,"(724.5, 891.0]",2,3,-1
31006.0,2020-02-22,"(891.0, 1057.5]",1,1,0
31006.0,2020-02-22,"(1057.5, 1224.0]",1,2,-1
31007.0,2020-02-22,"(624.288, 803.0]",3,8,-5
31007.0,2020-02-22,"(803.0, 981.0]",2,5,-3
31007.0,2020-02-22,"(981.0, 1159.0]",9,11,-2
31007.0,2020-02-22,"(1159.0, 1337.0]",1,1,0
31009.0,2020-02-22,"(593.25, 791.0]",1,1,0
31010.0,2020-02-22,"(709.726, 778.5]",1,1,0
31011.0,2020-02-22,"(420.424, 565.0]",2,4,-2
31011.0,2020-02-22,"(853.0, 997.0]",5,5,0
,,,,2.0,
31013.0,2020-02-22,"(603.269, 786.75]",2,7,-5
31013.0,2020-02-22,"(786.75, 969.5]",3,3,0
31013.0,2020-02-22,"(969.5, 1152.25]",3,5,-2
31013.0,2020-02-22,"(1152.25, 1335.0]",2,3,-1
31014.0,2020-02-22,"(537.258, 723.5]",2,3,-1
31014.0,2020-02-22,"(723.5, 909.0]",4,8,-4
31014.0,2020-02-22,"(909.0, 1094.5]",11,19,-8
31014.0,2020-02-22,"(1094.5, 1280.0]",4,4,0
31015.0,2020-02-22,"(164.973, 422.75]",1,1,0
31015.0,2020-02-22,"(422.75, 679.5]",1,1,0
31015.0,2020-02-22,"(679.5, 936.25]",1,1,0
31015.0,2020-02-22,"(936.25, 1193.0]",7,10,-3
31016.0,2020-02-22,"(610.588, 714.0]",1,2,-1
31016.0,2020-02-22,"(817.0, 920.0]",2,1,1
31016.0,2020-02-22,"(920.0, 1023.0]",3,4,-1
31017.0,2020-02-22,"(647.0, 910.0]",1,1,0
31017.0,2020-02-22,"(910.0, 1173.0]",1,1,0
31018.0,2020-02-22,"(768.0, 917.0]",2,1,1
31018.0,2020-02-22,"(1066.0, 1215.0]",1,2,-1
31019.0,2020-02-22,"(777.449, 915.75]",3,5,-2
31019.0,2020-02-22,"(915.75, 1053.5]",2,3,-1
31019.0,2020-02-22,"(1053.5, 1191.25]",3,3,0
31020.0,2020-02-22,"(816.699, 892.25]",1,5,-4
31020.0,2020-02-22,"(967.5, 1042.75]",1,2,-1
31020.0,2020-02-22,"(1042.75, 1118.0]",1,2,-1
31021.0,2020-02-22,"(473.073, 705.75]",3,6,-3
31021.0,2020-02-22,"(705.75, 937.5]",3,3,0
31021.0,2020-02-22,"(937.5, 1169.25]",2,8,-6
31021.0,2020-02-22,"(1169.25, 1401.0]",1,2,-1
31022.0,2020-02-22,"(453.25, 756.5]",3,1,2
31022.0,2020-02-22,"(756.5, 1059.75]",8,8,0
31022.0,2020-02-22,"(1059.75, 1363.0]",2,18,-16
31023.0,2020-02-22,"(472.493, 599.75]",2,2,0
31023.0,2020-02-22,"(599.75, 726.5]",3,5,-2
31023.0,2020-02-22,"(726.5, 853.25]",1,2,-1
31023.0,2020-02-22,"(853.25, 980.0]",3,4,-1
31024.0,2020-02-22,"(638.318, 809.5]",2,6,-4
31024.0,2020-02-22,"(809.5, 980.0]",3,4,-1
31024.0,2020-02-22,"(980.0, 1150.5]",1,3,-2
31024.0,2020-02-22,"(1150.5, 1321.0]",3,6,-3
31025.0,2020-02-22,"(598.548, 712.0]",1,2,-1
31025.0,2020-02-22,"(825.0, 938.0]",2,1,1
31025.0,2020-02-22,"(938.0, 1051.0]",1,2,-1
31026.0,2020-02-22,"(650.301, 825.75]",3,3,0
31026.0,2020-02-22,"(825.75, 1000.5]",1,2,-1
31026.0,2020-02-22,"(1000.5, 1175.25]",3,3,0
31027.0,2020-02-22,"(922.5, 1090.25]",1,2,-1
31027.0,2020-02-22,"(1090.25, 1258.0]",1,2,-1
31028.0,2020-02-22,"(944.5, 1030.25]",1,1,0
31029.0,2020-02-22,"(156.151, 369.25]",1,1,0
31029.0,2020-02-22,"(793.75, 1006.0]",1,1,0
31030.0,2020-02-22,"(579.274, 761.5]",1,5,-4
31030.0,2020-02-22,"(943.0, 1124.5]",1,2,-1
31030.0,2020-02-22,"(1124.5, 1306.0]",1,2,-1
31031.0,2020-02-22,"(692.25, 855.5]",1,2,-1
31031.0,2020-02-22,"(1018.75, 1182.0]",2,4,-2
31032.0,2020-02-22,"(1091.0, 1108.0]",1,2,-1
31033.0,2020-02-22,"(543.463, 678.25]",1,2,-1
31033.0,2020-02-22,"(678.25, 812.5]",2,2,0
31033.0,2020-02-22,"(812.5, 946.75]",2,4,-2
31033.0,2020-02-22,"(946.75, 1081.0]",1,1,0
31034.0,2020-02-22,"(642.237, 833.75]",1,3,-2
31034.0,2020-02-22,"(833.75, 1024.5]",3,3,0
31035.0,2020-02-22,"(677.75, 890.5]",1,1,0
31035.0,2020-02-22,"(1103.25, 1316.0]",1,2,-1
31036.0,2020-02-22,"(804.5, 968.75]",1,1,0
31036.0,2020-02-22,"(968.75, 1133.0]",2,2,0
31037.0,2020-02-22,"(514.357, 675.75]",2,4,-2
31037.0,2020-02-22,"(675.75, 836.5]",4,7,-3
31037.0,2020-02-22,"(836.5, 997.25]",1,5,-4
,,,,1.0,
,,,,1.0,
,,,,1.0,
31039.0,2020-02-22,"(480.347, 644.25]",6,7,-1
31039.0,2020-02-22,"(644.25, 807.5]",2,5,-3
31039.0,2020-02-22,"(807.5, 970.75]",1,6,-5
31039.0,2020-02-22,"(970.75, 1134.0]",3,6,-3
31040.0,2020-02-22,"(406.113, 628.75]",1,1,0
31040.0,2020-02-22,"(850.5, 1072.25]",1,3,-2
31040.0,2020-02-22,"(1072.25, 1294.0]",1,1,0
31041.0,2020-02-22,"(654.35, 817.5]",3,4,-1
31041.0,2020-02-22,"(817.5, 980.0]",5,10,-5
31041.0,2020-02-22,"(1142.5, 1305.0]",2,1,1
31042.0,2020-02-22,"(356.75, 690.5]",4,1,3
31042.0,2020-02-22,"(690.5, 1024.25]",5,6,-1
31042.0,2020-02-22,"(1024.25, 1358.0]",3,11,-8
31043.0,2020-02-22,"(579.203, 779.25]",2,5,-3
31043.0,2020-02-22,"(1177.75, 1377.0]",2,2,0
31044.0,2020-02-22,"(821.542, 936.5]",1,1,0
31044.0,2020-02-22,"(936.5, 1051.0]",2,4,-2
31045.0,2020-02-22,"(828.25, 945.0]",1,1,0
31046.0,2020-02-22,"(530.0, 795.0]",1,1,0
31046.0,2020-02-22,"(795.0, 1060.0]",1,1,0
31047.0,2020-02-22,"(597.0, 893.5]",3,1,2
31047.0,2020-02-22,"(893.5, 1190.0]",4,5,-1
,,,,1.0,
,,,,1.0,
31049.0,2020-02-22,"(592.276, 774.0]",1,5,-4
31049.0,2020-02-22,"(774.0, 955.0]",3,4,-1
31049.0,2020-02-22,"(1136.0, 1317.0]",1,2,-1
31050.0,2020-02-22,"(1346.0, 1406.0]",1,1,0
31051.0,2020-02-22,"(621.465, 755.75]",1,1,0
31052.0,2020-02-22,"(758.75, 978.5]",1,1,0
31053.0,2020-02-22,"(576.436, 718.0]",1,3,-2
31053.0,2020-02-22,"(718.0, 859.0]",2,2,0
,,,,2.0,
31055.0,2020-02-22,"(738.25, 900.5]",1,1,0
31055.0,2020-02-22,"(1062.75, 1225.0]",3,1,2
31056.0,2020-02-22,"(707.5, 814.25]",1,1,0
31056.0,2020-02-22,"(814.25, 921.0]",1,2,-1
31057.0,2020-02-22,"(986.998, 987.5]",1,1,0
31058.0,2020-02-22,"(717.645, 806.75]",2,4,-2
31059.0,2020-02-22,"(575.367, 734.25]",1,2,-1
31059.0,2020-02-22,"(734.25, 892.5]",1,4,-3
31059.0,2020-02-22,"(892.5, 1050.75]",1,2,-1
31060.0,2020-02-22,"(506.124, 726.0]",3,3,0
31060.0,2020-02-22,"(726.0, 945.0]",2,5,-3
31060.0,2020-02-22,"(945.0, 1164.0]",5,9,-4
31061.0,2020-02-22,"(649.698, 725.5]",1,1,0
31061.0,2020-02-22,"(876.5, 952.0]",1,1,0
31062.0,2020-02-22,"(441.327, 610.25]",5,7,-2
31062.0,2020-02-22,"(610.25, 778.5]",5,8,-3
31062.0,2020-02-22,"(778.5, 946.75]",17,35,-18
31062.0,2020-02-22,"(946.75, 1115.0]",17,35,-18
31063.0,2020-02-22,"(772.5, 1030.0]",1,1,0
31064.0,2020-02-22,"(484.359, 645.25]",2,4,-2
31064.0,2020-02-22,"(645.25, 805.5]",3,7,-4
31064.0,2020-02-22,"(805.5, 965.75]",12,24,-12
31064.0,2020-02-22,"(965.75, 1126.0]",13,22,-9
31065.0,2020-02-22,"(729.998, 730.5]",1,1,0
31066.0,2020-02-22,"(648.609, 746.75]",1,1,0
31066.0,2020-02-22,"(844.5, 942.25]",1,1,0
31066.0,2020-02-22,"(942.25, 1040.0]",1,1,0
31067.0,2020-02-22,"(502.362, 662.5]",2,3,-1
31068.0,2020-02-22,"(825.597, 926.75]",4,7,-3
31068.0,2020-02-22,"(1128.25, 1229.0]",1,1,0
31069.0,2020-02-22,"(624.483, 754.25]",1,5,-4
31069.0,2020-02-22,"(1012.75, 1142.0]",1,1,0
31070.0,2020-02-22,"(550.23, 743.5]",2,3,-1
31070.0,2020-02-22,"(743.5, 936.0]",2,3,-1
31070.0,2020-02-22,"(1128.5, 1321.0]",1,1,0
31071.0,2020-02-22,"(412.986, 667.5]",1,3,-2
31071.0,2020-02-22,"(667.5, 921.0]",1,4,-3
31071.0,2020-02-22,"(921.0, 1174.5]",6,17,-11
31071.0,2020-02-22,"(1174.5, 1428.0]",1,1,0
31072.0,2020-02-22,"(736.0, 751.0]",2,2,0
,,,,1.0,
,,,,1.0,
31074.0,2020-02-22,"(965.0, 1052.0]",1,2,-1
31075.0,2020-02-22,"(855.759, 916.25]",2,2,0
31076.0,2020-02-22,"(953.5, 976.25]",1,2,-1
31076.0,2020-02-22,"(976.25, 999.0]",2,1,1
31077.0,2020-02-22,"(469.339, 635.25]",2,3,-1
31077.0,2020-02-22,"(635.25, 800.5]",5,13,-8
31077.0,2020-02-22,"(800.5, 965.75]",12,16,-4
31077.0,2020-02-22,"(965.75, 1131.0]",1,4,-3
,,,,2.0,
31079.0,2020-02-22,"(467.102, 692.5]",2,6,-4
31079.0,2020-02-22,"(692.5, 917.0]",1,4,-3
31079.0,2020-02-22,"(917.0, 1141.5]",2,4,-2
31079.0,2020-02-22,"(1141.5, 1366.0]",2,3,-1
31080.0,2020-02-22,"(760.75, 972.5]",3,5,-2
31080.0,2020-02-22,"(972.5, 1184.25]",1,6,-5
31080.0,2020-02-22,"(1184.25, 1396.0]",2,4,-2
31081.0,2020-02-22,"(1170.806, 1219.5]",2,2,0
31082.0,2020-02-22,"(943.875, 975.25]",1,1,0
31082.0,2020-02-22,"(975.25, 1006.5]",1,2,-1
31082.0,2020-02-22,"(1037.75, 1069.0]",1,1,0
31083.0,2020-02-22,"(1294.994, 1296.5]",1,1,0
31084.0,2020-02-22,"(483.113, 705.75]",1,1,0
31084.0,2020-02-22,"(705.75, 927.5]",5,5,0
31084.0,2020-02-22,"(927.5, 1149.25]",2,4,-2
31084.0,2020-02-22,"(1149.25, 1371.0]",1,2,-1
31085.0,2020-02-22,"(731.25, 975.0]",1,1,0
31086.0,2020-02-22,"(708.99, 711.5]",1,1,0
,,,,1.0,
,,,,2.0,
,,,,1.0,
31088.0,2020-02-22,"(740.814, 787.5]",1,1,0
31089.0,2020-02-22,"(505.389, 658.75]",1,2,-1
31089.0,2020-02-22,"(658.75, 811.5]",1,3,-2
31089.0,2020-02-22,"(811.5, 964.25]",2,5,-3
31089.0,2020-02-22,"(964.25, 1117.0]",3,5,-2
31090.0,2020-02-22,"(910.876, 942.0]",1,1,0
31091.0,2020-02-22,"(940.0, 958.0]",1,1,0
31092.0,2020-02-22,"(589.445, 728.75]",1,3,-2
31092.0,2020-02-22,"(728.75, 867.5]",1,4,-3
31092.0,2020-02-22,"(1006.25, 1145.0]",1,1,0
,,,,1.0,
,,,,1.0,
31094.0,2020-02-22,"(126.884, 407.0]",1,1,0
31094.0,2020-02-22,"(686.0, 965.0]",2,3,-1
31094.0,2020-02-22,"(965.0, 1244.0]",2,3,-1
31095.0,2020-02-22,"(749.834, 791.5]",2,3,-1
31096.0,2020-02-22,"(533.175, 740.25]",2,5,-3
31096.0,2020-02-22,"(740.25, 946.5]",1,1,0
31096.0,2020-02-22,"(1152.75, 1359.0]",1,1,0
31097.0,2020-02-22,"(745.748, 809.0]",1,2,-1
31097.0,2020-02-22,"(935.0, 998.0]",1,4,-3
31098.0,2020-02-22,"(516.208, 715.0]",2,2,0
31098.0,2020-02-22,"(715.0, 913.0]",1,4,-3
31098.0,2020-02-22,"(913.0, 1111.0]",1,2,-1
31098.0,2020-02-22,"(1111.0, 1309.0]",2,4,-2
31099.0,2020-02-22,"(794.507, 918.25]",2,2,0
31099.0,2020-02-22,"(1041.5, 1164.75]",2,2,0
31100.0,2020-02-22,"(459.213, 656.75]",3,4,-1
31100.0,2020-02-22,"(656.75, 853.5]",2,3,-1
31100.0,2020-02-22,"(853.5, 1050.25]",2,4,-2
31100.0,2020-02-22,"(1050.25, 1247.0]",2,2,0
31101.0,2020-02-22,"(-0.386, 347.5]",2,7,-5
31101.0,2020-02-22,"(347.5, 694.0]",13,23,-10
31101.0,2020-02-22,"(694.0, 1040.5]",42,73,-31
31101.0,2020-02-22,"(1040.5, 1387.0]",26,43,-17
31102.0,2020-02-22,"(2.63, 346.5]",3,6,-3
31102.0,2020-02-22,"(346.5, 689.0]",4,14,-10
31102.0,2020-02-22,"(689.0, 1031.5]",5,22,-17
31102.0,2020-02-22,"(1031.5, 1374.0]",7,16,-9
31103.0,2020-02-22,"(208.841, 499.75]",2,2,0
31103.0,2020-02-22,"(499.75, 789.5]",7,24,-17
31103.0,2020-02-22,"(789.5, 1079.25]",8,35,-27
31103.0,2020-02-22,"(1079.25, 1369.0]",3,17,-14
31104.0,2020-02-22,"(413.0, 753.0]",13,3,10
31104.0,2020-02-22,"(753.0, 1093.0]",19,34,-15
31104.0,2020-02-22,"(1093.0, 1433.0]",6,35,-29
31105.0,2020-02-22,"(551.206, 750.5]",4,6,-2
31105.0,2020-02-22,"(750.5, 949.0]",2,6,-4
31105.0,2020-02-22,"(949.0, 1147.5]",1,5,-4
31105.0,2020-02-22,"(1147.5, 1346.0]",1,7,-6
31106.0,2020-02-22,"(662.0, 827.0]",2,2,0
31106.0,2020-02-22,"(827.0, 992.0]",2,7,-5
31106.0,2020-02-22,"(992.0, 1157.0]",3,4,-1
31107.0,2020-02-22,"(64.659, 401.25]",1,5,-4
31107.0,2020-02-22,"(401.25, 736.5]",5,20,-15
31107.0,2020-02-22,"(736.5, 1071.75]",12,29,-17
31107.0,2020-02-22,"(1071.75, 1407.0]",12,24,-12
31108.0,2020-02-22,"(449.035, 691.25]",8,15,-7
31108.0,2020-02-22,"(691.25, 932.5]",11,20,-9
31108.0,2020-02-22,"(932.5, 1173.75]",12,25,-13
31108.0,2020-02-22,"(1173.75, 1415.0]",7,10,-3
31109.0,2020-02-22,"(19.6, 371.0]",5,9,-4
31109.0,2020-02-22,"(371.0, 721.0]",9,15,-6
31109.0,2020-02-22,"(721.0, 1071.0]",19,46,-27
31109.0,2020-02-22,"(1071.0, 1421.0]",19,30,-11
31110.0,2020-02-22,"(32.63, 376.5]",2,2,0
31110.0,2020-02-22,"(376.5, 719.0]",11,23,-12
31110.0,2020-02-22,"(719.0, 1061.5]",8,21,-13
31110.0,2020-02-22,"(1061.5, 1404.0]",10,17,-7
31111.0,2020-02-22,"(0.576, 358.0]",2,3,-1
31111.0,2020-02-22,"(358.0, 714.0]",8,18,-10
31111.0,2020-02-22,"(714.0, 1070.0]",10,20,-10
31111.0,2020-02-22,"(1070.0, 1426.0]",8,17,-9
31112.0,2020-02-22,"(648.613, 745.75]",3,8,-5
31112.0,2020-02-22,"(745.75, 842.5]",1,5,-4
31112.0,2020-02-22,"(939.25, 1036.0]",3,2,1
31113.0,2020-02-22,"(12.651, 351.25]",1,4,-3
31113.0,2020-02-22,"(351.25, 688.5]",1,12,-11
31113.0,2020-02-22,"(688.5, 1025.75]",8,21,-13
31113.0,2020-02-22,"(1025.75, 1363.0]",9,19,-10
31114.0,2020-02-22,"(-0.435, 359.75]",2,6,-4
31114.0,2020-02-22,"(359.75, 718.5]",5,18,-13
31114.0,2020-02-22,"(718.5, 1077.25]",24,49,-25
31114.0,2020-02-22,"(1077.25, 1436.0]",10,28,-18
31115.0,2020-02-22,"(13.598, 365.5]",2,3,-1
31115.0,2020-02-22,"(365.5, 716.0]",4,16,-12
31115.0,2020-02-22,"(716.0, 1066.5]",13,28,-15
31115.0,2020-02-22,"(1066.5, 1417.0]",9,22,-13
31116.0,2020-02-22,"(46.658, 383.5]",1,1,0
31116.0,2020-02-22,"(383.5, 719.0]",18,32,-14
31116.0,2020-02-22,"(719.0, 1054.5]",23,46,-23
31116.0,2020-02-22,"(1054.5, 1390.0]",9,14,-5
31117.0,2020-02-22,"(7.576, 365.0]",1,2,-1
31117.0,2020-02-22,"(365.0, 721.0]",9,22,-13
31117.0,2020-02-22,"(721.0, 1077.0]",12,31,-19
31117.0,2020-02-22,"(1077.0, 1433.0]",7,11,-4
31118.0,2020-02-22,"(16.601, 367.75]",2,2,0
31118.0,2020-02-22,"(367.75, 717.5]",1,8,-7
31118.0,2020-02-22,"(717.5, 1067.25]",9,21,-12
31118.0,2020-02-22,"(1067.25, 1417.0]",7,12,-5
31119.0,2020-02-22,"(5.587, 360.25]",1,2,-1
31119.0,2020-02-22,"(360.25, 713.5]",10,22,-12
31119.0,2020-02-22,"(713.5, 1066.75]",12,27,-15
31119.0,2020-02-22,"(1066.75, 1420.0]",5,10,-5
31120.0,2020-02-22,"(6.571, 365.25]",3,3,0
31120.0,2020-02-22,"(365.25, 722.5]",4,10,-6
31120.0,2020-02-22,"(722.5, 1079.75]",13,26,-13
31120.0,2020-02-22,"(1079.75, 1437.0]",7,10,-3
31121.0,2020-02-22,"(482.5, 782.0]",4,2,2
31121.0,2020-02-22,"(782.0, 1081.5]",16,7,9
31121.0,2020-02-22,"(1081.5, 1381.0]",2,26,-24
31122.0,2020-02-22,"(427.75, 761.5]",3,2,1
31122.0,2020-02-22,"(761.5, 1095.25]",8,15,-7
31122.0,2020-02-22,"(1095.25, 1429.0]",4,22,-18
31123.0,2020-02-22,"(433.062, 668.5]",1,8,-7
31123.0,2020-02-22,"(668.5, 903.0]",4,19,-15
31123.0,2020-02-22,"(903.0, 1137.5]",5,11,-6
31123.0,2020-02-22,"(1137.5, 1372.0]",2,5,-3
31124.0,2020-02-22,"(26.6, 378.0]",2,5,-3
31124.0,2020-02-22,"(378.0, 728.0]",19,37,-18
31124.0,2020-02-22,"(728.0, 1078.0]",21,60,-39
31124.0,2020-02-22,"(1078.0, 1428.0]",10,31,-21
31125.0,2020-02-22,"(132.715, 455.25]",1,1,0
31125.0,2020-02-22,"(455.25, 776.5]",7,25,-18
31125.0,2020-02-22,"(776.5, 1097.75]",25,42,-17
31125.0,2020-02-22,"(1097.75, 1419.0]",10,17,-7
31126.0,2020-02-22,"(4.591, 358.25]",2,3,-1
31126.0,2020-02-22,"(358.25, 710.5]",6,22,-16
31126.0,2020-02-22,"(710.5, 1062.75]",10,34,-24
31126.0,2020-02-22,"(1062.75, 1415.0]",11,20,-9
31127.0,2020-02-22,"(10.647, 350.25]",2,5,-3
31127.0,2020-02-22,"(350.25, 688.5]",5,6,-1
31127.0,2020-02-22,"(688.5, 1026.75]",12,23,-11
31127.0,2020-02-22,"(1026.75, 1365.0]",10,19,-9
31128.0,2020-02-22,"(339.902, 615.5]",10,17,-7
31128.0,2020-02-22,"(615.5, 890.0]",18,34,-16
31128.0,2020-02-22,"(890.0, 1164.5]",13,22,-9
31128.0,2020-02-22,"(1164.5, 1439.0]",7,7,0
31129.0,2020-02-22,"(162.89, 441.5]",1,1,0
31129.0,2020-02-22,"(441.5, 719.0]",4,9,-5
31129.0,2020-02-22,"(719.0, 996.5]",14,33,-19
31129.0,2020-02-22,"(996.5, 1274.0]",2,9,-7
31130.0,2020-02-22,"(115.721, 436.75]",1,1,0
31130.0,2020-02-22,"(436.75, 756.5]",3,7,-4
31130.0,2020-02-22,"(756.5, 1076.25]",7,14,-7
31130.0,2020-02-22,"(1076.25, 1396.0]",5,14,-9
31131.0,2020-02-22,"(231.869, 515.75]",2,4,-2
31131.0,2020-02-22,"(515.75, 798.5]",4,15,-11
31131.0,2020-02-22,"(798.5, 1081.25]",5,10,-5
31131.0,2020-02-22,"(1081.25, 1364.0]",6,10,-4
31200.0,2020-02-22,"(127.838, 419.5]",2,2,0
31200.0,2020-02-22,"(419.5, 710.0]",6,8,-2
31200.0,2020-02-22,"(710.0, 1000.5]",17,32,-15
31200.0,2020-02-22,"(1000.5, 1291.0]",10,25,-15
31201.0,2020-02-22,"(0.588, 355.0]",2,6,-4
31201.0,2020-02-22,"(355.0, 708.0]",18,37,-19
31201.0,2020-02-22,"(708.0, 1061.0]",32,59,-27
31201.0,2020-02-22,"(1061.0, 1414.0]",14,29,-15
,,,,2.0,
31203.0,2020-02-22,"(414.0, 754.0]",22,4,18
31203.0,2020-02-22,"(754.0, 1094.0]",49,35,14
31203.0,2020-02-22,"(1094.0, 1434.0]",19,71,-52
31204.0,2020-02-22,"(13.649, 352.75]",4,4,0
31204.0,2020-02-22,"(690.5, 1028.25]",13,3,10
31204.0,2020-02-22,"(1028.25, 1366.0]",14,24,-10
31205.0,2020-02-22,"(410.045, 649.75]",3,4,-1
31205.0,2020-02-22,"(649.75, 888.5]",5,11,-6
31205.0,2020-02-22,"(888.5, 1127.25]",6,13,-7
31205.0,2020-02-22,"(1127.25, 1366.0]",7,19,-12
31206.0,2020-02-22,"(787.874, 819.5]",2,4,-2
31207.0,2020-02-22,"(484.236, 676.0]",3,6,-3
31207.0,2020-02-22,"(676.0, 867.0]",3,4,-1
31207.0,2020-02-22,"(867.0, 1058.0]",2,6,-4
31207.0,2020-02-22,"(1058.0, 1249.0]",1,1,0
31208.0,2020-02-22,"(591.248, 780.0]",4,11,-7
31208.0,2020-02-22,"(780.0, 968.0]",12,15,-3
31208.0,2020-02-22,"(968.0, 1156.0]",4,8,-4
31208.0,2020-02-22,"(1156.0, 1344.0]",3,4,-1
31209.0,2020-02-22,"(613.394, 765.5]",1,2,-1
31209.0,2020-02-22,"(765.5, 917.0]",1,4,-3
31209.0,2020-02-22,"(917.0, 1068.5]",1,5,-4
31209.0,2020-02-22,"(1068.5, 1220.0]",4,4,0
31211.0,2020-02-22,"(548.211, 746.25]",1,1,0
31211.0,2020-02-22,"(746.25, 943.5]",7,8,-1
31211.0,2020-02-22,"(943.5, 1140.75]",10,17,-7
31211.0,2020-02-22,"(1140.75, 1338.0]",3,6,-3
31212.0,2020-02-22,"(136.706, 461.5]",3,3,0
31212.0,2020-02-22,"(461.5, 785.0]",11,22,-11
31212.0,2020-02-22,"(785.0, 1108.5]",12,27,-15
31212.0,2020-02-22,"(1108.5, 1432.0]",4,10,-6
31213.0,2020-02-22,"(306.286, 485.5]",1,1,0
31213.0,2020-02-22,"(485.5, 664.0]",1,3,-2
31213.0,2020-02-22,"(664.0, 842.5]",4,7,-3
31213.0,2020-02-22,"(842.5, 1021.0]",6,12,-6
31214.0,2020-02-22,"(128.698, 455.5]",1,1,0
31214.0,2020-02-22,"(455.5, 781.0]",24,49,-25
31214.0,2020-02-22,"(781.0, 1106.5]",23,46,-23
31214.0,2020-02-22,"(1106.5, 1432.0]",7,12,-5
31215.0,2020-02-22,"(619.75, 828.5]",4,1,3
31215.0,2020-02-22,"(828.5, 1037.25]",21,5,16
31215.0,2020-02-22,"(1037.25, 1246.0]",5,34,-29
31216.0,2020-02-22,"(766.5, 1082.75]",13,1,12
31216.0,2020-02-22,"(1082.75, 1399.0]",10,17,-7
31217.0,2020-02-22,"(360.267, 544.25]",1,2,-1
31217.0,2020-02-22,"(544.25, 727.5]",1,2,-1
31217.0,2020-02-22,"(727.5, 910.75]",2,3,-1
31217.0,2020-02-22,"(910.75, 1094.0]",12,13,-1
31218.0,2020-02-22,"(342.0, 612.0]",1,1,0
31218.0,2020-02-22,"(612.0, 882.0]",6,1,5
31218.0,2020-02-22,"(882.0, 1152.0]",9,13,-4
31219.0,2020-02-22,"(497.217, 693.75]",6,8,-2
31219.0,2020-02-22,"(693.75, 889.5]",8,18,-10
31219.0,2020-02-22,"(889.5, 1085.25]",12,23,-11
31220.0,2020-02-22,"(831.863, 866.25]",2,2,0
31220.0,2020-02-22,"(934.75, 969.0]",1,2,-1
31221.0,2020-02-22,"(34.612, 383.0]",2,3,-1
31221.0,2020-02-22,"(383.0, 730.0]",8,10,-2
31221.0,2020-02-22,"(730.0, 1077.0]",12,19,-7
31221.0,2020-02-22,"(1077.0, 1424.0]",3,13,-10
31222.0,2020-02-22,"(311.948, 576.0]",2,3,-1
31222.0,2020-02-22,"(576.0, 839.0]",4,11,-7
31222.0,2020-02-22,"(839.0, 1102.0]",16,25,-9
31222.0,2020-02-22,"(1102.0, 1365.0]",6,13,-7
31223.0,2020-02-22,"(37.67, 371.5]",1,4,-3
31223.0,2020-02-22,"(371.5, 704.0]",6,12,-6
31223.0,2020-02-22,"(704.0, 1036.5]",11,18,-7
31223.0,2020-02-22,"(1036.5, 1369.0]",7,13,-6
31224.0,2020-02-22,"(517.112, 740.0]",3,5,-2
31224.0,2020-02-22,"(740.0, 962.0]",5,7,-2
31224.0,2020-02-22,"(962.0, 1184.0]",2,4,-2
31224.0,2020-02-22,"(1184.0, 1406.0]",2,4,-2
31225.0,2020-02-22,"(484.124, 704.0]",6,11,-5
31225.0,2020-02-22,"(704.0, 923.0]",13,25,-12
31225.0,2020-02-22,"(923.0, 1142.0]",6,13,-7
31225.0,2020-02-22,"(1142.0, 1361.0]",2,5,-3
31226.0,2020-02-22,"(461.074, 693.5]",3,7,-4
31226.0,2020-02-22,"(693.5, 925.0]",3,6,-3
31226.0,2020-02-22,"(925.0, 1156.5]",8,13,-5
31227.0,2020-02-22,"(520.102, 745.5]",3,5,-2
31227.0,2020-02-22,"(745.5, 970.0]",8,19,-11
31227.0,2020-02-22,"(970.0, 1194.5]",3,6,-3
31227.0,2020-02-22,"(1194.5, 1419.0]",3,6,-3
31228.0,2020-02-22,"(468.076, 700.0]",16,19,-3
31228.0,2020-02-22,"(700.0, 931.0]",17,33,-16
31228.0,2020-02-22,"(931.0, 1162.0]",18,26,-8
31228.0,2020-02-22,"(1162.0, 1393.0]",11,20,-9
31229.0,2020-02-22,"(32.601, 383.75]",2,5,-3
31229.0,2020-02-22,"(383.75, 733.5]",31,63,-32
31229.0,2020-02-22,"(733.5, 1083.25]",25,52,-27
31229.0,2020-02-22,"(1083.25, 1433.0]",14,31,-17
31230.0,2020-02-22,"(92.685, 422.75]",3,4,-1
31230.0,2020-02-22,"(422.75, 751.5]",12,16,-4
31230.0,2020-02-22,"(751.5, 1080.25]",19,26,-7
31230.0,2020-02-22,"(1080.25, 1409.0]",3,11,-8
31231.0,2020-02-22,"(586.388, 740.0]",3,3,0
31231.0,2020-02-22,"(740.0, 893.0]",1,6,-5
31231.0,2020-02-22,"(893.0, 1046.0]",2,3,-1
31231.0,2020-02-22,"(1046.0, 1199.0]",1,1,0
31232.0,2020-02-22,"(296.016, 543.0]",4,5,-1
31232.0,2020-02-22,"(543.0, 789.0]",10,15,-5
31232.0,2020-02-22,"(789.0, 1035.0]",11,21,-10
31232.0,2020-02-22,"(1035.0, 1281.0]",9,15,-6
31233.0,2020-02-22,"(454.054, 691.5]",3,4,-1
31233.0,2020-02-22,"(691.5, 928.0]",4,10,-6
31233.0,2020-02-22,"(928.0, 1164.5]",4,6,-2
31233.0,2020-02-22,"(1164.5, 1401.0]",4,8,-4
31234.0,2020-02-22,"(503.132, 721.0]",9,10,-1
31234.0,2020-02-22,"(721.0, 938.0]",5,10,-5
31234.0,2020-02-22,"(938.0, 1155.0]",4,13,-9
31234.0,2020-02-22,"(1155.0, 1372.0]",5,6,-1
31235.0,2020-02-22,"(27.93, 296.5]",1,5,-4
31235.0,2020-02-22,"(564.0, 831.5]",4,10,-6
31235.0,2020-02-22,"(831.5, 1099.0]",4,17,-13
31236.0,2020-02-22,"(512.121, 732.75]",11,21,-10
31236.0,2020-02-22,"(732.75, 952.5]",12,18,-6
31236.0,2020-02-22,"(952.5, 1172.25]",19,32,-13
31236.0,2020-02-22,"(1172.25, 1392.0]",3,9,-6
31237.0,2020-02-22,"(447.031, 690.25]",3,10,-7
31237.0,2020-02-22,"(690.25, 932.5]",7,16,-9
31237.0,2020-02-22,"(932.5, 1174.75]",13,19,-6
31237.0,2020-02-22,"(1174.75, 1417.0]",1,3,-2
31238.0,2020-02-22,"(54.792, 358.0]",1,1,0
31238.0,2020-02-22,"(358.0, 660.0]",1,2,-1
31238.0,2020-02-22,"(660.0, 962.0]",3,12,-9
31238.0,2020-02-22,"(962.0, 1264.0]",14,21,-7
31239.0,2020-02-22,"(518.14, 734.0]",14,19,-5
31239.0,2020-02-22,"(734.0, 949.0]",6,13,-7
31239.0,2020-02-22,"(949.0, 1164.0]",11,16,-5
31239.0,2020-02-22,"(1164.0, 1379.0]",1,4,-3
31240.0,2020-02-22,"(601.289, 779.75]",10,17,-7
31240.0,2020-02-22,"(779.75, 957.5]",3,17,-14
31240.0,2020-02-22,"(957.5, 1135.25]",2,11,-9
31240.0,2020-02-22,"(1135.25, 1313.0]",2,2,0
31241.0,2020-02-22,"(449.75, 769.5]",13,1,12
31241.0,2020-02-22,"(769.5, 1089.25]",13,38,-25
31241.0,2020-02-22,"(1089.25, 1409.0]",12,36,-24
31242.0,2020-02-22,"(501.299, 677.25]",2,4,-2
31242.0,2020-02-22,"(677.25, 852.5]",2,2,0
31242.0,2020-02-22,"(852.5, 1027.75]",12,23,-11
31242.0,2020-02-22,"(1027.75, 1203.0]",5,10,-5
31243.0,2020-02-22,"(551.351, 714.25]",3,5,-2
31243.0,2020-02-22,"(714.25, 876.5]",10,14,-4
31243.0,2020-02-22,"(876.5, 1038.75]",6,14,-8
31243.0,2020-02-22,"(1038.75, 1201.0]",5,7,-2
31244.0,2020-02-22,"(142.743, 458.25]",2,4,-2
31244.0,2020-02-22,"(458.25, 772.5]",4,6,-2
31244.0,2020-02-22,"(772.5, 1086.75]",12,16,-4
31244.0,2020-02-22,"(1086.75, 1401.0]",3,6,-3
31245.0,2020-02-22,"(212.777, 519.75]",1,2,-1
31245.0,2020-02-22,"(519.75, 825.5]",11,24,-13
31245.0,2020-02-22,"(825.5, 1131.25]",10,18,-8
31245.0,2020-02-22,"(1131.25, 1437.0]",8,14,-6
31246.0,2020-02-22,"(26.593, 379.75]",1,2,-1
31246.0,2020-02-22,"(379.75, 731.5]",12,19,-7
31246.0,2020-02-22,"(731.5, 1083.25]",21,41,-20
31246.0,2020-02-22,"(1083.25, 1435.0]",11,17,-6
31247.0,2020-02-22,"(417.074, 649.5]",8,13,-5
31247.0,2020-02-22,"(649.5, 881.0]",54,103,-49
31247.0,2020-02-22,"(881.0, 1112.5]",38,88,-50
31247.0,2020-02-22,"(1112.5, 1344.0]",6,9,-3
31248.0,2020-02-22,"(521.146, 735.5]",12,17,-5
31248.0,2020-02-22,"(735.5, 949.0]",45,79,-34
31248.0,2020-02-22,"(949.0, 1162.5]",15,37,-22
31248.0,2020-02-22,"(1162.5, 1376.0]",2,3,-1
31249.0,2020-02-22,"(505.183, 710.25]",3,7,-4
31249.0,2020-02-22,"(710.25, 914.5]",28,38,-10
31249.0,2020-02-22,"(914.5, 1118.75]",12,17,-5
31249.0,2020-02-22,"(1118.75, 1323.0]",1,2,-1
31250.0,2020-02-22,"(377.5, 708.0]",3,1,2
31250.0,2020-02-22,"(708.0, 1038.5]",4,3,1
31250.0,2020-02-22,"(1038.5, 1369.0]",5,7,-2
31251.0,2020-02-22,"(365.952, 629.0]",1,5,-4
31251.0,2020-02-22,"(629.0, 891.0]",4,19,-15
31251.0,2020-02-22,"(891.0, 1153.0]",7,11,-4
31251.0,2020-02-22,"(1153.0, 1415.0]",6,9,-3
31252.0,2020-02-22,"(528.458, 664.5]",1,2,-1
31252.0,2020-02-22,"(664.5, 800.0]",3,3,0
31252.0,2020-02-22,"(800.0, 935.5]",4,5,-1
31252.0,2020-02-22,"(935.5, 1071.0]",1,1,0
31253.0,2020-02-22,"(341.25, 671.5]",5,3,2
31253.0,2020-02-22,"(671.5, 1001.75]",4,6,-2
31253.0,2020-02-22,"(1001.75, 1332.0]",2,8,-6
31254.0,2020-02-22,"(377.996, 630.0]",1,2,-1
31254.0,2020-02-22,"(630.0, 881.0]",7,13,-6
31254.0,2020-02-22,"(881.0, 1132.0]",5,6,-1
31254.0,2020-02-22,"(1132.0, 1383.0]",2,6,-4
31255.0,2020-02-22,"(505.188, 709.0]",3,5,-2
31255.0,2020-02-22,"(709.0, 912.0]",2,4,-2
31255.0,2020-02-22,"(912.0, 1115.0]",2,4,-2
31255.0,2020-02-22,"(1115.0, 1318.0]",2,4,-2
31256.0,2020-02-22,"(478.297, 654.75]",2,3,-1
31256.0,2020-02-22,"(654.75, 830.5]",8,16,-8
31256.0,2020-02-22,"(830.5, 1006.25]",4,7,-3
31256.0,2020-02-22,"(1006.25, 1182.0]",5,10,-5
31257.0,2020-02-22,"(351.25, 659.5]",4,3,1
31257.0,2020-02-22,"(659.5, 967.75]",15,6,9
31257.0,2020-02-22,"(967.75, 1276.0]",16,29,-13
31258.0,2020-02-22,"(150.794, 453.5]",1,2,-1
31258.0,2020-02-22,"(453.5, 755.0]",22,48,-26
31258.0,2020-02-22,"(755.0, 1056.5]",70,138,-68
31258.0,2020-02-22,"(1056.5, 1358.0]",12,31,-19
,,,,2.0,
31260.0,2020-02-22,"(384.042, 624.5]",1,1,0
31260.0,2020-02-22,"(624.5, 864.0]",3,6,-3
31260.0,2020-02-22,"(864.0, 1103.5]",2,5,-3
31260.0,2020-02-22,"(1103.5, 1343.0]",2,2,0
31261.0,2020-02-22,"(598.568, 707.0]",2,2,0
31261.0,2020-02-22,"(707.0, 815.0]",1,1,0
31261.0,2020-02-22,"(815.0, 923.0]",5,13,-8
31261.0,2020-02-22,"(923.0, 1031.0]",1,1,0
31262.0,2020-02-22,"(374.105, 598.75]",2,2,0
31262.0,2020-02-22,"(598.75, 822.5]",7,13,-6
31262.0,2020-02-22,"(822.5, 1046.25]",8,12,-4
31262.0,2020-02-22,"(1046.25, 1270.0]",6,14,-8
31263.0,2020-02-22,"(384.987, 639.25]",4,8,-4
31263.0,2020-02-22,"(639.25, 892.5]",3,3,0
31263.0,2020-02-22,"(892.5, 1145.75]",15,28,-13
31263.0,2020-02-22,"(1145.75, 1399.0]",10,16,-6
31264.0,2020-02-22,"(318.933, 586.75]",2,2,0
31264.0,2020-02-22,"(586.75, 853.5]",10,13,-3
31264.0,2020-02-22,"(853.5, 1120.25]",3,7,-4
31264.0,2020-02-22,"(1120.25, 1387.0]",1,2,-1
31265.0,2020-02-22,"(371.981, 627.75]",3,9,-6
31265.0,2020-02-22,"(627.75, 882.5]",12,29,-17
31265.0,2020-02-22,"(882.5, 1137.25]",12,17,-5
31265.0,2020-02-22,"(1137.25, 1392.0]",5,10,-5
31266.0,2020-02-22,"(86.651, 425.25]",5,6,-1
31266.0,2020-02-22,"(425.25, 762.5]",7,28,-21
31266.0,2020-02-22,"(762.5, 1099.75]",27,45,-18
31266.0,2020-02-22,"(1099.75, 1437.0]",10,22,-12
31267.0,2020-02-22,"(366.0, 713.0]",5,1,4
31267.0,2020-02-22,"(713.0, 1060.0]",9,9,0
31267.0,2020-02-22,"(1060.0, 1407.0]",17,24,-7
31268.0,2020-02-22,"(99.685, 429.75]",1,3,-2
31268.0,2020-02-22,"(429.75, 758.5]",6,14,-8
31268.0,2020-02-22,"(758.5, 1087.25]",13,19,-6
31268.0,2020-02-22,"(1087.25, 1416.0]",14,21,-7
31269.0,2020-02-22,"(495.124, 715.0]",3,7,-4
31269.0,2020-02-22,"(715.0, 934.0]",19,28,-9
31269.0,2020-02-22,"(934.0, 1153.0]",6,18,-12
31269.0,2020-02-22,"(1153.0, 1372.0]",3,10,-7
31270.0,2020-02-22,"(565.139, 781.25]",7,13,-6
31270.0,2020-02-22,"(781.25, 996.5]",5,10,-5
31270.0,2020-02-22,"(996.5, 1211.75]",1,2,-1
31270.0,2020-02-22,"(1211.75, 1427.0]",1,5,-4
31271.0,2020-02-22,"(443.008, 692.0]",9,14,-5
31271.0,2020-02-22,"(692.0, 940.0]",16,47,-31
31271.0,2020-02-22,"(940.0, 1188.0]",9,22,-13
31271.0,2020-02-22,"(1188.0, 1436.0]",3,6,-3
31272.0,2020-02-22,"(490.105, 714.75]",3,5,-2
31272.0,2020-02-22,"(714.75, 938.5]",23,36,-13
31272.0,2020-02-22,"(938.5, 1162.25]",2,5,-3
31272.0,2020-02-22,"(1162.25, 1386.0]",1,2,-1
31273.0,2020-02-22,"(511.479, 642.25]",4,8,-4
31273.0,2020-02-22,"(642.25, 772.5]",4,6,-2
31273.0,2020-02-22,"(772.5, 902.75]",5,8,-3
31273.0,2020-02-22,"(902.75, 1033.0]",9,15,-6
31274.0,2020-02-22,"(463.308, 637.0]",2,2,0
31274.0,2020-02-22,"(637.0, 810.0]",3,5,-2
31274.0,2020-02-22,"(810.0, 983.0]",10,12,-2
31274.0,2020-02-22,"(983.0, 1156.0]",12,24,-12
31275.0,2020-02-22,"(81.664, 417.0]",4,4,0
31275.0,2020-02-22,"(417.0, 751.0]",8,16,-8
31275.0,2020-02-22,"(751.0, 1085.0]",8,17,-9
31275.0,2020-02-22,"(1085.0, 1419.0]",7,12,-5
31276.0,2020-02-22,"(649.5, 831.0]",2,1,1
31276.0,2020-02-22,"(831.0, 1012.5]",3,2,1
31276.0,2020-02-22,"(1012.5, 1194.0]",3,4,-1
31277.0,2020-02-22,"(108.995, 361.25]",1,2,-1
31277.0,2020-02-22,"(361.25, 612.5]",1,1,0
31277.0,2020-02-22,"(612.5, 863.75]",14,27,-13
31277.0,2020-02-22,"(863.75, 1115.0]",25,46,-21
31278.0,2020-02-22,"(504.096, 731.0]",6,12,-6
31278.0,2020-02-22,"(731.0, 957.0]",14,28,-14
31278.0,2020-02-22,"(957.0, 1183.0]",8,17,-9
31278.0,2020-02-22,"(1183.0, 1409.0]",5,10,-5
31279.0,2020-02-22,"(490.431, 633.25]",5,6,-1
31279.0,2020-02-22,"(633.25, 775.5]",1,4,-3
31279.0,2020-02-22,"(775.5, 917.75]",3,5,-2
31279.0,2020-02-22,"(917.75, 1060.0]",2,5,-3
31280.0,2020-02-22,"(10.617, 357.75]",1,3,-2
31280.0,2020-02-22,"(357.75, 703.5]",13,20,-7
31280.0,2020-02-22,"(703.5, 1049.25]",12,34,-22
31280.0,2020-02-22,"(1049.25, 1395.0]",9,22,-13
31000.0,2020-02-23,"(672.38, 828.0]",1,3,-2
31000.0,2020-02-23,"(828.0, 983.0]",2,2,0
31000.0,2020-02-23,"(1138.0, 1293.0]",2,2,0
31001.0,2020-02-23,"(685.669, 768.75]",3,6,-3
31001.0,2020-02-23,"(768.75, 851.5]",1,2,-1
31001.0,2020-02-23,"(934.25, 1017.0]",3,1,2
31002.0,2020-02-23,"(375.178, 581.5]",1,1,0
31002.0,2020-02-23,"(581.5, 787.0]",5,7,-2
31002.0,2020-02-23,"(787.0, 992.5]",2,6,-4
31002.0,2020-02-23,"(992.5, 1198.0]",2,5,-3
31003.0,2020-02-23,"(506.142, 721.5]",3,4,-1
31003.0,2020-02-23,"(936.0, 1150.5]",8,5,3
31003.0,2020-02-23,"(1150.5, 1365.0]",1,12,-11
31004.0,2020-02-23,"(759.5, 867.75]",1,1,0
31004.0,2020-02-23,"(867.75, 976.0]",2,3,-1
31005.0,2020-02-23,"(548.537, 664.75]",1,1,0
31005.0,2020-02-23,"(664.75, 780.5]",3,4,-1
31005.0,2020-02-23,"(780.5, 896.25]",3,8,-5
31005.0,2020-02-23,"(896.25, 1012.0]",3,7,-4
31006.0,2020-02-23,"(540.374, 697.5]",4,7,-3
31006.0,2020-02-23,"(697.5, 854.0]",5,7,-2
31006.0,2020-02-23,"(854.0, 1010.5]",3,13,-10
31006.0,2020-02-23,"(1010.5, 1167.0]",6,7,-1
31007.0,2020-02-23,"(603.217, 799.75]",4,8,-4
31007.0,2020-02-23,"(995.5, 1191.25]",3,7,-4
31007.0,2020-02-23,"(1191.25, 1387.0]",1,5,-4
31009.0,2020-02-23,"(686.501, 811.75]",1,3,-2
31009.0,2020-02-23,"(1061.25, 1186.0]",5,2,3
31010.0,2020-02-23,"(498.43, 641.5]",2,3,-1
31010.0,2020-02-23,"(784.0, 926.5]",5,1,4
31011.0,2020-02-23,"(441.212, 639.0]",1,2,-1
31011.0,2020-02-23,"(639.0, 836.0]",1,6,-5
31011.0,2020-02-23,"(836.0, 1033.0]",5,11,-6
31011.0,2020-02-23,"(1033.0, 1230.0]",1,6,-5
31012.0,2020-02-23,"(606.324, 776.0]",1,1,0
31012.0,2020-02-23,"(1114.0, 1283.0]",1,2,-1
31013.0,2020-02-23,"(701.342, 866.5]",3,5,-2
31013.0,2020-02-23,"(866.5, 1031.0]",3,4,-1
31013.0,2020-02-23,"(1195.5, 1360.0]",1,1,0
31014.0,2020-02-23,"(538.184, 743.0]",4,9,-5
31014.0,2020-02-23,"(743.0, 947.0]",6,21,-15
31014.0,2020-02-23,"(947.0, 1151.0]",17,24,-7
31014.0,2020-02-23,"(1151.0, 1355.0]",1,1,0
31015.0,2020-02-23,"(43.924, 314.0]",1,1,0
31015.0,2020-02-23,"(314.0, 583.0]",1,1,0
31015.0,2020-02-23,"(583.0, 852.0]",1,2,-1
31015.0,2020-02-23,"(852.0, 1121.0]",4,8,-4
31016.0,2020-02-23,"(523.184, 728.0]",3,5,-2
31016.0,2020-02-23,"(728.0, 932.0]",2,7,-5
31016.0,2020-02-23,"(932.0, 1136.0]",5,9,-4
31016.0,2020-02-23,"(1136.0, 1340.0]",8,8,0
,,,,1.0,
,,,,3.0,
,,,,3.0,
31018.0,2020-02-23,"(36.2, 237.0]",2,2,0
31019.0,2020-02-23,"(583.396, 735.0]",1,2,-1
31019.0,2020-02-23,"(886.0, 1037.0]",1,2,-1
31019.0,2020-02-23,"(1037.0, 1188.0]",1,3,-2
31020.0,2020-02-23,"(604.549, 717.75]",1,3,-2
31020.0,2020-02-23,"(717.75, 830.5]",3,6,-3
31020.0,2020-02-23,"(943.25, 1056.0]",2,1,1
31021.0,2020-02-23,"(483.473, 615.75]",1,3,-2
31021.0,2020-02-23,"(615.75, 747.5]",2,2,0
31022.0,2020-02-23,"(407.75, 680.5]",3,1,2
31022.0,2020-02-23,"(680.5, 953.25]",5,3,2
31022.0,2020-02-23,"(953.25, 1226.0]",3,17,-14
31023.0,2020-02-23,"(371.25, 664.5]",2,2,0
31023.0,2020-02-23,"(664.5, 957.75]",3,4,-1
31023.0,2020-02-23,"(957.75, 1251.0]",3,4,-1
31024.0,2020-02-23,"(518.258, 704.5]",1,4,-3
31024.0,2020-02-23,"(704.5, 890.0]",3,4,-1
31024.0,2020-02-23,"(890.0, 1075.5]",2,6,-4
31024.0,2020-02-23,"(1075.5, 1261.0]",2,4,-2
31025.0,2020-02-23,"(855.75, 918.5]",1,1,0
31025.0,2020-02-23,"(918.5, 981.25]",1,2,-1
31025.0,2020-02-23,"(981.25, 1044.0]",2,2,0
31026.0,2020-02-23,"(597.75, 854.5]",2,1,1
31026.0,2020-02-23,"(854.5, 1111.25]",2,5,-3
31027.0,2020-02-23,"(666.486, 795.5]",1,2,-1
31027.0,2020-02-23,"(924.0, 1052.5]",2,3,-1
31027.0,2020-02-23,"(1052.5, 1181.0]",2,2,0
31028.0,2020-02-23,"(484.199, 685.25]",1,3,-2
31028.0,2020-02-23,"(685.25, 885.5]",1,2,-1
31028.0,2020-02-23,"(885.5, 1085.75]",2,4,-2
31029.0,2020-02-23,"(937.0, 1125.0]",6,1,5
31029.0,2020-02-23,"(1125.0, 1313.0]",3,8,-5
31030.0,2020-02-23,"(496.431, 639.25]",1,2,-1
31030.0,2020-02-23,"(781.5, 923.75]",2,5,-3
31030.0,2020-02-23,"(923.75, 1066.0]",2,5,-3
31031.0,2020-02-23,"(724.25, 839.5]",1,2,-1
31031.0,2020-02-23,"(839.5, 954.75]",2,1,1
31031.0,2020-02-23,"(954.75, 1070.0]",1,3,-2
31032.0,2020-02-23,"(50.983, 306.25]",1,1,0
31032.0,2020-02-23,"(560.5, 814.75]",3,7,-4
31032.0,2020-02-23,"(814.75, 1069.0]",2,3,-1
31033.0,2020-02-23,"(895.25, 1020.0]",2,1,1
31034.0,2020-02-23,"(844.75, 953.5]",2,1,1
31035.0,2020-02-23,"(957.0, 1032.0]",3,1,2
31036.0,2020-02-23,"(911.511, 1034.25]",3,7,-4
31036.0,2020-02-23,"(1278.75, 1401.0]",1,1,0
31037.0,2020-02-23,"(381.25, 719.5]",1,1,0
31037.0,2020-02-23,"(719.5, 1057.75]",6,4,2
31037.0,2020-02-23,"(1057.75, 1396.0]",3,9,-6
31038.0,2020-02-23,"(876.5, 966.75]",2,2,0
31039.0,2020-02-23,"(81.91, 355.5]",1,1,0
31039.0,2020-02-23,"(628.0, 900.5]",1,1,0
31039.0,2020-02-23,"(900.5, 1173.0]",5,2,3
31040.0,2020-02-23,"(598.0, 894.5]",1,1,0
31040.0,2020-02-23,"(894.5, 1191.0]",1,2,-1
31041.0,2020-02-23,"(709.512, 832.0]",1,1,0
31041.0,2020-02-23,"(832.0, 954.0]",4,8,-4
31041.0,2020-02-23,"(954.0, 1076.0]",4,7,-3
31041.0,2020-02-23,"(1076.0, 1198.0]",2,4,-2
31042.0,2020-02-23,"(5.917, 277.75]",1,1,0
31042.0,2020-02-23,"(548.5, 819.25]",5,10,-5
31042.0,2020-02-23,"(819.25, 1090.0]",11,22,-11
31043.0,2020-02-23,"(735.802, 785.5]",3,3,0
31043.0,2020-02-23,"(884.5, 934.0]",1,2,-1
31044.0,2020-02-23,"(614.53, 732.5]",1,1,0
31044.0,2020-02-23,"(732.5, 850.0]",1,1,0
31044.0,2020-02-23,"(850.0, 967.5]",1,1,0
31045.0,2020-02-23,"(822.0, 942.0]",1,1,0
31045.0,2020-02-23,"(942.0, 1062.0]",2,1,1
31046.0,2020-02-23,"(704.653, 791.75]",1,2,-1
31046.0,2020-02-23,"(878.5, 965.25]",1,2,-1
31047.0,2020-02-23,"(607.389, 760.75]",2,3,-1
31047.0,2020-02-23,"(760.75, 913.5]",2,5,-3
31047.0,2020-02-23,"(913.5, 1066.25]",2,3,-1
31047.0,2020-02-23,"(1066.25, 1219.0]",2,3,-1
31048.0,2020-02-23,"(979.0, 1080.0]",2,1,1
31049.0,2020-02-23,"(921.75, 1051.0]",4,2,2
31050.0,2020-02-23,"(663.585, 767.75]",3,6,-3
31050.0,2020-02-23,"(975.25, 1079.0]",2,1,1
31051.0,2020-02-23,"(709.671, 792.25]",1,2,-1
31051.0,2020-02-23,"(792.25, 874.5]",1,3,-2
31052.0,2020-02-23,"(700.676, 782.0]",1,4,-3
31052.0,2020-02-23,"(863.0, 944.0]",2,2,0
31052.0,2020-02-23,"(944.0, 1025.0]",2,2,0
31053.0,2020-02-23,"(531.534, 648.5]",1,3,-2
31053.0,2020-02-23,"(765.0, 881.5]",1,2,-1
31053.0,2020-02-23,"(881.5, 998.0]",1,2,-1
,,,,1.0,
,,,,1.0,
31055.0,2020-02-23,"(749.958, 760.5]",2,2,0
31056.0,2020-02-23,"(922.0, 1089.0]",4,4,0
31056.0,2020-02-23,"(1256.0, 1423.0]",1,7,-6
31057.0,2020-02-23,"(791.25, 1055.0]",1,1,0
,,,,1.0,
,,,,1.0,
31059.0,2020-02-23,"(807.71, 880.5]",4,5,-1
31059.0,2020-02-23,"(953.0, 1025.5]",1,1,0
31059.0,2020-02-23,"(1025.5, 1098.0]",1,2,-1
31060.0,2020-02-23,"(562.153, 774.75]",2,7,-5
31060.0,2020-02-23,"(774.75, 986.5]",6,10,-4
31060.0,2020-02-23,"(986.5, 1198.25]",2,5,-3
31061.0,2020-02-23,"(429.0, 572.0]",1,1,0
31062.0,2020-02-23,"(627.515, 749.25]",6,8,-2
31062.0,2020-02-23,"(749.25, 870.5]",6,14,-8
31062.0,2020-02-23,"(870.5, 991.75]",9,19,-10
31062.0,2020-02-23,"(991.75, 1113.0]",9,15,-6
31063.0,2020-02-23,"(871.8, 922.0]",1,2,-1
31063.0,2020-02-23,"(922.0, 972.0]",1,1,0
31064.0,2020-02-23,"(558.439, 699.25]",3,7,-4
31064.0,2020-02-23,"(699.25, 839.5]",11,23,-12
31064.0,2020-02-23,"(839.5, 979.75]",25,45,-20
31064.0,2020-02-23,"(979.75, 1120.0]",19,39,-20
31065.0,2020-02-23,"(644.583, 749.25]",1,2,-1
31066.0,2020-02-23,"(740.48, 871.0]",1,2,-1
31066.0,2020-02-23,"(1131.0, 1261.0]",1,4,-3
31067.0,2020-02-23,"(123.911, 397.25]",1,2,-1
31067.0,2020-02-23,"(941.75, 1214.0]",1,1,0
31068.0,2020-02-23,"(132.747, 447.25]",1,1,0
31068.0,2020-02-23,"(760.5, 1073.75]",1,3,-2
31068.0,2020-02-23,"(1073.75, 1387.0]",3,3,0
31069.0,2020-02-23,"(583.643, 673.25]",2,3,-1
31070.0,2020-02-23,"(934.0, 1095.5]",3,1,2
31070.0,2020-02-23,"(1095.5, 1257.0]",2,1,1
31071.0,2020-02-23,"(435.221, 630.75]",3,7,-4
31071.0,2020-02-23,"(630.75, 825.5]",2,4,-2
31071.0,2020-02-23,"(825.5, 1020.25]",4,8,-4
31071.0,2020-02-23,"(1020.25, 1215.0]",3,6,-3
31072.0,2020-02-23,"(771.745, 835.75]",1,2,-1
31072.0,2020-02-23,"(963.25, 1027.0]",1,1,0
31073.0,2020-02-23,"(869.5, 1016.25]",1,1,0
31073.0,2020-02-23,"(1016.25, 1163.0]",1,2,-1
31074.0,2020-02-23,"(506.301, 681.75]",3,4,-1
31075.0,2020-02-23,"(782.608, 783.0]",1,2,-1
,,,,1.0,
,,,,3.0,
31077.0,2020-02-23,"(591.581, 696.75]",5,9,-4
31077.0,2020-02-23,"(696.75, 801.5]",1,4,-3
31077.0,2020-02-23,"(801.5, 906.25]",6,14,-8
31077.0,2020-02-23,"(906.25, 1011.0]",18,30,-12
,,,,1.0,
,,,,1.0,
31079.0,2020-02-23,"(10.722, 331.5]",1,1,0
31079.0,2020-02-23,"(651.0, 970.5]",2,4,-2
31079.0,2020-02-23,"(970.5, 1290.0]",6,3,3
31080.0,2020-02-23,"(573.0, 622.0]",1,1,0
,,,,2.0,
31082.0,2020-02-23,"(757.366, 916.5]",1,3,-2
31083.0,2020-02-23,"(719.842, 759.5]",1,4,-3
31083.0,2020-02-23,"(759.5, 799.0]",3,6,-3
31083.0,2020-02-23,"(799.0, 838.5]",3,4,-1
31083.0,2020-02-23,"(838.5, 878.0]",1,1,0
31084.0,2020-02-23,"(785.0, 849.0]",3,1,2
31084.0,2020-02-23,"(913.0, 977.0]",1,4,-3
,,,,2.0,
31086.0,2020-02-23,"(710.623, 805.25]",1,3,-2
31086.0,2020-02-23,"(993.75, 1088.0]",1,1,0
31087.0,2020-02-23,"(645.733, 712.75]",2,2,0
31087.0,2020-02-23,"(779.5, 846.25]",1,1,0
31088.0,2020-02-23,"(823.0, 1019.0]",2,4,-2
31088.0,2020-02-23,"(1215.0, 1411.0]",1,5,-4
31089.0,2020-02-23,"(137.831, 431.25]",2,2,0
31089.0,2020-02-23,"(431.25, 723.5]",4,6,-2
31089.0,2020-02-23,"(723.5, 1015.75]",3,10,-7
31089.0,2020-02-23,"(1015.75, 1308.0]",1,7,-6
31090.0,2020-02-23,"(765.696, 842.0]",1,1,0
31090.0,2020-02-23,"(918.0, 994.0]",1,2,-1
31090.0,2020-02-23,"(994.0, 1070.0]",1,3,-2
31091.0,2020-02-23,"(857.0, 952.0]",3,1,2
31091.0,2020-02-23,"(952.0, 1047.0]",1,5,-4
31092.0,2020-02-23,"(684.525, 803.75]",2,6,-4
31092.0,2020-02-23,"(1041.25, 1160.0]",3,4,-1
31093.0,2020-02-23,"(22.835, 315.25]",1,1,0
31093.0,2020-02-23,"(897.75, 1189.0]",5,2,3
31094.0,2020-02-23,"(903.5, 977.75]",2,2,0
31094.0,2020-02-23,"(977.75, 1052.0]",1,1,0
,,,,2.0,
31096.0,2020-02-23,"(1021.0, 1098.0]",1,1,0
31096.0,2020-02-23,"(1175.0, 1252.0]",1,1,0
31097.0,2020-02-23,"(709.46, 845.0]",1,1,0
31097.0,2020-02-23,"(845.0, 980.0]",5,9,-4
31097.0,2020-02-23,"(980.0, 1115.0]",9,12,-3
31097.0,2020-02-23,"(1115.0, 1250.0]",2,5,-3
31098.0,2020-02-23,"(557.0, 835.0]",1,1,0
31098.0,2020-02-23,"(835.0, 1113.0]",7,3,4
31099.0,2020-02-23,"(1069.5, 1162.25]",1,1,0
31099.0,2020-02-23,"(1162.25, 1255.0]",2,1,1
31100.0,2020-02-23,"(380.5, 733.0]",3,2,1
31100.0,2020-02-23,"(733.0, 1085.5]",3,3,0
31100.0,2020-02-23,"(1085.5, 1438.0]",1,5,-4
31101.0,2020-02-23,"(10.677, 342.75]",5,12,-7
31101.0,2020-02-23,"(342.75, 673.5]",7,13,-6
31101.0,2020-02-23,"(673.5, 1004.25]",49,77,-28
31101.0,2020-02-23,"(1004.25, 1335.0]",25,46,-21
31102.0,2020-02-23,"(32.725, 352.75]",1,7,-6
31102.0,2020-02-23,"(352.75, 671.5]",2,3,-1
31102.0,2020-02-23,"(671.5, 990.25]",8,20,-12
31102.0,2020-02-23,"(990.25, 1309.0]",3,9,-6
31103.0,2020-02-23,"(89.748, 404.0]",1,1,0
31103.0,2020-02-23,"(404.0, 717.0]",9,19,-10
31103.0,2020-02-23,"(717.0, 1030.0]",12,34,-22
31103.0,2020-02-23,"(1030.0, 1343.0]",4,14,-10
31104.0,2020-02-23,"(46.666, 381.5]",4,11,-7
31104.0,2020-02-23,"(381.5, 715.0]",4,20,-16
31104.0,2020-02-23,"(715.0, 1048.5]",26,43,-17
31104.0,2020-02-23,"(1048.5, 1382.0]",11,23,-12
31105.0,2020-02-23,"(29.602, 380.5]",2,6,-4
31105.0,2020-02-23,"(380.5, 730.0]",1,2,-1
31105.0,2020-02-23,"(730.0, 1079.5]",2,7,-5
31106.0,2020-02-23,"(523.151, 736.25]",2,5,-3
31106.0,2020-02-23,"(736.25, 948.5]",1,4,-3
31106.0,2020-02-23,"(948.5, 1160.75]",1,1,0
31106.0,2020-02-23,"(1160.75, 1373.0]",1,1,0
31107.0,2020-02-23,"(20.666, 355.5]",2,3,-1
31107.0,2020-02-23,"(355.5, 689.0]",3,16,-13
31107.0,2020-02-23,"(689.0, 1022.5]",14,35,-21
31107.0,2020-02-23,"(1022.5, 1356.0]",9,14,-5
31108.0,2020-02-23,"(504.13, 722.5]",7,20,-13
31108.0,2020-02-23,"(722.5, 940.0]",24,43,-19
31108.0,2020-02-23,"(940.0, 1157.5]",20,41,-21
31108.0,2020-02-23,"(1157.5, 1375.0]",10,12,-2
31109.0,2020-02-23,"(1.683, 332.25]",6,19,-13
31109.0,2020-02-23,"(332.25, 661.5]",5,9,-4
31109.0,2020-02-23,"(661.5, 990.75]",24,41,-17
31109.0,2020-02-23,"(990.75, 1320.0]",11,29,-18
31110.0,2020-02-23,"(49.673, 382.75]",2,5,-3
31110.0,2020-02-23,"(382.75, 714.5]",11,24,-13
31110.0,2020-02-23,"(714.5, 1046.25]",19,33,-14
31110.0,2020-02-23,"(1046.25, 1378.0]",6,15,-9
31111.0,2020-02-23,"(28.703, 354.25]",4,6,-2
31111.0,2020-02-23,"(354.25, 678.5]",1,5,-4
31111.0,2020-02-23,"(678.5, 1002.75]",11,27,-16
31111.0,2020-02-23,"(1002.75, 1327.0]",10,15,-5
31112.0,2020-02-23,"(107.996, 360.0]",1,1,0
31112.0,2020-02-23,"(360.0, 611.0]",5,6,-1
31112.0,2020-02-23,"(611.0, 862.0]",12,18,-6
31112.0,2020-02-23,"(862.0, 1113.0]",2,6,-4
31113.0,2020-02-23,"(588.75, 858.5]",7,3,4
31113.0,2020-02-23,"(858.5, 1128.25]",9,25,-16
31113.0,2020-02-23,"(1128.25, 1398.0]",10,24,-14
31114.0,2020-02-23,"(20.611, 369.25]",1,5,-4
31114.0,2020-02-23,"(369.25, 716.5]",3,6,-3
31114.0,2020-02-23,"(716.5, 1063.75]",29,63,-34
31114.0,2020-02-23,"(1063.75, 1411.0]",11,22,-11
31115.0,2020-02-23,"(39.653, 377.75]",2,2,0
31115.0,2020-02-23,"(377.75, 714.5]",3,21,-18
31115.0,2020-02-23,"(714.5, 1051.25]",8,26,-18
31115.0,2020-02-23,"(1051.25, 1388.0]",9,11,-2
31116.0,2020-02-23,"(21.675, 354.25]",1,4,-3
31116.0,2020-02-23,"(354.25, 685.5]",10,15,-5
31116.0,2020-02-23,"(685.5, 1016.75]",18,32,-14
31116.0,2020-02-23,"(1016.75, 1348.0]",7,17,-10
31117.0,2020-02-23,"(26.756, 339.0]",1,1,0
31117.0,2020-02-23,"(339.0, 650.0]",2,9,-7
31117.0,2020-02-23,"(650.0, 961.0]",10,38,-28
31117.0,2020-02-23,"(961.0, 1272.0]",6,14,-8
31118.0,2020-02-23,"(8.63, 352.5]",3,3,0
31118.0,2020-02-23,"(352.5, 695.0]",2,9,-7
31118.0,2020-02-23,"(695.0, 1037.5]",10,18,-8
31118.0,2020-02-23,"(1037.5, 1380.0]",6,7,-1
31119.0,2020-02-23,"(14.667, 349.25]",5,7,-2
31119.0,2020-02-23,"(349.25, 682.5]",9,18,-9
31119.0,2020-02-23,"(682.5, 1015.75]",15,32,-17
31119.0,2020-02-23,"(1015.75, 1349.0]",16,29,-13
31120.0,2020-02-23,"(11.592, 365.0]",2,5,-3
31120.0,2020-02-23,"(365.0, 717.0]",4,9,-5
31120.0,2020-02-23,"(717.0, 1069.0]",13,29,-16
31120.0,2020-02-23,"(1069.0, 1421.0]",8,13,-5
31121.0,2020-02-23,"(53.75, 367.5]",5,5,0
31121.0,2020-02-23,"(367.5, 680.0]",3,6,-3
31121.0,2020-02-23,"(680.0, 992.5]",15,29,-14
31121.0,2020-02-23,"(992.5, 1305.0]",5,12,-7
31122.0,2020-02-23,"(35.702, 361.5]",1,3,-2
31122.0,2020-02-23,"(361.5, 686.0]",1,5,-4
31122.0,2020-02-23,"(686.0, 1010.5]",10,26,-16
31122.0,2020-02-23,"(1010.5, 1335.0]",3,10,-7
31123.0,2020-02-23,"(337.75, 641.5]",2,1,1
31123.0,2020-02-23,"(641.5, 945.25]",6,9,-3
31123.0,2020-02-23,"(945.25, 1249.0]",4,22,-18
31124.0,2020-02-23,"(363.75, 695.5]",7,4,3
31124.0,2020-02-23,"(695.5, 1027.25]",16,17,-1
31124.0,2020-02-23,"(1027.25, 1359.0]",13,54,-41
31125.0,2020-02-23,"(23.759, 335.25]",2,4,-2
31125.0,2020-02-23,"(335.25, 645.5]",6,16,-10
31125.0,2020-02-23,"(645.5, 955.75]",18,38,-20
31125.0,2020-02-23,"(955.75, 1266.0]",16,29,-13
31126.0,2020-02-23,"(39.662, 375.5]",3,4,-1
31126.0,2020-02-23,"(375.5, 710.0]",2,14,-12
31126.0,2020-02-23,"(710.0, 1044.5]",13,30,-17
31126.0,2020-02-23,"(1044.5, 1379.0]",8,13,-5
31127.0,2020-02-23,"(5.597, 357.75]",2,2,0
31127.0,2020-02-23,"(357.75, 708.5]",8,10,-2
31127.0,2020-02-23,"(708.5, 1059.25]",13,20,-7
31127.0,2020-02-23,"(1059.25, 1410.0]",3,8,-5
31128.0,2020-02-23,"(350.008, 599.0]",5,10,-5
31128.0,2020-02-23,"(599.0, 847.0]",11,17,-6
31128.0,2020-02-23,"(847.0, 1095.0]",17,32,-15
31128.0,2020-02-23,"(1095.0, 1343.0]",8,18,-10
31129.0,2020-02-23,"(299.017, 545.75]",1,2,-1
31129.0,2020-02-23,"(545.75, 791.5]",11,15,-4
31129.0,2020-02-23,"(791.5, 1037.25]",26,52,-26
31129.0,2020-02-23,"(1037.25, 1283.0]",13,19,-6
31130.0,2020-02-23,"(13.818, 310.5]",1,5,-4
31130.0,2020-02-23,"(606.0, 901.5]",10,4,6
31130.0,2020-02-23,"(901.5, 1197.0]",9,19,-10
31131.0,2020-02-23,"(50.661, 386.75]",2,2,0
31131.0,2020-02-23,"(386.75, 721.5]",3,10,-7
31131.0,2020-02-23,"(721.5, 1056.25]",1,13,-12
31131.0,2020-02-23,"(1056.25, 1391.0]",4,9,-5
31200.0,2020-02-23,"(2.654, 340.5]",4,10,-6
31200.0,2020-02-23,"(340.5, 677.0]",34,54,-20
31200.0,2020-02-23,"(677.0, 1013.5]",33,70,-37
31200.0,2020-02-23,"(1013.5, 1350.0]",18,31,-13
31201.0,2020-02-23,"(4.615, 352.25]",4,5,-1
31201.0,2020-02-23,"(352.25, 698.5]",24,43,-19
31201.0,2020-02-23,"(698.5, 1044.75]",55,106,-51
31201.0,2020-02-23,"(1044.75, 1391.0]",23,41,-18
,,,,2.0,
31203.0,2020-02-23,"(3.689, 332.75]",6,16,-10
31203.0,2020-02-23,"(332.75, 660.5]",8,14,-6
31203.0,2020-02-23,"(660.5, 988.25]",34,61,-27
31203.0,2020-02-23,"(988.25, 1316.0]",28,51,-23
31204.0,2020-02-23,"(1.678, 333.5]",1,4,-3
31204.0,2020-02-23,"(333.5, 664.0]",1,7,-6
31204.0,2020-02-23,"(664.0, 994.5]",8,22,-14
31204.0,2020-02-23,"(994.5, 1325.0]",7,10,-3
31205.0,2020-02-23,"(541.185, 745.75]",8,12,-4
31205.0,2020-02-23,"(745.75, 949.5]",12,16,-4
31205.0,2020-02-23,"(949.5, 1153.25]",8,10,-2
31205.0,2020-02-23,"(1153.25, 1357.0]",10,14,-4
31206.0,2020-02-23,"(858.0, 942.0]",1,1,0
31207.0,2020-02-23,"(589.437, 730.75]",1,4,-3
31207.0,2020-02-23,"(730.75, 871.5]",2,2,0
31207.0,2020-02-23,"(871.5, 1012.25]",1,1,0
31207.0,2020-02-23,"(1012.25, 1153.0]",3,4,-1
31208.0,2020-02-23,"(553.308, 727.0]",1,2,-1
31208.0,2020-02-23,"(727.0, 900.0]",3,8,-5
31208.0,2020-02-23,"(900.0, 1073.0]",7,12,-5
31208.0,2020-02-23,"(1073.0, 1246.0]",7,9,-2
31209.0,2020-02-23,"(356.5, 664.0]",2,4,-2
31209.0,2020-02-23,"(664.0, 971.5]",9,3,6
31209.0,2020-02-23,"(971.5, 1279.0]",8,21,-13
31211.0,2020-02-23,"(623.523, 743.25]",8,10,-2
31211.0,2020-02-23,"(743.25, 862.5]",3,6,-3
31211.0,2020-02-23,"(862.5, 981.75]",1,2,-1
31211.0,2020-02-23,"(981.75, 1101.0]",9,18,-9
31212.0,2020-02-23,"(9.611, 358.25]",1,3,-2
31212.0,2020-02-23,"(358.25, 705.5]",11,22,-11
31212.0,2020-02-23,"(705.5, 1052.75]",16,29,-13
31212.0,2020-02-23,"(1052.75, 1400.0]",9,15,-6
31213.0,2020-02-23,"(775.0, 911.0]",4,1,3
31213.0,2020-02-23,"(911.0, 1047.0]",3,8,-5
31213.0,2020-02-23,"(1047.0, 1183.0]",1,5,-4
31214.0,2020-02-23,"(72.687, 402.25]",1,2,-1
31214.0,2020-02-23,"(402.25, 730.5]",13,27,-14
31214.0,2020-02-23,"(730.5, 1058.75]",20,46,-26
31214.0,2020-02-23,"(1058.75, 1387.0]",18,29,-11
31215.0,2020-02-23,"(492.344, 657.0]",6,10,-4
31215.0,2020-02-23,"(657.0, 821.0]",20,36,-16
31215.0,2020-02-23,"(821.0, 985.0]",10,20,-10
31215.0,2020-02-23,"(985.0, 1149.0]",2,5,-3
31216.0,2020-02-23,"(676.596, 778.0]",1,2,-1
31216.0,2020-02-23,"(879.0, 980.0]",1,4,-3
31217.0,2020-02-23,"(620.319, 791.25]",3,7,-4
31217.0,2020-02-23,"(791.25, 961.5]",20,30,-10
31217.0,2020-02-23,"(961.5, 1131.75]",5,5,0
31217.0,2020-02-23,"(1131.75, 1302.0]",1,1,0
31218.0,2020-02-23,"(18.652, 357.0]",1,1,0
31218.0,2020-02-23,"(357.0, 694.0]",4,7,-3
31218.0,2020-02-23,"(694.0, 1031.0]",10,20,-10
31219.0,2020-02-23,"(48.936, 316.0]",4,4,0
31219.0,2020-02-23,"(582.0, 848.0]",14,1,13
31219.0,2020-02-23,"(848.0, 1114.0]",24,21,3
31220.0,2020-02-23,"(911.655, 998.25]",1,1,0
31221.0,2020-02-23,"(0.568, 360.0]",1,3,-2
31221.0,2020-02-23,"(360.0, 718.0]",6,7,-1
31221.0,2020-02-23,"(718.0, 1076.0]",10,20,-10
31221.0,2020-02-23,"(1076.0, 1434.0]",3,5,-2
31222.0,2020-02-23,"(565.5, 818.0]",7,2,5
31222.0,2020-02-23,"(818.0, 1070.5]",11,14,-3
31222.0,2020-02-23,"(1070.5, 1323.0]",6,16,-10
31223.0,2020-02-23,"(548.207, 747.25]",12,23,-11
31223.0,2020-02-23,"(747.25, 945.5]",9,12,-3
31223.0,2020-02-23,"(1143.75, 1342.0]",4,3,1
31224.0,2020-02-23,"(629.527, 748.25]",3,9,-6
31224.0,2020-02-23,"(748.25, 866.5]",4,5,-1
31224.0,2020-02-23,"(866.5, 984.75]",1,1,0
31224.0,2020-02-23,"(984.75, 1103.0]",4,7,-3
31225.0,2020-02-23,"(469.298, 645.5]",5,8,-3
31225.0,2020-02-23,"(645.5, 821.0]",2,7,-5
31225.0,2020-02-23,"(821.0, 996.5]",8,13,-5
31225.0,2020-02-23,"(996.5, 1172.0]",2,5,-3
31226.0,2020-02-23,"(683.75, 813.5]",2,1,1
31226.0,2020-02-23,"(813.5, 943.25]",3,3,0
31226.0,2020-02-23,"(943.25, 1073.0]",11,3,8
31227.0,2020-02-23,"(449.341, 614.75]",2,7,-5
31227.0,2020-02-23,"(614.75, 779.5]",1,4,-3
31227.0,2020-02-23,"(779.5, 944.25]",5,7,-2
31227.0,2020-02-23,"(944.25, 1109.0]",6,11,-5
31228.0,2020-02-23,"(4.686, 334.5]",3,9,-6
31228.0,2020-02-23,"(334.5, 663.0]",5,6,-1
31228.0,2020-02-23,"(663.0, 991.5]",24,43,-19
31228.0,2020-02-23,"(991.5, 1320.0]",6,17,-11
31229.0,2020-02-23,"(-1.394, 348.5]",5,13,-8
31229.0,2020-02-23,"(348.5, 697.0]",20,35,-15
31229.0,2020-02-23,"(697.0, 1045.5]",30,63,-33
31229.0,2020-02-23,"(1045.5, 1394.0]",21,37,-16
31230.0,2020-02-23,"(498.213, 695.75]",7,7,0
31230.0,2020-02-23,"(695.75, 892.5]",10,16,-6
31230.0,2020-02-23,"(892.5, 1089.25]",8,12,-4
31230.0,2020-02-23,"(1089.25, 1286.0]",6,13,-7
31231.0,2020-02-23,"(790.0, 908.0]",6,1,5
31231.0,2020-02-23,"(908.0, 1026.0]",3,11,-8
31231.0,2020-02-23,"(1026.0, 1144.0]",3,8,-5
31232.0,2020-02-23,"(102.765, 412.75]",1,3,-2
31232.0,2020-02-23,"(412.75, 721.5]",7,8,-1
31232.0,2020-02-23,"(721.5, 1030.25]",36,76,-40
31232.0,2020-02-23,"(1030.25, 1339.0]",9,29,-20
31233.0,2020-02-23,"(384.111, 607.25]",3,4,-1
31233.0,2020-02-23,"(607.25, 829.5]",9,15,-6
31233.0,2020-02-23,"(829.5, 1051.75]",13,20,-7
31233.0,2020-02-23,"(1051.75, 1274.0]",3,4,-1
31234.0,2020-02-23,"(12.672, 346.0]",3,5,-2
31234.0,2020-02-23,"(346.0, 678.0]",6,11,-5
31234.0,2020-02-23,"(678.0, 1010.0]",19,32,-13
31234.0,2020-02-23,"(1010.0, 1342.0]",11,18,-7
31235.0,2020-02-23,"(705.498, 831.5]",6,12,-6
31235.0,2020-02-23,"(831.5, 957.0]",3,7,-4
31235.0,2020-02-23,"(957.0, 1082.5]",11,14,-3
31235.0,2020-02-23,"(1082.5, 1208.0]",1,2,-1
31236.0,2020-02-23,"(-0.435, 359.75]",5,7,-2
31236.0,2020-02-23,"(359.75, 718.5]",10,14,-4
31236.0,2020-02-23,"(718.5, 1077.25]",28,55,-27
31236.0,2020-02-23,"(1077.25, 1436.0]",5,20,-15
31237.0,2020-02-23,"(7.688, 337.0]",2,2,0
31237.0,2020-02-23,"(337.0, 665.0]",5,16,-11
31237.0,2020-02-23,"(665.0, 993.0]",18,30,-12
31237.0,2020-02-23,"(993.0, 1321.0]",10,20,-10
31238.0,2020-02-23,"(443.266, 627.5]",1,3,-2
31238.0,2020-02-23,"(627.5, 811.0]",3,8,-5
31238.0,2020-02-23,"(811.0, 994.5]",2,2,0
31238.0,2020-02-23,"(994.5, 1178.0]",8,10,-2
31239.0,2020-02-23,"(389.5, 698.0]",3,2,1
31239.0,2020-02-23,"(698.0, 1006.5]",11,4,7
31239.0,2020-02-23,"(1006.5, 1315.0]",5,15,-10
31240.0,2020-02-23,"(517.151, 730.25]",5,9,-4
31240.0,2020-02-23,"(730.25, 942.5]",28,55,-27
31240.0,2020-02-23,"(942.5, 1154.75]",13,20,-7
31240.0,2020-02-23,"(1154.75, 1367.0]",1,2,-1
31241.0,2020-02-23,"(15.639, 357.25]",2,5,-3
31241.0,2020-02-23,"(357.25, 697.5]",6,15,-9
31241.0,2020-02-23,"(697.5, 1037.75]",16,38,-22
31241.0,2020-02-23,"(1037.75, 1378.0]",14,24,-10
31242.0,2020-02-23,"(360.081, 590.75]",4,6,-2
31242.0,2020-02-23,"(590.75, 820.5]",5,9,-4
31242.0,2020-02-23,"(820.5, 1050.25]",10,21,-11
31242.0,2020-02-23,"(1050.25, 1280.0]",3,6,-3
31243.0,2020-02-23,"(411.5, 711.0]",6,1,5
31243.0,2020-02-23,"(711.0, 1010.5]",6,11,-5
31243.0,2020-02-23,"(1010.5, 1310.0]",4,12,-8
31244.0,2020-02-23,"(24.897, 301.75]",3,3,0
31244.0,2020-02-23,"(301.75, 577.5]",1,2,-1
31244.0,2020-02-23,"(577.5, 853.25]",7,15,-8
31244.0,2020-02-23,"(853.25, 1129.0]",8,14,-6
31245.0,2020-02-23,"(1.64, 343.0]",2,3,-1
31245.0,2020-02-23,"(343.0, 683.0]",1,8,-7
31245.0,2020-02-23,"(683.0, 1023.0]",13,26,-13
31245.0,2020-02-23,"(1023.0, 1363.0]",9,19,-10
31246.0,2020-02-23,"(31.619, 378.25]",2,3,-1
31246.0,2020-02-23,"(378.25, 723.5]",9,14,-5
31246.0,2020-02-23,"(723.5, 1068.75]",31,58,-27
31246.0,2020-02-23,"(1068.75, 1414.0]",4,10,-6
31247.0,2020-02-23,"(191.04, 432.0]",1,1,0
31247.0,2020-02-23,"(432.0, 672.0]",14,22,-8
31247.0,2020-02-23,"(672.0, 912.0]",52,100,-48
31247.0,2020-02-23,"(912.0, 1152.0]",55,116,-61
31248.0,2020-02-23,"(533.348, 697.0]",14,24,-10
31248.0,2020-02-23,"(697.0, 860.0]",18,33,-15
31248.0,2020-02-23,"(860.0, 1023.0]",42,86,-44
31248.0,2020-02-23,"(1023.0, 1186.0]",13,31,-18
31249.0,2020-02-23,"(357.189, 560.75]",2,3,-1
31249.0,2020-02-23,"(560.75, 763.5]",16,26,-10
31249.0,2020-02-23,"(763.5, 966.25]",11,24,-13
31249.0,2020-02-23,"(966.25, 1169.0]",11,22,-11
31250.0,2020-02-23,"(870.5, 955.0]",2,2,0
31250.0,2020-02-23,"(955.0, 1039.5]",1,3,-2
31250.0,2020-02-23,"(1039.5, 1124.0]",3,1,2
31251.0,2020-02-23,"(36.79, 340.5]",1,1,0
31251.0,2020-02-23,"(340.5, 643.0]",1,5,-4
31251.0,2020-02-23,"(643.0, 945.5]",10,25,-15
31251.0,2020-02-23,"(945.5, 1248.0]",14,20,-6
31252.0,2020-02-23,"(37.873, 320.75]",1,2,-1
31252.0,2020-02-23,"(320.75, 602.5]",3,3,0
31252.0,2020-02-23,"(602.5, 884.25]",3,3,0
31252.0,2020-02-23,"(884.25, 1166.0]",5,8,-3
31253.0,2020-02-23,"(441.113, 663.75]",3,6,-3
31253.0,2020-02-23,"(885.5, 1107.25]",3,6,-3
31253.0,2020-02-23,"(1107.25, 1329.0]",1,3,-2
31254.0,2020-02-23,"(251.839, 543.25]",2,3,-1
31254.0,2020-02-23,"(543.25, 833.5]",2,7,-5
31254.0,2020-02-23,"(833.5, 1123.75]",2,4,-2
31255.0,2020-02-23,"(509.257, 695.75]",4,7,-3
31255.0,2020-02-23,"(695.75, 881.5]",3,5,-2
31255.0,2020-02-23,"(881.5, 1067.25]",1,3,-2
31255.0,2020-02-23,"(1067.25, 1253.0]",4,7,-3
31256.0,2020-02-23,"(581.157, 792.75]",5,9,-4
31256.0,2020-02-23,"(792.75, 1003.5]",9,12,-3
31256.0,2020-02-23,"(1003.5, 1214.25]",2,4,-2
31257.0,2020-02-23,"(298.0, 590.0]",4,1,3
31257.0,2020-02-23,"(590.0, 882.0]",8,5,3
31257.0,2020-02-23,"(882.0, 1174.0]",7,16,-9
31258.0,2020-02-23,"(169.835, 462.25]",1,1,0
31258.0,2020-02-23,"(462.25, 753.5]",22,54,-32
31258.0,2020-02-23,"(753.5, 1044.75]",95,188,-93
31258.0,2020-02-23,"(1044.75, 1336.0]",16,34,-18
31259.0,2020-02-23,"(835.0, 1074.0]",3,1,2
31260.0,2020-02-23,"(641.213, 838.75]",4,8,-4
31260.0,2020-02-23,"(838.75, 1035.5]",10,15,-5
31260.0,2020-02-23,"(1035.5, 1232.25]",9,16,-7
31261.0,2020-02-23,"(127.0, 378.0]",2,2,0
31261.0,2020-02-23,"(628.0, 878.0]",4,10,-6
31261.0,2020-02-23,"(878.0, 1128.0]",2,3,-1
31262.0,2020-02-23,"(779.649, 867.75]",2,4,-2
31262.0,2020-02-23,"(867.75, 955.5]",1,1,0
31262.0,2020-02-23,"(955.5, 1043.25]",3,3,0
31262.0,2020-02-23,"(1043.25, 1131.0]",1,4,-3
31263.0,2020-02-23,"(383.247, 572.25]",3,4,-1
31263.0,2020-02-23,"(572.25, 760.5]",8,14,-6
31263.0,2020-02-23,"(760.5, 948.75]",9,17,-8
31263.0,2020-02-23,"(948.75, 1137.0]",5,8,-3
31264.0,2020-02-23,"(318.022, 563.5]",1,1,0
31264.0,2020-02-23,"(563.5, 808.0]",7,8,-1
31264.0,2020-02-23,"(808.0, 1052.5]",12,17,-5
31264.0,2020-02-23,"(1052.5, 1297.0]",5,9,-4
31265.0,2020-02-23,"(37.653, 375.75]",1,1,0
31265.0,2020-02-23,"(375.75, 712.5]",3,10,-7
31265.0,2020-02-23,"(712.5, 1049.25]",20,49,-29
31265.0,2020-02-23,"(1049.25, 1386.0]",12,18,-6
31266.0,2020-02-23,"(1.653, 339.75]",7,10,-3
31266.0,2020-02-23,"(339.75, 676.5]",6,20,-14
31266.0,2020-02-23,"(676.5, 1013.25]",14,36,-22
31266.0,2020-02-23,"(1013.25, 1350.0]",18,24,-6
31267.0,2020-02-23,"(177.836, 470.0]",1,6,-5
31267.0,2020-02-23,"(470.0, 761.0]",9,18,-9
31267.0,2020-02-23,"(761.0, 1052.0]",16,37,-21
31267.0,2020-02-23,"(1052.0, 1343.0]",5,8,-3
31268.0,2020-02-23,"(1.7, 328.0]",1,8,-7
31268.0,2020-02-23,"(328.0, 653.0]",11,15,-4
31268.0,2020-02-23,"(653.0, 978.0]",25,47,-22
31268.0,2020-02-23,"(978.0, 1303.0]",16,21,-5
31269.0,2020-02-23,"(83.724, 404.0]",1,2,-1
31269.0,2020-02-23,"(404.0, 723.0]",5,9,-4
31269.0,2020-02-23,"(723.0, 1042.0]",6,13,-7
31269.0,2020-02-23,"(1042.0, 1361.0]",9,13,-4
31270.0,2020-02-23,"(54.745, 369.75]",2,2,0
31270.0,2020-02-23,"(369.75, 683.5]",1,1,0
31270.0,2020-02-23,"(683.5, 997.25]",6,12,-6
31270.0,2020-02-23,"(997.25, 1311.0]",2,5,-3
31271.0,2020-02-23,"(599.341, 764.75]",10,15,-5
31271.0,2020-02-23,"(764.75, 929.5]",27,41,-14
31271.0,2020-02-23,"(929.5, 1094.25]",9,19,-10
31271.0,2020-02-23,"(1094.25, 1259.0]",6,11,-5
31272.0,2020-02-23,"(635.44, 776.0]",4,4,0
31272.0,2020-02-23,"(776.0, 916.0]",12,18,-6
31272.0,2020-02-23,"(916.0, 1056.0]",6,17,-11
31272.0,2020-02-23,"(1056.0, 1196.0]",3,3,0
31273.0,2020-02-23,"(590.325, 759.75]",1,1,0
31273.0,2020-02-23,"(759.75, 928.5]",5,14,-9
31273.0,2020-02-23,"(928.5, 1097.25]",14,27,-13
31273.0,2020-02-23,"(1097.25, 1266.0]",2,4,-2
31274.0,2020-02-23,"(42.902, 318.5]",1,4,-3
31274.0,2020-02-23,"(318.5, 593.0]",7,12,-5
31274.0,2020-02-23,"(593.0, 867.5]",6,8,-2
31274.0,2020-02-23,"(867.5, 1142.0]",5,11,-6
31275.0,2020-02-23,"(510.078, 741.5]",4,10,-6
31275.0,2020-02-23,"(741.5, 972.0]",15,23,-8
31275.0,2020-02-23,"(972.0, 1202.5]",7,11,-4
31275.0,2020-02-23,"(1202.5, 1433.0]",3,6,-3
31276.0,2020-02-23,"(334.225, 528.75]",2,3,-1
31276.0,2020-02-23,"(528.75, 722.5]",1,1,0
31276.0,2020-02-23,"(722.5, 916.25]",3,4,-1
31276.0,2020-02-23,"(916.25, 1110.0]",7,15,-8
31277.0,2020-02-23,"(442.257, 628.75]",3,3,0
31277.0,2020-02-23,"(628.75, 814.5]",12,18,-6
31277.0,2020-02-23,"(814.5, 1000.25]",7,14,-7
31277.0,2020-02-23,"(1000.25, 1186.0]",3,7,-4
31278.0,2020-02-23,"(319.75, 611.5]",3,2,1
31278.0,2020-02-23,"(611.5, 903.25]",12,4,8
31278.0,2020-02-23,"(903.25, 1195.0]",11,26,-15
31279.0,2020-02-23,"(604.3, 780.0]",2,4,-2
31279.0,2020-02-23,"(780.0, 955.0]",1,1,0
31280.0,2020-02-23,"(6.783, 312.25]",4,7,-3
31280.0,2020-02-23,"(312.25, 616.5]",8,13,-5
31280.0,2020-02-23,"(616.5, 920.75]",17,32,-15
31280.0,2020-02-23,"(920.75, 1225.0]",12,22,-10
31000.0,2020-02-24,"(830.0, 1114.5]",2,1,1
31000.0,2020-02-24,"(1114.5, 1399.0]",2,1,1
31001.0,2020-02-24,"(695.0, 1024.5]",1,1,0
31001.0,2020-02-24,"(1024.5, 1354.0]",4,2,2
31002.0,2020-02-24,"(389.312, 562.0]",2,7,-5
31002.0,2020-02-24,"(562.0, 734.0]",1,1,0
31002.0,2020-02-24,"(734.0, 906.0]",1,2,-1
31002.0,2020-02-24,"(906.0, 1078.0]",11,13,-2
31003.0,2020-02-24,"(379.236, 571.0]",3,5,-2
31003.0,2020-02-24,"(571.0, 762.0]",1,1,0
31003.0,2020-02-24,"(953.0, 1144.0]",2,3,-1
31004.0,2020-02-24,"(860.0, 1044.0]",2,2,0
31004.0,2020-02-24,"(1044.0, 1228.0]",3,2,1
31005.0,2020-02-24,"(109.886, 389.5]",1,2,-1
31005.0,2020-02-24,"(389.5, 668.0]",4,6,-2
31005.0,2020-02-24,"(668.0, 946.5]",1,2,-1
31005.0,2020-02-24,"(946.5, 1225.0]",5,12,-7
31006.0,2020-02-24,"(482.323, 652.25]",1,3,-2
31006.0,2020-02-24,"(990.75, 1160.0]",2,2,0
31007.0,2020-02-24,"(354.104, 579.0]",5,14,-9
31007.0,2020-02-24,"(579.0, 803.0]",5,10,-5
31007.0,2020-02-24,"(803.0, 1027.0]",2,8,-6
31007.0,2020-02-24,"(1027.0, 1251.0]",5,17,-12
31009.0,2020-02-24,"(509.185, 713.75]",3,4,-1
31009.0,2020-02-24,"(713.75, 917.5]",2,2,0
31009.0,2020-02-24,"(917.5, 1121.25]",1,5,-4
31009.0,2020-02-24,"(1121.25, 1325.0]",2,5,-3
31010.0,2020-02-24,"(663.5, 995.25]",1,1,0
31010.0,2020-02-24,"(995.25, 1327.0]",1,1,0
31011.0,2020-02-24,"(328.25, 609.5]",7,1,6
31011.0,2020-02-24,"(890.75, 1172.0]",2,8,-6
31012.0,2020-02-24,"(358.22, 554.0]",4,4,0
31012.0,2020-02-24,"(554.0, 749.0]",1,1,0
31012.0,2020-02-24,"(749.0, 944.0]",1,2,-1
31013.0,2020-02-24,"(35.962, 296.5]",1,1,0
31013.0,2020-02-24,"(556.0, 815.5]",1,3,-2
31013.0,2020-02-24,"(815.5, 1075.0]",2,2,0
31014.0,2020-02-24,"(346.054, 583.5]",22,26,-4
31014.0,2020-02-24,"(583.5, 820.0]",7,10,-3
31014.0,2020-02-24,"(820.0, 1056.5]",8,13,-5
31014.0,2020-02-24,"(1056.5, 1293.0]",9,21,-12
31015.0,2020-02-24,"(462.081, 692.75]",5,11,-6
31015.0,2020-02-24,"(692.75, 922.5]",7,9,-2
31015.0,2020-02-24,"(922.5, 1152.25]",5,10,-5
31015.0,2020-02-24,"(1152.25, 1382.0]",3,4,-1
31016.0,2020-02-24,"(444.242, 634.5]",5,11,-6
31016.0,2020-02-24,"(634.5, 824.0]",1,3,-2
31016.0,2020-02-24,"(824.0, 1013.5]",2,3,-1
31016.0,2020-02-24,"(1013.5, 1203.0]",4,7,-3
31017.0,2020-02-24,"(491.137, 707.75]",5,8,-3
31017.0,2020-02-24,"(707.75, 923.5]",1,4,-3
31017.0,2020-02-24,"(923.5, 1139.25]",1,7,-6
31017.0,2020-02-24,"(1139.25, 1355.0]",2,6,-4
31018.0,2020-02-24,"(667.0, 890.0]",3,2,1
31018.0,2020-02-24,"(890.0, 1113.0]",2,3,-1
31018.0,2020-02-24,"(1113.0, 1336.0]",1,3,-2
31019.0,2020-02-24,"(654.0, 853.0]",3,2,1
31019.0,2020-02-24,"(853.0, 1052.0]",2,3,-1
31019.0,2020-02-24,"(1052.0, 1251.0]",5,4,1
31020.0,2020-02-24,"(1053.871, 1086.25]",1,1,0
31021.0,2020-02-24,"(467.086, 696.5]",2,5,-3
31021.0,2020-02-24,"(925.0, 1153.5]",3,2,1
31021.0,2020-02-24,"(1153.5, 1382.0]",1,6,-5
31022.0,2020-02-24,"(415.214, 612.5]",2,5,-3
31022.0,2020-02-24,"(612.5, 809.0]",1,2,-1
31022.0,2020-02-24,"(1005.5, 1202.0]",2,3,-1
31023.0,2020-02-24,"(652.5, 815.0]",1,1,0
31024.0,2020-02-24,"(411.023, 656.25]",7,10,-3
31024.0,2020-02-24,"(900.5, 1144.75]",3,1,2
31025.0,2020-02-24,"(863.665, 947.75]",1,1,0
31025.0,2020-02-24,"(947.75, 1031.5]",1,2,-1
31025.0,2020-02-24,"(1031.5, 1115.25]",2,5,-3
31025.0,2020-02-24,"(1115.25, 1199.0]",1,2,-1
31026.0,2020-02-24,"(1078.25, 1315.0]",1,4,-3
31027.0,2020-02-24,"(717.25, 898.5]",1,2,-1
31027.0,2020-02-24,"(1079.75, 1261.0]",4,4,0
31028.0,2020-02-24,"(469.158, 680.5]",2,3,-1
31028.0,2020-02-24,"(891.0, 1101.5]",1,1,0
31029.0,2020-02-24,"(846.0, 1053.0]",1,7,-6
31029.0,2020-02-24,"(1053.0, 1260.0]",2,2,0
31030.0,2020-02-24,"(922.0, 1157.0]",6,11,-5
31030.0,2020-02-24,"(1157.0, 1392.0]",2,10,-8
31031.0,2020-02-24,"(348.964, 609.0]",1,5,-4
31031.0,2020-02-24,"(609.0, 868.0]",2,2,0
31031.0,2020-02-24,"(868.0, 1127.0]",2,3,-1
31031.0,2020-02-24,"(1127.0, 1386.0]",2,3,-1
31032.0,2020-02-24,"(1020.0, 1207.0]",2,3,-1
31033.0,2020-02-24,"(540.409, 688.75]",1,2,-1
31033.0,2020-02-24,"(984.25, 1132.0]",3,5,-2
31034.0,2020-02-24,"(467.192, 670.0]",3,6,-3
31034.0,2020-02-24,"(1074.0, 1276.0]",2,5,-3
31035.0,2020-02-24,"(431.995, 684.25]",1,8,-7
31035.0,2020-02-24,"(684.25, 935.5]",2,5,-3
31035.0,2020-02-24,"(935.5, 1186.75]",2,4,-2
31035.0,2020-02-24,"(1186.75, 1438.0]",2,2,0
31036.0,2020-02-24,"(518.191, 721.25]",1,4,-3
31036.0,2020-02-24,"(721.25, 923.5]",2,2,0
31036.0,2020-02-24,"(923.5, 1125.75]",4,5,-1
31036.0,2020-02-24,"(1125.75, 1328.0]",2,2,0
31037.0,2020-02-24,"(383.055, 620.25]",8,14,-6
31037.0,2020-02-24,"(620.25, 856.5]",5,10,-5
31037.0,2020-02-24,"(856.5, 1092.75]",5,12,-7
31037.0,2020-02-24,"(1092.75, 1329.0]",1,8,-7
31038.0,2020-02-24,"(777.717, 848.75]",1,2,-1
31038.0,2020-02-24,"(848.75, 919.5]",1,1,0
31038.0,2020-02-24,"(990.25, 1061.0]",2,5,-3
31039.0,2020-02-24,"(461.069, 694.75]",3,7,-4
31039.0,2020-02-24,"(927.5, 1160.25]",3,1,2
31039.0,2020-02-24,"(1160.25, 1393.0]",3,6,-3
31040.0,2020-02-24,"(450.225, 644.75]",3,3,0
31040.0,2020-02-24,"(644.75, 838.5]",2,3,-1
31040.0,2020-02-24,"(1032.25, 1226.0]",1,2,-1
31041.0,2020-02-24,"(806.401, 956.75]",2,7,-5
31041.0,2020-02-24,"(956.75, 1106.5]",1,1,0
31041.0,2020-02-24,"(1106.5, 1256.25]",6,8,-2
31041.0,2020-02-24,"(1256.25, 1406.0]",1,2,-1
31042.0,2020-02-24,"(445.038, 686.5]",3,3,0
31042.0,2020-02-24,"(686.5, 927.0]",2,4,-2
31042.0,2020-02-24,"(1167.5, 1408.0]",2,7,-5
31043.0,2020-02-24,"(414.262, 599.5]",4,6,-2
31043.0,2020-02-24,"(599.5, 784.0]",2,2,0
31043.0,2020-02-24,"(784.0, 968.5]",1,4,-3
31043.0,2020-02-24,"(968.5, 1153.0]",2,7,-5
31044.0,2020-02-24,"(485.131, 703.25]",1,1,0
31044.0,2020-02-24,"(703.25, 920.5]",2,5,-3
31044.0,2020-02-24,"(920.5, 1137.75]",2,3,-1
31044.0,2020-02-24,"(1137.75, 1355.0]",2,2,0
31045.0,2020-02-24,"(506.381, 661.75]",4,6,-2
31045.0,2020-02-24,"(661.75, 816.5]",1,4,-3
31045.0,2020-02-24,"(816.5, 971.25]",1,1,0
31045.0,2020-02-24,"(971.25, 1126.0]",3,3,0
31046.0,2020-02-24,"(397.337, 563.75]",1,4,-3
31046.0,2020-02-24,"(563.75, 729.5]",1,4,-3
31046.0,2020-02-24,"(895.25, 1061.0]",2,2,0
31047.0,2020-02-24,"(368.992, 622.0]",10,18,-8
31047.0,2020-02-24,"(622.0, 874.0]",6,6,0
31047.0,2020-02-24,"(874.0, 1126.0]",5,14,-9
31047.0,2020-02-24,"(1126.0, 1378.0]",1,8,-7
31048.0,2020-02-24,"(404.162, 614.5]",3,5,-2
31048.0,2020-02-24,"(614.5, 824.0]",2,4,-2
31048.0,2020-02-24,"(824.0, 1033.5]",1,1,0
31048.0,2020-02-24,"(1033.5, 1243.0]",2,8,-6
31049.0,2020-02-24,"(1100.0, 1215.0]",1,1,0
31050.0,2020-02-24,"(923.75, 1076.0]",2,2,0
31051.0,2020-02-24,"(807.5, 989.75]",2,5,-3
31051.0,2020-02-24,"(989.75, 1172.0]",7,2,5
31052.0,2020-02-24,"(384.254, 571.5]",4,5,-1
31052.0,2020-02-24,"(758.0, 944.5]",1,3,-2
31052.0,2020-02-24,"(944.5, 1131.0]",3,1,2
31053.0,2020-02-24,"(537.414, 684.5]",1,2,-1
31053.0,2020-02-24,"(977.5, 1124.0]",1,1,0
31054.0,2020-02-24,"(756.75, 1009.0]",1,1,0
31055.0,2020-02-24,"(412.038, 653.5]",1,2,-1
31055.0,2020-02-24,"(653.5, 894.0]",2,2,0
31055.0,2020-02-24,"(894.0, 1134.5]",3,5,-2
31055.0,2020-02-24,"(1134.5, 1375.0]",1,2,-1
31056.0,2020-02-24,"(860.5, 1033.0]",1,1,0
31056.0,2020-02-24,"(1033.0, 1205.5]",2,2,0
31056.0,2020-02-24,"(1205.5, 1378.0]",2,2,0
,,,,1.0,
,,,,1.0,
31058.0,2020-02-24,"(786.75, 1049.0]",1,1,0
31059.0,2020-02-24,"(550.369, 708.75]",1,1,0
31059.0,2020-02-24,"(1024.25, 1182.0]",1,1,0
31060.0,2020-02-24,"(699.507, 823.25]",1,2,-1
31060.0,2020-02-24,"(946.5, 1069.75]",1,1,0
31060.0,2020-02-24,"(1069.75, 1193.0]",1,2,-1
31061.0,2020-02-24,"(505.334, 672.5]",1,3,-2
31061.0,2020-02-24,"(839.0, 1005.5]",1,1,0
31061.0,2020-02-24,"(1005.5, 1172.0]",1,1,0
31062.0,2020-02-24,"(577.465, 711.75]",2,4,-2
31062.0,2020-02-24,"(845.5, 979.25]",7,2,5
31062.0,2020-02-24,"(979.25, 1113.0]",2,11,-9
31063.0,2020-02-24,"(159.885, 439.75]",1,1,0
31063.0,2020-02-24,"(718.5, 997.25]",1,2,-1
31064.0,2020-02-24,"(474.251, 662.25]",2,3,-1
31064.0,2020-02-24,"(662.25, 849.5]",5,9,-4
31064.0,2020-02-24,"(849.5, 1036.75]",9,18,-9
31064.0,2020-02-24,"(1036.75, 1224.0]",9,18,-9
31065.0,2020-02-24,"(996.866, 1030.5]",1,1,0
31065.0,2020-02-24,"(1097.5, 1131.0]",2,3,-1
31066.0,2020-02-24,"(937.5, 1086.0]",1,2,-1
31067.0,2020-02-24,"(918.5, 1170.25]",2,1,1
31067.0,2020-02-24,"(1170.25, 1422.0]",1,3,-2
31068.0,2020-02-24,"(535.202, 735.5]",1,2,-1
31068.0,2020-02-24,"(935.0, 1134.5]",1,1,0
31068.0,2020-02-24,"(1134.5, 1334.0]",2,2,0
31069.0,2020-02-24,"(668.5, 1002.75]",2,1,1
31069.0,2020-02-24,"(1002.75, 1337.0]",3,2,1
31070.0,2020-02-24,"(771.0, 970.0]",1,2,-1
31070.0,2020-02-24,"(970.0, 1169.0]",2,1,1
31070.0,2020-02-24,"(1169.0, 1368.0]",1,3,-2
31071.0,2020-02-24,"(52.698, 379.5]",1,1,0
31071.0,2020-02-24,"(379.5, 705.0]",1,4,-3
31071.0,2020-02-24,"(705.0, 1030.5]",5,9,-4
31071.0,2020-02-24,"(1030.5, 1356.0]",6,9,-3
,,,,1.0,
,,,,1.0,
,,,,2.0,
31073.0,2020-02-24,"(453.412, 601.0]",2,2,0
31074.0,2020-02-24,"(935.25, 1078.0]",3,2,1
31075.0,2020-02-24,"(970.25, 1113.0]",1,1,0
31076.0,2020-02-24,"(790.634, 882.5]",1,1,0
31076.0,2020-02-24,"(882.5, 974.0]",1,2,-1
31076.0,2020-02-24,"(974.0, 1065.5]",1,1,0
31076.0,2020-02-24,"(1065.5, 1157.0]",2,2,0
31077.0,2020-02-24,"(401.231, 594.25]",2,6,-4
31077.0,2020-02-24,"(594.25, 786.5]",4,6,-2
31077.0,2020-02-24,"(786.5, 978.75]",3,4,-1
31077.0,2020-02-24,"(978.75, 1171.0]",6,7,-1
31078.0,2020-02-24,"(479.399, 630.25]",6,7,-1
31078.0,2020-02-24,"(930.75, 1081.0]",2,1,1
31079.0,2020-02-24,"(409.017, 655.75]",1,7,-6
31079.0,2020-02-24,"(901.5, 1147.25]",3,1,2
31079.0,2020-02-24,"(1147.25, 1393.0]",5,4,1
31080.0,2020-02-24,"(399.016, 646.0]",1,9,-8
31080.0,2020-02-24,"(892.0, 1138.0]",2,1,1
31080.0,2020-02-24,"(1138.0, 1384.0]",3,2,1
31081.0,2020-02-24,"(475.306, 649.5]",1,2,-1
31081.0,2020-02-24,"(649.5, 823.0]",1,1,0
31081.0,2020-02-24,"(823.0, 996.5]",1,3,-2
31082.0,2020-02-24,"(515.344, 680.0]",1,1,0
31082.0,2020-02-24,"(680.0, 844.0]",1,1,0
31082.0,2020-02-24,"(1008.0, 1172.0]",1,1,0
31083.0,2020-02-24,"(925.5, 1075.25]",1,3,-2
31083.0,2020-02-24,"(1075.25, 1225.0]",2,1,1
31084.0,2020-02-24,"(294.915, 567.25]",3,3,0
31084.0,2020-02-24,"(567.25, 838.5]",3,5,-2
31084.0,2020-02-24,"(838.5, 1109.75]",1,5,-4
31084.0,2020-02-24,"(1109.75, 1381.0]",1,5,-4
31085.0,2020-02-24,"(402.261, 587.75]",1,3,-2
31085.0,2020-02-24,"(957.25, 1142.0]",2,2,0
31086.0,2020-02-24,"(913.75, 1079.0]",2,1,1
31087.0,2020-02-24,"(684.0, 917.0]",1,3,-2
31087.0,2020-02-24,"(917.0, 1150.0]",1,2,-1
31087.0,2020-02-24,"(1150.0, 1383.0]",2,1,1
31088.0,2020-02-24,"(824.5, 1041.25]",2,4,-2
31088.0,2020-02-24,"(1041.25, 1258.0]",5,2,3
31089.0,2020-02-24,"(410.022, 655.5]",5,12,-7
31089.0,2020-02-24,"(900.0, 1144.5]",6,2,4
31089.0,2020-02-24,"(1144.5, 1389.0]",2,25,-23
31090.0,2020-02-24,"(585.5, 750.0]",1,2,-1
31090.0,2020-02-24,"(914.5, 1079.0]",5,2,3
31091.0,2020-02-24,"(641.75, 875.5]",2,5,-3
31091.0,2020-02-24,"(875.5, 1109.25]",3,2,1
31091.0,2020-02-24,"(1109.25, 1343.0]",3,3,0
31092.0,2020-02-24,"(899.0, 1113.0]",2,2,0
31092.0,2020-02-24,"(1113.0, 1327.0]",3,3,0
31093.0,2020-02-24,"(1138.5, 1346.0]",1,3,-2
31094.0,2020-02-24,"(590.5, 607.0]",1,1,0
,,,,2.0,
31096.0,2020-02-24,"(677.0, 813.0]",1,2,-1
31096.0,2020-02-24,"(949.0, 1085.0]",2,1,1
31097.0,2020-02-24,"(477.367, 636.25]",5,7,-2
31097.0,2020-02-24,"(636.25, 794.5]",2,3,-1
31097.0,2020-02-24,"(794.5, 952.75]",1,3,-2
31098.0,2020-02-24,"(437.104, 662.0]",5,10,-5
31098.0,2020-02-24,"(886.0, 1110.0]",8,1,7
31098.0,2020-02-24,"(1110.0, 1334.0]",3,11,-8
31099.0,2020-02-24,"(479.401, 629.75]",1,2,-1
31099.0,2020-02-24,"(929.25, 1079.0]",1,1,0
31100.0,2020-02-24,"(434.218, 630.5]",7,7,0
31100.0,2020-02-24,"(826.0, 1021.5]",2,6,-4
31100.0,2020-02-24,"(1021.5, 1217.0]",5,22,-17
31101.0,2020-02-24,"(5.634, 348.5]",1,2,-1
31101.0,2020-02-24,"(348.5, 690.0]",7,43,-36
31101.0,2020-02-24,"(690.0, 1031.5]",22,34,-12
31101.0,2020-02-24,"(1031.5, 1373.0]",40,61,-21
31102.0,2020-02-24,"(362.94, 629.0]",1,23,-22
31102.0,2020-02-24,"(629.0, 894.0]",1,1,0
31102.0,2020-02-24,"(894.0, 1159.0]",8,12,-4
31102.0,2020-02-24,"(1159.0, 1424.0]",9,13,-4
31103.0,2020-02-24,"(847.0, 1093.5]",8,24,-16
31103.0,2020-02-24,"(1093.5, 1340.0]",8,8,0
31104.0,2020-02-24,"(360.961, 621.75]",3,14,-11
31104.0,2020-02-24,"(621.75, 881.5]",8,15,-7
31104.0,2020-02-24,"(881.5, 1141.25]",18,30,-12
31104.0,2020-02-24,"(1141.25, 1401.0]",2,7,-5
31105.0,2020-02-24,"(349.985, 604.75]",2,14,-12
31105.0,2020-02-24,"(604.75, 858.5]",1,7,-6
31105.0,2020-02-24,"(858.5, 1112.25]",4,7,-3
31105.0,2020-02-24,"(1112.25, 1366.0]",4,7,-3
31106.0,2020-02-24,"(868.75, 1136.0]",1,1,0
31107.0,2020-02-24,"(300.001, 550.75]",3,21,-18
31107.0,2020-02-24,"(550.75, 800.5]",4,11,-7
31107.0,2020-02-24,"(800.5, 1050.25]",6,10,-4
31107.0,2020-02-24,"(1050.25, 1300.0]",18,31,-13
31108.0,2020-02-24,"(342.957, 604.75]",12,33,-21
31108.0,2020-02-24,"(604.75, 865.5]",10,20,-10
31108.0,2020-02-24,"(865.5, 1126.25]",30,47,-17
31108.0,2020-02-24,"(1126.25, 1387.0]",4,8,-4
31109.0,2020-02-24,"(351.989, 605.75]",4,15,-11
31109.0,2020-02-24,"(605.75, 858.5]",3,5,-2
31109.0,2020-02-24,"(858.5, 1111.25]",20,27,-7
31109.0,2020-02-24,"(1111.25, 1364.0]",7,13,-6
31110.0,2020-02-24,"(57.673, 390.75]",4,4,0
31110.0,2020-02-24,"(390.75, 722.5]",18,42,-24
31110.0,2020-02-24,"(722.5, 1054.25]",10,21,-11
31110.0,2020-02-24,"(1054.25, 1386.0]",21,34,-13
31111.0,2020-02-24,"(335.008, 584.0]",10,24,-14
31111.0,2020-02-24,"(584.0, 832.0]",5,15,-10
31111.0,2020-02-24,"(832.0, 1080.0]",10,14,-4
31111.0,2020-02-24,"(1080.0, 1328.0]",9,12,-3
31112.0,2020-02-24,"(696.75, 849.5]",2,1,1
31112.0,2020-02-24,"(1002.25, 1155.0]",1,3,-2
31113.0,2020-02-24,"(591.75, 867.5]",2,10,-8
31113.0,2020-02-24,"(867.5, 1143.25]",12,12,0
31113.0,2020-02-24,"(1143.25, 1419.0]",4,22,-18
31114.0,2020-02-24,"(11.626, 356.5]",2,2,0
31114.0,2020-02-24,"(356.5, 700.0]",1,31,-30
31114.0,2020-02-24,"(700.0, 1043.5]",10,18,-8
31114.0,2020-02-24,"(1043.5, 1387.0]",24,39,-15
31115.0,2020-02-24,"(584.75, 821.5]",2,12,-10
31115.0,2020-02-24,"(821.5, 1058.25]",5,10,-5
31115.0,2020-02-24,"(1058.25, 1295.0]",8,10,-2
31116.0,2020-02-24,"(358.001, 608.75]",4,22,-18
31116.0,2020-02-24,"(608.75, 858.5]",6,10,-4
31116.0,2020-02-24,"(858.5, 1108.25]",13,18,-5
31116.0,2020-02-24,"(1108.25, 1358.0]",10,16,-6
31117.0,2020-02-24,"(307.994, 560.5]",1,5,-4
31117.0,2020-02-24,"(560.5, 812.0]",3,14,-11
31117.0,2020-02-24,"(812.0, 1063.5]",7,14,-7
31117.0,2020-02-24,"(1063.5, 1315.0]",15,29,-14
31118.0,2020-02-24,"(341.5, 679.0]",1,1,0
31118.0,2020-02-24,"(679.0, 1016.5]",3,10,-7
31118.0,2020-02-24,"(1016.5, 1354.0]",16,4,12
31119.0,2020-02-24,"(55.771, 364.25]",1,3,-2
31119.0,2020-02-24,"(364.25, 671.5]",3,11,-8
31119.0,2020-02-24,"(671.5, 978.75]",3,5,-2
31119.0,2020-02-24,"(978.75, 1286.0]",21,29,-8
31120.0,2020-02-24,"(673.0, 917.0]",3,8,-5
31120.0,2020-02-24,"(917.0, 1161.0]",7,5,2
31120.0,2020-02-24,"(1161.0, 1405.0]",8,10,-2
31121.0,2020-02-24,"(355.971, 614.25]",14,21,-7
31121.0,2020-02-24,"(614.25, 871.5]",1,4,-3
31121.0,2020-02-24,"(871.5, 1128.75]",5,12,-7
31121.0,2020-02-24,"(1128.75, 1386.0]",5,8,-3
31122.0,2020-02-24,"(431.051, 669.25]",2,12,-10
31122.0,2020-02-24,"(669.25, 906.5]",3,5,-2
31122.0,2020-02-24,"(906.5, 1143.75]",8,10,-2
31122.0,2020-02-24,"(1143.75, 1381.0]",2,7,-5
31123.0,2020-02-24,"(357.024, 602.0]",1,8,-7
31123.0,2020-02-24,"(846.0, 1090.0]",5,7,-2
31123.0,2020-02-24,"(1090.0, 1334.0]",3,7,-4
31124.0,2020-02-24,"(306.914, 579.5]",14,37,-23
31124.0,2020-02-24,"(579.5, 851.0]",4,22,-18
31124.0,2020-02-24,"(851.0, 1122.5]",17,38,-21
31124.0,2020-02-24,"(1122.5, 1394.0]",9,29,-20
31125.0,2020-02-24,"(40.743, 356.25]",1,3,-2
31125.0,2020-02-24,"(356.25, 670.5]",6,26,-20
31125.0,2020-02-24,"(670.5, 984.75]",6,18,-12
31125.0,2020-02-24,"(984.75, 1299.0]",38,51,-13
31126.0,2020-02-24,"(302.987, 557.25]",3,24,-21
31126.0,2020-02-24,"(557.25, 810.5]",3,5,-2
31126.0,2020-02-24,"(810.5, 1063.75]",7,10,-3
31126.0,2020-02-24,"(1063.75, 1317.0]",17,21,-4
31127.0,2020-02-24,"(369.0, 725.0]",10,1,9
31127.0,2020-02-24,"(725.0, 1081.0]",15,17,-2
31127.0,2020-02-24,"(1081.0, 1437.0]",5,33,-28
31128.0,2020-02-24,"(357.925, 627.75]",24,34,-10
31128.0,2020-02-24,"(627.75, 896.5]",25,41,-16
31128.0,2020-02-24,"(896.5, 1165.25]",10,22,-12
31128.0,2020-02-24,"(1165.25, 1434.0]",6,15,-9
31129.0,2020-02-24,"(424.077, 655.75]",15,16,-1
31129.0,2020-02-24,"(655.75, 886.5]",4,9,-5
31129.0,2020-02-24,"(886.5, 1117.25]",14,22,-8
31129.0,2020-02-24,"(1117.25, 1348.0]",5,10,-5
31130.0,2020-02-24,"(44.753, 357.75]",1,2,-1
31130.0,2020-02-24,"(357.75, 669.5]",1,11,-10
31130.0,2020-02-24,"(669.5, 981.25]",3,6,-3
31130.0,2020-02-24,"(981.25, 1293.0]",14,20,-6
31131.0,2020-02-24,"(20.613, 368.75]",1,1,0
31131.0,2020-02-24,"(368.75, 715.5]",1,12,-11
31131.0,2020-02-24,"(715.5, 1062.25]",3,10,-7
31131.0,2020-02-24,"(1062.25, 1409.0]",4,6,-2
31200.0,2020-02-24,"(358.983, 614.25]",24,33,-9
31200.0,2020-02-24,"(614.25, 868.5]",12,21,-9
31200.0,2020-02-24,"(868.5, 1122.75]",19,44,-25
31200.0,2020-02-24,"(1122.75, 1377.0]",13,33,-20
31201.0,2020-02-24,"(408.011, 656.25]",15,44,-29
31201.0,2020-02-24,"(656.25, 903.5]",18,30,-12
31201.0,2020-02-24,"(903.5, 1150.75]",36,63,-27
31201.0,2020-02-24,"(1150.75, 1398.0]",8,27,-19
,,,,2.0,
31203.0,2020-02-24,"(61.666, 396.5]",1,3,-2
31203.0,2020-02-24,"(396.5, 730.0]",15,38,-23
31203.0,2020-02-24,"(730.0, 1063.5]",23,39,-16
31203.0,2020-02-24,"(1063.5, 1397.0]",13,28,-15
31204.0,2020-02-24,"(439.006, 688.5]",14,17,-3
31204.0,2020-02-24,"(688.5, 937.0]",6,16,-10
31204.0,2020-02-24,"(937.0, 1185.5]",12,31,-19
31204.0,2020-02-24,"(1185.5, 1434.0]",4,6,-2
31205.0,2020-02-24,"(320.883, 601.25]",25,28,-3
31205.0,2020-02-24,"(601.25, 880.5]",13,22,-9
31205.0,2020-02-24,"(880.5, 1159.75]",12,36,-24
31205.0,2020-02-24,"(1159.75, 1439.0]",6,21,-15
31206.0,2020-02-24,"(422.334, 589.5]",5,5,0
31206.0,2020-02-24,"(756.0, 922.5]",1,1,0
31206.0,2020-02-24,"(922.5, 1089.0]",3,3,0
31207.0,2020-02-24,"(487.147, 701.25]",1,8,-7
31207.0,2020-02-24,"(914.5, 1127.75]",4,5,-1
31207.0,2020-02-24,"(1127.75, 1341.0]",2,3,-1
31208.0,2020-02-24,"(357.124, 577.0]",4,6,-2
31208.0,2020-02-24,"(796.0, 1015.0]",3,2,1
31208.0,2020-02-24,"(1015.0, 1234.0]",8,15,-7
31209.0,2020-02-24,"(455.351, 618.25]",1,2,-1
31209.0,2020-02-24,"(618.25, 780.5]",1,2,-1
31209.0,2020-02-24,"(942.75, 1105.0]",2,4,-2
31211.0,2020-02-24,"(403.039, 644.25]",2,4,-2
31211.0,2020-02-24,"(644.25, 884.5]",1,5,-4
31211.0,2020-02-24,"(884.5, 1124.75]",7,14,-7
31211.0,2020-02-24,"(1124.75, 1365.0]",1,4,-3
31212.0,2020-02-24,"(375.75, 717.5]",33,1,32
31212.0,2020-02-24,"(717.5, 1059.25]",9,45,-36
31212.0,2020-02-24,"(1059.25, 1401.0]",16,20,-4
31213.0,2020-02-24,"(230.834, 523.5]",21,32,-11
31213.0,2020-02-24,"(523.5, 815.0]",6,11,-5
31213.0,2020-02-24,"(815.0, 1106.5]",18,37,-19
31213.0,2020-02-24,"(1106.5, 1398.0]",5,13,-8
31214.0,2020-02-24,"(12.707, 337.25]",1,1,0
31214.0,2020-02-24,"(337.25, 660.5]",6,28,-22
31214.0,2020-02-24,"(660.5, 983.75]",8,15,-7
31214.0,2020-02-24,"(983.75, 1307.0]",31,46,-15
31215.0,2020-02-24,"(320.996, 573.0]",1,1,0
31215.0,2020-02-24,"(573.0, 824.0]",7,14,-7
31215.0,2020-02-24,"(824.0, 1075.0]",6,13,-7
31215.0,2020-02-24,"(1075.0, 1326.0]",12,20,-8
31216.0,2020-02-24,"(446.113, 668.75]",9,9,0
31216.0,2020-02-24,"(668.75, 890.5]",3,7,-4
31216.0,2020-02-24,"(890.5, 1112.25]",4,16,-12
31216.0,2020-02-24,"(1112.25, 1334.0]",1,15,-14
31217.0,2020-02-24,"(364.254, 551.5]",2,3,-1
31217.0,2020-02-24,"(551.5, 738.0]",1,2,-1
31217.0,2020-02-24,"(924.5, 1111.0]",1,2,-1
31218.0,2020-02-24,"(323.187, 527.25]",9,27,-18
31218.0,2020-02-24,"(527.25, 730.5]",13,16,-3
31218.0,2020-02-24,"(730.5, 933.75]",1,2,-1
31218.0,2020-02-24,"(933.75, 1137.0]",7,18,-11
31219.0,2020-02-24,"(376.241, 566.75]",12,13,-1
31219.0,2020-02-24,"(566.75, 756.5]",10,16,-6
31219.0,2020-02-24,"(756.5, 946.25]",3,8,-5
31219.0,2020-02-24,"(946.25, 1136.0]",2,9,-7
31220.0,2020-02-24,"(360.053, 597.75]",15,18,-3
31220.0,2020-02-24,"(597.75, 834.5]",2,3,-1
31220.0,2020-02-24,"(834.5, 1071.25]",3,19,-16
31221.0,2020-02-24,"(339.5, 679.0]",33,1,32
31221.0,2020-02-24,"(679.0, 1018.5]",17,38,-21
31221.0,2020-02-24,"(1018.5, 1358.0]",15,25,-10
31222.0,2020-02-24,"(321.134, 538.5]",14,16,-2
31222.0,2020-02-24,"(538.5, 755.0]",6,9,-3
31222.0,2020-02-24,"(755.0, 971.5]",4,17,-13
31222.0,2020-02-24,"(971.5, 1188.0]",4,18,-14
31223.0,2020-02-24,"(54.654, 392.5]",3,4,-1
31223.0,2020-02-24,"(392.5, 729.0]",9,31,-22
31223.0,2020-02-24,"(729.0, 1065.5]",12,25,-13
31223.0,2020-02-24,"(1065.5, 1402.0]",13,24,-11
31224.0,2020-02-24,"(472.219, 668.25]",14,21,-7
31224.0,2020-02-24,"(668.25, 863.5]",3,4,-1
31224.0,2020-02-24,"(863.5, 1058.75]",3,9,-6
31224.0,2020-02-24,"(1058.75, 1254.0]",5,15,-10
31225.0,2020-02-24,"(326.918, 598.5]",3,5,-2
31225.0,2020-02-24,"(869.0, 1139.5]",4,15,-11
31225.0,2020-02-24,"(1139.5, 1410.0]",8,10,-2
31226.0,2020-02-24,"(315.036, 557.0]",2,7,-5
31226.0,2020-02-24,"(557.0, 798.0]",5,8,-3
31226.0,2020-02-24,"(798.0, 1039.0]",3,9,-6
31226.0,2020-02-24,"(1039.0, 1280.0]",9,14,-5
31227.0,2020-02-24,"(292.942, 558.5]",18,18,0
31227.0,2020-02-24,"(558.5, 823.0]",5,14,-9
31227.0,2020-02-24,"(823.0, 1087.5]",9,22,-13
31227.0,2020-02-24,"(1087.5, 1352.0]",2,11,-9
31228.0,2020-02-24,"(313.984, 569.0]",13,16,-3
31228.0,2020-02-24,"(569.0, 823.0]",11,17,-6
31228.0,2020-02-24,"(823.0, 1077.0]",16,35,-19
31228.0,2020-02-24,"(1077.0, 1331.0]",12,34,-22
31229.0,2020-02-24,"(3.574, 361.5]",2,4,-2
31229.0,2020-02-24,"(361.5, 718.0]",13,61,-48
31229.0,2020-02-24,"(718.0, 1074.5]",28,47,-19
31229.0,2020-02-24,"(1074.5, 1431.0]",21,40,-19
31230.0,2020-02-24,"(353.96, 615.0]",60,65,-5
31230.0,2020-02-24,"(615.0, 875.0]",17,24,-7
31230.0,2020-02-24,"(875.0, 1135.0]",10,42,-32
31230.0,2020-02-24,"(1135.0, 1395.0]",3,9,-6
31231.0,2020-02-24,"(333.116, 555.0]",15,17,-2
31231.0,2020-02-24,"(555.0, 776.0]",3,8,-5
31231.0,2020-02-24,"(776.0, 997.0]",5,13,-8
31231.0,2020-02-24,"(997.0, 1218.0]",5,23,-18
31232.0,2020-02-24,"(221.786, 526.5]",9,14,-5
31232.0,2020-02-24,"(526.5, 830.0]",29,35,-6
31232.0,2020-02-24,"(830.0, 1133.5]",22,41,-19
31232.0,2020-02-24,"(1133.5, 1437.0]",4,16,-12
31233.0,2020-02-24,"(374.956, 637.0]",45,55,-10
31233.0,2020-02-24,"(637.0, 898.0]",21,25,-4
31233.0,2020-02-24,"(898.0, 1159.0]",18,45,-27
31233.0,2020-02-24,"(1159.0, 1420.0]",6,15,-9
31234.0,2020-02-24,"(37.691, 366.25]",1,2,-1
31234.0,2020-02-24,"(366.25, 693.5]",25,39,-14
31234.0,2020-02-24,"(693.5, 1020.75]",12,22,-10
31234.0,2020-02-24,"(1020.75, 1348.0]",16,34,-18
31235.0,2020-02-24,"(420.263, 605.25]",21,22,-1
31235.0,2020-02-24,"(605.25, 789.5]",2,2,0
31235.0,2020-02-24,"(789.5, 973.75]",3,3,0
31235.0,2020-02-24,"(973.75, 1158.0]",1,4,-3
31236.0,2020-02-24,"(380.0, 732.0]",16,1,15
31236.0,2020-02-24,"(732.0, 1084.0]",13,20,-7
31236.0,2020-02-24,"(1084.0, 1436.0]",14,35,-21
31237.0,2020-02-24,"(405.02, 651.0]",9,18,-9
31237.0,2020-02-24,"(651.0, 896.0]",7,14,-7
31237.0,2020-02-24,"(896.0, 1141.0]",13,28,-15
31237.0,2020-02-24,"(1141.0, 1386.0]",10,18,-8
31238.0,2020-02-24,"(59.757, 371.75]",2,3,-1
31238.0,2020-02-24,"(371.75, 682.5]",5,10,-5
31238.0,2020-02-24,"(682.5, 993.25]",2,9,-7
31238.0,2020-02-24,"(993.25, 1304.0]",5,23,-18
31239.0,2020-02-24,"(388.951, 652.25]",16,18,-2
31239.0,2020-02-24,"(652.25, 914.5]",11,19,-8
31239.0,2020-02-24,"(914.5, 1176.75]",10,37,-27
31239.0,2020-02-24,"(1176.75, 1439.0]",3,6,-3
31240.0,2020-02-24,"(589.353, 751.75]",6,7,-1
31240.0,2020-02-24,"(751.75, 913.5]",3,6,-3
31240.0,2020-02-24,"(1075.25, 1237.0]",1,2,-1
31241.0,2020-02-24,"(14.652, 353.0]",1,2,-1
31241.0,2020-02-24,"(353.0, 690.0]",39,68,-29
31241.0,2020-02-24,"(690.0, 1027.0]",8,21,-13
31241.0,2020-02-24,"(1027.0, 1364.0]",20,41,-21
31242.0,2020-02-24,"(416.065, 650.75]",15,18,-3
31242.0,2020-02-24,"(650.75, 884.5]",16,26,-10
31242.0,2020-02-24,"(884.5, 1118.25]",6,32,-26
31242.0,2020-02-24,"(1118.25, 1352.0]",6,16,-10
31243.0,2020-02-24,"(359.084, 589.0]",27,32,-5
31243.0,2020-02-24,"(589.0, 818.0]",1,2,-1
31243.0,2020-02-24,"(818.0, 1047.0]",13,27,-14
31243.0,2020-02-24,"(1047.0, 1276.0]",5,22,-17
31244.0,2020-02-24,"(457.11, 680.5]",9,19,-10
31244.0,2020-02-24,"(680.5, 903.0]",4,11,-7
31244.0,2020-02-24,"(903.0, 1125.5]",6,15,-9
31244.0,2020-02-24,"(1125.5, 1348.0]",9,14,-5
31245.0,2020-02-24,"(391.996, 644.0]",6,18,-12
31245.0,2020-02-24,"(644.0, 895.0]",5,12,-7
31245.0,2020-02-24,"(895.0, 1146.0]",18,27,-9
31245.0,2020-02-24,"(1146.0, 1397.0]",8,14,-6
31246.0,2020-02-24,"(3.648, 343.0]",1,2,-1
31246.0,2020-02-24,"(343.0, 681.0]",9,15,-6
31246.0,2020-02-24,"(681.0, 1019.0]",3,8,-5
31246.0,2020-02-24,"(1019.0, 1357.0]",10,18,-8
31247.0,2020-02-24,"(368.938, 635.5]",15,17,-2
31247.0,2020-02-24,"(635.5, 901.0]",16,37,-21
31247.0,2020-02-24,"(901.0, 1166.5]",21,43,-22
31247.0,2020-02-24,"(1166.5, 1432.0]",4,11,-7
31248.0,2020-02-24,"(356.995, 609.25]",16,24,-8
31248.0,2020-02-24,"(609.25, 860.5]",14,31,-17
31248.0,2020-02-24,"(860.5, 1111.75]",22,44,-22
31248.0,2020-02-24,"(1111.75, 1363.0]",5,15,-10
31249.0,2020-02-24,"(440.198, 641.5]",4,8,-4
31249.0,2020-02-24,"(641.5, 842.0]",7,18,-11
31249.0,2020-02-24,"(842.0, 1042.5]",9,16,-7
31249.0,2020-02-24,"(1042.5, 1243.0]",6,11,-5
31250.0,2020-02-24,"(416.026, 660.5]",6,12,-6
31250.0,2020-02-24,"(660.5, 904.0]",3,5,-2
31250.0,2020-02-24,"(904.0, 1147.5]",10,22,-12
31250.0,2020-02-24,"(1147.5, 1391.0]",1,8,-7
31251.0,2020-02-24,"(360.021, 605.75]",15,23,-8
31251.0,2020-02-24,"(605.75, 850.5]",7,18,-11
31251.0,2020-02-24,"(850.5, 1095.25]",5,16,-11
31251.0,2020-02-24,"(1095.25, 1340.0]",11,17,-6
31252.0,2020-02-24,"(435.06, 671.0]",6,8,-2
31252.0,2020-02-24,"(671.0, 906.0]",4,7,-3
31252.0,2020-02-24,"(906.0, 1141.0]",1,17,-16
31252.0,2020-02-24,"(1141.0, 1376.0]",4,12,-8
31253.0,2020-02-24,"(405.006, 654.5]",17,20,-3
31253.0,2020-02-24,"(654.5, 903.0]",3,6,-3
31253.0,2020-02-24,"(1151.5, 1400.0]",2,13,-11
31254.0,2020-02-24,"(367.992, 621.0]",31,36,-5
31254.0,2020-02-24,"(621.0, 873.0]",5,12,-7
31254.0,2020-02-24,"(873.0, 1125.0]",5,26,-21
31254.0,2020-02-24,"(1125.0, 1377.0]",1,7,-6
31255.0,2020-02-24,"(450.133, 667.75]",19,23,-4
31255.0,2020-02-24,"(667.75, 884.5]",4,8,-4
31255.0,2020-02-24,"(884.5, 1101.25]",13,27,-14
31255.0,2020-02-24,"(1101.25, 1318.0]",5,9,-4
31256.0,2020-02-24,"(324.975, 582.25]",14,15,-1
31256.0,2020-02-24,"(582.25, 838.5]",2,2,0
31256.0,2020-02-24,"(838.5, 1094.75]",11,24,-13
31256.0,2020-02-24,"(1094.75, 1351.0]",1,10,-9
31257.0,2020-02-24,"(417.047, 656.25]",11,22,-11
31257.0,2020-02-24,"(656.25, 894.5]",5,10,-5
31257.0,2020-02-24,"(894.5, 1132.75]",9,28,-19
31257.0,2020-02-24,"(1132.75, 1371.0]",10,22,-12
31258.0,2020-02-24,"(450.011, 698.25]",18,37,-19
31258.0,2020-02-24,"(698.25, 945.5]",20,40,-20
31258.0,2020-02-24,"(945.5, 1192.75]",9,17,-8
31258.0,2020-02-24,"(1192.75, 1440.0]",8,9,-1
31259.0,2020-02-24,"(473.329, 641.75]",9,9,0
31259.0,2020-02-24,"(641.75, 809.5]",1,2,-1
31259.0,2020-02-24,"(977.25, 1145.0]",2,1,1
31260.0,2020-02-24,"(320.958, 582.5]",6,8,-2
31260.0,2020-02-24,"(582.5, 843.0]",8,13,-5
31260.0,2020-02-24,"(843.0, 1103.5]",3,15,-12
31260.0,2020-02-24,"(1103.5, 1364.0]",2,10,-8
31261.0,2020-02-24,"(387.122, 607.5]",14,14,0
31261.0,2020-02-24,"(607.5, 827.0]",1,2,-1
31261.0,2020-02-24,"(827.0, 1046.5]",1,5,-4
31262.0,2020-02-24,"(268.981, 524.75]",5,5,0
31262.0,2020-02-24,"(524.75, 779.5]",4,5,-1
31262.0,2020-02-24,"(779.5, 1034.25]",1,2,-1
31262.0,2020-02-24,"(1034.25, 1289.0]",1,16,-15
31263.0,2020-02-24,"(366.943, 632.25]",27,34,-7
31263.0,2020-02-24,"(632.25, 896.5]",6,16,-10
31263.0,2020-02-24,"(896.5, 1160.75]",10,32,-22
31263.0,2020-02-24,"(1160.75, 1425.0]",8,15,-7
31264.0,2020-02-24,"(396.236, 588.0]",8,11,-3
31264.0,2020-02-24,"(588.0, 779.0]",2,3,-1
31264.0,2020-02-24,"(779.0, 970.0]",1,4,-3
31264.0,2020-02-24,"(970.0, 1161.0]",8,17,-9
31265.0,2020-02-24,"(71.689, 400.75]",1,4,-3
31265.0,2020-02-24,"(400.75, 728.5]",17,41,-24
31265.0,2020-02-24,"(728.5, 1056.25]",18,33,-15
31265.0,2020-02-24,"(1056.25, 1384.0]",27,40,-13
31266.0,2020-02-24,"(375.943, 641.25]",8,29,-21
31266.0,2020-02-24,"(641.25, 905.5]",10,17,-7
31266.0,2020-02-24,"(905.5, 1169.75]",22,41,-19
31266.0,2020-02-24,"(1169.75, 1434.0]",12,16,-4
31267.0,2020-02-24,"(417.017, 663.75]",27,47,-20
31267.0,2020-02-24,"(663.75, 909.5]",11,19,-8
31267.0,2020-02-24,"(909.5, 1155.25]",9,21,-12
31267.0,2020-02-24,"(1155.25, 1401.0]",9,16,-7
31268.0,2020-02-24,"(327.039, 568.25]",13,32,-19
31268.0,2020-02-24,"(568.25, 808.5]",2,12,-10
31268.0,2020-02-24,"(808.5, 1048.75]",9,12,-3
31268.0,2020-02-24,"(1048.75, 1289.0]",21,32,-11
31269.0,2020-02-24,"(348.98, 605.0]",9,18,-9
31269.0,2020-02-24,"(605.0, 860.0]",14,22,-8
31269.0,2020-02-24,"(860.0, 1115.0]",5,12,-7
31269.0,2020-02-24,"(1115.0, 1370.0]",3,8,-5
31270.0,2020-02-24,"(325.921, 596.75]",17,22,-5
31270.0,2020-02-24,"(596.75, 866.5]",3,7,-4
31270.0,2020-02-24,"(866.5, 1136.25]",7,15,-8
31270.0,2020-02-24,"(1136.25, 1406.0]",2,4,-2
31271.0,2020-02-24,"(367.187, 571.25]",13,18,-5
31271.0,2020-02-24,"(571.25, 774.5]",10,13,-3
31271.0,2020-02-24,"(774.5, 977.75]",6,14,-8
31271.0,2020-02-24,"(977.75, 1181.0]",6,15,-9
31272.0,2020-02-24,"(289.062, 524.5]",5,7,-2
31272.0,2020-02-24,"(524.5, 759.0]",12,15,-3
31272.0,2020-02-24,"(759.0, 993.5]",9,20,-11
31272.0,2020-02-24,"(993.5, 1228.0]",3,27,-24
31273.0,2020-02-24,"(373.137, 589.75]",3,5,-2
31273.0,2020-02-24,"(589.75, 805.5]",2,8,-6
31273.0,2020-02-24,"(805.5, 1021.25]",4,6,-2
31273.0,2020-02-24,"(1021.25, 1237.0]",1,2,-1
31274.0,2020-02-24,"(393.118, 614.5]",16,18,-2
31274.0,2020-02-24,"(614.5, 835.0]",3,6,-3
31274.0,2020-02-24,"(835.0, 1055.5]",6,15,-9
31274.0,2020-02-24,"(1055.5, 1276.0]",6,16,-10
31275.0,2020-02-24,"(330.978, 587.5]",15,23,-8
31275.0,2020-02-24,"(587.5, 843.0]",3,6,-3
31275.0,2020-02-24,"(843.0, 1098.5]",13,31,-18
31275.0,2020-02-24,"(1098.5, 1354.0]",11,16,-5
31276.0,2020-02-24,"(417.026, 661.5]",7,9,-2
31276.0,2020-02-24,"(905.0, 1148.5]",6,1,5
31276.0,2020-02-24,"(1148.5, 1392.0]",1,30,-29
31277.0,2020-02-24,"(412.095, 639.25]",45,51,-6
31277.0,2020-02-24,"(639.25, 865.5]",3,6,-3
31277.0,2020-02-24,"(865.5, 1091.75]",10,34,-24
31277.0,2020-02-24,"(1091.75, 1318.0]",3,15,-12
31278.0,2020-02-24,"(365.25, 682.5]",6,2,4
31278.0,2020-02-24,"(682.5, 999.75]",4,24,-20
31278.0,2020-02-24,"(999.75, 1317.0]",30,12,18
31279.0,2020-02-24,"(420.05, 658.5]",20,22,-2
31279.0,2020-02-24,"(658.5, 896.0]",8,17,-9
31279.0,2020-02-24,"(896.0, 1133.5]",9,32,-23
31279.0,2020-02-24,"(1133.5, 1371.0]",2,8,-6
31280.0,2020-02-24,"(355.041, 595.75]",8,23,-15
31280.0,2020-02-24,"(595.75, 835.5]",2,4,-2
31280.0,2020-02-24,"(835.5, 1075.25]",7,11,-4
31280.0,2020-02-24,"(1075.25, 1315.0]",21,25,-4
31000.0,2020-02-25,"(897.793, 949.75]",1,1,0
31000.0,2020-02-25,"(1053.25, 1105.0]",1,2,-1
31001.0,2020-02-25,"(918.0, 1116.5]",3,1,2
31001.0,2020-02-25,"(1116.5, 1315.0]",2,4,-2
31002.0,2020-02-25,"(384.015, 631.25]",1,4,-3
31002.0,2020-02-25,"(877.5, 1123.75]",3,1,2
31003.0,2020-02-25,"(484.342, 649.5]",1,1,0
31003.0,2020-02-25,"(649.5, 814.0]",2,3,-1
31003.0,2020-02-25,"(814.0, 978.5]",1,2,-1
31003.0,2020-02-25,"(978.5, 1143.0]",4,6,-2
31004.0,2020-02-25,"(699.75, 933.0]",1,1,0
31005.0,2020-02-25,"(780.604, 880.0]",1,2,-1
31005.0,2020-02-25,"(880.0, 979.0]",2,3,-1
31005.0,2020-02-25,"(1078.0, 1177.0]",2,3,-1
31006.0,2020-02-25,"(1005.0, 1159.0]",2,1,1
31007.0,2020-02-25,"(460.05, 698.5]",2,7,-5
31007.0,2020-02-25,"(698.5, 936.0]",1,5,-4
31007.0,2020-02-25,"(936.0, 1173.5]",11,23,-12
31007.0,2020-02-25,"(1173.5, 1411.0]",2,7,-5
31009.0,2020-02-25,"(554.282, 734.5]",2,2,0
31009.0,2020-02-25,"(734.5, 914.0]",1,1,0
31009.0,2020-02-25,"(1093.5, 1273.0]",1,5,-4
31010.0,2020-02-25,"(451.216, 648.0]",1,1,0
31010.0,2020-02-25,"(648.0, 844.0]",1,1,0
31010.0,2020-02-25,"(1040.0, 1236.0]",4,1,3
31011.0,2020-02-25,"(328.057, 564.75]",4,5,-1
31011.0,2020-02-25,"(564.75, 800.5]",1,1,0
31011.0,2020-02-25,"(800.5, 1036.25]",1,2,-1
31011.0,2020-02-25,"(1036.25, 1272.0]",3,10,-7
31012.0,2020-02-25,"(387.368, 546.0]",1,1,0
31012.0,2020-02-25,"(704.0, 862.0]",1,1,0
31013.0,2020-02-25,"(836.5, 1050.25]",1,2,-1
31013.0,2020-02-25,"(1050.25, 1264.0]",2,1,1
31014.0,2020-02-25,"(175.818, 472.5]",3,4,-1
31014.0,2020-02-25,"(472.5, 768.0]",9,11,-2
31014.0,2020-02-25,"(768.0, 1063.5]",9,15,-6
31014.0,2020-02-25,"(1063.5, 1359.0]",15,24,-9
31015.0,2020-02-25,"(534.75, 774.5]",3,2,1
31015.0,2020-02-25,"(774.5, 1014.25]",3,3,0
31015.0,2020-02-25,"(1014.25, 1254.0]",4,5,-1
31016.0,2020-02-25,"(507.24, 698.0]",2,4,-2
31016.0,2020-02-25,"(698.0, 888.0]",1,3,-2
31016.0,2020-02-25,"(888.0, 1078.0]",2,3,-1
31016.0,2020-02-25,"(1078.0, 1268.0]",3,5,-2
31017.0,2020-02-25,"(506.116, 728.0]",3,5,-2
31017.0,2020-02-25,"(728.0, 949.0]",2,5,-3
31018.0,2020-02-25,"(909.75, 1043.0]",1,1,0
31019.0,2020-02-25,"(955.617, 1051.75]",1,1,0
,,,,2.0,
31021.0,2020-02-25,"(373.013, 620.75]",1,2,-1
31021.0,2020-02-25,"(620.75, 867.5]",1,3,-2
31021.0,2020-02-25,"(867.5, 1114.25]",2,4,-2
31021.0,2020-02-25,"(1114.25, 1361.0]",2,7,-5
31022.0,2020-02-25,"(739.483, 869.25]",2,2,0
31022.0,2020-02-25,"(998.5, 1127.75]",3,2,1
31023.0,2020-02-25,"(975.584, 1080.0]",1,2,-1
31024.0,2020-02-25,"(413.016, 660.0]",2,4,-2
31024.0,2020-02-25,"(906.0, 1152.0]",3,13,-10
31024.0,2020-02-25,"(1152.0, 1398.0]",2,2,0
31025.0,2020-02-25,"(1106.757, 1167.75]",3,3,0
31026.0,2020-02-25,"(409.054, 646.5]",1,3,-2
31026.0,2020-02-25,"(883.0, 1119.5]",2,7,-5
31027.0,2020-02-25,"(850.5, 1134.0]",2,1,1
31028.0,2020-02-25,"(754.397, 905.75]",1,1,0
31028.0,2020-02-25,"(905.75, 1056.5]",2,3,-1
31028.0,2020-02-25,"(1207.25, 1358.0]",1,1,0
31029.0,2020-02-25,"(815.0, 1077.0]",1,2,-1
31029.0,2020-02-25,"(1077.0, 1339.0]",6,1,5
31030.0,2020-02-25,"(932.0, 1149.0]",5,4,1
31030.0,2020-02-25,"(1149.0, 1366.0]",3,6,-3
31031.0,2020-02-25,"(980.0, 989.0]",1,1,0
31032.0,2020-02-25,"(1035.25, 1224.0]",2,2,0
31033.0,2020-02-25,"(833.25, 1111.0]",1,1,0
31034.0,2020-02-25,"(530.236, 722.0]",1,1,0
31034.0,2020-02-25,"(913.0, 1104.0]",2,1,1
31034.0,2020-02-25,"(1104.0, 1295.0]",1,6,-5
31035.0,2020-02-25,"(957.0, 1138.0]",3,1,2
31036.0,2020-02-25,"(953.0, 1086.0]",2,2,0
31037.0,2020-02-25,"(417.124, 637.0]",4,5,-1
31037.0,2020-02-25,"(637.0, 856.0]",4,6,-2
31037.0,2020-02-25,"(856.0, 1075.0]",4,11,-7
31037.0,2020-02-25,"(1075.0, 1294.0]",2,10,-8
31038.0,2020-02-25,"(912.85, 950.5]",2,2,0
31038.0,2020-02-25,"(988.0, 1025.5]",1,1,0
31039.0,2020-02-25,"(903.0, 1067.0]",7,1,6
31039.0,2020-02-25,"(1067.0, 1231.0]",1,9,-8
31040.0,2020-02-25,"(457.207, 656.25]",2,2,0
31040.0,2020-02-25,"(854.5, 1052.75]",1,3,-2
31040.0,2020-02-25,"(1052.75, 1251.0]",2,6,-4
31041.0,2020-02-25,"(585.75, 781.0]",2,1,1
31042.0,2020-02-25,"(440.145, 654.75]",3,4,-1
31042.0,2020-02-25,"(654.75, 868.5]",1,1,0
31042.0,2020-02-25,"(868.5, 1082.25]",1,6,-5
31042.0,2020-02-25,"(1082.25, 1296.0]",3,6,-3
31043.0,2020-02-25,"(913.0, 1004.0]",1,1,0
31043.0,2020-02-25,"(1004.0, 1095.0]",2,4,-2
31043.0,2020-02-25,"(1095.0, 1186.0]",4,4,0
31044.0,2020-02-25,"(517.355, 679.25]",1,2,-1
31044.0,2020-02-25,"(1001.75, 1163.0]",3,1,2
31045.0,2020-02-25,"(770.25, 891.5]",1,2,-1
31045.0,2020-02-25,"(1012.75, 1134.0]",4,1,3
31046.0,2020-02-25,"(511.5, 682.0]",1,1,0
31047.0,2020-02-25,"(357.048, 596.0]",4,5,-1
31047.0,2020-02-25,"(596.0, 834.0]",2,5,-3
31047.0,2020-02-25,"(834.0, 1072.0]",5,16,-11
31047.0,2020-02-25,"(1072.0, 1310.0]",7,20,-13
31048.0,2020-02-25,"(762.5, 952.0]",1,1,0
31048.0,2020-02-25,"(952.0, 1141.5]",1,1,0
31048.0,2020-02-25,"(1141.5, 1331.0]",2,6,-4
31049.0,2020-02-25,"(986.752, 1049.0]",1,1,0
31049.0,2020-02-25,"(1049.0, 1111.0]",1,1,0
31049.0,2020-02-25,"(1173.0, 1235.0]",1,1,0
31050.0,2020-02-25,"(1018.5, 1358.0]",2,1,1
31051.0,2020-02-25,"(833.0, 991.0]",3,1,2
31051.0,2020-02-25,"(991.0, 1149.0]",4,3,1
31052.0,2020-02-25,"(1132.788, 1186.0]",1,1,0
31052.0,2020-02-25,"(1292.0, 1345.0]",1,1,0
31053.0,2020-02-25,"(1153.75, 1225.0]",1,1,0
31054.0,2020-02-25,"(773.25, 852.5]",1,1,0
31054.0,2020-02-25,"(931.75, 1011.0]",1,1,0
31055.0,2020-02-25,"(421.231, 614.25]",1,1,0
31055.0,2020-02-25,"(806.5, 998.75]",1,1,0
31055.0,2020-02-25,"(998.75, 1191.0]",5,8,-3
31056.0,2020-02-25,"(907.473, 1039.75]",1,4,-3
31056.0,2020-02-25,"(1303.25, 1435.0]",1,1,0
,,,,2.0,
,,,,2.0,
31059.0,2020-02-25,"(638.0, 957.0]",1,1,0
31059.0,2020-02-25,"(957.0, 1276.0]",1,1,0
31060.0,2020-02-25,"(984.563, 1094.25]",1,1,0
,,,,2.0,
31062.0,2020-02-25,"(742.52, 863.0]",2,4,-2
31062.0,2020-02-25,"(983.0, 1103.0]",1,2,-1
31062.0,2020-02-25,"(1103.0, 1223.0]",2,4,-2
31063.0,2020-02-25,"(1129.86, 1165.0]",1,1,0
31064.0,2020-02-25,"(994.635, 1086.25]",7,13,-6
31064.0,2020-02-25,"(1086.25, 1177.5]",3,6,-3
31064.0,2020-02-25,"(1177.5, 1268.75]",1,2,-1
31064.0,2020-02-25,"(1268.75, 1360.0]",1,4,-3
,,,,1.0,
,,,,1.0,
31066.0,2020-02-25,"(817.25, 833.0]",1,1,0
31067.0,2020-02-25,"(827.25, 1103.0]",3,1,2
31068.0,2020-02-25,"(1029.0, 1372.0]",2,1,1
31069.0,2020-02-25,"(781.0, 1046.0]",1,1,0
31069.0,2020-02-25,"(1046.0, 1311.0]",7,2,5
31070.0,2020-02-25,"(1021.0, 1214.5]",1,2,-1
31070.0,2020-02-25,"(1214.5, 1408.0]",3,2,1
31071.0,2020-02-25,"(892.25, 1084.0]",4,1,3
,,,,2.0,
31073.0,2020-02-25,"(700.443, 840.25]",1,2,-1
31073.0,2020-02-25,"(1118.75, 1258.0]",1,1,0
31074.0,2020-02-25,"(861.0, 1148.0]",2,1,1
31075.0,2020-02-25,"(834.75, 1113.0]",1,1,0
31076.0,2020-02-25,"(1143.0, 1182.0]",1,1,0
31076.0,2020-02-25,"(1182.0, 1221.0]",1,1,0
31077.0,2020-02-25,"(549.226, 743.5]",1,2,-1
31077.0,2020-02-25,"(937.0, 1130.5]",3,1,2
31077.0,2020-02-25,"(1130.5, 1324.0]",1,4,-3
31078.0,2020-02-25,"(505.41, 653.5]",2,2,0
31078.0,2020-02-25,"(653.5, 801.0]",1,1,0
31078.0,2020-02-25,"(948.5, 1096.0]",2,5,-3
31079.0,2020-02-25,"(846.25, 1018.5]",1,3,-2
31079.0,2020-02-25,"(1018.5, 1190.75]",1,3,-2
31079.0,2020-02-25,"(1190.75, 1363.0]",4,1,3
31080.0,2020-02-25,"(397.978, 654.5]",1,6,-5
31080.0,2020-02-25,"(910.0, 1165.5]",7,12,-5
31080.0,2020-02-25,"(1165.5, 1421.0]",7,8,-1
31081.0,2020-02-25,"(758.642, 848.5]",2,3,-1
31081.0,2020-02-25,"(848.5, 938.0]",1,1,0
31081.0,2020-02-25,"(1027.5, 1117.0]",2,2,0
31082.0,2020-02-25,"(780.675, 862.25]",1,2,-1
31082.0,2020-02-25,"(862.25, 943.5]",1,1,0
31082.0,2020-02-25,"(1024.75, 1106.0]",1,1,0
31083.0,2020-02-25,"(942.0, 1018.0]",1,1,0
31083.0,2020-02-25,"(1018.0, 1094.0]",4,2,2
31084.0,2020-02-25,"(502.175, 709.25]",2,2,0
31084.0,2020-02-25,"(709.25, 915.5]",1,4,-3
31084.0,2020-02-25,"(915.5, 1121.75]",2,4,-2
31084.0,2020-02-25,"(1121.75, 1328.0]",1,5,-4
31085.0,2020-02-25,"(939.75, 1253.0]",2,1,1
31086.0,2020-02-25,"(1055.985, 1059.75]",1,2,-1
31086.0,2020-02-25,"(1067.25, 1071.0]",1,1,0
31087.0,2020-02-25,"(1003.75, 1170.0]",4,1,3
31088.0,2020-02-25,"(1071.846, 1110.5]",2,2,0
31088.0,2020-02-25,"(1149.0, 1187.5]",1,1,0
31088.0,2020-02-25,"(1187.5, 1226.0]",1,2,-1
31089.0,2020-02-25,"(264.868, 549.0]",2,3,-1
31089.0,2020-02-25,"(549.0, 832.0]",4,6,-2
31089.0,2020-02-25,"(832.0, 1115.0]",2,18,-16
31089.0,2020-02-25,"(1115.0, 1398.0]",3,9,-6
31090.0,2020-02-25,"(890.5, 1046.0]",1,2,-1
31091.0,2020-02-25,"(952.75, 1104.0]",3,2,1
31092.0,2020-02-25,"(839.75, 1026.5]",1,2,-1
31092.0,2020-02-25,"(1026.5, 1213.25]",1,2,-1
31092.0,2020-02-25,"(1213.25, 1400.0]",2,3,-1
31093.0,2020-02-25,"(961.0, 1064.0]",1,1,0
31094.0,2020-02-25,"(663.0, 884.0]",1,1,0
31095.0,2020-02-25,"(828.406, 977.5]",1,1,0
31095.0,2020-02-25,"(977.5, 1126.0]",1,2,-1
31095.0,2020-02-25,"(1274.5, 1423.0]",1,1,0
31096.0,2020-02-25,"(801.0, 1068.0]",1,1,0
31097.0,2020-02-25,"(521.355, 683.25]",1,2,-1
31097.0,2020-02-25,"(683.25, 844.5]",1,1,0
31097.0,2020-02-25,"(844.5, 1005.75]",3,5,-2
31097.0,2020-02-25,"(1005.75, 1167.0]",1,3,-2
31098.0,2020-02-25,"(433.154, 645.5]",1,3,-2
31098.0,2020-02-25,"(857.0, 1068.5]",3,2,1
31098.0,2020-02-25,"(1068.5, 1280.0]",3,7,-4
31099.0,2020-02-25,"(922.25, 1065.0]",1,1,0
31100.0,2020-02-25,"(511.422, 656.5]",5,6,-1
31100.0,2020-02-25,"(801.0, 945.5]",2,1,1
31100.0,2020-02-25,"(945.5, 1090.0]",1,2,-1
31101.0,2020-02-25,"(17.606, 367.5]",2,3,-1
31101.0,2020-02-25,"(367.5, 716.0]",4,14,-10
31101.0,2020-02-25,"(716.0, 1064.5]",19,31,-12
31101.0,2020-02-25,"(1064.5, 1413.0]",22,36,-14
31102.0,2020-02-25,"(832.5, 1065.75]",4,7,-3
31102.0,2020-02-25,"(1065.75, 1299.0]",11,2,9
31103.0,2020-02-25,"(556.148, 770.0]",1,5,-4
31103.0,2020-02-25,"(770.0, 983.0]",1,6,-5
31103.0,2020-02-25,"(983.0, 1196.0]",11,18,-7
31103.0,2020-02-25,"(1196.0, 1409.0]",5,10,-5
31104.0,2020-02-25,"(595.25, 866.5]",3,11,-8
31104.0,2020-02-25,"(866.5, 1137.75]",14,10,4
31104.0,2020-02-25,"(1137.75, 1409.0]",5,20,-15
31105.0,2020-02-25,"(347.0, 692.0]",1,2,-1
31105.0,2020-02-25,"(692.0, 1037.0]",2,5,-3
31105.0,2020-02-25,"(1037.0, 1382.0]",3,2,1
31106.0,2020-02-25,"(359.983, 615.25]",1,2,-1
31106.0,2020-02-25,"(615.25, 869.5]",2,2,0
31106.0,2020-02-25,"(869.5, 1123.75]",3,3,0
31106.0,2020-02-25,"(1123.75, 1378.0]",7,8,-1
31107.0,2020-02-25,"(692.5, 1024.75]",9,2,7
31107.0,2020-02-25,"(1024.75, 1357.0]",18,7,11
31108.0,2020-02-25,"(57.825, 352.75]",1,1,0
31108.0,2020-02-25,"(352.75, 646.5]",2,5,-3
31108.0,2020-02-25,"(646.5, 940.25]",12,20,-8
31108.0,2020-02-25,"(940.25, 1234.0]",27,44,-17
31109.0,2020-02-25,"(462.244, 652.0]",1,4,-3
31109.0,2020-02-25,"(652.0, 841.0]",4,6,-2
31109.0,2020-02-25,"(841.0, 1030.0]",9,13,-4
31109.0,2020-02-25,"(1030.0, 1219.0]",13,26,-13
31110.0,2020-02-25,"(350.946, 615.5]",7,15,-8
31110.0,2020-02-25,"(615.5, 879.0]",4,11,-7
31110.0,2020-02-25,"(879.0, 1142.5]",13,27,-14
31110.0,2020-02-25,"(1142.5, 1406.0]",16,21,-5
31111.0,2020-02-25,"(83.743, 399.25]",1,1,0
31111.0,2020-02-25,"(399.25, 713.5]",3,7,-4
31111.0,2020-02-25,"(713.5, 1027.75]",4,8,-4
31111.0,2020-02-25,"(1027.75, 1342.0]",20,31,-11
31112.0,2020-02-25,"(360.509, 483.75]",1,2,-1
31112.0,2020-02-25,"(729.25, 852.0]",1,1,0
31113.0,2020-02-25,"(313.954, 576.5]",1,9,-8
31113.0,2020-02-25,"(576.5, 838.0]",1,3,-2
31113.0,2020-02-25,"(838.0, 1099.5]",4,9,-5
31113.0,2020-02-25,"(1099.5, 1361.0]",9,16,-7
31114.0,2020-02-25,"(24.594, 377.5]",1,2,-1
31114.0,2020-02-25,"(729.0, 1080.5]",9,13,-4
31114.0,2020-02-25,"(1080.5, 1432.0]",26,17,9
31115.0,2020-02-25,"(245.856, 533.0]",1,8,-7
31115.0,2020-02-25,"(819.0, 1105.0]",6,2,4
31115.0,2020-02-25,"(1105.0, 1391.0]",12,14,-2
31116.0,2020-02-25,"(22.668, 357.0]",3,3,0
31116.0,2020-02-25,"(357.0, 690.0]",4,8,-4
31116.0,2020-02-25,"(690.0, 1023.0]",10,16,-6
31116.0,2020-02-25,"(1023.0, 1356.0]",25,37,-12
31117.0,2020-02-25,"(342.943, 608.25]",1,7,-6
31117.0,2020-02-25,"(608.25, 872.5]",4,12,-8
31117.0,2020-02-25,"(872.5, 1136.75]",11,22,-11
31117.0,2020-02-25,"(1136.75, 1401.0]",14,24,-10
31118.0,2020-02-25,"(352.997, 604.75]",2,12,-10
31118.0,2020-02-25,"(604.75, 855.5]",1,3,-2
31118.0,2020-02-25,"(855.5, 1106.25]",9,13,-4
31118.0,2020-02-25,"(1106.25, 1357.0]",6,8,-2
31119.0,2020-02-25,"(346.911, 620.25]",3,18,-15
31119.0,2020-02-25,"(620.25, 892.5]",2,3,-1
31119.0,2020-02-25,"(892.5, 1164.75]",9,20,-11
31119.0,2020-02-25,"(1164.75, 1437.0]",8,14,-6
31120.0,2020-02-25,"(14.65, 353.5]",1,1,0
31120.0,2020-02-25,"(691.0, 1028.5]",3,7,-4
31120.0,2020-02-25,"(1028.5, 1366.0]",15,7,8
31121.0,2020-02-25,"(333.917, 605.75]",11,15,-4
31121.0,2020-02-25,"(605.75, 876.5]",3,5,-2
31121.0,2020-02-25,"(876.5, 1147.25]",6,17,-11
31121.0,2020-02-25,"(1147.25, 1418.0]",11,16,-5
31122.0,2020-02-25,"(690.5, 935.0]",1,4,-3
31122.0,2020-02-25,"(935.0, 1179.5]",6,3,3
31122.0,2020-02-25,"(1179.5, 1424.0]",9,9,0
31123.0,2020-02-25,"(9.571, 368.25]",3,4,-1
31123.0,2020-02-25,"(368.25, 725.5]",1,10,-9
31123.0,2020-02-25,"(725.5, 1082.75]",2,4,-2
31123.0,2020-02-25,"(1082.75, 1440.0]",10,16,-6
31124.0,2020-02-25,"(24.639, 366.25]",4,4,0
31124.0,2020-02-25,"(366.25, 706.5]",10,20,-10
31124.0,2020-02-25,"(706.5, 1046.75]",4,17,-13
31124.0,2020-02-25,"(1046.75, 1387.0]",18,53,-35
31125.0,2020-02-25,"(354.971, 613.25]",3,16,-13
31125.0,2020-02-25,"(613.25, 870.5]",6,11,-5
31125.0,2020-02-25,"(870.5, 1127.75]",22,28,-6
31125.0,2020-02-25,"(1127.75, 1385.0]",6,13,-7
31126.0,2020-02-25,"(300.935, 568.25]",3,16,-13
31126.0,2020-02-25,"(834.5, 1100.75]",10,7,3
31126.0,2020-02-25,"(1100.75, 1367.0]",16,16,0
31127.0,2020-02-25,"(101.809, 400.75]",1,2,-1
31127.0,2020-02-25,"(400.75, 698.5]",3,4,-1
31127.0,2020-02-25,"(698.5, 996.25]",12,25,-13
31127.0,2020-02-25,"(996.25, 1294.0]",13,36,-23
31128.0,2020-02-25,"(375.945, 640.75]",13,19,-6
31128.0,2020-02-25,"(640.75, 904.5]",7,16,-9
31128.0,2020-02-25,"(904.5, 1168.25]",12,16,-4
31128.0,2020-02-25,"(1168.25, 1432.0]",2,6,-4
31129.0,2020-02-25,"(460.056, 697.0]",2,3,-1
31129.0,2020-02-25,"(697.0, 933.0]",4,8,-4
31129.0,2020-02-25,"(933.0, 1169.0]",9,15,-6
31130.0,2020-02-25,"(11.872, 295.0]",1,1,0
31130.0,2020-02-25,"(295.0, 577.0]",3,6,-3
31130.0,2020-02-25,"(577.0, 859.0]",1,3,-2
31130.0,2020-02-25,"(859.0, 1141.0]",11,16,-5
31131.0,2020-02-25,"(6.593, 359.75]",1,2,-1
31131.0,2020-02-25,"(359.75, 711.5]",1,7,-6
31131.0,2020-02-25,"(711.5, 1063.25]",1,5,-4
31131.0,2020-02-25,"(1063.25, 1415.0]",10,12,-2
31200.0,2020-02-25,"(337.903, 613.25]",10,11,-1
31200.0,2020-02-25,"(613.25, 887.5]",8,19,-11
31200.0,2020-02-25,"(887.5, 1161.75]",19,47,-28
31200.0,2020-02-25,"(1161.75, 1436.0]",7,14,-7
31201.0,2020-02-25,"(18.653, 356.75]",2,3,-1
31201.0,2020-02-25,"(356.75, 693.5]",13,26,-13
31201.0,2020-02-25,"(693.5, 1030.25]",24,46,-22
31201.0,2020-02-25,"(1030.25, 1367.0]",34,62,-28
,,,,2.0,
31203.0,2020-02-25,"(375.976, 633.0]",2,10,-8
31203.0,2020-02-25,"(633.0, 889.0]",7,11,-4
31203.0,2020-02-25,"(889.0, 1145.0]",26,38,-12
31203.0,2020-02-25,"(1145.0, 1401.0]",8,19,-11
31204.0,2020-02-25,"(12.583, 368.25]",3,3,0
31204.0,2020-02-25,"(368.25, 722.5]",4,5,-1
31204.0,2020-02-25,"(722.5, 1076.75]",9,29,-20
31204.0,2020-02-25,"(1076.75, 1431.0]",5,6,-1
31205.0,2020-02-25,"(448.107, 672.25]",6,8,-2
31205.0,2020-02-25,"(672.25, 895.5]",14,18,-4
31205.0,2020-02-25,"(895.5, 1118.75]",11,36,-25
31205.0,2020-02-25,"(1118.75, 1342.0]",5,14,-9
31206.0,2020-02-25,"(489.164, 699.0]",4,4,0
31206.0,2020-02-25,"(699.0, 908.0]",1,5,-4
31206.0,2020-02-25,"(908.0, 1117.0]",3,6,-3
31206.0,2020-02-25,"(1117.0, 1326.0]",4,8,-4
31207.0,2020-02-25,"(590.75, 847.5]",2,3,-1
31207.0,2020-02-25,"(847.5, 1104.25]",3,3,0
31207.0,2020-02-25,"(1104.25, 1361.0]",6,6,0
31208.0,2020-02-25,"(390.095, 617.25]",5,5,0
31208.0,2020-02-25,"(843.5, 1069.75]",1,1,0
31208.0,2020-02-25,"(1069.75, 1296.0]",3,16,-13
31209.0,2020-02-25,"(918.66, 1004.0]",2,2,0
31209.0,2020-02-25,"(1004.0, 1089.0]",1,1,0
31209.0,2020-02-25,"(1089.0, 1174.0]",1,4,-3
31209.0,2020-02-25,"(1174.0, 1259.0]",3,4,-1
31211.0,2020-02-25,"(51.762, 362.5]",2,2,0
31211.0,2020-02-25,"(362.5, 672.0]",1,3,-2
31211.0,2020-02-25,"(672.0, 981.5]",4,4,0
31211.0,2020-02-25,"(981.5, 1291.0]",5,14,-9
31212.0,2020-02-25,"(2.568, 362.0]",2,2,0
31212.0,2020-02-25,"(362.0, 720.0]",15,18,-3
31212.0,2020-02-25,"(720.0, 1078.0]",11,24,-13
31212.0,2020-02-25,"(1078.0, 1436.0]",13,24,-11
31213.0,2020-02-25,"(245.954, 508.5]",5,8,-3
31213.0,2020-02-25,"(508.5, 770.0]",12,22,-10
31213.0,2020-02-25,"(770.0, 1031.5]",12,24,-12
31213.0,2020-02-25,"(1031.5, 1293.0]",11,33,-22
31214.0,2020-02-25,"(364.75, 709.5]",8,4,4
31214.0,2020-02-25,"(709.5, 1054.25]",15,14,1
31214.0,2020-02-25,"(1054.25, 1399.0]",26,29,-3
31215.0,2020-02-25,"(47.791, 351.25]",1,2,-1
31215.0,2020-02-25,"(351.25, 653.5]",9,11,-2
31215.0,2020-02-25,"(653.5, 955.75]",4,4,0
31215.0,2020-02-25,"(955.75, 1258.0]",13,31,-18
31216.0,2020-02-25,"(344.157, 555.75]",5,6,-1
31216.0,2020-02-25,"(555.75, 766.5]",2,4,-2
31216.0,2020-02-25,"(766.5, 977.25]",5,9,-4
31216.0,2020-02-25,"(977.25, 1188.0]",9,25,-16
31217.0,2020-02-25,"(303.192, 506.0]",4,5,-1
31217.0,2020-02-25,"(506.0, 708.0]",1,1,0
31217.0,2020-02-25,"(708.0, 910.0]",4,8,-4
31217.0,2020-02-25,"(910.0, 1112.0]",2,12,-10
31218.0,2020-02-25,"(316.01, 564.5]",7,13,-6
31218.0,2020-02-25,"(564.5, 812.0]",1,1,0
31218.0,2020-02-25,"(812.0, 1059.5]",7,13,-6
31218.0,2020-02-25,"(1059.5, 1307.0]",5,9,-4
31219.0,2020-02-25,"(347.105, 571.75]",6,6,0
31220.0,2020-02-25,"(358.289, 536.75]",9,11,-2
31221.0,2020-02-25,"(367.25, 707.5]",6,2,4
31221.0,2020-02-25,"(707.5, 1047.75]",12,8,4
31221.0,2020-02-25,"(1047.75, 1388.0]",9,26,-17
31222.0,2020-02-25,"(492.075, 724.25]",10,10,0
31222.0,2020-02-25,"(724.25, 955.5]",1,6,-5
31222.0,2020-02-25,"(955.5, 1186.75]",2,10,-8
31222.0,2020-02-25,"(1186.75, 1418.0]",1,1,0
31223.0,2020-02-25,"(387.75, 730.5]",13,3,10
31223.0,2020-02-25,"(730.5, 1073.25]",14,20,-6
31223.0,2020-02-25,"(1073.25, 1416.0]",14,24,-10
31224.0,2020-02-25,"(22.787, 327.25]",2,4,-2
31224.0,2020-02-25,"(327.25, 630.5]",6,6,0
31224.0,2020-02-25,"(630.5, 933.75]",4,7,-3
31224.0,2020-02-25,"(933.75, 1237.0]",4,24,-20
31225.0,2020-02-25,"(421.051, 659.25]",3,5,-2
31225.0,2020-02-25,"(659.25, 896.5]",2,5,-3
31225.0,2020-02-25,"(896.5, 1133.75]",5,16,-11
31225.0,2020-02-25,"(1133.75, 1371.0]",7,8,-1
31226.0,2020-02-25,"(314.019, 560.25]",1,3,-2
31226.0,2020-02-25,"(560.25, 805.5]",2,4,-2
31226.0,2020-02-25,"(805.5, 1050.75]",4,10,-6
31226.0,2020-02-25,"(1050.75, 1296.0]",5,10,-5
31227.0,2020-02-25,"(297.167, 506.25]",4,4,0
31227.0,2020-02-25,"(506.25, 714.5]",6,7,-1
31227.0,2020-02-25,"(714.5, 922.75]",6,14,-8
31227.0,2020-02-25,"(922.75, 1131.0]",5,22,-17
31228.0,2020-02-25,"(327.921, 598.75]",7,9,-2
31228.0,2020-02-25,"(598.75, 868.5]",9,14,-5
31228.0,2020-02-25,"(868.5, 1138.25]",22,41,-19
31228.0,2020-02-25,"(1138.25, 1408.0]",12,21,-9
31229.0,2020-02-25,"(9.604, 360.0]",2,2,0
31229.0,2020-02-25,"(360.0, 709.0]",5,27,-22
31229.0,2020-02-25,"(709.0, 1058.0]",31,52,-21
31229.0,2020-02-25,"(1058.0, 1407.0]",30,53,-23
31230.0,2020-02-25,"(330.905, 605.75]",19,22,-3
31230.0,2020-02-25,"(605.75, 879.5]",7,12,-5
31230.0,2020-02-25,"(879.5, 1153.25]",9,36,-27
31230.0,2020-02-25,"(1153.25, 1427.0]",11,20,-9
31231.0,2020-02-25,"(44.837, 336.75]",1,2,-1
31231.0,2020-02-25,"(336.75, 627.5]",7,7,0
31231.0,2020-02-25,"(627.5, 918.25]",4,11,-7
31231.0,2020-02-25,"(918.25, 1209.0]",13,34,-21
31232.0,2020-02-25,"(237.864, 523.0]",6,8,-2
31232.0,2020-02-25,"(523.0, 807.0]",5,7,-2
31232.0,2020-02-25,"(807.0, 1091.0]",17,27,-10
31232.0,2020-02-25,"(1091.0, 1375.0]",6,24,-18
31233.0,2020-02-25,"(108.957, 370.75]",3,3,0
31233.0,2020-02-25,"(370.75, 631.5]",8,10,-2
31233.0,2020-02-25,"(631.5, 892.25]",2,6,-4
31233.0,2020-02-25,"(892.25, 1153.0]",16,45,-29
31234.0,2020-02-25,"(410.041, 650.75]",4,10,-6
31234.0,2020-02-25,"(650.75, 890.5]",4,9,-5
31234.0,2020-02-25,"(890.5, 1130.25]",18,26,-8
31234.0,2020-02-25,"(1130.25, 1370.0]",5,21,-16
31235.0,2020-02-25,"(531.166, 740.5]",2,2,0
31235.0,2020-02-25,"(740.5, 949.0]",1,2,-1
31235.0,2020-02-25,"(1157.5, 1366.0]",2,6,-4
31236.0,2020-02-25,"(367.0, 721.0]",5,2,3
31236.0,2020-02-25,"(721.0, 1075.0]",12,6,6
31236.0,2020-02-25,"(1075.0, 1429.0]",7,24,-17
31237.0,2020-02-25,"(343.947, 608.25]",1,7,-6
31237.0,2020-02-25,"(608.25, 871.5]",6,14,-8
31237.0,2020-02-25,"(871.5, 1134.75]",12,18,-6
31237.0,2020-02-25,"(1134.75, 1398.0]",9,18,-9
31238.0,2020-02-25,"(49.887, 329.25]",1,1,0
31238.0,2020-02-25,"(329.25, 607.5]",5,8,-3
31238.0,2020-02-25,"(607.5, 885.75]",8,13,-5
31238.0,2020-02-25,"(885.75, 1164.0]",8,32,-24
31239.0,2020-02-25,"(331.974, 589.5]",18,19,-1
31239.0,2020-02-25,"(589.5, 846.0]",5,9,-4
31239.0,2020-02-25,"(846.0, 1102.5]",7,25,-18
31239.0,2020-02-25,"(1102.5, 1359.0]",4,16,-12
31240.0,2020-02-25,"(822.5, 917.0]",3,1,2
31240.0,2020-02-25,"(1011.5, 1106.0]",7,5,2
31241.0,2020-02-25,"(38.652, 377.0]",2,3,-1
31241.0,2020-02-25,"(377.0, 714.0]",14,23,-9
31241.0,2020-02-25,"(714.0, 1051.0]",9,23,-14
31241.0,2020-02-25,"(1051.0, 1388.0]",22,51,-29
31242.0,2020-02-25,"(391.259, 577.25]",3,5,-2
31242.0,2020-02-25,"(577.25, 762.5]",10,12,-2
31242.0,2020-02-25,"(762.5, 947.75]",5,13,-8
31242.0,2020-02-25,"(947.75, 1133.0]",3,25,-22
31243.0,2020-02-25,"(387.951, 651.25]",14,14,0
31243.0,2020-02-25,"(651.25, 913.5]",2,11,-9
31243.0,2020-02-25,"(913.5, 1175.75]",12,30,-18
31243.0,2020-02-25,"(1175.75, 1438.0]",4,6,-2
31244.0,2020-02-25,"(351.927, 621.25]",6,9,-3
31244.0,2020-02-25,"(621.25, 889.5]",3,10,-7
31244.0,2020-02-25,"(889.5, 1157.75]",12,23,-11
31244.0,2020-02-25,"(1157.75, 1426.0]",2,3,-1
31245.0,2020-02-25,"(517.141, 732.75]",1,4,-3
31245.0,2020-02-25,"(732.75, 947.5]",2,2,0
31245.0,2020-02-25,"(947.5, 1162.25]",7,14,-7
31245.0,2020-02-25,"(1162.25, 1377.0]",8,16,-8
31246.0,2020-02-25,"(424.133, 641.75]",7,10,-3
31246.0,2020-02-25,"(641.75, 858.5]",4,6,-2
31246.0,2020-02-25,"(858.5, 1075.25]",5,13,-8
31246.0,2020-02-25,"(1075.25, 1292.0]",7,19,-12
31247.0,2020-02-25,"(464.213, 661.75]",3,6,-3
31247.0,2020-02-25,"(661.75, 858.5]",4,8,-4
31247.0,2020-02-25,"(858.5, 1055.25]",8,20,-12
31247.0,2020-02-25,"(1055.25, 1252.0]",6,15,-9
31248.0,2020-02-25,"(411.269, 594.75]",1,5,-4
31248.0,2020-02-25,"(594.75, 777.5]",3,3,0
31248.0,2020-02-25,"(777.5, 960.25]",5,16,-11
31248.0,2020-02-25,"(960.25, 1143.0]",10,24,-14
31249.0,2020-02-25,"(7.911, 281.25]",1,2,-1
31249.0,2020-02-25,"(281.25, 553.5]",3,5,-2
31249.0,2020-02-25,"(553.5, 825.75]",3,6,-3
31249.0,2020-02-25,"(825.75, 1098.0]",8,15,-7
31250.0,2020-02-25,"(32.784, 338.0]",1,2,-1
31250.0,2020-02-25,"(338.0, 642.0]",6,7,-1
31250.0,2020-02-25,"(642.0, 946.0]",7,11,-4
31250.0,2020-02-25,"(946.0, 1250.0]",3,24,-21
31251.0,2020-02-25,"(30.673, 363.75]",5,5,0
31251.0,2020-02-25,"(363.75, 695.5]",7,13,-6
31251.0,2020-02-25,"(695.5, 1027.25]",3,10,-7
31251.0,2020-02-25,"(1027.25, 1359.0]",16,35,-19
31252.0,2020-02-25,"(448.106, 672.5]",9,10,-1
31252.0,2020-02-25,"(672.5, 896.0]",3,7,-4
31252.0,2020-02-25,"(896.0, 1119.5]",2,19,-17
31252.0,2020-02-25,"(1119.5, 1343.0]",3,12,-9
31253.0,2020-02-25,"(505.284, 685.0]",8,9,-1
31253.0,2020-02-25,"(685.0, 864.0]",4,6,-2
31253.0,2020-02-25,"(864.0, 1043.0]",1,2,-1
31253.0,2020-02-25,"(1043.0, 1222.0]",4,18,-14
31254.0,2020-02-25,"(394.06, 630.0]",10,10,0
31254.0,2020-02-25,"(630.0, 865.0]",4,6,-2
31254.0,2020-02-25,"(865.0, 1100.0]",3,21,-18
31254.0,2020-02-25,"(1100.0, 1335.0]",3,6,-3
31255.0,2020-02-25,"(785.515, 907.25]",3,6,-3
31255.0,2020-02-25,"(907.25, 1028.5]",1,10,-9
31255.0,2020-02-25,"(1028.5, 1149.75]",3,12,-9
31255.0,2020-02-25,"(1149.75, 1271.0]",2,2,0
31256.0,2020-02-25,"(264.044, 504.0]",4,4,0
31256.0,2020-02-25,"(504.0, 743.0]",6,8,-2
31256.0,2020-02-25,"(743.0, 982.0]",2,4,-2
31256.0,2020-02-25,"(982.0, 1221.0]",6,24,-18
31257.0,2020-02-25,"(89.672, 423.0]",1,2,-1
31257.0,2020-02-25,"(423.0, 755.0]",10,13,-3
31257.0,2020-02-25,"(755.0, 1087.0]",13,27,-14
31257.0,2020-02-25,"(1087.0, 1419.0]",13,32,-19
31258.0,2020-02-25,"(604.407, 753.25]",2,3,-1
31258.0,2020-02-25,"(753.25, 901.5]",4,7,-3
31258.0,2020-02-25,"(901.5, 1049.75]",5,15,-10
31258.0,2020-02-25,"(1049.75, 1198.0]",6,15,-9
31259.0,2020-02-25,"(475.324, 645.0]",4,4,0
31260.0,2020-02-25,"(329.957, 591.75]",5,6,-1
31260.0,2020-02-25,"(591.75, 852.5]",2,3,-1
31260.0,2020-02-25,"(852.5, 1113.25]",2,13,-11
31260.0,2020-02-25,"(1113.25, 1374.0]",4,5,-1
31261.0,2020-02-25,"(392.034, 634.5]",9,9,0
31261.0,2020-02-25,"(634.5, 876.0]",1,3,-2
31261.0,2020-02-25,"(876.0, 1117.5]",2,9,-7
31261.0,2020-02-25,"(1117.5, 1359.0]",2,8,-6
31262.0,2020-02-25,"(485.058, 721.5]",4,6,-2
31262.0,2020-02-25,"(721.5, 957.0]",1,2,-1
31262.0,2020-02-25,"(957.0, 1192.5]",8,16,-8
31262.0,2020-02-25,"(1192.5, 1428.0]",1,4,-3
31263.0,2020-02-25,"(366.043, 606.25]",8,11,-3
31263.0,2020-02-25,"(606.25, 845.5]",7,14,-7
31263.0,2020-02-25,"(845.5, 1084.75]",7,21,-14
31263.0,2020-02-25,"(1084.75, 1324.0]",5,14,-9
31264.0,2020-02-25,"(485.191, 688.25]",4,6,-2
31264.0,2020-02-25,"(688.25, 890.5]",2,5,-3
31264.0,2020-02-25,"(890.5, 1092.75]",6,14,-8
31264.0,2020-02-25,"(1092.75, 1295.0]",2,5,-3
31265.0,2020-02-25,"(438.031, 681.25]",5,17,-12
31265.0,2020-02-25,"(681.25, 923.5]",6,9,-3
31265.0,2020-02-25,"(923.5, 1165.75]",29,50,-21
31265.0,2020-02-25,"(1165.75, 1408.0]",8,15,-7
31266.0,2020-02-25,"(23.661, 359.75]",1,3,-2
31266.0,2020-02-25,"(359.75, 694.5]",4,18,-14
31266.0,2020-02-25,"(694.5, 1029.25]",19,37,-18
31266.0,2020-02-25,"(1029.25, 1364.0]",20,29,-9
31267.0,2020-02-25,"(358.924, 629.0]",4,11,-7
31267.0,2020-02-25,"(629.0, 898.0]",8,17,-9
31267.0,2020-02-25,"(898.0, 1167.0]",16,32,-16
31267.0,2020-02-25,"(1167.0, 1436.0]",11,21,-10
31268.0,2020-02-25,"(46.652, 385.0]",10,12,-2
31268.0,2020-02-25,"(385.0, 722.0]",9,17,-8
31268.0,2020-02-25,"(722.0, 1059.0]",10,15,-5
31268.0,2020-02-25,"(1059.0, 1396.0]",29,41,-12
31269.0,2020-02-25,"(344.937, 611.75]",4,5,-1
31269.0,2020-02-25,"(611.75, 877.5]",4,7,-3
31269.0,2020-02-25,"(877.5, 1143.25]",6,10,-4
31269.0,2020-02-25,"(1143.25, 1409.0]",3,9,-6
31270.0,2020-02-25,"(526.274, 708.5]",3,5,-2
31270.0,2020-02-25,"(708.5, 890.0]",2,5,-3
31270.0,2020-02-25,"(890.0, 1071.5]",7,11,-4
31270.0,2020-02-25,"(1071.5, 1253.0]",3,7,-4
31271.0,2020-02-25,"(494.327, 663.25]",3,3,0
31271.0,2020-02-25,"(663.25, 831.5]",3,5,-2
31271.0,2020-02-25,"(831.5, 999.75]",3,6,-3
31271.0,2020-02-25,"(999.75, 1168.0]",1,10,-9
31272.0,2020-02-25,"(9.681, 340.75]",1,2,-1
31272.0,2020-02-25,"(340.75, 670.5]",6,7,-1
31272.0,2020-02-25,"(670.5, 1000.25]",11,23,-12
31272.0,2020-02-25,"(1000.25, 1330.0]",4,21,-17
31273.0,2020-02-25,"(477.419, 623.25]",1,3,-2
31273.0,2020-02-25,"(768.5, 913.75]",1,1,0
31273.0,2020-02-25,"(913.75, 1059.0]",4,1,3
31274.0,2020-02-25,"(456.126, 675.5]",4,5,-1
31274.0,2020-02-25,"(675.5, 894.0]",1,5,-4
31274.0,2020-02-25,"(894.0, 1112.5]",6,15,-9
31275.0,2020-02-25,"(315.95, 579.5]",5,7,-2
31275.0,2020-02-25,"(579.5, 842.0]",5,16,-11
31275.0,2020-02-25,"(842.0, 1104.5]",14,30,-16
31275.0,2020-02-25,"(1104.5, 1367.0]",12,21,-9
31276.0,2020-02-25,"(429.29, 607.5]",7,8,-1
31276.0,2020-02-25,"(607.5, 785.0]",7,12,-5
31276.0,2020-02-25,"(785.0, 962.5]",2,8,-6
31276.0,2020-02-25,"(962.5, 1140.0]",3,17,-14
31277.0,2020-02-25,"(433.298, 609.5]",14,15,-1
31277.0,2020-02-25,"(609.5, 785.0]",1,2,-1
31277.0,2020-02-25,"(785.0, 960.5]",5,8,-3
31277.0,2020-02-25,"(960.5, 1136.0]",5,31,-26
31278.0,2020-02-25,"(369.083, 599.25]",2,9,-7
31278.0,2020-02-25,"(599.25, 828.5]",6,9,-3
31278.0,2020-02-25,"(828.5, 1057.75]",6,10,-4
31278.0,2020-02-25,"(1057.75, 1287.0]",16,27,-11
31279.0,2020-02-25,"(411.348, 575.0]",10,11,-1
31279.0,2020-02-25,"(575.0, 738.0]",3,6,-3
31279.0,2020-02-25,"(738.0, 901.0]",4,11,-7
31279.0,2020-02-25,"(901.0, 1064.0]",8,24,-16
31280.0,2020-02-25,"(353.144, 568.0]",2,8,-6
31280.0,2020-02-25,"(568.0, 782.0]",2,5,-3
31280.0,2020-02-25,"(782.0, 996.0]",5,7,-2
31280.0,2020-02-25,"(996.0, 1210.0]",15,18,-3
31000.0,2020-02-26,"(1012.5, 1151.25]",1,3,-2
31000.0,2020-02-26,"(1151.25, 1290.0]",2,3,-1
31001.0,2020-02-26,"(717.75, 915.5]",1,2,-1
31001.0,2020-02-26,"(915.5, 1113.25]",3,1,2
31002.0,2020-02-26,"(523.15, 736.5]",6,7,-1
31002.0,2020-02-26,"(736.5, 949.0]",1,2,-1
31002.0,2020-02-26,"(949.0, 1161.5]",2,4,-2
31002.0,2020-02-26,"(1161.5, 1374.0]",1,6,-5
31003.0,2020-02-26,"(383.017, 629.75]",1,3,-2
31003.0,2020-02-26,"(629.75, 875.5]",3,4,-1
31003.0,2020-02-26,"(875.5, 1121.25]",6,9,-3
31004.0,2020-02-26,"(927.5, 1062.0]",1,1,0
31005.0,2020-02-26,"(422.159, 633.25]",5,5,0
31005.0,2020-02-26,"(633.25, 843.5]",2,3,-1
31005.0,2020-02-26,"(1053.75, 1264.0]",3,2,1
31006.0,2020-02-26,"(865.0, 1031.0]",2,1,1
31006.0,2020-02-26,"(1031.0, 1197.0]",1,2,-1
31007.0,2020-02-26,"(7.888, 287.0]",1,1,0
31007.0,2020-02-26,"(287.0, 565.0]",7,22,-15
31007.0,2020-02-26,"(565.0, 843.0]",7,12,-5
31007.0,2020-02-26,"(843.0, 1121.0]",4,11,-7
31009.0,2020-02-26,"(456.179, 662.25]",7,7,0
31009.0,2020-02-26,"(1072.75, 1278.0]",1,1,0
31010.0,2020-02-26,"(472.374, 629.5]",1,3,-2
31010.0,2020-02-26,"(629.5, 786.0]",1,1,0
31011.0,2020-02-26,"(489.403, 639.25]",4,5,-1
31011.0,2020-02-26,"(788.5, 937.75]",2,1,1
31011.0,2020-02-26,"(937.75, 1087.0]",1,2,-1
31012.0,2020-02-26,"(387.391, 540.25]",3,3,0
31012.0,2020-02-26,"(540.25, 692.5]",1,1,0
31012.0,2020-02-26,"(692.5, 844.75]",1,2,-1
31013.0,2020-02-26,"(607.5, 844.0]",2,3,-1
31013.0,2020-02-26,"(844.0, 1080.5]",2,3,-1
31013.0,2020-02-26,"(1080.5, 1317.0]",2,3,-1
31014.0,2020-02-26,"(404.003, 654.25]",21,26,-5
31014.0,2020-02-26,"(654.25, 903.5]",7,10,-3
31014.0,2020-02-26,"(903.5, 1152.75]",11,21,-10
31014.0,2020-02-26,"(1152.75, 1402.0]",3,6,-3
31015.0,2020-02-26,"(155.993, 408.75]",1,2,-1
31015.0,2020-02-26,"(408.75, 660.5]",13,14,-1
31015.0,2020-02-26,"(660.5, 912.25]",1,4,-3
31015.0,2020-02-26,"(912.25, 1164.0]",8,8,0
31016.0,2020-02-26,"(345.084, 575.0]",2,2,0
31016.0,2020-02-26,"(804.0, 1033.0]",2,3,-1
31016.0,2020-02-26,"(1033.0, 1262.0]",4,4,0
31017.0,2020-02-26,"(482.295, 659.25]",7,8,-1
31017.0,2020-02-26,"(835.5, 1011.75]",1,1,0
31017.0,2020-02-26,"(1011.75, 1188.0]",2,5,-3
31018.0,2020-02-26,"(466.105, 690.75]",4,10,-6
31018.0,2020-02-26,"(914.5, 1138.25]",2,1,1
31018.0,2020-02-26,"(1138.25, 1362.0]",1,2,-1
31019.0,2020-02-26,"(342.221, 537.75]",1,1,0
31019.0,2020-02-26,"(537.75, 732.5]",1,3,-2
31019.0,2020-02-26,"(732.5, 927.25]",1,2,-1
31019.0,2020-02-26,"(927.25, 1122.0]",2,3,-1
31020.0,2020-02-26,"(649.576, 756.0]",1,2,-1
31020.0,2020-02-26,"(756.0, 862.0]",1,1,0
31021.0,2020-02-26,"(387.022, 632.5]",3,8,-5
31021.0,2020-02-26,"(632.5, 877.0]",2,4,-2
31021.0,2020-02-26,"(1121.5, 1366.0]",2,1,1
31022.0,2020-02-26,"(527.249, 715.75]",1,4,-3
31022.0,2020-02-26,"(715.75, 903.5]",2,5,-3
31022.0,2020-02-26,"(903.5, 1091.25]",1,3,-2
31023.0,2020-02-26,"(683.75, 907.5]",7,2,5
31023.0,2020-02-26,"(907.5, 1131.25]",1,10,-9
31023.0,2020-02-26,"(1131.25, 1355.0]",3,3,0
31024.0,2020-02-26,"(467.151, 680.25]",4,7,-3
31024.0,2020-02-26,"(680.25, 892.5]",1,3,-2
31024.0,2020-02-26,"(892.5, 1104.75]",2,5,-3
31024.0,2020-02-26,"(1104.75, 1317.0]",3,5,-2
,,,,1.0,
,,,,1.0,
31026.0,2020-02-26,"(344.968, 604.0]",1,4,-3
31026.0,2020-02-26,"(862.0, 1120.0]",1,8,-7
31026.0,2020-02-26,"(1120.0, 1378.0]",1,2,-1
31027.0,2020-02-26,"(795.5, 917.75]",1,3,-2
31027.0,2020-02-26,"(917.75, 1040.0]",1,1,0
31028.0,2020-02-26,"(507.223, 702.25]",2,2,0
31028.0,2020-02-26,"(1090.75, 1285.0]",2,1,1
31029.0,2020-02-26,"(666.5, 874.0]",1,8,-7
31029.0,2020-02-26,"(874.0, 1081.5]",1,2,-1
31029.0,2020-02-26,"(1081.5, 1289.0]",2,4,-2
31030.0,2020-02-26,"(1038.5, 1272.0]",4,13,-9
31031.0,2020-02-26,"(512.0, 715.0]",1,4,-3
31031.0,2020-02-26,"(918.0, 1121.0]",3,1,2
31032.0,2020-02-26,"(973.75, 1141.0]",2,2,0
,,,,1.0,
,,,,1.0,
31034.0,2020-02-26,"(455.428, 599.0]",3,6,-3
31035.0,2020-02-26,"(446.0, 649.5]",1,1,0
31036.0,2020-02-26,"(943.5, 1104.0]",5,2,3
31037.0,2020-02-26,"(321.135, 538.25]",7,14,-7
31037.0,2020-02-26,"(538.25, 754.5]",5,5,0
31037.0,2020-02-26,"(754.5, 970.75]",3,6,-3
31037.0,2020-02-26,"(970.75, 1187.0]",1,9,-8
31038.0,2020-02-26,"(717.686, 796.5]",1,2,-1
31038.0,2020-02-26,"(953.5, 1032.0]",1,1,0
31039.0,2020-02-26,"(491.314, 663.5]",2,5,-3
31039.0,2020-02-26,"(663.5, 835.0]",3,3,0
31039.0,2020-02-26,"(835.0, 1006.5]",1,1,0
31039.0,2020-02-26,"(1006.5, 1178.0]",3,8,-5
31040.0,2020-02-26,"(455.15, 668.5]",3,4,-1
31040.0,2020-02-26,"(668.5, 881.0]",1,1,0
31040.0,2020-02-26,"(881.0, 1093.5]",1,3,-2
31040.0,2020-02-26,"(1093.5, 1306.0]",1,2,-1
31041.0,2020-02-26,"(386.25, 515.0]",1,1,0
31042.0,2020-02-26,"(437.063, 672.25]",7,7,0
31042.0,2020-02-26,"(672.25, 906.5]",2,4,-2
31042.0,2020-02-26,"(906.5, 1140.75]",5,11,-6
31042.0,2020-02-26,"(1140.75, 1375.0]",2,3,-1
31043.0,2020-02-26,"(417.202, 617.5]",1,2,-1
31043.0,2020-02-26,"(1016.5, 1216.0]",2,1,1
31044.0,2020-02-26,"(581.327, 750.25]",4,6,-2
31044.0,2020-02-26,"(918.5, 1086.75]",1,1,0
31044.0,2020-02-26,"(1086.75, 1255.0]",2,4,-2
31045.0,2020-02-26,"(227.867, 512.25]",1,1,0
31045.0,2020-02-26,"(512.25, 795.5]",1,2,-1
31046.0,2020-02-26,"(395.316, 567.0]",2,6,-4
31046.0,2020-02-26,"(909.0, 1080.0]",3,5,-2
31047.0,2020-02-26,"(356.993, 609.75]",12,20,-8
31047.0,2020-02-26,"(609.75, 861.5]",2,3,-1
31047.0,2020-02-26,"(861.5, 1113.25]",7,22,-15
31047.0,2020-02-26,"(1113.25, 1365.0]",1,4,-3
31048.0,2020-02-26,"(485.196, 687.0]",2,5,-3
31048.0,2020-02-26,"(687.0, 888.0]",1,1,0
31048.0,2020-02-26,"(888.0, 1089.0]",2,4,-2
31049.0,2020-02-26,"(426.399, 577.25]",1,2,-1
31050.0,2020-02-26,"(1034.25, 1208.0]",3,1,2
31051.0,2020-02-26,"(770.0, 928.5]",1,5,-4
31051.0,2020-02-26,"(928.5, 1087.0]",3,1,2
31052.0,2020-02-26,"(445.419, 591.25]",3,4,-1
31052.0,2020-02-26,"(591.25, 736.5]",1,1,0
31053.0,2020-02-26,"(405.0, 540.0]",1,1,0
31054.0,2020-02-26,"(997.5, 1003.0]",1,1,0
31055.0,2020-02-26,"(942.5, 1103.0]",3,2,1
,,,,1.0,
,,,,1.0,
,,,,2.0,
,,,,2.0,
31059.0,2020-02-26,"(419.25, 559.0]",1,1,0
31060.0,2020-02-26,"(898.554, 1010.5]",1,1,0
31060.0,2020-02-26,"(1233.5, 1345.0]",1,1,0
31061.0,2020-02-26,"(529.398, 680.5]",1,2,-1
31061.0,2020-02-26,"(831.0, 981.5]",1,2,-1
31061.0,2020-02-26,"(981.5, 1132.0]",1,1,0
31062.0,2020-02-26,"(462.339, 628.25]",1,2,-1
31062.0,2020-02-26,"(958.75, 1124.0]",2,6,-4
31063.0,2020-02-26,"(1134.868, 1168.0]",1,1,0
31064.0,2020-02-26,"(433.14, 649.0]",4,8,-4
31064.0,2020-02-26,"(649.0, 864.0]",1,3,-2
31064.0,2020-02-26,"(864.0, 1079.0]",7,12,-5
31064.0,2020-02-26,"(1079.0, 1294.0]",2,4,-2
31065.0,2020-02-26,"(849.0, 1004.0]",1,1,0
31066.0,2020-02-26,"(819.75, 1093.0]",1,1,0
31067.0,2020-02-26,"(23.874, 306.5]",1,1,0
31067.0,2020-02-26,"(869.5, 1151.0]",2,3,-1
31068.0,2020-02-26,"(1151.0, 1344.0]",1,1,0
31069.0,2020-02-26,"(403.43, 546.5]",1,6,-5
31069.0,2020-02-26,"(689.0, 831.5]",2,2,0
31069.0,2020-02-26,"(831.5, 974.0]",1,2,-1
31070.0,2020-02-26,"(433.335, 600.25]",1,3,-2
31070.0,2020-02-26,"(932.75, 1099.0]",4,1,3
31071.0,2020-02-26,"(472.229, 665.75]",1,5,-4
31071.0,2020-02-26,"(665.75, 858.5]",1,2,-1
31071.0,2020-02-26,"(858.5, 1051.25]",2,2,0
31071.0,2020-02-26,"(1051.25, 1244.0]",2,5,-3
,,,,2.0,
31073.0,2020-02-26,"(469.394, 621.5]",1,3,-2
31073.0,2020-02-26,"(924.5, 1076.0]",1,1,0
31074.0,2020-02-26,"(48.874, 331.5]",1,1,0
31074.0,2020-02-26,"(894.5, 1176.0]",4,1,3
31075.0,2020-02-26,"(941.5, 1106.0]",3,2,1
31076.0,2020-02-26,"(847.5, 1031.75]",1,2,-1
31076.0,2020-02-26,"(1031.75, 1216.0]",2,1,1
31077.0,2020-02-26,"(468.261, 653.75]",1,7,-6
31077.0,2020-02-26,"(838.5, 1023.25]",5,1,4
31077.0,2020-02-26,"(1023.25, 1208.0]",2,7,-5
31078.0,2020-02-26,"(477.401, 627.75]",5,6,-1
31078.0,2020-02-26,"(927.25, 1077.0]",1,3,-2
31079.0,2020-02-26,"(418.003, 668.25]",1,9,-8
31079.0,2020-02-26,"(668.25, 917.5]",2,2,0
31079.0,2020-02-26,"(917.5, 1166.75]",1,5,-4
31079.0,2020-02-26,"(1166.75, 1416.0]",1,1,0
31080.0,2020-02-26,"(812.0, 1027.0]",1,8,-7
31080.0,2020-02-26,"(1027.0, 1242.0]",4,1,3
31081.0,2020-02-26,"(495.326, 664.5]",1,4,-3
31081.0,2020-02-26,"(664.5, 833.0]",1,1,0
31081.0,2020-02-26,"(833.0, 1001.5]",1,3,-2
31081.0,2020-02-26,"(1001.5, 1170.0]",1,2,-1
31082.0,2020-02-26,"(740.25, 853.0]",1,1,0
31083.0,2020-02-26,"(935.25, 1113.0]",5,3,2
31084.0,2020-02-26,"(443.25, 663.5]",4,1,3
31084.0,2020-02-26,"(663.5, 883.75]",1,5,-4
31085.0,2020-02-26,"(400.24, 591.0]",1,4,-3
31085.0,2020-02-26,"(971.0, 1161.0]",1,1,0
,,,,1.0,
,,,,1.0,
31087.0,2020-02-26,"(613.25, 788.5]",1,2,-1
31087.0,2020-02-26,"(963.75, 1139.0]",4,2,2
31088.0,2020-02-26,"(862.5, 1092.75]",1,3,-2
31088.0,2020-02-26,"(1092.75, 1323.0]",2,1,1
31089.0,2020-02-26,"(418.007, 667.25]",9,14,-5
31089.0,2020-02-26,"(667.25, 915.5]",3,8,-5
31089.0,2020-02-26,"(915.5, 1163.75]",3,21,-18
31090.0,2020-02-26,"(882.75, 1038.0]",1,1,0
31091.0,2020-02-26,"(28.707, 353.25]",1,1,0
31091.0,2020-02-26,"(676.5, 999.75]",2,6,-4
31091.0,2020-02-26,"(999.75, 1323.0]",5,3,2
31092.0,2020-02-26,"(547.5, 714.0]",1,1,0
31092.0,2020-02-26,"(880.5, 1047.0]",2,1,1
31093.0,2020-02-26,"(956.5, 1128.0]",2,7,-5
,,,,1.0,
,,,,1.0,
,,,,1.0,
,,,,1.0,
31096.0,2020-02-26,"(534.492, 662.0]",1,2,-1
31096.0,2020-02-26,"(916.0, 1043.0]",1,1,0
31097.0,2020-02-26,"(535.256, 722.0]",2,2,0
31097.0,2020-02-26,"(722.0, 908.0]",1,2,-1
31097.0,2020-02-26,"(908.0, 1094.0]",1,4,-3
31097.0,2020-02-26,"(1094.0, 1280.0]",1,1,0
31098.0,2020-02-26,"(408.131, 626.25]",5,8,-3
31098.0,2020-02-26,"(626.25, 843.5]",1,1,0
31098.0,2020-02-26,"(843.5, 1060.75]",2,3,-1
31098.0,2020-02-26,"(1060.75, 1278.0]",2,5,-3
31099.0,2020-02-26,"(975.75, 1301.0]",2,1,1
31100.0,2020-02-26,"(436.025, 680.75]",14,16,-2
31100.0,2020-02-26,"(680.75, 924.5]",3,6,-3
31100.0,2020-02-26,"(924.5, 1168.25]",4,14,-10
31100.0,2020-02-26,"(1168.25, 1412.0]",1,8,-7
31101.0,2020-02-26,"(2.621, 348.75]",3,4,-1
31101.0,2020-02-26,"(348.75, 693.5]",11,49,-38
31101.0,2020-02-26,"(693.5, 1038.25]",18,24,-6
31101.0,2020-02-26,"(1038.25, 1383.0]",31,49,-18
31102.0,2020-02-26,"(374.035, 616.25]",2,28,-26
31102.0,2020-02-26,"(616.25, 857.5]",2,3,-1
31102.0,2020-02-26,"(857.5, 1098.75]",1,3,-2
31102.0,2020-02-26,"(1098.75, 1340.0]",8,9,-1
31103.0,2020-02-26,"(601.0, 864.0]",2,26,-24
31103.0,2020-02-26,"(864.0, 1127.0]",3,14,-11
31103.0,2020-02-26,"(1127.0, 1390.0]",7,15,-8
31104.0,2020-02-26,"(329.911, 603.25]",9,31,-22
31104.0,2020-02-26,"(603.25, 875.5]",7,13,-6
31104.0,2020-02-26,"(875.5, 1147.75]",15,21,-6
31104.0,2020-02-26,"(1147.75, 1420.0]",7,19,-12
31105.0,2020-02-26,"(325.964, 586.0]",1,14,-13
31105.0,2020-02-26,"(586.0, 845.0]",2,7,-5
31105.0,2020-02-26,"(845.0, 1104.0]",1,2,-1
31106.0,2020-02-26,"(431.079, 662.25]",3,12,-9
31106.0,2020-02-26,"(892.5, 1122.75]",3,3,0
31106.0,2020-02-26,"(1122.75, 1353.0]",5,5,0
31107.0,2020-02-26,"(369.98, 626.0]",7,31,-24
31107.0,2020-02-26,"(626.0, 881.0]",2,9,-7
31107.0,2020-02-26,"(881.0, 1136.0]",15,22,-7
31107.0,2020-02-26,"(1136.0, 1391.0]",10,13,-3
31108.0,2020-02-26,"(352.137, 568.75]",4,24,-20
31108.0,2020-02-26,"(568.75, 784.5]",4,9,-5
31108.0,2020-02-26,"(784.5, 1000.25]",13,28,-15
31108.0,2020-02-26,"(1000.25, 1216.0]",19,26,-7
31109.0,2020-02-26,"(352.032, 595.0]",5,15,-10
31109.0,2020-02-26,"(595.0, 837.0]",3,11,-8
31109.0,2020-02-26,"(837.0, 1079.0]",9,18,-9
31109.0,2020-02-26,"(1079.0, 1321.0]",14,20,-6
31110.0,2020-02-26,"(377.992, 631.0]",14,30,-16
31110.0,2020-02-26,"(631.0, 883.0]",1,9,-8
31110.0,2020-02-26,"(883.0, 1135.0]",18,28,-10
31110.0,2020-02-26,"(1135.0, 1387.0]",6,13,-7
31111.0,2020-02-26,"(708.25, 937.5]",2,13,-11
31111.0,2020-02-26,"(937.5, 1166.75]",8,2,6
31111.0,2020-02-26,"(1166.75, 1396.0]",6,13,-7
31112.0,2020-02-26,"(983.5, 1140.0]",3,2,1
31113.0,2020-02-26,"(315.046, 554.5]",1,20,-19
31113.0,2020-02-26,"(1031.5, 1270.0]",9,10,-1
31114.0,2020-02-26,"(37.69, 366.5]",4,5,-1
31114.0,2020-02-26,"(366.5, 694.0]",6,35,-29
31114.0,2020-02-26,"(694.0, 1021.5]",7,12,-5
31114.0,2020-02-26,"(1021.5, 1349.0]",23,32,-9
31115.0,2020-02-26,"(35.695, 363.25]",1,2,-1
31115.0,2020-02-26,"(363.25, 689.5]",1,17,-16
31115.0,2020-02-26,"(689.5, 1015.75]",8,14,-6
31115.0,2020-02-26,"(1015.75, 1342.0]",10,17,-7
31116.0,2020-02-26,"(399.027, 643.25]",2,23,-21
31116.0,2020-02-26,"(643.25, 886.5]",8,16,-8
31116.0,2020-02-26,"(886.5, 1129.75]",9,9,0
31116.0,2020-02-26,"(1129.75, 1373.0]",11,15,-4
31117.0,2020-02-26,"(214.855, 502.25]",3,20,-17
31117.0,2020-02-26,"(502.25, 788.5]",4,13,-9
31117.0,2020-02-26,"(788.5, 1074.75]",4,7,-3
31117.0,2020-02-26,"(1074.75, 1361.0]",8,20,-12
31118.0,2020-02-26,"(317.116, 539.0]",4,16,-12
31118.0,2020-02-26,"(539.0, 760.0]",1,8,-7
31118.0,2020-02-26,"(760.0, 981.0]",4,7,-3
31118.0,2020-02-26,"(981.0, 1202.0]",16,19,-3
31119.0,2020-02-26,"(352.942, 618.5]",5,21,-16
31119.0,2020-02-26,"(618.5, 883.0]",3,6,-3
31119.0,2020-02-26,"(883.0, 1147.5]",18,28,-10
31119.0,2020-02-26,"(1147.5, 1412.0]",6,12,-6
31120.0,2020-02-26,"(601.25, 854.5]",3,13,-10
31120.0,2020-02-26,"(854.5, 1107.75]",8,9,-1
31120.0,2020-02-26,"(1107.75, 1361.0]",10,11,-1
31121.0,2020-02-26,"(331.993, 584.75]",15,25,-10
31121.0,2020-02-26,"(584.75, 836.5]",4,7,-3
31121.0,2020-02-26,"(836.5, 1088.25]",5,13,-8
31121.0,2020-02-26,"(1088.25, 1340.0]",5,12,-7
31122.0,2020-02-26,"(349.5, 693.0]",5,1,4
31122.0,2020-02-26,"(693.0, 1036.5]",1,20,-19
31122.0,2020-02-26,"(1036.5, 1380.0]",7,5,2
31123.0,2020-02-26,"(859.5, 1102.75]",3,19,-16
31123.0,2020-02-26,"(1102.75, 1346.0]",4,4,0
31124.0,2020-02-26,"(309.917, 581.75]",11,26,-15
31124.0,2020-02-26,"(581.75, 852.5]",4,21,-17
31124.0,2020-02-26,"(852.5, 1123.25]",10,27,-17
31124.0,2020-02-26,"(1123.25, 1394.0]",6,23,-17
31125.0,2020-02-26,"(367.084, 597.0]",8,34,-26
31125.0,2020-02-26,"(597.0, 826.0]",5,18,-13
31125.0,2020-02-26,"(826.0, 1055.0]",10,16,-6
31125.0,2020-02-26,"(1055.0, 1284.0]",19,25,-6
31126.0,2020-02-26,"(305.909, 579.75]",4,27,-23
31126.0,2020-02-26,"(579.75, 852.5]",1,2,-1
31126.0,2020-02-26,"(852.5, 1125.25]",7,9,-2
31126.0,2020-02-26,"(1125.25, 1398.0]",10,13,-3
31127.0,2020-02-26,"(391.088, 620.0]",12,16,-4
31127.0,2020-02-26,"(620.0, 848.0]",11,22,-11
31127.0,2020-02-26,"(848.0, 1076.0]",15,23,-8
31127.0,2020-02-26,"(1076.0, 1304.0]",6,15,-9
31128.0,2020-02-26,"(345.998, 597.5]",24,38,-14
31128.0,2020-02-26,"(597.5, 848.0]",13,21,-8
31128.0,2020-02-26,"(848.0, 1098.5]",11,23,-12
31128.0,2020-02-26,"(1098.5, 1349.0]",11,21,-10
31129.0,2020-02-26,"(419.022, 664.5]",11,14,-3
31129.0,2020-02-26,"(664.5, 909.0]",3,4,-1
31129.0,2020-02-26,"(909.0, 1153.5]",5,11,-6
31129.0,2020-02-26,"(1153.5, 1398.0]",1,3,-2
31130.0,2020-02-26,"(368.004, 618.0]",3,12,-9
31130.0,2020-02-26,"(618.0, 867.0]",4,8,-4
31130.0,2020-02-26,"(867.0, 1116.0]",8,11,-3
31130.0,2020-02-26,"(1116.0, 1365.0]",1,2,-1
31131.0,2020-02-26,"(413.029, 656.75]",2,15,-13
31131.0,2020-02-26,"(656.75, 899.5]",2,6,-4
31131.0,2020-02-26,"(899.5, 1142.25]",4,6,-2
31200.0,2020-02-26,"(3.645, 343.75]",2,5,-3
31200.0,2020-02-26,"(343.75, 682.5]",30,51,-21
31200.0,2020-02-26,"(682.5, 1021.25]",18,33,-15
31200.0,2020-02-26,"(1021.25, 1360.0]",20,51,-31
31201.0,2020-02-26,"(16.617, 363.75]",2,3,-1
31201.0,2020-02-26,"(363.75, 709.5]",21,59,-38
31201.0,2020-02-26,"(709.5, 1055.25]",34,53,-19
31201.0,2020-02-26,"(1055.25, 1401.0]",25,55,-30
,,,,2.0,
31203.0,2020-02-26,"(336.94, 603.0]",12,27,-15
31203.0,2020-02-26,"(603.0, 868.0]",9,15,-6
31203.0,2020-02-26,"(868.0, 1133.0]",20,27,-7
31203.0,2020-02-26,"(1133.0, 1398.0]",10,16,-6
31204.0,2020-02-26,"(345.056, 582.0]",13,16,-3
31204.0,2020-02-26,"(582.0, 818.0]",4,7,-3
31204.0,2020-02-26,"(818.0, 1054.0]",1,13,-12
31204.0,2020-02-26,"(1054.0, 1290.0]",4,11,-7
31205.0,2020-02-26,"(415.111, 638.25]",35,39,-4
31205.0,2020-02-26,"(638.25, 860.5]",12,18,-6
31205.0,2020-02-26,"(860.5, 1082.75]",8,25,-17
31205.0,2020-02-26,"(1082.75, 1305.0]",8,24,-16
31206.0,2020-02-26,"(399.306, 573.5]",5,5,0
31206.0,2020-02-26,"(573.5, 747.0]",2,3,-1
31206.0,2020-02-26,"(747.0, 920.5]",2,3,-1
31206.0,2020-02-26,"(920.5, 1094.0]",2,6,-4
31207.0,2020-02-26,"(911.5, 1134.25]",5,5,0
31207.0,2020-02-26,"(1134.25, 1357.0]",3,7,-4
31208.0,2020-02-26,"(361.096, 588.0]",16,18,-2
31208.0,2020-02-26,"(588.0, 814.0]",4,9,-5
31208.0,2020-02-26,"(814.0, 1040.0]",6,18,-12
31208.0,2020-02-26,"(1040.0, 1266.0]",1,5,-4
31209.0,2020-02-26,"(450.279, 631.25]",5,7,-2
31209.0,2020-02-26,"(991.75, 1172.0]",1,3,-2
31211.0,2020-02-26,"(378.138, 594.5]",14,17,-3
31211.0,2020-02-26,"(594.5, 810.0]",2,3,-1
31211.0,2020-02-26,"(810.0, 1025.5]",3,4,-1
31211.0,2020-02-26,"(1025.5, 1241.0]",3,7,-4
31212.0,2020-02-26,"(362.0, 712.0]",23,1,22
31212.0,2020-02-26,"(712.0, 1062.0]",11,35,-24
31212.0,2020-02-26,"(1062.0, 1412.0]",10,26,-16
31213.0,2020-02-26,"(262.881, 543.75]",28,41,-13
31213.0,2020-02-26,"(543.75, 823.5]",21,36,-15
31213.0,2020-02-26,"(823.5, 1103.25]",17,31,-14
31213.0,2020-02-26,"(1103.25, 1383.0]",9,15,-6
31214.0,2020-02-26,"(109.72, 431.0]",1,5,-4
31214.0,2020-02-26,"(431.0, 751.0]",18,46,-28
31214.0,2020-02-26,"(751.0, 1071.0]",8,14,-6
31214.0,2020-02-26,"(1071.0, 1391.0]",23,40,-17
31215.0,2020-02-26,"(388.234, 580.5]",16,17,-1
31215.0,2020-02-26,"(580.5, 772.0]",4,6,-2
31215.0,2020-02-26,"(772.0, 963.5]",4,6,-2
31215.0,2020-02-26,"(963.5, 1155.0]",9,17,-8
31216.0,2020-02-26,"(450.162, 660.5]",25,28,-3
31216.0,2020-02-26,"(660.5, 870.0]",6,11,-5
31216.0,2020-02-26,"(870.0, 1079.5]",2,10,-8
31216.0,2020-02-26,"(1079.5, 1289.0]",6,16,-10
31217.0,2020-02-26,"(324.039, 565.25]",11,14,-3
31217.0,2020-02-26,"(565.25, 805.5]",6,8,-2
31217.0,2020-02-26,"(805.5, 1045.75]",3,8,-5
31217.0,2020-02-26,"(1045.75, 1286.0]",3,7,-4
31218.0,2020-02-26,"(369.049, 607.75]",18,39,-21
31218.0,2020-02-26,"(607.75, 845.5]",5,8,-3
31218.0,2020-02-26,"(845.5, 1083.25]",8,18,-10
31218.0,2020-02-26,"(1083.25, 1321.0]",2,5,-3
31219.0,2020-02-26,"(359.033, 601.75]",13,14,-1
31219.0,2020-02-26,"(601.75, 843.5]",10,14,-4
31219.0,2020-02-26,"(843.5, 1085.25]",1,8,-7
31219.0,2020-02-26,"(1085.25, 1327.0]",1,1,0
31220.0,2020-02-26,"(383.32, 554.0]",15,20,-5
31220.0,2020-02-26,"(554.0, 724.0]",5,7,-2
31220.0,2020-02-26,"(724.0, 894.0]",6,12,-6
31220.0,2020-02-26,"(894.0, 1064.0]",1,15,-14
31221.0,2020-02-26,"(445.146, 659.5]",30,33,-3
31221.0,2020-02-26,"(659.5, 873.0]",14,26,-12
31221.0,2020-02-26,"(873.0, 1086.5]",9,30,-21
31221.0,2020-02-26,"(1086.5, 1300.0]",9,18,-9
31222.0,2020-02-26,"(327.5, 653.0]",22,1,21
31222.0,2020-02-26,"(653.0, 978.5]",3,26,-23
31222.0,2020-02-26,"(978.5, 1304.0]",7,9,-2
31223.0,2020-02-26,"(47.62, 394.0]",1,2,-1
31223.0,2020-02-26,"(394.0, 739.0]",9,34,-25
31223.0,2020-02-26,"(739.0, 1084.0]",19,41,-22
31223.0,2020-02-26,"(1084.0, 1429.0]",12,22,-10
31224.0,2020-02-26,"(456.234, 648.5]",21,25,-4
31224.0,2020-02-26,"(648.5, 840.0]",6,10,-4
31224.0,2020-02-26,"(840.0, 1031.5]",3,9,-6
31224.0,2020-02-26,"(1031.5, 1223.0]",1,10,-9
31225.0,2020-02-26,"(416.211, 614.25]",6,11,-5
31225.0,2020-02-26,"(614.25, 811.5]",2,5,-3
31225.0,2020-02-26,"(811.5, 1008.75]",2,8,-6
31225.0,2020-02-26,"(1008.75, 1206.0]",9,21,-12
31226.0,2020-02-26,"(317.213, 514.75]",3,7,-4
31226.0,2020-02-26,"(514.75, 711.5]",1,4,-3
31226.0,2020-02-26,"(711.5, 908.25]",1,6,-5
31226.0,2020-02-26,"(908.25, 1105.0]",4,7,-3
31227.0,2020-02-26,"(295.018, 541.5]",24,26,-2
31227.0,2020-02-26,"(541.5, 787.0]",8,17,-9
31227.0,2020-02-26,"(787.0, 1032.5]",5,12,-7
31227.0,2020-02-26,"(1032.5, 1278.0]",5,21,-16
31228.0,2020-02-26,"(355.25, 683.5]",22,1,21
31228.0,2020-02-26,"(683.5, 1011.75]",13,31,-18
31228.0,2020-02-26,"(1011.75, 1340.0]",26,24,2
31229.0,2020-02-26,"(363.038, 604.5]",10,56,-46
31229.0,2020-02-26,"(604.5, 845.0]",16,31,-15
31229.0,2020-02-26,"(845.0, 1085.5]",20,29,-9
31229.0,2020-02-26,"(1085.5, 1326.0]",21,36,-15
31230.0,2020-02-26,"(398.978, 655.5]",43,51,-8
31230.0,2020-02-26,"(655.5, 911.0]",6,14,-8
31230.0,2020-02-26,"(911.0, 1166.5]",13,39,-26
31231.0,2020-02-26,"(392.191, 595.25]",29,36,-7
31231.0,2020-02-26,"(595.25, 797.5]",5,11,-6
31231.0,2020-02-26,"(797.5, 999.75]",8,15,-7
31231.0,2020-02-26,"(999.75, 1202.0]",6,19,-13
31232.0,2020-02-26,"(255.87, 539.5]",18,24,-6
31232.0,2020-02-26,"(539.5, 822.0]",6,12,-6
31232.0,2020-02-26,"(822.0, 1104.5]",13,27,-14
31232.0,2020-02-26,"(1104.5, 1387.0]",5,19,-14
31233.0,2020-02-26,"(378.039, 619.25]",41,51,-10
31233.0,2020-02-26,"(619.25, 859.5]",15,20,-5
31233.0,2020-02-26,"(859.5, 1099.75]",12,32,-20
31233.0,2020-02-26,"(1099.75, 1340.0]",4,12,-8
31234.0,2020-02-26,"(386.045, 625.75]",23,35,-12
31234.0,2020-02-26,"(625.75, 864.5]",12,20,-8
31234.0,2020-02-26,"(864.5, 1103.25]",10,17,-7
31234.0,2020-02-26,"(1103.25, 1342.0]",12,17,-5
31235.0,2020-02-26,"(508.385, 662.75]",9,9,0
31236.0,2020-02-26,"(156.764, 467.0]",2,3,-1
31236.0,2020-02-26,"(467.0, 776.0]",19,27,-8
31236.0,2020-02-26,"(776.0, 1085.0]",9,18,-9
31236.0,2020-02-26,"(1085.0, 1394.0]",3,10,-7
31237.0,2020-02-26,"(332.98, 589.0]",8,20,-12
31237.0,2020-02-26,"(589.0, 844.0]",17,31,-14
31237.0,2020-02-26,"(844.0, 1099.0]",9,17,-8
31237.0,2020-02-26,"(1099.0, 1354.0]",6,12,-6
31238.0,2020-02-26,"(53.751, 367.25]",1,1,0
31238.0,2020-02-26,"(367.25, 679.5]",22,26,-4
31238.0,2020-02-26,"(679.5, 991.75]",6,11,-5
31238.0,2020-02-26,"(991.75, 1304.0]",8,33,-25
31239.0,2020-02-26,"(333.032, 576.0]",26,29,-3
31239.0,2020-02-26,"(576.0, 818.0]",7,15,-8
31239.0,2020-02-26,"(818.0, 1060.0]",9,24,-15
31239.0,2020-02-26,"(1060.0, 1302.0]",7,27,-20
31240.0,2020-02-26,"(710.0, 803.0]",3,1,2
31240.0,2020-02-26,"(803.0, 896.0]",2,6,-4
31241.0,2020-02-26,"(4.604, 355.0]",1,1,0
31241.0,2020-02-26,"(355.0, 704.0]",25,58,-33
31241.0,2020-02-26,"(704.0, 1053.0]",10,22,-12
31241.0,2020-02-26,"(1053.0, 1402.0]",14,25,-11
31242.0,2020-02-26,"(387.08, 618.0]",27,29,-2
31242.0,2020-02-26,"(618.0, 848.0]",2,6,-4
31242.0,2020-02-26,"(848.0, 1078.0]",7,24,-17
31242.0,2020-02-26,"(1078.0, 1308.0]",4,21,-17
31243.0,2020-02-26,"(374.973, 632.75]",19,25,-6
31243.0,2020-02-26,"(632.75, 889.5]",3,6,-3
31243.0,2020-02-26,"(889.5, 1146.25]",11,29,-18
31243.0,2020-02-26,"(1146.25, 1403.0]",1,3,-2
31244.0,2020-02-26,"(354.118, 575.5]",14,23,-9
31244.0,2020-02-26,"(575.5, 796.0]",2,4,-2
31244.0,2020-02-26,"(796.0, 1016.5]",8,18,-10
31244.0,2020-02-26,"(1016.5, 1237.0]",8,18,-10
31245.0,2020-02-26,"(335.933, 603.75]",7,18,-11
31245.0,2020-02-26,"(603.75, 870.5]",2,9,-7
31245.0,2020-02-26,"(870.5, 1137.25]",10,22,-12
31245.0,2020-02-26,"(1137.25, 1404.0]",11,15,-4
31246.0,2020-02-26,"(352.009, 600.75]",16,20,-4
31246.0,2020-02-26,"(600.75, 848.5]",3,8,-5
31246.0,2020-02-26,"(848.5, 1096.25]",2,15,-13
31246.0,2020-02-26,"(1096.25, 1344.0]",11,16,-5
31247.0,2020-02-26,"(354.142, 569.5]",16,19,-3
31247.0,2020-02-26,"(569.5, 784.0]",5,7,-2
31247.0,2020-02-26,"(784.0, 998.5]",15,29,-14
31247.0,2020-02-26,"(998.5, 1213.0]",5,13,-8
31248.0,2020-02-26,"(351.235, 543.25]",9,13,-4
31248.0,2020-02-26,"(543.25, 734.5]",4,8,-4
31248.0,2020-02-26,"(734.5, 925.75]",10,18,-8
31248.0,2020-02-26,"(925.75, 1117.0]",14,22,-8
31249.0,2020-02-26,"(387.281, 567.75]",2,3,-1
31249.0,2020-02-26,"(567.75, 747.5]",2,4,-2
31249.0,2020-02-26,"(747.5, 927.25]",1,2,-1
31249.0,2020-02-26,"(927.25, 1107.0]",4,9,-5
31250.0,2020-02-26,"(363.023, 608.25]",20,22,-2
31250.0,2020-02-26,"(608.25, 852.5]",2,4,-2
31250.0,2020-02-26,"(852.5, 1096.75]",7,16,-9
31250.0,2020-02-26,"(1096.75, 1341.0]",2,15,-13
31251.0,2020-02-26,"(4.671, 338.25]",3,4,-1
31251.0,2020-02-26,"(338.25, 670.5]",18,35,-17
31251.0,2020-02-26,"(670.5, 1002.75]",9,20,-11
31251.0,2020-02-26,"(1002.75, 1335.0]",13,27,-14
31252.0,2020-02-26,"(421.106, 645.5]",17,17,0
31252.0,2020-02-26,"(645.5, 869.0]",1,3,-2
31252.0,2020-02-26,"(869.0, 1092.5]",4,14,-10
31253.0,2020-02-26,"(206.92, 478.0]",8,8,0
31253.0,2020-02-26,"(478.0, 748.0]",15,18,-3
31253.0,2020-02-26,"(748.0, 1018.0]",2,4,-2
31253.0,2020-02-26,"(1018.0, 1288.0]",5,21,-16
31254.0,2020-02-26,"(345.947, 610.25]",25,28,-3
31254.0,2020-02-26,"(610.25, 873.5]",8,14,-6
31254.0,2020-02-26,"(873.5, 1136.75]",4,11,-7
31254.0,2020-02-26,"(1136.75, 1400.0]",3,4,-1
31255.0,2020-02-26,"(362.974, 620.5]",19,26,-7
31255.0,2020-02-26,"(620.5, 877.0]",3,8,-5
31255.0,2020-02-26,"(877.0, 1133.5]",8,16,-8
31255.0,2020-02-26,"(1133.5, 1390.0]",3,3,0
31256.0,2020-02-26,"(265.884, 546.0]",14,14,0
31256.0,2020-02-26,"(546.0, 825.0]",1,2,-1
31256.0,2020-02-26,"(825.0, 1104.0]",5,10,-5
31257.0,2020-02-26,"(383.077, 614.75]",20,28,-8
31257.0,2020-02-26,"(614.75, 845.5]",5,10,-5
31257.0,2020-02-26,"(845.5, 1076.25]",8,18,-10
31257.0,2020-02-26,"(1076.25, 1307.0]",7,21,-14
31258.0,2020-02-26,"(3.805, 303.75]",1,2,-1
31258.0,2020-02-26,"(303.75, 602.5]",15,36,-21
31258.0,2020-02-26,"(602.5, 901.25]",7,16,-9
31258.0,2020-02-26,"(901.25, 1200.0]",15,37,-22
31259.0,2020-02-26,"(471.315, 643.25]",7,7,0
31259.0,2020-02-26,"(814.5, 985.75]",3,4,-1
31260.0,2020-02-26,"(343.75, 638.5]",18,1,17
31260.0,2020-02-26,"(638.5, 933.25]",1,23,-22
31260.0,2020-02-26,"(933.25, 1228.0]",7,4,3
31261.0,2020-02-26,"(386.07, 619.5]",13,14,-1
31261.0,2020-02-26,"(1084.5, 1317.0]",1,3,-2
31262.0,2020-02-26,"(324.996, 577.0]",11,12,-1
31262.0,2020-02-26,"(577.0, 828.0]",8,13,-5
31262.0,2020-02-26,"(828.0, 1079.0]",5,11,-6
31262.0,2020-02-26,"(1079.0, 1330.0]",4,8,-4
31263.0,2020-02-26,"(358.029, 601.75]",30,42,-12
31263.0,2020-02-26,"(601.75, 844.5]",4,7,-3
31263.0,2020-02-26,"(844.5, 1087.25]",13,32,-19
31263.0,2020-02-26,"(1087.25, 1330.0]",3,10,-7
31264.0,2020-02-26,"(356.969, 615.75]",9,13,-4
31264.0,2020-02-26,"(873.5, 1131.25]",9,1,8
31264.0,2020-02-26,"(1131.25, 1389.0]",1,21,-20
31265.0,2020-02-26,"(23.617, 370.75]",1,1,0
31265.0,2020-02-26,"(370.75, 716.5]",20,43,-23
31265.0,2020-02-26,"(716.5, 1062.25]",13,28,-15
31265.0,2020-02-26,"(1062.25, 1408.0]",12,19,-7
31266.0,2020-02-26,"(336.934, 604.5]",4,26,-22
31266.0,2020-02-26,"(604.5, 871.0]",5,12,-7
31266.0,2020-02-26,"(871.0, 1137.5]",11,29,-18
31266.0,2020-02-26,"(1137.5, 1404.0]",14,21,-7
31267.0,2020-02-26,"(361.5, 687.0]",28,1,27
31267.0,2020-02-26,"(687.0, 1012.5]",7,50,-43
31267.0,2020-02-26,"(1012.5, 1338.0]",18,16,2
31268.0,2020-02-26,"(12.63, 356.5]",1,2,-1
31268.0,2020-02-26,"(356.5, 699.0]",13,41,-28
31268.0,2020-02-26,"(699.0, 1041.5]",17,22,-5
31268.0,2020-02-26,"(1041.5, 1384.0]",19,25,-6
31269.0,2020-02-26,"(349.992, 603.0]",8,14,-6
31269.0,2020-02-26,"(603.0, 855.0]",4,12,-8
31269.0,2020-02-26,"(855.0, 1107.0]",4,11,-7
31269.0,2020-02-26,"(1107.0, 1359.0]",3,7,-4
31270.0,2020-02-26,"(395.991, 649.25]",16,23,-7
31270.0,2020-02-26,"(649.25, 901.5]",4,9,-5
31270.0,2020-02-26,"(901.5, 1153.75]",9,17,-8
31270.0,2020-02-26,"(1153.75, 1406.0]",2,5,-3
31271.0,2020-02-26,"(381.22, 577.0]",9,10,-1
31271.0,2020-02-26,"(577.0, 772.0]",9,14,-5
31271.0,2020-02-26,"(772.0, 967.0]",6,12,-6
31271.0,2020-02-26,"(967.0, 1162.0]",7,19,-12
31272.0,2020-02-26,"(290.985, 545.75]",27,30,-3
31272.0,2020-02-26,"(545.75, 799.5]",13,16,-3
31272.0,2020-02-26,"(799.5, 1053.25]",10,29,-19
31272.0,2020-02-26,"(1053.25, 1307.0]",2,10,-8
31273.0,2020-02-26,"(469.542, 584.5]",1,3,-2
31273.0,2020-02-26,"(813.5, 928.0]",1,1,0
31274.0,2020-02-26,"(50.763, 361.25]",1,1,0
31274.0,2020-02-26,"(361.25, 670.5]",25,29,-4
31274.0,2020-02-26,"(670.5, 979.75]",6,14,-8
31274.0,2020-02-26,"(979.75, 1289.0]",10,21,-11
31275.0,2020-02-26,"(29.602, 380.5]",2,3,-1
31275.0,2020-02-26,"(380.5, 730.0]",17,32,-15
31275.0,2020-02-26,"(730.0, 1079.5]",12,23,-11
31275.0,2020-02-26,"(1079.5, 1429.0]",8,18,-10
31276.0,2020-02-26,"(344.139, 560.25]",16,16,0
31276.0,2020-02-26,"(560.25, 775.5]",9,11,-2
31276.0,2020-02-26,"(775.5, 990.75]",1,12,-11
31276.0,2020-02-26,"(990.75, 1206.0]",6,24,-18
31277.0,2020-02-26,"(413.049, 651.75]",41,44,-3
31277.0,2020-02-26,"(651.75, 889.5]",13,19,-6
31277.0,2020-02-26,"(889.5, 1127.25]",12,32,-20
31277.0,2020-02-26,"(1127.25, 1365.0]",1,10,-9
31278.0,2020-02-26,"(346.019, 592.25]",8,31,-23
31278.0,2020-02-26,"(592.25, 837.5]",10,15,-5
31278.0,2020-02-26,"(837.5, 1082.75]",9,17,-8
31278.0,2020-02-26,"(1082.75, 1328.0]",18,27,-9
31279.0,2020-02-26,"(414.104, 639.0]",23,24,-1
31279.0,2020-02-26,"(639.0, 863.0]",5,12,-7
31279.0,2020-02-26,"(863.0, 1087.0]",5,20,-15
31279.0,2020-02-26,"(1087.0, 1311.0]",2,13,-11
31280.0,2020-02-26,"(373.025, 617.75]",6,27,-21
31280.0,2020-02-26,"(617.75, 861.5]",3,8,-5
31280.0,2020-02-26,"(861.5, 1105.25]",8,12,-4
31280.0,2020-02-26,"(1105.25, 1349.0]",9,14,-5
31000.0,2020-02-27,"(536.25, 715.0]",1,1,0
31001.0,2020-02-27,"(406.181, 611.75]",1,2,-1
31001.0,2020-02-27,"(1021.25, 1226.0]",1,2,-1
31002.0,2020-02-27,"(459.29, 637.5]",2,5,-3
31002.0,2020-02-27,"(637.5, 815.0]",1,3,-2
31002.0,2020-02-27,"(992.5, 1170.0]",3,7,-4
31003.0,2020-02-27,"(482.137, 698.75]",2,5,-3
31003.0,2020-02-27,"(698.75, 914.5]",2,4,-2
31003.0,2020-02-27,"(914.5, 1130.25]",2,4,-2
31003.0,2020-02-27,"(1130.25, 1346.0]",2,2,0
31004.0,2020-02-27,"(493.443, 633.25]",2,5,-3
31004.0,2020-02-27,"(911.75, 1051.0]",1,1,0
31005.0,2020-02-27,"(431.166, 640.5]",4,5,-1
31005.0,2020-02-27,"(849.0, 1057.5]",2,3,-1
31006.0,2020-02-27,"(840.0, 978.0]",1,1,0
31006.0,2020-02-27,"(978.0, 1116.0]",1,1,0
31007.0,2020-02-27,"(484.092, 712.0]",3,5,-2
31007.0,2020-02-27,"(712.0, 939.0]",3,6,-3
31007.0,2020-02-27,"(1166.0, 1393.0]",2,1,1
31009.0,2020-02-27,"(480.412, 628.0]",5,5,0
31009.0,2020-02-27,"(775.0, 922.0]",3,2,1
31010.0,2020-02-27,"(303.25, 606.5]",1,1,0
31010.0,2020-02-27,"(909.75, 1213.0]",1,1,0
31011.0,2020-02-27,"(493.45, 631.5]",5,7,-2
31011.0,2020-02-27,"(769.0, 906.5]",1,2,-1
31011.0,2020-02-27,"(906.5, 1044.0]",1,5,-4
31012.0,2020-02-27,"(506.203, 706.25]",1,1,0
31012.0,2020-02-27,"(706.25, 905.5]",2,4,-2
31012.0,2020-02-27,"(1104.75, 1304.0]",1,1,0
31013.0,2020-02-27,"(753.0, 865.0]",1,2,-1
31013.0,2020-02-27,"(865.0, 977.0]",2,1,1
31014.0,2020-02-27,"(345.948, 610.0]",23,27,-4
31014.0,2020-02-27,"(873.0, 1136.0]",10,19,-9
31014.0,2020-02-27,"(1136.0, 1399.0]",4,6,-2
31015.0,2020-02-27,"(422.355, 584.25]",11,13,-2
31015.0,2020-02-27,"(584.25, 745.5]",1,3,-2
31015.0,2020-02-27,"(745.5, 906.75]",2,3,-1
31015.0,2020-02-27,"(906.75, 1068.0]",3,8,-5
31016.0,2020-02-27,"(420.144, 635.0]",2,6,-4
31016.0,2020-02-27,"(635.0, 849.0]",1,1,0
31016.0,2020-02-27,"(849.0, 1063.0]",2,4,-2
31016.0,2020-02-27,"(1063.0, 1277.0]",2,4,-2
31017.0,2020-02-27,"(480.277, 661.75]",5,7,-2
31018.0,2020-02-27,"(441.428, 585.0]",3,6,-3
31018.0,2020-02-27,"(871.0, 1014.0]",1,1,0
31019.0,2020-02-27,"(826.0, 1003.5]",1,4,-3
31019.0,2020-02-27,"(1003.5, 1181.0]",2,1,1
31020.0,2020-02-27,"(1067.821, 1112.75]",1,1,0
31021.0,2020-02-27,"(618.0, 874.0]",1,1,0
31021.0,2020-02-27,"(874.0, 1130.0]",3,2,1
31021.0,2020-02-27,"(1130.0, 1386.0]",1,4,-3
31022.0,2020-02-27,"(995.5, 1177.0]",1,3,-2
31023.0,2020-02-27,"(471.0, 498.5]",1,1,0
31024.0,2020-02-27,"(451.059, 687.25]",5,9,-4
31024.0,2020-02-27,"(687.25, 922.5]",2,5,-3
31024.0,2020-02-27,"(922.5, 1157.75]",5,11,-6
31024.0,2020-02-27,"(1157.75, 1393.0]",2,8,-6
,,,,1.0,
,,,,1.0,
31026.0,2020-02-27,"(952.25, 1224.0]",2,1,1
31027.0,2020-02-27,"(874.0, 1055.5]",1,2,-1
31027.0,2020-02-27,"(1055.5, 1237.0]",1,2,-1
31028.0,2020-02-27,"(454.018, 700.5]",2,3,-1
31028.0,2020-02-27,"(946.0, 1191.5]",2,1,1
31029.0,2020-02-27,"(133.696, 461.0]",1,2,-1
31029.0,2020-02-27,"(461.0, 787.0]",1,10,-9
31029.0,2020-02-27,"(787.0, 1113.0]",1,2,-1
31029.0,2020-02-27,"(1113.0, 1439.0]",5,6,-1
31030.0,2020-02-27,"(475.267, 659.25]",1,11,-10
31030.0,2020-02-27,"(842.5, 1025.75]",1,1,0
31030.0,2020-02-27,"(1025.75, 1209.0]",4,5,-1
31031.0,2020-02-27,"(1026.5, 1234.0]",1,3,-2
31032.0,2020-02-27,"(137.995, 390.25]",1,1,0
31032.0,2020-02-27,"(892.75, 1144.0]",1,2,-1
,,,,1.0,
,,,,1.0,
31034.0,2020-02-27,"(531.342, 696.5]",2,3,-1
31034.0,2020-02-27,"(696.5, 861.0]",1,1,0
31034.0,2020-02-27,"(1025.5, 1190.0]",1,2,-1
31035.0,2020-02-27,"(547.175, 754.25]",2,3,-1
31035.0,2020-02-27,"(754.25, 960.5]",1,2,-1
31035.0,2020-02-27,"(1166.75, 1373.0]",2,1,1
31036.0,2020-02-27,"(1010.25, 1179.0]",3,2,1
31037.0,2020-02-27,"(383.068, 617.0]",9,12,-3
31037.0,2020-02-27,"(617.0, 850.0]",2,7,-5
31037.0,2020-02-27,"(850.0, 1083.0]",4,6,-2
31037.0,2020-02-27,"(1083.0, 1316.0]",1,8,-7
31038.0,2020-02-27,"(989.25, 1319.0]",1,1,0
31039.0,2020-02-27,"(419.267, 603.25]",2,7,-5
31039.0,2020-02-27,"(603.25, 786.5]",2,3,-1
31039.0,2020-02-27,"(969.75, 1153.0]",1,5,-4
31040.0,2020-02-27,"(452.359, 613.25]",2,2,0
31040.0,2020-02-27,"(613.25, 773.5]",1,1,0
31040.0,2020-02-27,"(773.5, 933.75]",1,2,-1
31041.0,2020-02-27,"(457.4, 608.0]",1,2,-1
31041.0,2020-02-27,"(908.0, 1058.0]",1,1,0
31042.0,2020-02-27,"(439.16, 650.0]",5,7,-2
31042.0,2020-02-27,"(650.0, 860.0]",1,1,0
31042.0,2020-02-27,"(860.0, 1070.0]",1,4,-3
31042.0,2020-02-27,"(1070.0, 1280.0]",2,2,0
31043.0,2020-02-27,"(414.353, 576.75]",2,3,-1
31043.0,2020-02-27,"(738.5, 900.25]",1,2,-1
31043.0,2020-02-27,"(900.25, 1062.0]",2,6,-4
31044.0,2020-02-27,"(521.486, 650.5]",2,2,0
31045.0,2020-02-27,"(537.228, 731.0]",1,3,-2
31045.0,2020-02-27,"(731.0, 924.0]",1,1,0
31045.0,2020-02-27,"(924.0, 1117.0]",2,2,0
31045.0,2020-02-27,"(1117.0, 1310.0]",1,1,0
31046.0,2020-02-27,"(653.25, 780.5]",2,1,1
31046.0,2020-02-27,"(780.5, 907.75]",1,3,-2
31046.0,2020-02-27,"(907.75, 1035.0]",1,2,-1
31047.0,2020-02-27,"(355.985, 610.75]",18,28,-10
31047.0,2020-02-27,"(610.75, 864.5]",3,5,-2
31047.0,2020-02-27,"(864.5, 1118.25]",5,18,-13
31047.0,2020-02-27,"(1118.25, 1372.0]",2,7,-5
31048.0,2020-02-27,"(353.25, 678.5]",2,1,1
31048.0,2020-02-27,"(678.5, 1003.75]",1,6,-5
31048.0,2020-02-27,"(1003.75, 1329.0]",2,2,0
,,,,1.0,
,,,,1.0,
31050.0,2020-02-27,"(922.75, 1057.0]",2,2,0
31051.0,2020-02-27,"(677.5, 846.0]",1,2,-1
31051.0,2020-02-27,"(1014.5, 1183.0]",4,2,2
31052.0,2020-02-27,"(535.512, 658.0]",1,1,0
31052.0,2020-02-27,"(902.0, 1024.0]",1,1,0
31053.0,2020-02-27,"(1015.5, 1118.0]",1,1,0
,,,,2.0,
31055.0,2020-02-27,"(875.5, 1077.75]",2,1,1
31055.0,2020-02-27,"(1077.75, 1280.0]",3,2,1
31056.0,2020-02-27,"(944.75, 1100.0]",1,1,0
31057.0,2020-02-27,"(1061.75, 1069.0]",1,1,0
31058.0,2020-02-27,"(929.86, 965.0]",1,1,0
31058.0,2020-02-27,"(1000.0, 1035.0]",1,2,-1
31059.0,2020-02-27,"(1090.5, 1113.0]",1,1,0
31060.0,2020-02-27,"(725.25, 967.0]",2,1,1
,,,,1.0,
,,,,1.0,
31062.0,2020-02-27,"(1079.998, 1080.5]",1,1,0
31062.0,2020-02-27,"(1080.5, 1081.0]",1,1,0
,,,,1.0,
,,,,1.0,
31064.0,2020-02-27,"(486.411, 634.25]",1,3,-2
31064.0,2020-02-27,"(634.25, 781.5]",1,2,-1
31064.0,2020-02-27,"(781.5, 928.75]",1,2,-1
31064.0,2020-02-27,"(928.75, 1076.0]",5,10,-5
31065.0,2020-02-27,"(955.5, 1125.0]",3,1,2
,,,,2.0,
31067.0,2020-02-27,"(74.867, 359.25]",1,1,0
31067.0,2020-02-27,"(359.25, 642.5]",1,3,-2
31067.0,2020-02-27,"(925.75, 1209.0]",4,5,-1
31068.0,2020-02-27,"(952.75, 1078.0]",1,1,0
31069.0,2020-02-27,"(1037.25, 1222.0]",4,2,2
31070.0,2020-02-27,"(482.252, 670.0]",1,3,-2
31070.0,2020-02-27,"(1044.0, 1231.0]",1,2,-1
31071.0,2020-02-27,"(481.259, 667.25]",1,3,-2
31071.0,2020-02-27,"(852.5, 1037.75]",2,1,1
31071.0,2020-02-27,"(1037.75, 1223.0]",3,2,1
,,,,2.0,
31073.0,2020-02-27,"(759.25, 840.0]",1,1,0
31074.0,2020-02-27,"(803.5, 953.25]",2,2,0
31074.0,2020-02-27,"(953.25, 1103.0]",1,2,-1
31075.0,2020-02-27,"(966.5, 1114.0]",1,1,0
31076.0,2020-02-27,"(822.75, 1097.0]",1,1,0
31077.0,2020-02-27,"(622.5, 743.0]",1,3,-2
31077.0,2020-02-27,"(743.0, 863.5]",1,1,0
31077.0,2020-02-27,"(863.5, 984.0]",1,1,0
31078.0,2020-02-27,"(477.375, 634.25]",6,6,0
31078.0,2020-02-27,"(634.25, 790.5]",2,5,-3
31078.0,2020-02-27,"(946.75, 1103.0]",1,1,0
31079.0,2020-02-27,"(373.944, 639.0]",1,12,-11
31079.0,2020-02-27,"(903.0, 1167.0]",2,1,1
31079.0,2020-02-27,"(1167.0, 1431.0]",4,2,2
31080.0,2020-02-27,"(584.0, 824.0]",1,6,-5
31080.0,2020-02-27,"(824.0, 1064.0]",2,4,-2
31080.0,2020-02-27,"(1064.0, 1304.0]",10,3,7
31081.0,2020-02-27,"(485.704, 560.0]",1,1,0
31081.0,2020-02-27,"(560.0, 634.0]",2,2,0
31081.0,2020-02-27,"(708.0, 782.0]",1,1,0
,,,,1.0,
,,,,1.0,
31083.0,2020-02-27,"(903.0, 1132.0]",2,4,-2
31083.0,2020-02-27,"(1132.0, 1361.0]",2,2,0
31084.0,2020-02-27,"(29.725, 349.75]",1,1,0
31084.0,2020-02-27,"(349.75, 668.5]",4,6,-2
31084.0,2020-02-27,"(668.5, 987.25]",2,3,-1
31084.0,2020-02-27,"(987.25, 1306.0]",2,7,-5
31085.0,2020-02-27,"(400.113, 622.75]",1,3,-2
31085.0,2020-02-27,"(1066.25, 1288.0]",1,1,0
31086.0,2020-02-27,"(801.0, 916.0]",1,1,0
31087.0,2020-02-27,"(772.0, 940.0]",1,2,-1
31087.0,2020-02-27,"(940.0, 1108.0]",2,1,1
31088.0,2020-02-27,"(666.5, 861.0]",1,1,0
31088.0,2020-02-27,"(861.0, 1055.5]",1,2,-1
31088.0,2020-02-27,"(1055.5, 1250.0]",3,1,2
31089.0,2020-02-27,"(478.045, 717.75]",7,10,-3
31089.0,2020-02-27,"(717.75, 956.5]",3,4,-1
31089.0,2020-02-27,"(956.5, 1195.25]",1,14,-13
31090.0,2020-02-27,"(636.784, 691.0]",1,1,0
31090.0,2020-02-27,"(799.0, 853.0]",1,1,0
31091.0,2020-02-27,"(827.5, 1026.75]",1,5,-4
31091.0,2020-02-27,"(1026.75, 1226.0]",3,1,2
31092.0,2020-02-27,"(1028.0, 1192.0]",3,1,2
31093.0,2020-02-27,"(1026.75, 1196.0]",1,1,0
,,,,2.0,
,,,,2.0,
31096.0,2020-02-27,"(926.75, 927.0]",1,1,0
31097.0,2020-02-27,"(498.243, 688.25]",4,6,-2
31097.0,2020-02-27,"(688.25, 877.5]",2,4,-2
31097.0,2020-02-27,"(877.5, 1066.75]",1,6,-5
31097.0,2020-02-27,"(1066.75, 1256.0]",1,4,-3
31098.0,2020-02-27,"(404.348, 568.0]",2,6,-4
31098.0,2020-02-27,"(568.0, 731.0]",3,4,-1
31098.0,2020-02-27,"(894.0, 1057.0]",5,7,-2
31099.0,2020-02-27,"(554.0, 712.0]",1,2,-1
31099.0,2020-02-27,"(870.0, 1028.0]",2,1,1
31100.0,2020-02-27,"(429.221, 624.75]",13,14,-1
31100.0,2020-02-27,"(624.75, 819.5]",1,2,-1
31100.0,2020-02-27,"(819.5, 1014.25]",1,4,-3
31101.0,2020-02-27,"(355.974, 613.5]",8,41,-33
31101.0,2020-02-27,"(613.5, 870.0]",6,12,-6
31101.0,2020-02-27,"(870.0, 1126.5]",30,42,-12
31101.0,2020-02-27,"(1126.5, 1383.0]",14,21,-7
31102.0,2020-02-27,"(321.91, 595.5]",1,18,-17
31102.0,2020-02-27,"(595.5, 868.0]",1,4,-3
31102.0,2020-02-27,"(868.0, 1140.5]",2,6,-4
31102.0,2020-02-27,"(1140.5, 1413.0]",7,10,-3
31103.0,2020-02-27,"(355.994, 608.5]",3,28,-25
31103.0,2020-02-27,"(608.5, 860.0]",1,8,-7
31103.0,2020-02-27,"(860.0, 1111.5]",2,9,-7
31103.0,2020-02-27,"(1111.5, 1363.0]",9,16,-7
31104.0,2020-02-27,"(397.5, 734.0]",7,5,2
31104.0,2020-02-27,"(734.0, 1070.5]",9,13,-4
31104.0,2020-02-27,"(1070.5, 1407.0]",17,15,2
31105.0,2020-02-27,"(343.98, 600.0]",2,11,-9
31105.0,2020-02-27,"(855.0, 1110.0]",4,2,2
31105.0,2020-02-27,"(1110.0, 1365.0]",2,11,-9
31106.0,2020-02-27,"(454.091, 682.25]",1,7,-6
31106.0,2020-02-27,"(682.25, 909.5]",1,2,-1
31106.0,2020-02-27,"(909.5, 1136.75]",2,2,0
31106.0,2020-02-27,"(1136.75, 1364.0]",1,1,0
31107.0,2020-02-27,"(340.949, 604.75]",3,22,-19
31107.0,2020-02-27,"(604.75, 867.5]",1,3,-2
31107.0,2020-02-27,"(867.5, 1130.25]",12,16,-4
31107.0,2020-02-27,"(1130.25, 1393.0]",4,7,-3
31108.0,2020-02-27,"(358.007, 607.25]",8,27,-19
31108.0,2020-02-27,"(607.25, 855.5]",5,10,-5
31108.0,2020-02-27,"(855.5, 1103.75]",14,23,-9
31108.0,2020-02-27,"(1103.75, 1352.0]",16,21,-5
31109.0,2020-02-27,"(42.672, 376.0]",1,3,-2
31109.0,2020-02-27,"(376.0, 708.0]",8,22,-14
31109.0,2020-02-27,"(708.0, 1040.0]",7,13,-6
31109.0,2020-02-27,"(1040.0, 1372.0]",15,26,-11
31110.0,2020-02-27,"(361.051, 599.25]",14,32,-18
31110.0,2020-02-27,"(599.25, 836.5]",4,11,-7
31110.0,2020-02-27,"(836.5, 1073.75]",8,16,-8
31110.0,2020-02-27,"(1073.75, 1311.0]",10,19,-9
31111.0,2020-02-27,"(351.082, 581.5]",11,24,-13
31111.0,2020-02-27,"(581.5, 811.0]",3,6,-3
31111.0,2020-02-27,"(811.0, 1040.5]",3,8,-5
31111.0,2020-02-27,"(1040.5, 1270.0]",15,20,-5
31112.0,2020-02-27,"(852.0, 1000.0]",2,2,0
31112.0,2020-02-27,"(1000.0, 1148.0]",3,1,2
31113.0,2020-02-27,"(611.5, 880.0]",1,22,-21
31113.0,2020-02-27,"(880.0, 1148.5]",6,12,-6
31113.0,2020-02-27,"(1148.5, 1417.0]",4,11,-7
31114.0,2020-02-27,"(328.977, 585.75]",2,19,-17
31114.0,2020-02-27,"(585.75, 841.5]",2,4,-2
31114.0,2020-02-27,"(841.5, 1097.25]",7,10,-3
31114.0,2020-02-27,"(1097.25, 1353.0]",7,16,-9
31115.0,2020-02-27,"(244.83, 538.5]",1,13,-12
31115.0,2020-02-27,"(538.5, 831.0]",2,11,-9
31115.0,2020-02-27,"(831.0, 1123.5]",11,18,-7
31115.0,2020-02-27,"(1123.5, 1416.0]",14,23,-9
31116.0,2020-02-27,"(328.999, 580.25]",7,30,-23
31116.0,2020-02-27,"(580.25, 830.5]",7,14,-7
31116.0,2020-02-27,"(830.5, 1080.75]",6,9,-3
31116.0,2020-02-27,"(1080.75, 1331.0]",18,21,-3
31117.0,2020-02-27,"(62.654, 400.5]",1,3,-2
31117.0,2020-02-27,"(400.5, 737.0]",2,11,-9
31117.0,2020-02-27,"(737.0, 1073.5]",5,15,-10
31117.0,2020-02-27,"(1073.5, 1410.0]",8,12,-4
31118.0,2020-02-27,"(317.932, 586.0]",3,17,-14
31118.0,2020-02-27,"(586.0, 853.0]",1,4,-3
31118.0,2020-02-27,"(853.0, 1120.0]",7,8,-1
31118.0,2020-02-27,"(1120.0, 1387.0]",9,12,-3
31119.0,2020-02-27,"(310.989, 564.75]",9,23,-14
31119.0,2020-02-27,"(564.75, 817.5]",2,3,-1
31119.0,2020-02-27,"(817.5, 1070.25]",10,16,-6
31119.0,2020-02-27,"(1070.25, 1323.0]",15,23,-8
31120.0,2020-02-27,"(450.099, 676.25]",1,17,-16
31120.0,2020-02-27,"(676.25, 901.5]",2,3,-1
31120.0,2020-02-27,"(901.5, 1126.75]",5,7,-2
31120.0,2020-02-27,"(1126.75, 1352.0]",5,6,-1
31121.0,2020-02-27,"(350.972, 609.0]",12,21,-9
31121.0,2020-02-27,"(609.0, 866.0]",2,3,-1
31121.0,2020-02-27,"(866.0, 1123.0]",7,14,-7
31121.0,2020-02-27,"(1123.0, 1380.0]",7,11,-4
31122.0,2020-02-27,"(424.035, 666.25]",2,13,-11
31122.0,2020-02-27,"(666.25, 907.5]",2,4,-2
31122.0,2020-02-27,"(907.5, 1148.75]",5,8,-3
31122.0,2020-02-27,"(1148.75, 1390.0]",6,8,-2
31123.0,2020-02-27,"(54.651, 393.25]",1,2,-1
31123.0,2020-02-27,"(393.25, 730.5]",1,26,-25
31123.0,2020-02-27,"(730.5, 1067.75]",1,5,-4
31123.0,2020-02-27,"(1067.75, 1405.0]",8,16,-8
31124.0,2020-02-27,"(301.875, 584.25]",20,38,-18
31124.0,2020-02-27,"(584.25, 865.5]",1,12,-11
31124.0,2020-02-27,"(865.5, 1146.75]",16,41,-25
31124.0,2020-02-27,"(1146.75, 1428.0]",6,20,-14
31125.0,2020-02-27,"(355.943, 621.25]",5,28,-23
31125.0,2020-02-27,"(621.25, 885.5]",5,8,-3
31125.0,2020-02-27,"(885.5, 1149.75]",22,28,-6
31125.0,2020-02-27,"(1149.75, 1414.0]",3,8,-5
31126.0,2020-02-27,"(297.884, 578.0]",5,20,-15
31126.0,2020-02-27,"(578.0, 857.0]",1,3,-2
31126.0,2020-02-27,"(857.0, 1136.0]",12,15,-3
31126.0,2020-02-27,"(1136.0, 1415.0]",9,10,-1
31127.0,2020-02-27,"(207.855, 495.25]",6,9,-3
31127.0,2020-02-27,"(495.25, 781.5]",8,12,-4
31127.0,2020-02-27,"(781.5, 1067.75]",12,26,-14
31127.0,2020-02-27,"(1067.75, 1354.0]",15,32,-17
31128.0,2020-02-27,"(350.957, 612.75]",18,28,-10
31128.0,2020-02-27,"(612.75, 873.5]",8,18,-10
31128.0,2020-02-27,"(873.5, 1134.25]",20,25,-5
31128.0,2020-02-27,"(1134.25, 1395.0]",3,9,-6
31129.0,2020-02-27,"(490.377, 646.75]",6,9,-3
31129.0,2020-02-27,"(646.75, 802.5]",4,10,-6
31129.0,2020-02-27,"(802.5, 958.25]",4,4,0
31129.0,2020-02-27,"(958.25, 1114.0]",2,7,-5
31130.0,2020-02-27,"(593.25, 859.5]",7,11,-4
31130.0,2020-02-27,"(859.5, 1125.75]",9,11,-2
31130.0,2020-02-27,"(1125.75, 1392.0]",7,14,-7
31131.0,2020-02-27,"(347.939, 614.25]",2,12,-10
31131.0,2020-02-27,"(879.5, 1144.75]",5,1,4
31131.0,2020-02-27,"(1144.75, 1410.0]",4,6,-2
31200.0,2020-02-27,"(339.974, 597.5]",30,44,-14
31200.0,2020-02-27,"(597.5, 854.0]",10,18,-8
31200.0,2020-02-27,"(854.0, 1110.5]",11,26,-15
31200.0,2020-02-27,"(1110.5, 1367.0]",7,24,-17
31201.0,2020-02-27,"(300.895, 578.25]",17,41,-24
31201.0,2020-02-27,"(578.25, 854.5]",12,16,-4
31201.0,2020-02-27,"(854.5, 1130.75]",26,44,-18
31201.0,2020-02-27,"(1130.75, 1407.0]",13,27,-14
,,,,2.0,
31203.0,2020-02-27,"(335.958, 597.5]",4,22,-18
31203.0,2020-02-27,"(597.5, 858.0]",4,9,-5
31203.0,2020-02-27,"(858.0, 1118.5]",20,28,-8
31203.0,2020-02-27,"(1118.5, 1379.0]",16,22,-6
31204.0,2020-02-27,"(237.828, 532.0]",9,9,0
31204.0,2020-02-27,"(532.0, 825.0]",2,10,-8
31204.0,2020-02-27,"(825.0, 1118.0]",8,19,-11
31204.0,2020-02-27,"(1118.0, 1411.0]",3,6,-3
31205.0,2020-02-27,"(414.057, 650.75]",27,30,-3
31205.0,2020-02-27,"(650.75, 886.5]",10,16,-6
31205.0,2020-02-27,"(886.5, 1122.25]",10,30,-20
31205.0,2020-02-27,"(1122.25, 1358.0]",5,13,-8
31206.0,2020-02-27,"(401.002, 651.5]",3,3,0
31206.0,2020-02-27,"(901.0, 1150.5]",2,2,0
31207.0,2020-02-27,"(546.5, 740.0]",1,5,-4
31207.0,2020-02-27,"(740.0, 933.5]",1,3,-2
31207.0,2020-02-27,"(933.5, 1127.0]",2,4,-2
31208.0,2020-02-27,"(358.191, 561.25]",11,12,-1
31208.0,2020-02-27,"(561.25, 763.5]",1,3,-2
31208.0,2020-02-27,"(763.5, 965.75]",4,11,-7
31208.0,2020-02-27,"(965.75, 1168.0]",3,13,-10
31209.0,2020-02-27,"(457.26, 643.0]",2,3,-1
31209.0,2020-02-27,"(1013.0, 1198.0]",6,8,-2
31211.0,2020-02-27,"(389.099, 615.25]",7,10,-3
31211.0,2020-02-27,"(615.25, 840.5]",1,1,0
31211.0,2020-02-27,"(840.5, 1065.75]",4,5,-1
31211.0,2020-02-27,"(1065.75, 1291.0]",3,10,-7
31212.0,2020-02-27,"(319.882, 600.5]",26,44,-18
31212.0,2020-02-27,"(600.5, 880.0]",19,29,-10
31212.0,2020-02-27,"(880.0, 1159.5]",12,28,-16
31212.0,2020-02-27,"(1159.5, 1439.0]",6,13,-7
31213.0,2020-02-27,"(325.917, 597.75]",33,48,-15
31213.0,2020-02-27,"(597.75, 868.5]",11,23,-12
31213.0,2020-02-27,"(868.5, 1139.25]",16,32,-16
31213.0,2020-02-27,"(1139.25, 1410.0]",7,13,-6
31214.0,2020-02-27,"(409.127, 628.25]",9,30,-21
31214.0,2020-02-27,"(628.25, 846.5]",6,8,-2
31214.0,2020-02-27,"(846.5, 1064.75]",8,14,-6
31214.0,2020-02-27,"(1064.75, 1283.0]",17,25,-8
31215.0,2020-02-27,"(330.022, 575.5]",15,16,-1
31215.0,2020-02-27,"(575.5, 820.0]",8,9,-1
31215.0,2020-02-27,"(820.0, 1064.5]",5,9,-4
31215.0,2020-02-27,"(1064.5, 1309.0]",1,6,-5
31216.0,2020-02-27,"(448.079, 679.25]",19,20,-1
31216.0,2020-02-27,"(679.25, 909.5]",7,12,-5
31216.0,2020-02-27,"(909.5, 1139.75]",3,12,-9
31216.0,2020-02-27,"(1139.75, 1370.0]",2,11,-9
31217.0,2020-02-27,"(326.116, 548.0]",11,11,0
31217.0,2020-02-27,"(548.0, 769.0]",1,4,-3
31217.0,2020-02-27,"(769.0, 990.0]",2,8,-6
31217.0,2020-02-27,"(990.0, 1211.0]",2,6,-4
31218.0,2020-02-27,"(324.166, 533.5]",6,17,-11
31218.0,2020-02-27,"(533.5, 742.0]",7,10,-3
31218.0,2020-02-27,"(742.0, 950.5]",8,11,-3
31218.0,2020-02-27,"(950.5, 1159.0]",7,15,-8
31219.0,2020-02-27,"(364.287, 543.25]",8,8,0
31219.0,2020-02-27,"(543.25, 721.5]",5,5,0
31219.0,2020-02-27,"(721.5, 899.75]",1,3,-2
31220.0,2020-02-27,"(379.298, 555.5]",13,15,-2
31220.0,2020-02-27,"(555.5, 731.0]",3,7,-4
31220.0,2020-02-27,"(731.0, 906.5]",3,5,-2
31220.0,2020-02-27,"(906.5, 1082.0]",1,13,-12
31221.0,2020-02-27,"(438.032, 681.0]",30,32,-2
31221.0,2020-02-27,"(681.0, 923.0]",11,17,-6
31221.0,2020-02-27,"(923.0, 1165.0]",15,30,-15
31221.0,2020-02-27,"(1165.0, 1407.0]",7,9,-2
31222.0,2020-02-27,"(311.022, 556.5]",15,17,-2
31222.0,2020-02-27,"(556.5, 801.0]",1,6,-5
31222.0,2020-02-27,"(801.0, 1045.5]",4,13,-9
31222.0,2020-02-27,"(1045.5, 1290.0]",3,14,-11
31223.0,2020-02-27,"(37.604, 388.0]",3,4,-1
31223.0,2020-02-27,"(388.0, 737.0]",18,42,-24
31223.0,2020-02-27,"(737.0, 1086.0]",14,27,-13
31223.0,2020-02-27,"(1086.0, 1435.0]",11,25,-14
31224.0,2020-02-27,"(475.208, 674.0]",13,15,-2
31224.0,2020-02-27,"(674.0, 872.0]",1,3,-2
31224.0,2020-02-27,"(872.0, 1070.0]",2,9,-7
31224.0,2020-02-27,"(1070.0, 1268.0]",4,9,-5
31225.0,2020-02-27,"(424.175, 631.25]",2,5,-3
31225.0,2020-02-27,"(837.5, 1043.75]",4,1,3
31225.0,2020-02-27,"(1043.75, 1250.0]",2,8,-6
31226.0,2020-02-27,"(313.925, 583.75]",4,7,-3
31226.0,2020-02-27,"(852.5, 1121.25]",4,1,3
31226.0,2020-02-27,"(1121.25, 1390.0]",3,10,-7
31227.0,2020-02-27,"(444.169, 652.75]",26,33,-7
31227.0,2020-02-27,"(652.75, 860.5]",8,14,-6
31227.0,2020-02-27,"(860.5, 1068.25]",6,15,-9
31227.0,2020-02-27,"(1068.25, 1276.0]",3,13,-10
31228.0,2020-02-27,"(355.938, 622.5]",15,20,-5
31228.0,2020-02-27,"(622.5, 888.0]",12,20,-8
31228.0,2020-02-27,"(888.0, 1153.5]",18,29,-11
31228.0,2020-02-27,"(1153.5, 1419.0]",3,12,-9
31229.0,2020-02-27,"(301.892, 580.0]",10,55,-45
31229.0,2020-02-27,"(580.0, 857.0]",6,17,-11
31229.0,2020-02-27,"(857.0, 1134.0]",26,43,-17
31229.0,2020-02-27,"(1134.0, 1411.0]",10,19,-9
31230.0,2020-02-27,"(373.995, 626.25]",41,45,-4
31230.0,2020-02-27,"(626.25, 877.5]",8,13,-5
31230.0,2020-02-27,"(877.5, 1128.75]",7,30,-23
31230.0,2020-02-27,"(1128.75, 1380.0]",1,16,-15
31231.0,2020-02-27,"(339.022, 584.5]",17,19,-2
31231.0,2020-02-27,"(584.5, 829.0]",8,18,-10
31231.0,2020-02-27,"(829.0, 1073.5]",8,21,-13
31232.0,2020-02-27,"(294.903, 570.25]",10,16,-6
31232.0,2020-02-27,"(570.25, 844.5]",7,10,-3
31232.0,2020-02-27,"(844.5, 1118.75]",6,9,-3
31232.0,2020-02-27,"(1118.75, 1393.0]",8,17,-9
31233.0,2020-02-27,"(423.096, 650.0]",44,49,-5
31233.0,2020-02-27,"(650.0, 876.0]",7,7,0
31233.0,2020-02-27,"(876.0, 1102.0]",15,31,-16
31233.0,2020-02-27,"(1102.0, 1328.0]",5,13,-8
31234.0,2020-02-27,"(375.969, 634.75]",25,40,-15
31234.0,2020-02-27,"(634.75, 892.5]",8,12,-4
31234.0,2020-02-27,"(892.5, 1150.25]",18,29,-11
31234.0,2020-02-27,"(1150.25, 1408.0]",8,17,-9
31235.0,2020-02-27,"(508.377, 664.75]",5,5,0
31235.0,2020-02-27,"(820.5, 976.25]",2,1,1
31235.0,2020-02-27,"(976.25, 1132.0]",1,4,-3
31236.0,2020-02-27,"(120.81, 419.5]",1,3,-2
31236.0,2020-02-27,"(419.5, 717.0]",16,20,-4
31236.0,2020-02-27,"(717.0, 1014.5]",7,22,-15
31236.0,2020-02-27,"(1014.5, 1312.0]",6,23,-17
31237.0,2020-02-27,"(374.02, 620.0]",7,15,-8
31237.0,2020-02-27,"(620.0, 865.0]",3,10,-7
31237.0,2020-02-27,"(865.0, 1110.0]",11,16,-5
31237.0,2020-02-27,"(1110.0, 1355.0]",8,18,-10
31238.0,2020-02-27,"(44.741, 360.75]",1,2,-1
31238.0,2020-02-27,"(360.75, 675.5]",16,19,-3
31238.0,2020-02-27,"(675.5, 990.25]",8,14,-6
31238.0,2020-02-27,"(990.25, 1305.0]",2,22,-20
31239.0,2020-02-27,"(334.016, 581.0]",24,28,-4
31239.0,2020-02-27,"(827.0, 1073.0]",7,1,6
31239.0,2020-02-27,"(1073.0, 1319.0]",7,23,-16
31240.0,2020-02-27,"(609.5, 776.0]",1,1,0
31240.0,2020-02-27,"(776.0, 942.5]",2,2,0
31240.0,2020-02-27,"(942.5, 1109.0]",2,5,-3
31241.0,2020-02-27,"(43.699, 370.25]",2,2,0
31241.0,2020-02-27,"(370.25, 695.5]",24,49,-25
31241.0,2020-02-27,"(695.5, 1020.75]",11,21,-10
31241.0,2020-02-27,"(1020.75, 1346.0]",19,45,-26
31242.0,2020-02-27,"(360.1, 586.0]",25,28,-3
31242.0,2020-02-27,"(586.0, 811.0]",7,12,-5
31242.0,2020-02-27,"(811.0, 1036.0]",4,17,-13
31242.0,2020-02-27,"(1036.0, 1261.0]",4,24,-20
31243.0,2020-02-27,"(342.75, 644.5]",30,2,28
31243.0,2020-02-27,"(644.5, 946.25]",1,35,-34
31243.0,2020-02-27,"(946.25, 1248.0]",7,5,2
31244.0,2020-02-27,"(351.933, 619.75]",11,19,-8
31244.0,2020-02-27,"(619.75, 886.5]",7,7,0
31244.0,2020-02-27,"(886.5, 1153.25]",9,19,-10
31244.0,2020-02-27,"(1153.25, 1420.0]",2,4,-2
31245.0,2020-02-27,"(419.082, 649.5]",8,20,-12
31245.0,2020-02-27,"(649.5, 879.0]",2,4,-2
31245.0,2020-02-27,"(879.0, 1108.5]",8,15,-7
31245.0,2020-02-27,"(1108.5, 1338.0]",9,14,-5
31246.0,2020-02-27,"(25.714, 348.5]",1,2,-1
31246.0,2020-02-27,"(348.5, 670.0]",12,20,-8
31246.0,2020-02-27,"(670.0, 991.5]",12,18,-6
31246.0,2020-02-27,"(991.5, 1313.0]",15,27,-12
31247.0,2020-02-27,"(423.231, 616.25]",9,10,-1
31247.0,2020-02-27,"(616.25, 808.5]",2,2,0
31247.0,2020-02-27,"(808.5, 1000.75]",2,5,-3
31247.0,2020-02-27,"(1000.75, 1193.0]",3,7,-4
31248.0,2020-02-27,"(426.259, 612.25]",5,11,-6
31248.0,2020-02-27,"(797.5, 982.75]",1,2,-1
31248.0,2020-02-27,"(982.75, 1168.0]",6,18,-12
31249.0,2020-02-27,"(477.477, 608.75]",3,4,-1
31249.0,2020-02-27,"(870.25, 1001.0]",1,2,-1
31250.0,2020-02-27,"(335.011, 583.25]",16,19,-3
31250.0,2020-02-27,"(583.25, 830.5]",2,4,-2
31250.0,2020-02-27,"(830.5, 1077.75]",4,14,-10
31250.0,2020-02-27,"(1077.75, 1325.0]",2,9,-7
31251.0,2020-02-27,"(362.02, 608.0]",19,32,-13
31251.0,2020-02-27,"(608.0, 853.0]",3,6,-3
31251.0,2020-02-27,"(853.0, 1098.0]",9,23,-14
31251.0,2020-02-27,"(1098.0, 1343.0]",3,10,-7
31252.0,2020-02-27,"(419.179, 625.25]",16,18,-2
31252.0,2020-02-27,"(830.5, 1035.75]",1,2,-1
31252.0,2020-02-27,"(1035.75, 1241.0]",3,4,-1
31253.0,2020-02-27,"(390.149, 603.75]",11,11,0
31253.0,2020-02-27,"(603.75, 816.5]",1,2,-1
31253.0,2020-02-27,"(816.5, 1029.25]",3,10,-7
31253.0,2020-02-27,"(1029.25, 1242.0]",3,13,-10
31254.0,2020-02-27,"(386.078, 617.5]",28,33,-5
31254.0,2020-02-27,"(617.5, 848.0]",2,4,-2
31254.0,2020-02-27,"(848.0, 1078.5]",1,19,-18
31254.0,2020-02-27,"(1078.5, 1309.0]",3,6,-3
31255.0,2020-02-27,"(185.941, 451.75]",2,4,-2
31255.0,2020-02-27,"(451.75, 716.5]",14,17,-3
31255.0,2020-02-27,"(716.5, 981.25]",9,19,-10
31255.0,2020-02-27,"(981.25, 1246.0]",6,21,-15
31256.0,2020-02-27,"(425.011, 673.25]",12,12,0
31256.0,2020-02-27,"(673.25, 920.5]",1,3,-2
31256.0,2020-02-27,"(920.5, 1167.75]",11,23,-12
31256.0,2020-02-27,"(1167.75, 1415.0]",2,5,-3
31257.0,2020-02-27,"(21.639, 363.25]",1,2,-1
31257.0,2020-02-27,"(363.25, 703.5]",22,36,-14
31257.0,2020-02-27,"(703.5, 1043.75]",10,22,-12
31257.0,2020-02-27,"(1043.75, 1384.0]",11,31,-20
31258.0,2020-02-27,"(52.016, 299.0]",1,2,-1
31258.0,2020-02-27,"(299.0, 545.0]",2,4,-2
31258.0,2020-02-27,"(545.0, 791.0]",4,8,-4
31258.0,2020-02-27,"(791.0, 1037.0]",3,8,-5
31259.0,2020-02-27,"(476.353, 638.75]",6,6,0
31259.0,2020-02-27,"(800.5, 962.25]",1,2,-1
31260.0,2020-02-27,"(384.258, 570.5]",16,17,-1
31260.0,2020-02-27,"(570.5, 756.0]",2,2,0
31260.0,2020-02-27,"(756.0, 941.5]",2,5,-3
31260.0,2020-02-27,"(941.5, 1127.0]",1,19,-18
31261.0,2020-02-27,"(388.229, 581.75]",9,9,0
31261.0,2020-02-27,"(581.75, 774.5]",2,3,-1
31261.0,2020-02-27,"(774.5, 967.25]",2,6,-4
31261.0,2020-02-27,"(967.25, 1160.0]",4,8,-4
31262.0,2020-02-27,"(451.264, 636.0]",11,13,-2
31262.0,2020-02-27,"(636.0, 820.0]",1,3,-2
31262.0,2020-02-27,"(820.0, 1004.0]",2,6,-4
31262.0,2020-02-27,"(1004.0, 1188.0]",1,6,-5
31263.0,2020-02-27,"(363.992, 617.0]",22,33,-11
31263.0,2020-02-27,"(617.0, 869.0]",2,3,-1
31263.0,2020-02-27,"(869.0, 1121.0]",8,21,-13
31263.0,2020-02-27,"(1121.0, 1373.0]",3,9,-6
31264.0,2020-02-27,"(280.924, 551.0]",9,12,-3
31264.0,2020-02-27,"(551.0, 820.0]",6,11,-5
31264.0,2020-02-27,"(820.0, 1089.0]",7,15,-8
31264.0,2020-02-27,"(1089.0, 1358.0]",1,6,-5
31265.0,2020-02-27,"(379.004, 629.0]",12,36,-24
31265.0,2020-02-27,"(629.0, 878.0]",10,14,-4
31265.0,2020-02-27,"(878.0, 1127.0]",17,33,-16
31265.0,2020-02-27,"(1127.0, 1376.0]",12,18,-6
31266.0,2020-02-27,"(289.894, 567.5]",5,34,-29
31266.0,2020-02-27,"(567.5, 844.0]",9,21,-12
31266.0,2020-02-27,"(844.0, 1120.5]",17,31,-14
31266.0,2020-02-27,"(1120.5, 1397.0]",17,27,-10
31267.0,2020-02-27,"(412.989, 666.75]",16,33,-17
31267.0,2020-02-27,"(666.75, 919.5]",5,12,-7
31267.0,2020-02-27,"(919.5, 1172.25]",15,23,-8
31267.0,2020-02-27,"(1172.25, 1425.0]",4,10,-6
31268.0,2020-02-27,"(327.039, 568.25]",14,37,-23
31268.0,2020-02-27,"(568.25, 808.5]",7,16,-9
31268.0,2020-02-27,"(808.5, 1048.75]",9,13,-4
31268.0,2020-02-27,"(1048.75, 1289.0]",20,25,-5
31269.0,2020-02-27,"(375.034, 617.5]",5,8,-3
31269.0,2020-02-27,"(617.5, 859.0]",7,11,-4
31269.0,2020-02-27,"(859.0, 1100.5]",1,7,-6
31269.0,2020-02-27,"(1100.5, 1342.0]",2,9,-7
31270.0,2020-02-27,"(315.896, 593.0]",9,14,-5
31270.0,2020-02-27,"(593.0, 869.0]",7,9,-2
31270.0,2020-02-27,"(869.0, 1145.0]",10,19,-9
31270.0,2020-02-27,"(1145.0, 1421.0]",1,3,-2
31271.0,2020-02-27,"(414.106, 638.5]",15,16,-1
31271.0,2020-02-27,"(638.5, 862.0]",3,6,-3
31271.0,2020-02-27,"(862.0, 1085.5]",8,17,-9
31271.0,2020-02-27,"(1085.5, 1309.0]",2,11,-9
31272.0,2020-02-27,"(400.225, 594.75]",22,23,-1
31272.0,2020-02-27,"(594.75, 788.5]",2,5,-3
31272.0,2020-02-27,"(788.5, 982.25]",2,9,-7
31272.0,2020-02-27,"(982.25, 1176.0]",6,18,-12
31273.0,2020-02-27,"(465.547, 579.25]",1,2,-1
31273.0,2020-02-27,"(579.25, 692.5]",5,7,-2
31273.0,2020-02-27,"(692.5, 805.75]",1,1,0
31273.0,2020-02-27,"(805.75, 919.0]",1,1,0
31274.0,2020-02-27,"(427.06, 663.0]",16,18,-2
31274.0,2020-02-27,"(663.0, 898.0]",3,7,-4
31274.0,2020-02-27,"(898.0, 1133.0]",3,13,-10
31274.0,2020-02-27,"(1133.0, 1368.0]",2,2,0
31275.0,2020-02-27,"(323.972, 582.0]",12,20,-8
31275.0,2020-02-27,"(582.0, 839.0]",8,14,-6
31275.0,2020-02-27,"(839.0, 1096.0]",13,28,-15
31275.0,2020-02-27,"(1096.0, 1353.0]",9,18,-9
31276.0,2020-02-27,"(429.152, 642.0]",23,26,-3
31276.0,2020-02-27,"(642.0, 854.0]",4,6,-2
31276.0,2020-02-27,"(854.0, 1066.0]",1,12,-11
31277.0,2020-02-27,"(416.243, 606.25]",33,37,-4
31277.0,2020-02-27,"(606.25, 795.5]",6,9,-3
31277.0,2020-02-27,"(795.5, 984.75]",6,19,-13
31277.0,2020-02-27,"(984.75, 1174.0]",5,27,-22
31278.0,2020-02-27,"(375.158, 586.5]",7,18,-11
31278.0,2020-02-27,"(586.5, 797.0]",4,16,-12
31278.0,2020-02-27,"(797.0, 1007.5]",3,4,-1
31278.0,2020-02-27,"(1007.5, 1218.0]",18,25,-7
31279.0,2020-02-27,"(407.081, 637.75]",23,25,-2
31279.0,2020-02-27,"(637.75, 867.5]",1,2,-1
31279.0,2020-02-27,"(867.5, 1097.25]",6,19,-13
31279.0,2020-02-27,"(1097.25, 1327.0]",1,14,-13
31280.0,2020-02-27,"(358.989, 612.75]",9,25,-16
31280.0,2020-02-27,"(612.75, 865.5]",3,5,-2
31280.0,2020-02-27,"(865.5, 1118.25]",10,11,-1
31280.0,2020-02-27,"(1118.25, 1371.0]",8,9,-1
,,,,1.0,
,,,,1.0,
,,,,1.0,
,,,,2.0,
31002.0,2020-02-28,"(465.12, 686.0]",3,5,-2
31002.0,2020-02-28,"(686.0, 906.0]",1,2,-1
31002.0,2020-02-28,"(906.0, 1126.0]",3,7,-4
31002.0,2020-02-28,"(1126.0, 1346.0]",1,3,-2
31003.0,2020-02-28,"(442.109, 665.75]",1,2,-1
31003.0,2020-02-28,"(665.75, 888.5]",3,3,0
31003.0,2020-02-28,"(888.5, 1111.25]",3,7,-4
31003.0,2020-02-28,"(1111.25, 1334.0]",2,4,-2
31004.0,2020-02-28,"(1008.0, 1179.0]",3,2,1
31005.0,2020-02-28,"(422.126, 641.5]",4,5,-1
31005.0,2020-02-28,"(860.0, 1078.5]",3,1,2
31005.0,2020-02-28,"(1078.5, 1297.0]",2,5,-3
31006.0,2020-02-28,"(966.75, 1105.5]",2,2,0
31006.0,2020-02-28,"(1105.5, 1244.25]",1,2,-1
31007.0,2020-02-28,"(424.097, 650.75]",5,14,-9
31007.0,2020-02-28,"(650.75, 876.5]",4,6,-2
31007.0,2020-02-28,"(876.5, 1102.25]",3,13,-10
31007.0,2020-02-28,"(1102.25, 1328.0]",1,1,0
31009.0,2020-02-28,"(407.25, 543.0]",2,1,1
31010.0,2020-02-28,"(1043.781, 1098.75]",1,2,-1
31010.0,2020-02-28,"(1208.25, 1263.0]",2,1,1
31011.0,2020-02-28,"(489.225, 683.75]",4,4,0
31011.0,2020-02-28,"(877.5, 1071.25]",3,1,2
31011.0,2020-02-28,"(1071.25, 1265.0]",2,5,-3
31012.0,2020-02-28,"(534.473, 666.75]",2,2,0
31012.0,2020-02-28,"(930.25, 1062.0]",1,1,0
31013.0,2020-02-28,"(756.0, 967.0]",4,1,3
31013.0,2020-02-28,"(967.0, 1178.0]",2,7,-5
31013.0,2020-02-28,"(1178.0, 1389.0]",1,4,-3
31014.0,2020-02-28,"(133.851, 422.25]",6,6,0
31014.0,2020-02-28,"(422.25, 709.5]",14,18,-4
31014.0,2020-02-28,"(709.5, 996.75]",5,7,-2
31014.0,2020-02-28,"(996.75, 1284.0]",11,16,-5
31015.0,2020-02-28,"(452.156, 664.0]",9,10,-1
31015.0,2020-02-28,"(664.0, 875.0]",2,2,0
31015.0,2020-02-28,"(875.0, 1086.0]",2,7,-5
31015.0,2020-02-28,"(1086.0, 1297.0]",4,6,-2
31016.0,2020-02-28,"(453.233, 645.75]",2,4,-2
31016.0,2020-02-28,"(837.5, 1029.25]",1,1,0
31016.0,2020-02-28,"(1029.25, 1221.0]",1,1,0
31017.0,2020-02-28,"(498.282, 678.5]",2,3,-1
31017.0,2020-02-28,"(678.5, 858.0]",1,1,0
31017.0,2020-02-28,"(858.0, 1037.5]",1,4,-3
31017.0,2020-02-28,"(1037.5, 1217.0]",1,7,-6
31018.0,2020-02-28,"(447.401, 597.75]",2,5,-3
31018.0,2020-02-28,"(747.5, 897.25]",1,1,0
31018.0,2020-02-28,"(897.25, 1047.0]",1,1,0
31019.0,2020-02-28,"(699.75, 921.5]",1,1,0
31019.0,2020-02-28,"(921.5, 1143.25]",1,4,-3
31019.0,2020-02-28,"(1143.25, 1365.0]",1,3,-2
31020.0,2020-02-28,"(713.5, 1065.75]",1,1,0
31020.0,2020-02-28,"(1065.75, 1418.0]",2,1,1
31021.0,2020-02-28,"(379.061, 614.75]",1,5,-4
31021.0,2020-02-28,"(614.75, 849.5]",1,1,0
31021.0,2020-02-28,"(849.5, 1084.25]",1,4,-3
31021.0,2020-02-28,"(1084.25, 1319.0]",2,5,-3
31022.0,2020-02-28,"(718.5, 927.0]",5,2,3
31022.0,2020-02-28,"(927.0, 1135.5]",4,8,-4
31022.0,2020-02-28,"(1135.5, 1344.0]",1,9,-8
31023.0,2020-02-28,"(429.118, 650.5]",1,1,0
31023.0,2020-02-28,"(650.5, 871.0]",1,1,0
31024.0,2020-02-28,"(456.131, 674.25]",2,4,-2
31024.0,2020-02-28,"(674.25, 891.5]",2,3,-1
31024.0,2020-02-28,"(891.5, 1108.75]",1,4,-3
31024.0,2020-02-28,"(1108.75, 1326.0]",2,7,-5
31025.0,2020-02-28,"(818.5, 881.0]",1,1,0
31025.0,2020-02-28,"(943.5, 1006.0]",1,2,-1
31026.0,2020-02-28,"(727.0, 910.5]",1,1,0
31026.0,2020-02-28,"(910.5, 1094.0]",1,1,0
31027.0,2020-02-28,"(929.0, 1049.5]",1,1,0
31027.0,2020-02-28,"(1049.5, 1170.0]",1,1,0
31028.0,2020-02-28,"(421.24, 612.0]",1,2,-1
31028.0,2020-02-28,"(612.0, 802.0]",1,2,-1
31028.0,2020-02-28,"(802.0, 992.0]",1,1,0
31028.0,2020-02-28,"(992.0, 1182.0]",2,2,0
31029.0,2020-02-28,"(632.75, 826.5]",1,5,-4
31029.0,2020-02-28,"(826.5, 1020.25]",1,2,-1
31029.0,2020-02-28,"(1020.25, 1214.0]",3,2,1
31030.0,2020-02-28,"(10.668, 345.0]",1,1,0
31030.0,2020-02-28,"(678.0, 1011.0]",3,7,-4
31030.0,2020-02-28,"(1011.0, 1344.0]",7,4,3
31031.0,2020-02-28,"(980.5, 1107.0]",1,2,-1
,,,,2.0,
31033.0,2020-02-28,"(645.75, 861.0]",1,1,0
31034.0,2020-02-28,"(424.293, 601.75]",3,5,-2
31035.0,2020-02-28,"(465.033, 707.75]",1,2,-1
31035.0,2020-02-28,"(707.75, 949.5]",1,3,-2
31035.0,2020-02-28,"(949.5, 1191.25]",2,4,-2
31035.0,2020-02-28,"(1191.25, 1433.0]",2,3,-1
31036.0,2020-02-28,"(403.296, 580.0]",1,3,-2
31036.0,2020-02-28,"(756.0, 932.0]",2,2,0
31036.0,2020-02-28,"(932.0, 1108.0]",3,2,1
31037.0,2020-02-28,"(408.139, 624.25]",7,8,-1
31037.0,2020-02-28,"(624.25, 839.5]",2,4,-2
31037.0,2020-02-28,"(839.5, 1054.75]",4,11,-7
31037.0,2020-02-28,"(1054.75, 1270.0]",4,12,-8
31038.0,2020-02-28,"(24.071, 257.25]",2,2,0
31038.0,2020-02-28,"(721.75, 954.0]",4,1,3
31039.0,2020-02-28,"(460.208, 659.0]",3,6,-3
31039.0,2020-02-28,"(659.0, 857.0]",2,5,-3
31039.0,2020-02-28,"(857.0, 1055.0]",6,9,-3
31039.0,2020-02-28,"(1055.0, 1253.0]",4,6,-2
31040.0,2020-02-28,"(279.0, 543.0]",3,2,1
31040.0,2020-02-28,"(807.0, 1071.0]",2,4,-2
31041.0,2020-02-28,"(1004.0, 1194.0]",2,1,1
31042.0,2020-02-28,"(489.306, 663.5]",4,5,-1
31042.0,2020-02-28,"(837.0, 1010.5]",2,3,-1
31042.0,2020-02-28,"(1010.5, 1184.0]",1,3,-2
31043.0,2020-02-28,"(446.049, 684.75]",2,2,0
31043.0,2020-02-28,"(922.5, 1160.25]",3,2,1
31043.0,2020-02-28,"(1160.25, 1398.0]",1,6,-5
31044.0,2020-02-28,"(584.381, 739.75]",1,2,-1
31044.0,2020-02-28,"(739.75, 894.5]",1,1,0
31045.0,2020-02-28,"(962.25, 1116.0]",1,1,0
31046.0,2020-02-28,"(471.359, 632.25]",1,2,-1
31046.0,2020-02-28,"(952.75, 1113.0]",1,3,-2
31047.0,2020-02-28,"(356.956, 619.0]",10,16,-6
31047.0,2020-02-28,"(619.0, 880.0]",2,6,-4
31047.0,2020-02-28,"(880.0, 1141.0]",9,23,-14
31047.0,2020-02-28,"(1141.0, 1402.0]",1,3,-2
31048.0,2020-02-28,"(527.35, 690.5]",2,3,-1
31048.0,2020-02-28,"(853.0, 1015.5]",2,2,0
31048.0,2020-02-28,"(1015.5, 1178.0]",3,6,-3
31049.0,2020-02-28,"(634.25, 827.5]",1,3,-2
31049.0,2020-02-28,"(827.5, 1020.75]",1,1,0
31049.0,2020-02-28,"(1020.75, 1214.0]",1,1,0
31050.0,2020-02-28,"(721.5, 930.0]",1,3,-2
31050.0,2020-02-28,"(930.0, 1138.5]",3,1,2
31050.0,2020-02-28,"(1138.5, 1347.0]",1,3,-2
31051.0,2020-02-28,"(932.5, 1136.25]",4,3,1
31051.0,2020-02-28,"(1136.25, 1340.0]",1,4,-3
31052.0,2020-02-28,"(459.19, 662.5]",2,3,-1
31052.0,2020-02-28,"(662.5, 865.0]",1,2,-1
31052.0,2020-02-28,"(865.0, 1067.5]",1,2,-1
31052.0,2020-02-28,"(1067.5, 1270.0]",3,3,0
31053.0,2020-02-28,"(106.97, 365.5]",1,7,-6
31053.0,2020-02-28,"(880.5, 1138.0]",1,1,0
,,,,2.0,
31055.0,2020-02-28,"(669.0, 873.0]",1,1,0
31055.0,2020-02-28,"(873.0, 1077.0]",1,2,-1
31055.0,2020-02-28,"(1077.0, 1281.0]",1,1,0
31056.0,2020-02-28,"(583.254, 770.5]",1,3,-2
31056.0,2020-02-28,"(1143.5, 1330.0]",1,1,0
31057.0,2020-02-28,"(1091.0, 1104.0]",1,1,0
31057.0,2020-02-28,"(1104.0, 1117.0]",1,2,-1
31058.0,2020-02-28,"(105.997, 357.75]",1,2,-1
31058.0,2020-02-28,"(859.25, 1110.0]",1,1,0
31059.0,2020-02-28,"(997.0, 1111.0]",3,1,2
31060.0,2020-02-28,"(593.276, 775.0]",1,3,-2
31060.0,2020-02-28,"(956.0, 1137.0]",1,1,0
31061.0,2020-02-28,"(408.75, 545.0]",1,1,0
31062.0,2020-02-28,"(499.681, 579.75]",1,2,-1
31062.0,2020-02-28,"(739.25, 819.0]",3,6,-3
,,,,1.0,
,,,,1.0,
31064.0,2020-02-28,"(482.395, 634.25]",1,2,-1
31064.0,2020-02-28,"(634.25, 785.5]",3,6,-3
31064.0,2020-02-28,"(785.5, 936.75]",1,2,-1
31064.0,2020-02-28,"(936.75, 1088.0]",8,16,-8
31065.0,2020-02-28,"(521.5, 570.0]",1,1,0
31066.0,2020-02-28,"(964.0, 1133.0]",1,2,-1
31067.0,2020-02-28,"(64.911, 338.25]",2,3,-1
31067.0,2020-02-28,"(882.75, 1155.0]",4,1,3
31068.0,2020-02-28,"(590.0, 647.0]",1,2,-1
31068.0,2020-02-28,"(647.0, 704.0]",2,2,0
31069.0,2020-02-28,"(839.0, 1043.5]",2,2,0
31069.0,2020-02-28,"(1043.5, 1248.0]",4,3,1
31070.0,2020-02-28,"(941.5, 1130.75]",3,2,1
31070.0,2020-02-28,"(1130.75, 1320.0]",2,5,-3
31071.0,2020-02-28,"(449.156, 661.0]",2,5,-3
31071.0,2020-02-28,"(661.0, 872.0]",2,3,-1
31071.0,2020-02-28,"(872.0, 1083.0]",5,7,-2
31071.0,2020-02-28,"(1083.0, 1294.0]",1,2,-1
31072.0,2020-02-28,"(502.5, 670.0]",1,1,0
31073.0,2020-02-28,"(437.708, 511.0]",1,2,-1
31074.0,2020-02-28,"(810.0, 956.0]",1,1,0
31074.0,2020-02-28,"(956.0, 1102.0]",1,1,0
31075.0,2020-02-28,"(970.0, 1115.0]",1,2,-1
31076.0,2020-02-28,"(830.25, 1107.0]",2,1,1
31077.0,2020-02-28,"(624.33, 792.5]",3,4,-1
31077.0,2020-02-28,"(792.5, 960.0]",1,2,-1
31077.0,2020-02-28,"(960.0, 1127.5]",2,3,-1
31078.0,2020-02-28,"(465.388, 619.0]",5,6,-1
31078.0,2020-02-28,"(619.0, 772.0]",2,4,-2
31078.0,2020-02-28,"(925.0, 1078.0]",1,9,-8
31079.0,2020-02-28,"(468.067, 702.25]",1,8,-7
31079.0,2020-02-28,"(702.25, 935.5]",2,4,-2
31079.0,2020-02-28,"(935.5, 1168.75]",4,6,-2
31079.0,2020-02-28,"(1168.75, 1402.0]",2,3,-1
31080.0,2020-02-28,"(714.75, 946.5]",1,6,-5
31080.0,2020-02-28,"(946.5, 1178.25]",2,1,1
31080.0,2020-02-28,"(1178.25, 1410.0]",3,4,-1
31081.0,2020-02-28,"(1182.5, 1214.0]",1,1,0
31082.0,2020-02-28,"(715.0, 763.0]",1,1,0
31083.0,2020-02-28,"(570.5, 742.0]",1,1,0
31083.0,2020-02-28,"(742.0, 913.5]",1,2,-1
31083.0,2020-02-28,"(913.5, 1085.0]",1,1,0
31084.0,2020-02-28,"(650.357, 811.75]",4,5,-1
31084.0,2020-02-28,"(811.75, 972.5]",1,1,0
31084.0,2020-02-28,"(972.5, 1133.25]",1,3,-2
31085.0,2020-02-28,"(401.129, 619.75]",1,4,-3
31085.0,2020-02-28,"(619.75, 837.5]",1,2,-1
31085.0,2020-02-28,"(1055.25, 1273.0]",3,1,2
31086.0,2020-02-28,"(871.0, 1070.5]",1,3,-2
31086.0,2020-02-28,"(1070.5, 1270.0]",3,2,1
31087.0,2020-02-28,"(670.513, 792.75]",1,1,0
31087.0,2020-02-28,"(1036.25, 1158.0]",1,1,0
31088.0,2020-02-28,"(881.5, 1067.25]",1,3,-2
31088.0,2020-02-28,"(1067.25, 1253.0]",2,1,1
31089.0,2020-02-28,"(474.077, 705.75]",6,11,-5
31089.0,2020-02-28,"(705.75, 936.5]",2,6,-4
31089.0,2020-02-28,"(936.5, 1167.25]",6,16,-10
31090.0,2020-02-28,"(880.5, 1038.0]",1,1,0
31091.0,2020-02-28,"(28.888, 308.0]",1,1,0
31091.0,2020-02-28,"(864.0, 1142.0]",2,5,-3
31092.0,2020-02-28,"(953.0, 1105.0]",2,1,1
31093.0,2020-02-28,"(1036.0, 1210.0]",1,4,-3
,,,,2.0,
31095.0,2020-02-28,"(732.651, 820.25]",1,1,0
31095.0,2020-02-28,"(994.75, 1082.0]",1,2,-1
31096.0,2020-02-28,"(1048.5, 1110.75]",1,1,0
31097.0,2020-02-28,"(507.451, 645.25]",3,4,-1
31097.0,2020-02-28,"(919.75, 1057.0]",2,2,0
31098.0,2020-02-28,"(409.24, 600.0]",3,7,-4
31098.0,2020-02-28,"(600.0, 790.0]",1,1,0
31098.0,2020-02-28,"(790.0, 980.0]",3,3,0
31098.0,2020-02-28,"(980.0, 1170.0]",2,5,-3
31099.0,2020-02-28,"(936.0, 1116.0]",1,1,0
31100.0,2020-02-28,"(456.107, 680.25]",9,9,0
31100.0,2020-02-28,"(680.25, 903.5]",7,13,-6
31100.0,2020-02-28,"(903.5, 1126.75]",5,14,-9
31100.0,2020-02-28,"(1126.75, 1350.0]",1,7,-6
31101.0,2020-02-28,"(40.641, 381.75]",4,11,-7
31101.0,2020-02-28,"(381.75, 721.5]",14,53,-39
31101.0,2020-02-28,"(721.5, 1061.25]",26,41,-15
31101.0,2020-02-28,"(1061.25, 1401.0]",28,38,-10
31102.0,2020-02-28,"(356.5, 685.0]",2,2,0
31102.0,2020-02-28,"(685.0, 1013.5]",1,13,-12
31102.0,2020-02-28,"(1013.5, 1342.0]",14,4,10
31103.0,2020-02-28,"(11.632, 355.0]",1,2,-1
31103.0,2020-02-28,"(355.0, 697.0]",1,20,-19
31103.0,2020-02-28,"(697.0, 1039.0]",5,19,-14
31103.0,2020-02-28,"(1039.0, 1381.0]",8,21,-13
31104.0,2020-02-28,"(314.962, 575.5]",4,18,-14
31104.0,2020-02-28,"(575.5, 835.0]",2,5,-3
31104.0,2020-02-28,"(835.0, 1094.5]",19,27,-8
31104.0,2020-02-28,"(1094.5, 1354.0]",15,29,-14
31105.0,2020-02-28,"(334.933, 602.75]",3,11,-8
31105.0,2020-02-28,"(602.75, 869.5]",1,4,-3
31105.0,2020-02-28,"(869.5, 1136.25]",1,5,-4
31105.0,2020-02-28,"(1136.25, 1403.0]",1,3,-2
31106.0,2020-02-28,"(1084.0, 1298.0]",2,4,-2
31107.0,2020-02-28,"(31.688, 361.0]",1,1,0
31107.0,2020-02-28,"(361.0, 689.0]",5,27,-22
31107.0,2020-02-28,"(689.0, 1017.0]",5,9,-4
31107.0,2020-02-28,"(1017.0, 1345.0]",15,25,-10
31108.0,2020-02-28,"(376.095, 603.25]",4,21,-17
31108.0,2020-02-28,"(603.25, 829.5]",11,25,-14
31108.0,2020-02-28,"(829.5, 1055.75]",12,19,-7
31108.0,2020-02-28,"(1055.75, 1282.0]",18,21,-3
31109.0,2020-02-28,"(385.955, 648.25]",4,15,-11
31109.0,2020-02-28,"(648.25, 909.5]",8,17,-9
31109.0,2020-02-28,"(909.5, 1170.75]",19,26,-7
31109.0,2020-02-28,"(1170.75, 1432.0]",4,8,-4
31110.0,2020-02-28,"(132.713, 455.75]",3,4,-1
31110.0,2020-02-28,"(455.75, 777.5]",16,33,-17
31110.0,2020-02-28,"(777.5, 1099.25]",11,25,-14
31110.0,2020-02-28,"(1099.25, 1421.0]",13,22,-9
31111.0,2020-02-28,"(9.579, 366.25]",1,2,-1
31111.0,2020-02-28,"(366.25, 721.5]",7,19,-12
31111.0,2020-02-28,"(721.5, 1076.75]",10,16,-6
31111.0,2020-02-28,"(1076.75, 1432.0]",2,4,-2
31112.0,2020-02-28,"(475.455, 612.25]",1,3,-2
31112.0,2020-02-28,"(748.5, 884.75]",2,3,-1
31113.0,2020-02-28,"(398.066, 632.5]",2,20,-18
31113.0,2020-02-28,"(632.5, 866.0]",7,14,-7
31113.0,2020-02-28,"(866.0, 1099.5]",2,7,-5
31113.0,2020-02-28,"(1099.5, 1333.0]",8,10,-2
31114.0,2020-02-28,"(86.704, 412.0]",7,10,-3
31114.0,2020-02-28,"(736.0, 1060.0]",10,20,-10
31114.0,2020-02-28,"(1060.0, 1384.0]",19,18,1
31115.0,2020-02-28,"(246.881, 527.75]",1,13,-12
31115.0,2020-02-28,"(527.75, 807.5]",1,13,-12
31115.0,2020-02-28,"(807.5, 1087.25]",11,18,-7
31115.0,2020-02-28,"(1087.25, 1367.0]",5,11,-6
31116.0,2020-02-28,"(332.924, 603.0]",3,22,-19
31116.0,2020-02-28,"(603.0, 872.0]",7,16,-9
31116.0,2020-02-28,"(872.0, 1141.0]",18,24,-6
31116.0,2020-02-28,"(1141.0, 1410.0]",9,14,-5
31117.0,2020-02-28,"(333.927, 603.25]",2,27,-25
31117.0,2020-02-28,"(603.25, 871.5]",4,16,-12
31117.0,2020-02-28,"(871.5, 1139.75]",6,10,-4
31117.0,2020-02-28,"(1139.75, 1408.0]",7,13,-6
31118.0,2020-02-28,"(328.902, 604.5]",4,20,-16
31118.0,2020-02-28,"(879.0, 1153.5]",7,9,-2
31118.0,2020-02-28,"(1153.5, 1428.0]",2,3,-1
31119.0,2020-02-28,"(323.899, 600.25]",2,17,-15
31119.0,2020-02-28,"(600.25, 875.5]",1,2,-1
31119.0,2020-02-28,"(875.5, 1150.75]",11,15,-4
31119.0,2020-02-28,"(1150.75, 1426.0]",7,14,-7
31120.0,2020-02-28,"(112.705, 437.75]",2,4,-2
31120.0,2020-02-28,"(437.75, 761.5]",5,16,-11
31120.0,2020-02-28,"(761.5, 1085.25]",4,8,-4
31120.0,2020-02-28,"(1085.25, 1409.0]",11,19,-8
31121.0,2020-02-28,"(343.054, 580.5]",9,12,-3
31121.0,2020-02-28,"(580.5, 817.0]",1,6,-5
31121.0,2020-02-28,"(817.0, 1053.5]",6,14,-8
31121.0,2020-02-28,"(1053.5, 1290.0]",6,18,-12
31122.0,2020-02-28,"(440.136, 657.0]",3,11,-8
31122.0,2020-02-28,"(873.0, 1089.0]",1,3,-2
31122.0,2020-02-28,"(1089.0, 1305.0]",6,2,4
31123.0,2020-02-28,"(309.953, 572.75]",1,19,-18
31123.0,2020-02-28,"(572.75, 834.5]",3,6,-3
31123.0,2020-02-28,"(834.5, 1096.25]",9,18,-9
31123.0,2020-02-28,"(1096.25, 1358.0]",4,11,-7
31124.0,2020-02-28,"(66.664, 402.0]",1,3,-2
31124.0,2020-02-28,"(402.0, 736.0]",11,28,-17
31124.0,2020-02-28,"(736.0, 1070.0]",15,40,-25
31124.0,2020-02-28,"(1070.0, 1404.0]",7,28,-21
31125.0,2020-02-28,"(129.771, 438.25]",3,10,-7
31125.0,2020-02-28,"(438.25, 745.5]",7,25,-18
31125.0,2020-02-28,"(745.5, 1052.75]",12,19,-7
31125.0,2020-02-28,"(1052.75, 1360.0]",21,29,-8
31126.0,2020-02-28,"(83.661, 419.75]",1,3,-2
31126.0,2020-02-28,"(419.75, 754.5]",6,27,-21
31126.0,2020-02-28,"(754.5, 1089.25]",7,15,-8
31126.0,2020-02-28,"(1089.25, 1424.0]",7,9,-2
31127.0,2020-02-28,"(131.94, 398.0]",1,1,0
31127.0,2020-02-28,"(398.0, 663.0]",8,12,-4
31127.0,2020-02-28,"(663.0, 928.0]",11,19,-8
31127.0,2020-02-28,"(928.0, 1193.0]",11,27,-16
31128.0,2020-02-28,"(310.75, 619.5]",21,1,20
31128.0,2020-02-28,"(619.5, 928.25]",16,30,-14
31128.0,2020-02-28,"(928.25, 1237.0]",17,28,-11
31129.0,2020-02-28,"(500.236, 692.0]",8,11,-3
31129.0,2020-02-28,"(692.0, 883.0]",1,3,-2
31129.0,2020-02-28,"(883.0, 1074.0]",11,16,-5
31129.0,2020-02-28,"(1074.0, 1265.0]",3,6,-3
31130.0,2020-02-28,"(305.25, 608.5]",3,1,2
31130.0,2020-02-28,"(608.5, 911.75]",2,10,-8
31130.0,2020-02-28,"(911.75, 1215.0]",17,6,11
31131.0,2020-02-28,"(699.5, 938.0]",1,14,-13
31131.0,2020-02-28,"(938.0, 1176.5]",4,3,1
31131.0,2020-02-28,"(1176.5, 1415.0]",1,8,-7
31200.0,2020-02-28,"(387.988, 642.0]",23,37,-14
31200.0,2020-02-28,"(642.0, 895.0]",8,16,-8
31200.0,2020-02-28,"(895.0, 1148.0]",20,35,-15
31200.0,2020-02-28,"(1148.0, 1401.0]",14,24,-10
31201.0,2020-02-28,"(4.572, 363.0]",3,4,-1
31201.0,2020-02-28,"(363.0, 720.0]",18,38,-20
31201.0,2020-02-28,"(720.0, 1077.0]",45,81,-36
31201.0,2020-02-28,"(1077.0, 1434.0]",27,53,-26
,,,,2.0,
31203.0,2020-02-28,"(79.664, 415.0]",2,6,-4
31203.0,2020-02-28,"(415.0, 749.0]",10,33,-23
31203.0,2020-02-28,"(749.0, 1083.0]",28,41,-13
31203.0,2020-02-28,"(1083.0, 1417.0]",18,40,-22
31204.0,2020-02-28,"(27.691, 356.25]",3,5,-2
31204.0,2020-02-28,"(356.25, 683.5]",11,14,-3
31204.0,2020-02-28,"(683.5, 1010.75]",5,8,-3
31204.0,2020-02-28,"(1010.75, 1338.0]",5,15,-10
31205.0,2020-02-28,"(410.098, 636.5]",20,24,-4
31205.0,2020-02-28,"(636.5, 862.0]",12,23,-11
31205.0,2020-02-28,"(862.0, 1087.5]",4,25,-21
31205.0,2020-02-28,"(1087.5, 1313.0]",2,4,-2
31206.0,2020-02-28,"(485.193, 687.75]",3,3,0
31206.0,2020-02-28,"(687.75, 889.5]",2,2,0
31206.0,2020-02-28,"(889.5, 1091.25]",2,8,-6
31206.0,2020-02-28,"(1091.25, 1293.0]",2,3,-1
31207.0,2020-02-28,"(483.151, 696.25]",1,2,-1
31207.0,2020-02-28,"(696.25, 908.5]",3,5,-2
31207.0,2020-02-28,"(908.5, 1120.75]",2,5,-3
31207.0,2020-02-28,"(1120.75, 1333.0]",1,3,-2
31208.0,2020-02-28,"(358.211, 556.25]",13,16,-3
31208.0,2020-02-28,"(556.25, 753.5]",2,3,-1
31208.0,2020-02-28,"(753.5, 950.75]",3,6,-3
31208.0,2020-02-28,"(950.75, 1148.0]",4,13,-9
31209.0,2020-02-28,"(664.25, 857.5]",3,4,-1
31209.0,2020-02-28,"(857.5, 1050.75]",1,3,-2
31209.0,2020-02-28,"(1050.75, 1244.0]",2,1,1
31211.0,2020-02-28,"(387.001, 637.75]",6,7,-1
31211.0,2020-02-28,"(637.75, 887.5]",2,5,-3
31211.0,2020-02-28,"(887.5, 1137.25]",5,10,-5
31211.0,2020-02-28,"(1137.25, 1387.0]",4,9,-5
31212.0,2020-02-28,"(448.037, 689.75]",30,42,-12
31212.0,2020-02-28,"(689.75, 930.5]",8,19,-11
31212.0,2020-02-28,"(930.5, 1171.25]",14,28,-14
31212.0,2020-02-28,"(1171.25, 1412.0]",6,12,-6
31213.0,2020-02-28,"(324.936, 592.0]",31,40,-9
31213.0,2020-02-28,"(592.0, 858.0]",7,11,-4
31213.0,2020-02-28,"(858.0, 1124.0]",10,21,-11
31213.0,2020-02-28,"(1124.0, 1390.0]",3,10,-7
31214.0,2020-02-28,"(11.69, 340.5]",1,2,-1
31214.0,2020-02-28,"(340.5, 668.0]",15,39,-24
31214.0,2020-02-28,"(668.0, 995.5]",20,38,-18
31214.0,2020-02-28,"(995.5, 1323.0]",19,28,-9
31215.0,2020-02-28,"(439.047, 678.25]",12,12,0
31215.0,2020-02-28,"(678.25, 916.5]",10,16,-6
31215.0,2020-02-28,"(916.5, 1154.75]",7,14,-7
31215.0,2020-02-28,"(1154.75, 1393.0]",1,3,-2
31216.0,2020-02-28,"(363.07, 596.5]",20,24,-4
31216.0,2020-02-28,"(596.5, 829.0]",9,14,-5
31216.0,2020-02-28,"(829.0, 1061.5]",8,19,-11
31216.0,2020-02-28,"(1061.5, 1294.0]",8,19,-11
31217.0,2020-02-28,"(374.28, 555.0]",7,8,-1
31217.0,2020-02-28,"(735.0, 915.0]",2,5,-3
31217.0,2020-02-28,"(915.0, 1095.0]",4,8,-4
31218.0,2020-02-28,"(374.233, 566.75]",7,15,-8
31218.0,2020-02-28,"(566.75, 758.5]",2,6,-4
31218.0,2020-02-28,"(758.5, 950.25]",6,8,-2
31218.0,2020-02-28,"(950.25, 1142.0]",2,11,-9
31219.0,2020-02-28,"(361.259, 547.25]",6,6,0
31219.0,2020-02-28,"(547.25, 732.5]",3,5,-2
31219.0,2020-02-28,"(732.5, 917.75]",8,11,-3
31219.0,2020-02-28,"(917.75, 1103.0]",10,19,-9
31220.0,2020-02-28,"(465.126, 684.5]",16,18,-2
31220.0,2020-02-28,"(684.5, 903.0]",2,7,-5
31220.0,2020-02-28,"(903.0, 1121.5]",1,13,-12
31220.0,2020-02-28,"(1121.5, 1340.0]",1,1,0
31221.0,2020-02-28,"(331.0, 638.0]",26,3,23
31221.0,2020-02-28,"(638.0, 945.0]",4,29,-25
31221.0,2020-02-28,"(945.0, 1252.0]",12,9,3
31222.0,2020-02-28,"(321.927, 591.25]",13,15,-2
31222.0,2020-02-28,"(591.25, 859.5]",8,15,-7
31222.0,2020-02-28,"(859.5, 1127.75]",3,13,-10
31222.0,2020-02-28,"(1127.75, 1396.0]",5,11,-6
31223.0,2020-02-28,"(43.768, 353.0]",1,2,-1
31223.0,2020-02-28,"(353.0, 661.0]",16,40,-24
31223.0,2020-02-28,"(661.0, 969.0]",5,11,-6
31223.0,2020-02-28,"(969.0, 1277.0]",17,23,-6
31224.0,2020-02-28,"(398.164, 608.0]",7,7,0
31224.0,2020-02-28,"(608.0, 817.0]",6,12,-6
31224.0,2020-02-28,"(817.0, 1026.0]",6,15,-9
31224.0,2020-02-28,"(1026.0, 1235.0]",4,9,-5
31225.0,2020-02-28,"(424.05, 662.5]",5,10,-5
31225.0,2020-02-28,"(662.5, 900.0]",5,10,-5
31225.0,2020-02-28,"(900.0, 1137.5]",6,12,-6
31225.0,2020-02-28,"(1137.5, 1375.0]",6,8,-2
31226.0,2020-02-28,"(322.059, 558.25]",1,5,-4
31226.0,2020-02-28,"(558.25, 793.5]",2,3,-1
31226.0,2020-02-28,"(793.5, 1028.75]",1,3,-2
31226.0,2020-02-28,"(1028.75, 1264.0]",7,11,-4
31227.0,2020-02-28,"(360.192, 563.0]",18,20,-2
31227.0,2020-02-28,"(563.0, 765.0]",10,17,-7
31227.0,2020-02-28,"(765.0, 967.0]",7,14,-7
31227.0,2020-02-28,"(967.0, 1169.0]",6,23,-17
31228.0,2020-02-28,"(35.611, 384.25]",1,2,-1
31228.0,2020-02-28,"(384.25, 731.5]",13,17,-4
31228.0,2020-02-28,"(731.5, 1078.75]",14,27,-13
31228.0,2020-02-28,"(1078.75, 1426.0]",14,22,-8
31229.0,2020-02-28,"(18.581, 374.75]",1,3,-2
31229.0,2020-02-28,"(374.75, 729.5]",15,60,-45
31229.0,2020-02-28,"(729.5, 1084.25]",38,61,-23
31229.0,2020-02-28,"(1084.25, 1439.0]",11,26,-15
31230.0,2020-02-28,"(332.897, 609.75]",48,55,-7
31230.0,2020-02-28,"(609.75, 885.5]",4,8,-4
31230.0,2020-02-28,"(885.5, 1161.25]",12,34,-22
31230.0,2020-02-28,"(1161.25, 1437.0]",1,6,-5
31231.0,2020-02-28,"(327.023, 572.25]",15,18,-3
31231.0,2020-02-28,"(572.25, 816.5]",7,17,-10
31231.0,2020-02-28,"(816.5, 1060.75]",8,17,-9
31231.0,2020-02-28,"(1060.75, 1305.0]",1,2,-1
31232.0,2020-02-28,"(140.724, 461.0]",3,5,-2
31232.0,2020-02-28,"(461.0, 780.0]",12,18,-6
31232.0,2020-02-28,"(780.0, 1099.0]",7,13,-6
31232.0,2020-02-28,"(1099.0, 1418.0]",6,17,-11
31233.0,2020-02-28,"(409.143, 624.25]",30,32,-2
31233.0,2020-02-28,"(624.25, 838.5]",8,14,-6
31233.0,2020-02-28,"(838.5, 1052.75]",6,14,-8
31233.0,2020-02-28,"(1052.75, 1267.0]",8,22,-14
31234.0,2020-02-28,"(47.661, 383.75]",1,3,-2
31234.0,2020-02-28,"(383.75, 718.5]",20,38,-18
31234.0,2020-02-28,"(718.5, 1053.25]",15,25,-10
31234.0,2020-02-28,"(1053.25, 1388.0]",13,22,-9
31235.0,2020-02-28,"(403.222, 598.5]",2,3,-1
31235.0,2020-02-28,"(793.0, 987.5]",3,3,0
31235.0,2020-02-28,"(987.5, 1182.0]",2,3,-1
31236.0,2020-02-28,"(499.21, 697.5]",15,20,-5
31236.0,2020-02-28,"(697.5, 895.0]",13,15,-2
31236.0,2020-02-28,"(895.0, 1092.5]",11,36,-25
31236.0,2020-02-28,"(1092.5, 1290.0]",2,10,-8
31237.0,2020-02-28,"(430.041, 670.75]",5,10,-5
31237.0,2020-02-28,"(670.75, 910.5]",7,13,-6
31237.0,2020-02-28,"(910.5, 1150.25]",5,9,-4
31237.0,2020-02-28,"(1150.25, 1390.0]",6,14,-8
31238.0,2020-02-28,"(51.779, 358.25]",1,1,0
31238.0,2020-02-28,"(358.25, 663.5]",10,11,-1
31238.0,2020-02-28,"(663.5, 968.75]",15,26,-11
31238.0,2020-02-28,"(968.75, 1274.0]",2,19,-17
31239.0,2020-02-28,"(113.698, 440.5]",3,7,-4
31239.0,2020-02-28,"(440.5, 766.0]",22,29,-7
31239.0,2020-02-28,"(766.0, 1091.5]",11,41,-30
31239.0,2020-02-28,"(1091.5, 1417.0]",5,8,-3
31240.0,2020-02-28,"(432.447, 571.25]",2,3,-1
31240.0,2020-02-28,"(571.25, 709.5]",1,1,0
31240.0,2020-02-28,"(709.5, 847.75]",1,2,-1
31240.0,2020-02-28,"(847.75, 986.0]",12,23,-11
31241.0,2020-02-28,"(112.674, 445.5]",5,7,-2
31241.0,2020-02-28,"(445.5, 777.0]",29,50,-21
31241.0,2020-02-28,"(777.0, 1108.5]",15,39,-24
31241.0,2020-02-28,"(1108.5, 1440.0]",13,19,-6
31242.0,2020-02-28,"(409.178, 615.5]",18,19,-1
31242.0,2020-02-28,"(615.5, 821.0]",11,15,-4
31242.0,2020-02-28,"(821.0, 1026.5]",9,24,-15
31243.0,2020-02-28,"(363.25, 688.5]",22,1,21
31243.0,2020-02-28,"(688.5, 1013.75]",14,31,-17
31243.0,2020-02-28,"(1013.75, 1339.0]",6,30,-24
31244.0,2020-02-28,"(350.943, 616.25]",6,11,-5
31244.0,2020-02-28,"(616.25, 880.5]",8,17,-9
31244.0,2020-02-28,"(880.5, 1144.75]",6,13,-7
31244.0,2020-02-28,"(1144.75, 1409.0]",3,5,-2
31245.0,2020-02-28,"(419.103, 644.25]",7,16,-9
31245.0,2020-02-28,"(644.25, 868.5]",5,8,-3
31245.0,2020-02-28,"(868.5, 1092.75]",6,16,-10
31245.0,2020-02-28,"(1092.75, 1317.0]",12,14,-2
31246.0,2020-02-28,"(427.054, 664.5]",7,12,-5
31246.0,2020-02-28,"(664.5, 901.0]",10,17,-7
31246.0,2020-02-28,"(901.0, 1137.5]",14,23,-9
31246.0,2020-02-28,"(1137.5, 1374.0]",1,5,-4
31247.0,2020-02-28,"(448.209, 646.75]",13,19,-6
31247.0,2020-02-28,"(646.75, 844.5]",8,31,-23
31247.0,2020-02-28,"(844.5, 1042.25]",11,26,-15
31247.0,2020-02-28,"(1042.25, 1240.0]",3,6,-3
31248.0,2020-02-28,"(356.957, 618.75]",11,14,-3
31248.0,2020-02-28,"(618.75, 879.5]",8,14,-6
31248.0,2020-02-28,"(879.5, 1140.25]",28,48,-20
31248.0,2020-02-28,"(1140.25, 1401.0]",2,2,0
31249.0,2020-02-28,"(653.256, 840.0]",5,12,-7
31249.0,2020-02-28,"(840.0, 1026.0]",2,6,-4
31249.0,2020-02-28,"(1026.0, 1212.0]",6,11,-5
31249.0,2020-02-28,"(1212.0, 1398.0]",1,1,0
31250.0,2020-02-28,"(385.0, 670.0]",13,1,12
31250.0,2020-02-28,"(670.0, 955.0]",8,14,-6
31250.0,2020-02-28,"(955.0, 1240.0]",5,16,-11
31251.0,2020-02-28,"(400.106, 624.5]",20,30,-10
31251.0,2020-02-28,"(624.5, 848.0]",5,12,-7
31251.0,2020-02-28,"(848.0, 1071.5]",5,19,-14
31251.0,2020-02-28,"(1071.5, 1295.0]",3,8,-5
31252.0,2020-02-28,"(358.0, 698.0]",15,1,14
31252.0,2020-02-28,"(698.0, 1038.0]",6,18,-12
31252.0,2020-02-28,"(1038.0, 1378.0]",3,18,-15
31253.0,2020-02-28,"(368.931, 637.25]",19,22,-3
31253.0,2020-02-28,"(637.25, 904.5]",7,10,-3
31253.0,2020-02-28,"(904.5, 1171.75]",3,12,-9
31253.0,2020-02-28,"(1171.75, 1439.0]",1,6,-5
31254.0,2020-02-28,"(427.273, 609.75]",19,20,-1
31254.0,2020-02-28,"(791.5, 973.25]",1,4,-3
31254.0,2020-02-28,"(973.25, 1155.0]",1,19,-18
31255.0,2020-02-28,"(455.125, 674.75]",13,20,-7
31255.0,2020-02-28,"(674.75, 893.5]",6,10,-4
31255.0,2020-02-28,"(893.5, 1112.25]",8,19,-11
31255.0,2020-02-28,"(1112.25, 1331.0]",5,11,-6
31256.0,2020-02-28,"(357.07, 590.5]",11,12,-1
31256.0,2020-02-28,"(590.5, 823.0]",4,9,-5
31256.0,2020-02-28,"(823.0, 1055.5]",6,15,-9
31256.0,2020-02-28,"(1055.5, 1288.0]",8,10,-2
31257.0,2020-02-28,"(37.603, 388.25]",2,3,-1
31257.0,2020-02-28,"(388.25, 737.5]",24,42,-18
31257.0,2020-02-28,"(737.5, 1086.75]",15,36,-21
31257.0,2020-02-28,"(1086.75, 1436.0]",7,14,-7
31258.0,2020-02-28,"(0.571, 359.25]",1,2,-1
31258.0,2020-02-28,"(359.25, 716.5]",15,30,-15
31258.0,2020-02-28,"(716.5, 1073.75]",16,30,-14
31258.0,2020-02-28,"(1073.75, 1431.0]",7,16,-9
31259.0,2020-02-28,"(417.297, 593.75]",5,6,-1
31259.0,2020-02-28,"(593.75, 769.5]",1,2,-1
31260.0,2020-02-28,"(390.046, 629.5]",13,14,-1
31260.0,2020-02-28,"(629.5, 868.0]",5,10,-5
31260.0,2020-02-28,"(868.0, 1106.5]",2,12,-10
31260.0,2020-02-28,"(1106.5, 1345.0]",3,7,-4
31261.0,2020-02-28,"(376.013, 623.75]",5,5,0
31261.0,2020-02-28,"(623.75, 870.5]",2,10,-8
31261.0,2020-02-28,"(870.5, 1117.25]",9,18,-9
31261.0,2020-02-28,"(1117.25, 1364.0]",2,7,-5
31262.0,2020-02-28,"(428.217, 624.75]",12,14,-2
31262.0,2020-02-28,"(624.75, 820.5]",4,6,-2
31262.0,2020-02-28,"(820.5, 1016.25]",2,4,-2
31262.0,2020-02-28,"(1016.25, 1212.0]",1,9,-8
31263.0,2020-02-28,"(330.25, 639.5]",19,1,18
31263.0,2020-02-28,"(639.5, 948.75]",6,31,-25
31263.0,2020-02-28,"(948.75, 1258.0]",11,14,-3
31264.0,2020-02-28,"(321.75, 630.5]",13,1,12
31264.0,2020-02-28,"(630.5, 939.25]",3,18,-15
31264.0,2020-02-28,"(939.25, 1248.0]",9,7,2
31265.0,2020-02-28,"(409.058, 645.5]",14,33,-19
31265.0,2020-02-28,"(645.5, 881.0]",9,16,-7
31265.0,2020-02-28,"(881.0, 1116.5]",14,31,-17
31265.0,2020-02-28,"(1116.5, 1352.0]",8,12,-4
31266.0,2020-02-28,"(13.605, 363.75]",2,3,-1
31266.0,2020-02-28,"(363.75, 712.5]",5,20,-15
31266.0,2020-02-28,"(712.5, 1061.25]",10,18,-8
31266.0,2020-02-28,"(1061.25, 1410.0]",15,29,-14
31267.0,2020-02-28,"(124.763, 435.25]",2,6,-4
31267.0,2020-02-28,"(435.25, 744.5]",17,30,-13
31267.0,2020-02-28,"(744.5, 1053.75]",17,29,-12
31267.0,2020-02-28,"(1053.75, 1363.0]",13,25,-12
31268.0,2020-02-28,"(132.713, 455.75]",4,9,-5
31268.0,2020-02-28,"(455.75, 777.5]",10,36,-26
31268.0,2020-02-28,"(777.5, 1099.25]",25,38,-13
31268.0,2020-02-28,"(1099.25, 1421.0]",10,18,-8
31269.0,2020-02-28,"(381.013, 628.75]",6,9,-3
31269.0,2020-02-28,"(628.75, 875.5]",6,8,-2
31269.0,2020-02-28,"(875.5, 1122.25]",8,20,-12
31269.0,2020-02-28,"(1122.25, 1369.0]",2,6,-4
31270.0,2020-02-28,"(327.985, 582.75]",8,11,-3
31270.0,2020-02-28,"(582.75, 836.5]",8,12,-4
31270.0,2020-02-28,"(836.5, 1090.25]",6,18,-12
31270.0,2020-02-28,"(1090.25, 1344.0]",8,9,-1
31271.0,2020-02-28,"(380.981, 636.75]",12,16,-4
31271.0,2020-02-28,"(636.75, 891.5]",7,13,-6
31271.0,2020-02-28,"(891.5, 1146.25]",10,21,-11
31271.0,2020-02-28,"(1146.25, 1401.0]",2,3,-1
31272.0,2020-02-28,"(299.972, 558.0]",18,22,-4
31272.0,2020-02-28,"(558.0, 815.0]",5,12,-7
31272.0,2020-02-28,"(815.0, 1072.0]",8,19,-11
31272.0,2020-02-28,"(1072.0, 1329.0]",2,7,-5
31273.0,2020-02-28,"(969.25, 1121.0]",1,1,0
31274.0,2020-02-28,"(351.047, 590.25]",17,19,-2
31274.0,2020-02-28,"(590.25, 828.5]",7,10,-3
31274.0,2020-02-28,"(828.5, 1066.75]",9,15,-6
31274.0,2020-02-28,"(1066.75, 1305.0]",6,8,-2
31275.0,2020-02-28,"(325.093, 552.75]",15,22,-7
31275.0,2020-02-28,"(552.75, 779.5]",8,18,-10
31275.0,2020-02-28,"(779.5, 1006.25]",13,27,-14
31275.0,2020-02-28,"(1006.25, 1233.0]",18,30,-12
31276.0,2020-02-28,"(349.017, 595.75]",17,19,-2
31276.0,2020-02-28,"(595.75, 841.5]",5,6,-1
31276.0,2020-02-28,"(841.5, 1087.25]",2,12,-10
31276.0,2020-02-28,"(1087.25, 1333.0]",4,9,-5
31277.0,2020-02-28,"(442.254, 629.5]",31,34,-3
31277.0,2020-02-28,"(629.5, 816.0]",3,7,-4
31277.0,2020-02-28,"(816.0, 1002.5]",6,10,-4
31277.0,2020-02-28,"(1002.5, 1189.0]",7,30,-23
31278.0,2020-02-28,"(448.171, 656.25]",6,22,-16
31278.0,2020-02-28,"(656.25, 863.5]",6,9,-3
31278.0,2020-02-28,"(863.5, 1070.75]",13,23,-10
31278.0,2020-02-28,"(1070.75, 1278.0]",11,18,-7
31279.0,2020-02-28,"(27.761, 338.75]",2,2,0
31279.0,2020-02-28,"(338.75, 648.5]",19,22,-3
31279.0,2020-02-28,"(648.5, 958.25]",12,26,-14
31279.0,2020-02-28,"(958.25, 1268.0]",5,28,-23
31280.0,2020-02-28,"(371.956, 634.0]",6,24,-18
31280.0,2020-02-28,"(634.0, 895.0]",5,9,-4
31280.0,2020-02-28,"(895.0, 1156.0]",12,14,-2
31280.0,2020-02-28,"(1156.0, 1417.0]",3,6,-3
31000.0,2020-02-29,"(803.0, 878.0]",1,1,0
31001.0,2020-02-29,"(536.587, 640.25]",1,1,0
,,,,1.0,
,,,,1.0,
31003.0,2020-02-29,"(868.25, 972.0]",1,3,-2
31004.0,2020-02-29,"(1024.0, 1205.0]",1,1,0
31004.0,2020-02-29,"(1205.0, 1386.0]",1,4,-3
31005.0,2020-02-29,"(500.119, 721.25]",4,4,0
31005.0,2020-02-29,"(721.25, 941.5]",8,10,-2
31005.0,2020-02-29,"(941.5, 1161.75]",3,3,0
31006.0,2020-02-29,"(529.374, 686.5]",2,3,-1
31006.0,2020-02-29,"(843.0, 999.5]",2,1,1
31006.0,2020-02-29,"(999.5, 1156.0]",3,3,0
31007.0,2020-02-29,"(591.5, 878.25]",2,1,1
31007.0,2020-02-29,"(878.25, 1165.0]",3,3,0
,,,,1.0,
,,,,2.0,
31010.0,2020-02-29,"(449.25, 599.0]",1,1,0
31011.0,2020-02-29,"(539.353, 701.75]",1,1,0
,,,,2.0,
31013.0,2020-02-29,"(19.753, 332.75]",1,1,0
31013.0,2020-02-29,"(644.5, 956.25]",1,3,-2
31013.0,2020-02-29,"(956.25, 1268.0]",3,4,-1
31014.0,2020-02-29,"(54.617, 401.75]",1,1,0
31014.0,2020-02-29,"(401.75, 747.5]",5,9,-4
31014.0,2020-02-29,"(747.5, 1093.25]",10,12,-2
31014.0,2020-02-29,"(1093.25, 1439.0]",3,5,-2
31015.0,2020-02-29,"(334.909, 608.75]",1,1,0
31015.0,2020-02-29,"(608.75, 881.5]",4,4,0
31015.0,2020-02-29,"(881.5, 1154.25]",2,2,0
31016.0,2020-02-29,"(333.939, 600.25]",1,3,-2
31016.0,2020-02-29,"(600.25, 865.5]",1,6,-5
31016.0,2020-02-29,"(1130.75, 1396.0]",2,3,-1
31017.0,2020-02-29,"(31.921, 302.75]",1,1,0
31017.0,2020-02-29,"(572.5, 842.25]",1,1,0
31017.0,2020-02-29,"(842.25, 1112.0]",1,4,-3
,,,,1.0,
,,,,1.0,
,,,,4.0,
31019.0,2020-02-29,"(597.265, 781.75]",2,3,-1
31019.0,2020-02-29,"(781.75, 965.5]",3,4,-1
31019.0,2020-02-29,"(965.5, 1149.25]",1,2,-1
31020.0,2020-02-29,"(651.5, 664.0]",1,1,0
31021.0,2020-02-29,"(335.5, 642.0]",2,1,1
31021.0,2020-02-29,"(642.0, 948.5]",2,2,0
31021.0,2020-02-29,"(948.5, 1255.0]",1,5,-4
31022.0,2020-02-29,"(619.226, 813.5]",5,7,-2
31022.0,2020-02-29,"(813.5, 1007.0]",1,3,-2
31023.0,2020-02-29,"(452.369, 610.75]",2,2,0
31023.0,2020-02-29,"(610.75, 768.5]",1,2,-1
31023.0,2020-02-29,"(768.5, 926.25]",1,3,-2
31024.0,2020-02-29,"(569.482, 699.5]",4,6,-2
31024.0,2020-02-29,"(699.5, 829.0]",1,4,-3
31024.0,2020-02-29,"(958.5, 1088.0]",2,1,1
31025.0,2020-02-29,"(637.64, 728.0]",2,3,-1
31026.0,2020-02-29,"(576.75, 682.5]",1,1,0
31026.0,2020-02-29,"(682.5, 788.25]",1,3,-2
31027.0,2020-02-29,"(450.058, 686.5]",1,1,0
31027.0,2020-02-29,"(1157.5, 1393.0]",3,2,1
31028.0,2020-02-29,"(789.797, 840.75]",1,2,-1
31029.0,2020-02-29,"(188.425, 332.75]",1,1,0
31029.0,2020-02-29,"(476.5, 620.25]",1,3,-2
31029.0,2020-02-29,"(620.25, 764.0]",1,4,-3
,,,,1.0,
,,,,1.0,
,,,,1.0,
,,,,1.0,
,,,,1.0,
,,,,1.0,
31032.0,2020-02-29,"(587.25, 783.0]",1,1,0
31033.0,2020-02-29,"(567.846, 606.5]",1,1,0
31034.0,2020-02-29,"(728.329, 896.75]",4,5,-1
31034.0,2020-02-29,"(896.75, 1064.5]",1,1,0
,,,,1.0,
,,,,2.0,
31036.0,2020-02-29,"(725.0, 846.0]",1,1,0
31036.0,2020-02-29,"(846.0, 967.0]",1,3,-2
31037.0,2020-02-29,"(314.75, 571.5]",1,1,0
31037.0,2020-02-29,"(571.5, 828.25]",3,1,2
31037.0,2020-02-29,"(828.25, 1085.0]",3,6,-3
31038.0,2020-02-29,"(419.694, 496.5]",1,2,-1
31038.0,2020-02-29,"(649.5, 726.0]",1,3,-2
31039.0,2020-02-29,"(369.25, 717.5]",3,1,2
31039.0,2020-02-29,"(717.5, 1065.75]",3,5,-2
31039.0,2020-02-29,"(1065.75, 1414.0]",1,6,-5
31040.0,2020-02-29,"(426.685, 505.75]",1,1,0
31040.0,2020-02-29,"(584.5, 663.25]",1,2,-1
31040.0,2020-02-29,"(663.25, 742.0]",2,3,-1
31041.0,2020-02-29,"(1030.75, 1055.0]",1,1,0
31042.0,2020-02-29,"(558.548, 672.0]",2,6,-4
31042.0,2020-02-29,"(672.0, 785.0]",4,6,-2
31042.0,2020-02-29,"(898.0, 1011.0]",5,2,3
31043.0,2020-02-29,"(587.383, 742.25]",4,7,-3
31043.0,2020-02-29,"(896.5, 1050.75]",2,4,-2
31043.0,2020-02-29,"(1050.75, 1205.0]",1,3,-2
31044.0,2020-02-29,"(517.563, 627.25]",1,1,0
31044.0,2020-02-29,"(736.5, 845.75]",2,1,1
31045.0,2020-02-29,"(815.814, 862.5]",1,1,0
31046.0,2020-02-29,"(495.287, 674.25]",1,2,-1
31046.0,2020-02-29,"(1030.75, 1209.0]",1,2,-1
31047.0,2020-02-29,"(680.5, 883.0]",2,1,1
31047.0,2020-02-29,"(883.0, 1085.5]",1,3,-2
,,,,2.0,
,,,,1.0,
,,,,1.0,
,,,,1.0,
,,,,1.0,
31051.0,2020-02-29,"(881.856, 918.0]",1,1,0
31051.0,2020-02-29,"(954.0, 990.0]",1,1,0
31052.0,2020-02-29,"(910.5, 1003.0]",1,1,0
,,,,1.0,
,,,,1.0,
,,,,1.0,
,,,,1.0,
31055.0,2020-02-29,"(672.25, 710.0]",1,1,0
31056.0,2020-02-29,"(666.0, 714.0]",1,1,0
,,,,2.0,
,,,,2.0,
31059.0,2020-02-29,"(796.828, 840.0]",1,2,-1
31059.0,2020-02-29,"(926.0, 969.0]",1,2,-1
31060.0,2020-02-29,"(534.402, 684.5]",2,2,0
31060.0,2020-02-29,"(684.5, 834.0]",1,2,-1
31060.0,2020-02-29,"(834.0, 983.5]",2,4,-2
31061.0,2020-02-29,"(732.822, 777.5]",1,1,0
31061.0,2020-02-29,"(822.0, 866.5]",1,1,0
31062.0,2020-02-29,"(500.45, 638.5]",3,3,0
31062.0,2020-02-29,"(913.5, 1051.0]",2,4,-2
,,,,2.0,
31064.0,2020-02-29,"(623.42, 769.0]",3,3,0
31064.0,2020-02-29,"(769.0, 914.0]",3,5,-2
31064.0,2020-02-29,"(914.0, 1059.0]",2,4,-2
31064.0,2020-02-29,"(1059.0, 1204.0]",1,2,-1
,,,,2.0,
31066.0,2020-02-29,"(1023.812, 1071.0]",3,6,-3
31066.0,2020-02-29,"(1165.0, 1212.0]",3,3,0
31067.0,2020-02-29,"(-0.97, 242.5]",1,2,-1
31067.0,2020-02-29,"(727.5, 970.0]",1,1,0
31068.0,2020-02-29,"(71.658, 408.5]",1,1,0
31068.0,2020-02-29,"(744.0, 1079.5]",1,1,0
31068.0,2020-02-29,"(1079.5, 1415.0]",2,3,-1
31069.0,2020-02-29,"(662.25, 910.5]",1,1,0
31069.0,2020-02-29,"(1158.75, 1407.0]",1,2,-1
31070.0,2020-02-29,"(560.556, 672.0]",1,3,-2
31070.0,2020-02-29,"(672.0, 783.0]",1,2,-1
31070.0,2020-02-29,"(783.0, 894.0]",1,2,-1
31070.0,2020-02-29,"(894.0, 1005.0]",3,3,0
31071.0,2020-02-29,"(648.457, 784.75]",1,4,-3
31071.0,2020-02-29,"(784.75, 920.5]",1,1,0
31071.0,2020-02-29,"(920.5, 1056.25]",1,2,-1
31071.0,2020-02-29,"(1056.25, 1192.0]",1,1,0
,,,,2.0,
,,,,2.0,
31074.0,2020-02-29,"(684.5, 924.0]",1,1,0
31075.0,2020-02-29,"(822.454, 959.5]",1,4,-3
31075.0,2020-02-29,"(1232.5, 1369.0]",1,1,0
,,,,1.0,
,,,,1.0,
31077.0,2020-02-29,"(146.199, 347.25]",1,1,0
31077.0,2020-02-29,"(347.25, 547.5]",1,1,0
31077.0,2020-02-29,"(747.75, 948.0]",2,4,-2
,,,,2.0,
31079.0,2020-02-29,"(492.214, 689.5]",1,4,-3
31079.0,2020-02-29,"(689.5, 886.0]",1,2,-1
31079.0,2020-02-29,"(886.0, 1082.5]",3,5,-2
31079.0,2020-02-29,"(1082.5, 1279.0]",2,2,0
31080.0,2020-02-29,"(895.0, 1118.0]",1,2,-1
31080.0,2020-02-29,"(1118.0, 1341.0]",1,1,0
,,,,1.0,
,,,,1.0,
31082.0,2020-02-29,"(757.5, 1010.0]",2,1,1
31083.0,2020-02-29,"(665.61, 763.5]",1,3,-2
31083.0,2020-02-29,"(763.5, 861.0]",1,1,0
31083.0,2020-02-29,"(958.5, 1056.0]",1,1,0
31084.0,2020-02-29,"(674.414, 821.5]",1,3,-2
31084.0,2020-02-29,"(1114.5, 1261.0]",1,1,0
31085.0,2020-02-29,"(694.403, 844.25]",4,6,-2
31085.0,2020-02-29,"(1142.75, 1292.0]",1,1,0
31086.0,2020-02-29,"(491.5, 734.75]",2,1,1
31086.0,2020-02-29,"(734.75, 978.0]",1,3,-2
31087.0,2020-02-29,"(1105.0, 1119.0]",1,1,0
,,,,1.0,
,,,,2.0,
31089.0,2020-02-29,"(496.239, 687.25]",2,3,-1
31089.0,2020-02-29,"(687.25, 877.5]",2,6,-4
31089.0,2020-02-29,"(877.5, 1067.75]",1,4,-3
31089.0,2020-02-29,"(1067.75, 1258.0]",1,1,0
31090.0,2020-02-29,"(632.893, 659.75]",1,1,0
31091.0,2020-02-29,"(13.752, 327.0]",1,1,0
31091.0,2020-02-29,"(639.0, 951.0]",2,2,0
31091.0,2020-02-29,"(951.0, 1263.0]",1,2,-1
31092.0,2020-02-29,"(965.75, 1004.0]",1,1,0
31093.0,2020-02-29,"(73.004, 323.0]",1,1,0
31093.0,2020-02-29,"(572.0, 821.0]",1,5,-4
,,,,2.0,
,,,,2.0,
31096.0,2020-02-29,"(604.5, 627.0]",1,1,0
31097.0,2020-02-29,"(921.25, 1058.0]",1,1,0
31098.0,2020-02-29,"(879.0, 996.0]",2,1,1
31099.0,2020-02-29,"(949.5, 1086.25]",1,1,0
31099.0,2020-02-29,"(1086.25, 1223.0]",2,1,1
31100.0,2020-02-29,"(459.273, 641.75]",2,3,-1
31100.0,2020-02-29,"(641.75, 823.5]",1,1,0
31100.0,2020-02-29,"(823.5, 1005.25]",1,4,-3
31100.0,2020-02-29,"(1005.25, 1187.0]",3,6,-3
31101.0,2020-02-29,"(354.75, 702.5]",26,2,24
31101.0,2020-02-29,"(702.5, 1050.25]",43,36,7
31101.0,2020-02-29,"(1050.25, 1398.0]",22,64,-42
31102.0,2020-02-29,"(35.673, 368.75]",1,5,-4
31102.0,2020-02-29,"(368.75, 700.5]",2,15,-13
31102.0,2020-02-29,"(700.5, 1032.25]",1,5,-4
31102.0,2020-02-29,"(1032.25, 1364.0]",2,4,-2
31103.0,2020-02-29,"(38.66, 375.0]",1,1,0
31103.0,2020-02-29,"(375.0, 710.0]",7,24,-17
31103.0,2020-02-29,"(710.0, 1045.0]",5,22,-17
31103.0,2020-02-29,"(1045.0, 1380.0]",8,22,-14
31104.0,2020-02-29,"(27.652, 366.0]",1,8,-7
31104.0,2020-02-29,"(366.0, 703.0]",9,19,-10
31104.0,2020-02-29,"(703.0, 1040.0]",13,30,-17
31104.0,2020-02-29,"(1040.0, 1377.0]",11,17,-6
31105.0,2020-02-29,"(80.891, 359.25]",1,1,0
31105.0,2020-02-29,"(359.25, 636.5]",6,8,-2
31105.0,2020-02-29,"(636.5, 913.75]",4,10,-6
31105.0,2020-02-29,"(913.75, 1191.0]",2,5,-3
31106.0,2020-02-29,"(531.222, 726.5]",1,2,-1
31106.0,2020-02-29,"(921.0, 1115.5]",1,2,-1
31106.0,2020-02-29,"(1115.5, 1310.0]",1,1,0
31107.0,2020-02-29,"(59.734, 377.5]",2,3,-1
31107.0,2020-02-29,"(377.5, 694.0]",5,17,-12
31107.0,2020-02-29,"(694.0, 1010.5]",3,16,-13
31107.0,2020-02-29,"(1010.5, 1327.0]",4,8,-4
31108.0,2020-02-29,"(414.025, 658.75]",5,14,-9
31108.0,2020-02-29,"(658.75, 902.5]",12,25,-13
31108.0,2020-02-29,"(902.5, 1146.25]",10,19,-9
31108.0,2020-02-29,"(1146.25, 1390.0]",11,11,0
31109.0,2020-02-29,"(15.841, 306.75]",1,1,0
31109.0,2020-02-29,"(306.75, 596.5]",1,5,-4
31109.0,2020-02-29,"(596.5, 886.25]",14,24,-10
31109.0,2020-02-29,"(886.25, 1176.0]",15,20,-5
31110.0,2020-02-29,"(64.649, 403.75]",2,2,0
31110.0,2020-02-29,"(403.75, 741.5]",14,26,-12
31110.0,2020-02-29,"(741.5, 1079.25]",8,19,-11
31110.0,2020-02-29,"(1079.25, 1417.0]",3,9,-6
31111.0,2020-02-29,"(117.706, 442.5]",1,3,-2
31111.0,2020-02-29,"(442.5, 766.0]",5,8,-3
31111.0,2020-02-29,"(766.0, 1089.5]",7,13,-6
31111.0,2020-02-29,"(1089.5, 1413.0]",8,15,-7
31112.0,2020-02-29,"(649.548, 763.0]",1,2,-1
31112.0,2020-02-29,"(989.0, 1102.0]",3,6,-3
31113.0,2020-02-29,"(98.666, 433.5]",2,2,0
31113.0,2020-02-29,"(433.5, 767.0]",3,16,-13
31113.0,2020-02-29,"(767.0, 1100.5]",3,13,-10
31113.0,2020-02-29,"(1100.5, 1434.0]",2,6,-4
31114.0,2020-02-29,"(4.614, 352.5]",3,9,-6
31114.0,2020-02-29,"(352.5, 699.0]",4,9,-5
31114.0,2020-02-29,"(699.0, 1045.5]",10,25,-15
31114.0,2020-02-29,"(1045.5, 1392.0]",11,21,-10
31115.0,2020-02-29,"(90.704, 416.0]",1,2,-1
31115.0,2020-02-29,"(416.0, 740.0]",2,14,-12
31115.0,2020-02-29,"(740.0, 1064.0]",4,14,-10
31115.0,2020-02-29,"(1064.0, 1388.0]",3,6,-3
31116.0,2020-02-29,"(225.79, 529.5]",6,7,-1
31116.0,2020-02-29,"(529.5, 832.0]",10,21,-11
31116.0,2020-02-29,"(832.0, 1134.5]",18,29,-11
31116.0,2020-02-29,"(1134.5, 1437.0]",4,13,-9
31117.0,2020-02-29,"(-1.391, 347.75]",1,1,0
31117.0,2020-02-29,"(347.75, 695.5]",2,10,-8
31117.0,2020-02-29,"(695.5, 1043.25]",3,5,-2
31117.0,2020-02-29,"(1043.25, 1391.0]",3,7,-4
31118.0,2020-02-29,"(3.58, 360.0]",4,4,0
31118.0,2020-02-29,"(360.0, 715.0]",3,11,-8
31118.0,2020-02-29,"(715.0, 1070.0]",3,10,-7
31118.0,2020-02-29,"(1070.0, 1425.0]",4,6,-2
31119.0,2020-02-29,"(342.5, 671.0]",9,2,7
31119.0,2020-02-29,"(671.0, 999.5]",5,19,-14
31119.0,2020-02-29,"(999.5, 1328.0]",8,12,-4
31120.0,2020-02-29,"(37.647, 377.25]",1,2,-1
31120.0,2020-02-29,"(377.25, 715.5]",3,6,-3
31120.0,2020-02-29,"(715.5, 1053.75]",8,15,-7
31120.0,2020-02-29,"(1053.75, 1392.0]",8,10,-2
31121.0,2020-02-29,"(67.892, 346.0]",1,4,-3
31121.0,2020-02-29,"(346.0, 623.0]",1,6,-5
31121.0,2020-02-29,"(623.0, 900.0]",5,10,-5
31121.0,2020-02-29,"(900.0, 1177.0]",4,8,-4
31122.0,2020-02-29,"(11.653, 349.75]",4,6,-2
31122.0,2020-02-29,"(349.75, 686.5]",2,4,-2
31122.0,2020-02-29,"(686.5, 1023.25]",3,6,-3
31122.0,2020-02-29,"(1023.25, 1360.0]",3,6,-3
31123.0,2020-02-29,"(592.75, 840.5]",3,6,-3
31124.0,2020-02-29,"(6.635, 349.25]",1,2,-1
31124.0,2020-02-29,"(349.25, 690.5]",11,17,-6
31124.0,2020-02-29,"(690.5, 1031.75]",11,37,-26
31124.0,2020-02-29,"(1031.75, 1373.0]",10,26,-16
31125.0,2020-02-29,"(513.075, 745.25]",7,19,-12
31125.0,2020-02-29,"(745.25, 976.5]",5,24,-19
31125.0,2020-02-29,"(976.5, 1207.75]",6,7,-1
31125.0,2020-02-29,"(1207.75, 1439.0]",2,6,-4
31126.0,2020-02-29,"(18.754, 331.5]",4,8,-4
31126.0,2020-02-29,"(331.5, 643.0]",1,12,-11
31126.0,2020-02-29,"(643.0, 954.5]",2,14,-12
31126.0,2020-02-29,"(954.5, 1266.0]",8,19,-11
31127.0,2020-02-29,"(501.143, 716.25]",4,6,-2
31127.0,2020-02-29,"(716.25, 930.5]",2,7,-5
31127.0,2020-02-29,"(930.5, 1144.75]",3,9,-6
31127.0,2020-02-29,"(1144.75, 1359.0]",2,4,-2
31128.0,2020-02-29,"(341.943, 607.25]",5,9,-4
31128.0,2020-02-29,"(607.25, 871.5]",10,21,-11
31128.0,2020-02-29,"(871.5, 1135.75]",7,20,-13
31128.0,2020-02-29,"(1135.75, 1400.0]",7,9,-2
31129.0,2020-02-29,"(613.26, 799.0]",2,4,-2
31129.0,2020-02-29,"(799.0, 984.0]",1,3,-2
31129.0,2020-02-29,"(984.0, 1169.0]",5,8,-3
31129.0,2020-02-29,"(1169.0, 1354.0]",2,4,-2
31130.0,2020-02-29,"(522.098, 748.5]",4,12,-8
31130.0,2020-02-29,"(748.5, 974.0]",5,8,-3
31130.0,2020-02-29,"(974.0, 1199.5]",2,6,-4
31130.0,2020-02-29,"(1199.5, 1425.0]",3,3,0
31131.0,2020-02-29,"(600.5, 847.0]",6,1,5
31131.0,2020-02-29,"(847.0, 1093.5]",2,9,-7
31131.0,2020-02-29,"(1093.5, 1340.0]",1,5,-4
31200.0,2020-02-29,"(26.658, 363.5]",5,5,0
31200.0,2020-02-29,"(363.5, 699.0]",10,10,0
31200.0,2020-02-29,"(699.0, 1034.5]",11,25,-14
31200.0,2020-02-29,"(1034.5, 1370.0]",11,20,-9
31201.0,2020-02-29,"(10.584, 366.0]",3,8,-5
31201.0,2020-02-29,"(366.0, 720.0]",19,29,-10
31201.0,2020-02-29,"(720.0, 1074.0]",30,53,-23
31201.0,2020-02-29,"(1074.0, 1428.0]",10,18,-8
,,,,2.0,
31203.0,2020-02-29,"(2.575, 360.25]",1,8,-7
31203.0,2020-02-29,"(360.25, 716.5]",9,18,-9
31203.0,2020-02-29,"(716.5, 1072.75]",22,31,-9
31203.0,2020-02-29,"(1072.75, 1429.0]",22,32,-10
31204.0,2020-02-29,"(503.126, 722.5]",2,10,-8
31204.0,2020-02-29,"(722.5, 941.0]",5,10,-5
31204.0,2020-02-29,"(941.0, 1159.5]",8,11,-3
31204.0,2020-02-29,"(1159.5, 1378.0]",5,6,-1
31205.0,2020-02-29,"(361.006, 610.5]",2,2,0
31205.0,2020-02-29,"(610.5, 859.0]",6,9,-3
31205.0,2020-02-29,"(859.0, 1107.5]",4,14,-10
31205.0,2020-02-29,"(1107.5, 1356.0]",1,2,-1
31206.0,2020-02-29,"(926.5, 948.0]",1,1,0
31207.0,2020-02-29,"(515.101, 740.75]",6,12,-6
31207.0,2020-02-29,"(740.75, 965.5]",1,5,-4
31207.0,2020-02-29,"(965.5, 1190.25]",3,6,-3
31207.0,2020-02-29,"(1190.25, 1415.0]",2,3,-1
31208.0,2020-02-29,"(399.061, 634.75]",4,5,-1
31208.0,2020-02-29,"(634.75, 869.5]",4,4,0
31208.0,2020-02-29,"(869.5, 1104.25]",3,6,-3
31208.0,2020-02-29,"(1104.25, 1339.0]",1,2,-1
31209.0,2020-02-29,"(445.75, 683.5]",4,1,3
31209.0,2020-02-29,"(683.5, 921.25]",9,8,1
31209.0,2020-02-29,"(921.25, 1159.0]",1,24,-23
31211.0,2020-02-29,"(709.418, 855.5]",2,4,-2
31211.0,2020-02-29,"(855.5, 1001.0]",1,2,-1
31211.0,2020-02-29,"(1001.0, 1146.5]",5,8,-3
31211.0,2020-02-29,"(1146.5, 1292.0]",2,4,-2
31212.0,2020-02-29,"(34.707, 359.25]",3,3,0
31212.0,2020-02-29,"(359.25, 682.5]",5,13,-8
31212.0,2020-02-29,"(682.5, 1005.75]",12,24,-12
31212.0,2020-02-29,"(1005.75, 1329.0]",5,6,-1
31213.0,2020-02-29,"(309.902, 585.5]",8,12,-4
31213.0,2020-02-29,"(585.5, 860.0]",4,7,-3
31213.0,2020-02-29,"(860.0, 1134.5]",2,6,-4
31213.0,2020-02-29,"(1134.5, 1409.0]",4,5,-1
31214.0,2020-02-29,"(16.579, 373.25]",2,4,-2
31214.0,2020-02-29,"(373.25, 728.5]",14,27,-13
31214.0,2020-02-29,"(728.5, 1083.75]",17,32,-15
31214.0,2020-02-29,"(1083.75, 1439.0]",10,22,-12
31215.0,2020-02-29,"(661.25, 849.5]",2,4,-2
31215.0,2020-02-29,"(849.5, 1037.0]",6,7,-1
31215.0,2020-02-29,"(1037.0, 1224.5]",2,5,-3
31215.0,2020-02-29,"(1224.5, 1412.0]",1,1,0
31216.0,2020-02-29,"(583.75, 754.5]",2,1,1
31216.0,2020-02-29,"(925.25, 1096.0]",2,2,0
31217.0,2020-02-29,"(539.442, 679.5]",2,5,-3
31217.0,2020-02-29,"(819.0, 958.5]",5,5,0
31217.0,2020-02-29,"(958.5, 1098.0]",2,3,-1
31218.0,2020-02-29,"(665.0, 772.0]",3,2,1
31218.0,2020-02-29,"(772.0, 879.0]",2,4,-2
31218.0,2020-02-29,"(879.0, 986.0]",1,2,-1
31219.0,2020-02-29,"(626.647, 715.25]",1,2,-1
31219.0,2020-02-29,"(715.25, 803.5]",1,1,0
31219.0,2020-02-29,"(803.5, 891.75]",4,5,-1
31219.0,2020-02-29,"(891.75, 980.0]",4,7,-3
31220.0,2020-02-29,"(844.75, 969.0]",1,1,0
31221.0,2020-02-29,"(40.675, 373.25]",1,3,-2
31221.0,2020-02-29,"(373.25, 704.5]",4,6,-2
31221.0,2020-02-29,"(704.5, 1035.75]",10,16,-6
31221.0,2020-02-29,"(1035.75, 1367.0]",5,7,-2
31222.0,2020-02-29,"(441.079, 672.25]",3,6,-3
31222.0,2020-02-29,"(902.5, 1132.75]",3,1,2
31222.0,2020-02-29,"(1132.75, 1363.0]",2,5,-3
31223.0,2020-02-29,"(375.0, 708.0]",7,1,6
31223.0,2020-02-29,"(708.0, 1041.0]",10,10,0
31223.0,2020-02-29,"(1041.0, 1374.0]",5,22,-17
31224.0,2020-02-29,"(741.328, 910.0]",2,5,-3
31224.0,2020-02-29,"(910.0, 1078.0]",2,4,-2
31224.0,2020-02-29,"(1078.0, 1246.0]",2,5,-3
31224.0,2020-02-29,"(1246.0, 1414.0]",2,4,-2
31225.0,2020-02-29,"(490.066, 724.5]",9,10,-1
31225.0,2020-02-29,"(724.5, 958.0]",3,3,0
31225.0,2020-02-29,"(1191.5, 1425.0]",1,1,0
31226.0,2020-02-29,"(621.0, 883.0]",2,2,0
31226.0,2020-02-29,"(883.0, 1145.0]",4,1,3
31227.0,2020-02-29,"(656.5, 937.25]",4,1,3
31227.0,2020-02-29,"(937.25, 1218.0]",1,4,-3
31228.0,2020-02-29,"(355.25, 679.5]",18,1,17
31228.0,2020-02-29,"(679.5, 1003.75]",9,28,-19
31228.0,2020-02-29,"(1003.75, 1328.0]",11,16,-5
31229.0,2020-02-29,"(5.615, 353.25]",2,6,-4
31229.0,2020-02-29,"(353.25, 699.5]",14,37,-23
31229.0,2020-02-29,"(699.5, 1045.75]",21,46,-25
31229.0,2020-02-29,"(1045.75, 1392.0]",14,30,-16
31230.0,2020-02-29,"(486.154, 698.5]",10,14,-4
31230.0,2020-02-29,"(698.5, 910.0]",1,1,0
31230.0,2020-02-29,"(910.0, 1121.5]",2,7,-5
31230.0,2020-02-29,"(1121.5, 1333.0]",4,11,-7
31231.0,2020-02-29,"(565.791, 618.25]",1,1,0
31232.0,2020-02-29,"(367.5, 695.0]",9,2,7
31232.0,2020-02-29,"(695.0, 1022.5]",11,14,-3
31232.0,2020-02-29,"(1022.5, 1350.0]",10,18,-8
31233.0,2020-02-29,"(500.068, 734.0]",3,4,-1
31233.0,2020-02-29,"(734.0, 967.0]",1,2,-1
31233.0,2020-02-29,"(967.0, 1200.0]",1,4,-3
31234.0,2020-02-29,"(12.759, 324.25]",4,7,-3
31234.0,2020-02-29,"(324.25, 634.5]",9,13,-4
31234.0,2020-02-29,"(634.5, 944.75]",14,20,-6
31234.0,2020-02-29,"(944.75, 1255.0]",3,7,-4
31235.0,2020-02-29,"(897.0, 934.0]",2,1,1
31235.0,2020-02-29,"(971.0, 1008.0]",1,2,-1
31236.0,2020-02-29,"(440.25, 772.5]",9,1,8
31236.0,2020-02-29,"(772.5, 1104.75]",5,14,-9
31236.0,2020-02-29,"(1104.75, 1437.0]",2,14,-12
31237.0,2020-02-29,"(15.64, 357.0]",2,2,0
31237.0,2020-02-29,"(357.0, 697.0]",4,10,-6
31237.0,2020-02-29,"(697.0, 1037.0]",6,17,-11
31237.0,2020-02-29,"(1037.0, 1377.0]",5,13,-8
31238.0,2020-02-29,"(47.851, 336.25]",1,2,-1
31238.0,2020-02-29,"(336.25, 623.5]",4,6,-2
31238.0,2020-02-29,"(623.5, 910.75]",3,5,-2
31238.0,2020-02-29,"(910.75, 1198.0]",2,3,-1
31239.0,2020-02-29,"(5.81, 304.5]",1,1,0
31239.0,2020-02-29,"(304.5, 602.0]",3,3,0
31239.0,2020-02-29,"(602.0, 899.5]",15,20,-5
31239.0,2020-02-29,"(899.5, 1197.0]",8,17,-9
31240.0,2020-02-29,"(589.455, 726.25]",4,11,-7
31240.0,2020-02-29,"(726.25, 862.5]",1,1,0
31240.0,2020-02-29,"(998.75, 1135.0]",1,2,-1
31241.0,2020-02-29,"(200.778, 507.5]",1,5,-4
31241.0,2020-02-29,"(507.5, 813.0]",5,22,-17
31241.0,2020-02-29,"(813.0, 1118.5]",10,20,-10
31241.0,2020-02-29,"(1118.5, 1424.0]",9,15,-6
31242.0,2020-02-29,"(356.081, 586.75]",1,1,0
31242.0,2020-02-29,"(586.75, 816.5]",3,7,-4
31242.0,2020-02-29,"(816.5, 1046.25]",4,8,-4
31242.0,2020-02-29,"(1046.25, 1276.0]",2,8,-6
31243.0,2020-02-29,"(470.183, 675.25]",1,2,-1
31243.0,2020-02-29,"(675.25, 879.5]",2,2,0
31243.0,2020-02-29,"(879.5, 1083.75]",5,15,-10
31243.0,2020-02-29,"(1083.75, 1288.0]",3,4,-1
31244.0,2020-02-29,"(430.16, 641.0]",5,7,-2
31244.0,2020-02-29,"(641.0, 851.0]",2,5,-3
31244.0,2020-02-29,"(851.0, 1061.0]",5,6,-1
31244.0,2020-02-29,"(1061.0, 1271.0]",1,5,-4
31245.0,2020-02-29,"(470.034, 712.5]",4,8,-4
31245.0,2020-02-29,"(712.5, 954.0]",10,16,-6
31245.0,2020-02-29,"(954.0, 1195.5]",7,14,-7
31245.0,2020-02-29,"(1195.5, 1437.0]",5,9,-4
31246.0,2020-02-29,"(65.658, 402.5]",1,1,0
31246.0,2020-02-29,"(402.5, 738.0]",5,8,-3
31246.0,2020-02-29,"(738.0, 1073.5]",16,28,-12
31246.0,2020-02-29,"(1073.5, 1409.0]",3,13,-10
31247.0,2020-02-29,"(456.374, 613.5]",6,7,-1
31247.0,2020-02-29,"(613.5, 770.0]",10,11,-1
31247.0,2020-02-29,"(770.0, 926.5]",10,17,-7
31247.0,2020-02-29,"(926.5, 1083.0]",9,13,-4
31248.0,2020-02-29,"(578.21, 776.5]",8,13,-5
31248.0,2020-02-29,"(776.5, 974.0]",9,24,-15
31248.0,2020-02-29,"(974.0, 1171.5]",5,13,-8
31248.0,2020-02-29,"(1171.5, 1369.0]",13,25,-12
31249.0,2020-02-29,"(697.706, 771.5]",1,3,-2
31249.0,2020-02-29,"(771.5, 845.0]",1,1,0
31249.0,2020-02-29,"(845.0, 918.5]",4,7,-3
31249.0,2020-02-29,"(918.5, 992.0]",1,1,0
31250.0,2020-02-29,"(700.332, 868.0]",1,1,0
31250.0,2020-02-29,"(868.0, 1035.0]",1,3,-2
31250.0,2020-02-29,"(1035.0, 1202.0]",4,5,-1
31250.0,2020-02-29,"(1202.0, 1369.0]",1,2,-1
31251.0,2020-02-29,"(421.017, 667.75]",2,5,-3
31251.0,2020-02-29,"(667.75, 913.5]",5,8,-3
31251.0,2020-02-29,"(913.5, 1159.25]",9,12,-3
31252.0,2020-02-29,"(47.707, 372.25]",1,2,-1
31252.0,2020-02-29,"(372.25, 695.5]",3,3,0
31252.0,2020-02-29,"(1018.75, 1342.0]",1,2,-1
31253.0,2020-02-29,"(472.5, 699.75]",2,1,1
31253.0,2020-02-29,"(699.75, 927.0]",1,2,-1
31254.0,2020-02-29,"(546.0, 803.0]",1,2,-1
31254.0,2020-02-29,"(803.0, 1060.0]",4,1,3
31255.0,2020-02-29,"(512.416, 659.0]",6,8,-2
31255.0,2020-02-29,"(805.0, 951.0]",3,1,2
31255.0,2020-02-29,"(951.0, 1097.0]",2,4,-2
31256.0,2020-02-29,"(661.38, 817.0]",1,4,-3
31256.0,2020-02-29,"(817.0, 972.0]",8,9,-1
31256.0,2020-02-29,"(972.0, 1127.0]",5,7,-2
31256.0,2020-02-29,"(1127.0, 1282.0]",1,3,-2
31257.0,2020-02-29,"(19.687, 349.25]",1,2,-1
31257.0,2020-02-29,"(349.25, 677.5]",5,10,-5
31257.0,2020-02-29,"(677.5, 1005.75]",9,21,-12
31257.0,2020-02-29,"(1005.75, 1334.0]",5,9,-4
31258.0,2020-02-29,"(445.306, 619.5]",2,7,-5
31258.0,2020-02-29,"(619.5, 793.0]",7,14,-7
31258.0,2020-02-29,"(793.0, 966.5]",5,16,-11
31258.0,2020-02-29,"(966.5, 1140.0]",15,29,-14
31259.0,2020-02-29,"(707.959, 718.25]",1,1,0
31260.0,2020-02-29,"(403.182, 608.5]",1,1,0
31260.0,2020-02-29,"(1017.5, 1222.0]",4,3,1
31261.0,2020-02-29,"(687.258, 873.5]",2,5,-3
31261.0,2020-02-29,"(873.5, 1059.0]",2,3,-1
31261.0,2020-02-29,"(1059.0, 1244.5]",6,7,-1
31261.0,2020-02-29,"(1244.5, 1430.0]",1,5,-4
31262.0,2020-02-29,"(369.968, 629.0]",1,1,0
31262.0,2020-02-29,"(629.0, 887.0]",4,6,-2
31262.0,2020-02-29,"(887.0, 1145.0]",1,4,-3
31262.0,2020-02-29,"(1145.0, 1403.0]",5,7,-2
31263.0,2020-02-29,"(506.242, 696.5]",5,7,-2
31263.0,2020-02-29,"(696.5, 886.0]",5,7,-2
31263.0,2020-02-29,"(886.0, 1075.5]",8,15,-7
31263.0,2020-02-29,"(1075.5, 1265.0]",3,4,-1
31264.0,2020-02-29,"(569.19, 772.5]",4,6,-2
31264.0,2020-02-29,"(772.5, 975.0]",3,4,-1
31264.0,2020-02-29,"(975.0, 1177.5]",3,7,-4
31265.0,2020-02-29,"(34.626, 379.5]",2,2,0
31265.0,2020-02-29,"(379.5, 723.0]",5,14,-9
31265.0,2020-02-29,"(723.0, 1066.5]",6,23,-17
31265.0,2020-02-29,"(1066.5, 1410.0]",9,14,-5
31266.0,2020-02-29,"(54.624, 400.0]",1,3,-2
31266.0,2020-02-29,"(400.0, 744.0]",6,27,-21
31266.0,2020-02-29,"(744.0, 1088.0]",11,23,-12
31266.0,2020-02-29,"(1088.0, 1432.0]",9,18,-9
31267.0,2020-02-29,"(394.0, 727.0]",5,1,4
31267.0,2020-02-29,"(727.0, 1060.0]",8,9,-1
31267.0,2020-02-29,"(1060.0, 1393.0]",4,16,-12
31268.0,2020-02-29,"(4.681, 335.75]",3,5,-2
31268.0,2020-02-29,"(335.75, 665.5]",10,16,-6
31268.0,2020-02-29,"(665.5, 995.25]",8,12,-4
31268.0,2020-02-29,"(995.25, 1325.0]",7,12,-5
31269.0,2020-02-29,"(510.173, 717.75]",7,10,-3
31269.0,2020-02-29,"(717.75, 924.5]",5,9,-4
31269.0,2020-02-29,"(924.5, 1131.25]",7,9,-2
31269.0,2020-02-29,"(1131.25, 1338.0]",1,5,-4
31270.0,2020-02-29,"(569.415, 716.25]",2,3,-1
31270.0,2020-02-29,"(716.25, 862.5]",3,4,-1
31270.0,2020-02-29,"(862.5, 1008.75]",3,4,-1
31270.0,2020-02-29,"(1008.75, 1155.0]",2,5,-3
31271.0,2020-02-29,"(608.329, 776.75]",7,10,-3
31271.0,2020-02-29,"(776.75, 944.5]",1,3,-2
31271.0,2020-02-29,"(944.5, 1112.25]",1,10,-9
31271.0,2020-02-29,"(1112.25, 1280.0]",2,4,-2
31272.0,2020-02-29,"(533.469, 666.75]",5,5,0
31272.0,2020-02-29,"(666.75, 799.5]",6,11,-5
31272.0,2020-02-29,"(799.5, 932.25]",6,10,-4
31272.0,2020-02-29,"(932.25, 1065.0]",7,13,-6
31273.0,2020-02-29,"(914.75, 964.0]",1,1,0
31274.0,2020-02-29,"(320.5, 611.0]",4,1,3
31274.0,2020-02-29,"(611.0, 901.5]",8,5,3
31274.0,2020-02-29,"(901.5, 1192.0]",4,12,-8
31275.0,2020-02-29,"(62.93, 331.5]",1,2,-1
31275.0,2020-02-29,"(331.5, 599.0]",1,1,0
31275.0,2020-02-29,"(599.0, 866.5]",3,5,-2
31275.0,2020-02-29,"(866.5, 1134.0]",2,4,-2
31276.0,2020-02-29,"(329.75, 589.5]",2,1,1
31276.0,2020-02-29,"(589.5, 849.25]",1,4,-3
31276.0,2020-02-29,"(849.25, 1109.0]",3,4,-1
31277.0,2020-02-29,"(455.538, 571.5]",1,1,0
31277.0,2020-02-29,"(571.5, 687.0]",1,1,0
31277.0,2020-02-29,"(687.0, 802.5]",2,8,-6
31277.0,2020-02-29,"(802.5, 918.0]",2,8,-6
31278.0,2020-02-29,"(424.5, 736.0]",6,2,4
31278.0,2020-02-29,"(736.0, 1047.5]",10,12,-2
31278.0,2020-02-29,"(1047.5, 1359.0]",7,19,-12
31279.0,2020-02-29,"(489.646, 578.5]",1,1,0
31279.0,2020-02-29,"(755.5, 844.0]",1,1,0
31280.0,2020-02-29,"(443.5, 730.0]",14,1,13
31280.0,2020-02-29,"(730.0, 1016.5]",5,26,-21
31280.0,2020-02-29,"(1016.5, 1303.0]",8,11,-3
